3,53658535300,53658566200,00000030900,a02,open
3,53658571500,53658609000,00000037500,a00,read
3,53658614000,53658615000,00000001000,a03,close
3,53658677800,53658693500,00000015700,a02,open
3,53658695500,53658728700,00000033200,a00,read
3,53658730900,53658731200,00000000300,a03,close
3,53658744000,53658753900,00000009900,a02,open
3,53658755800,53658769300,00000013500,a00,read
3,53658770800,53658771000,00000000200,a03,close
3,53669808100,53669810700,00000002600,a01,write
3,53669812700,53670075300,00000262600,a00,read
3,53669812700,53673130400,00003317700,a00,read
3,53673140300,53673150200,00000009900,a01,write
3,53673151800,53673153400,00000001600,a01,write
3,53673155000,53682453100,00009298100,a00,read
3,53682476300,53682488700,00000012400,a01,write
3,53682491500,53682493500,00000002000,a01,write
3,53717330600,53717374100,00000043500,a02,open
3,53717377300,53717379200,00000001900,a05,fstat
3,53717380600,53717436200,00000055600,a00,read
3,53717455200,53717532500,00000077300,a00,read
3,53717538200,53717539100,00000000900,a03,close
3,53717549200,53717555500,00000006300,a02,open
3,53717556600,53717556900,00000000300,a05,fstat
3,53717557400,53717615000,00000057600,a00,read
3,53717632500,53717633200,00000000700,a00,read
3,53717634800,53717635100,00000000300,a03,close
3,53717653000,53717662700,00000009700,a02,open
3,53718991600,53718994600,00000003000,a2f,recvmsg
3,53719002700,53719004700,00000002000,a07,poll
3,53719005300,53719007100,00000001800,a00,read
3,53719864900,53719867700,00000002800,a07,poll
3,53719868600,53719884200,00000015600,a14,writev
3,53719887100,53720022200,00000135100,a07,poll
3,53720024700,53720031400,00000006700,a2f,recvmsg
3,53720038000,53720201100,00000163100,a07,poll
3,53720203400,53720224700,00000021300,a2f,recvmsg
3,53720227700,53720309600,00000081900,a07,poll
3,53720311600,53720317300,00000005700,a2f,recvmsg
3,53720325200,53720325900,00000000700,a2f,recvmsg
3,53720353600,53720355700,00000002100,a07,poll
3,53720356300,53720358200,00000001900,a00,read
3,53720382700,53720383400,00000000700,a2f,recvmsg
3,53720385800,53720386300,00000000500,a2f,recvmsg
3,53721116400,53721143300,00000026900,a02,open
3,53721148200,53721182200,00000034000,a00,read
3,53721186500,53721187400,00000000900,a03,close
3,53721243100,53721256600,00000013500,a02,open
3,53721258500,53721288700,00000030200,a00,read
3,53721290500,53721290800,00000000300,a03,close
3,53721302800,53721311700,00000008900,a02,open
3,53721313400,53721325000,00000011600,a00,read
3,53721326500,53721326700,00000000200,a03,close
3,53721332000,53728045900,00006713900,a07,poll
3,53728083300,53728118100,00000034800,a02,open
3,53728124300,53728162900,00000038600,a00,read
3,53728168700,53728169700,00000001000,a03,close
3,53728235000,53728251600,00000016600,a02,open
3,53728254000,53728287600,00000033600,a00,read
3,53728289700,53728289900,00000000200,a03,close
3,53728303200,53728313900,00000010700,a02,open
3,53728315700,53728328400,00000012700,a00,read
3,53728329900,53728330100,00000000200,a03,close
1,55734116700,55734117500,00000000800,a0e,rt_sigprocmask
1,55734117600,55734117800,00000000200,a0e,rt_sigprocmask
1,55734119000,55734119400,00000000400,ae4,clock_gettime
1,55734120700,55734125200,00000004500,a00,read
1,55734135100,55734135300,00000000200,ae4,clock_gettime
1,55734136600,55734139700,00000003100,a17,select
1,55734140000,55734140200,00000000200,a0e,rt_sigprocmask
1,55734140400,55734140600,00000000200,a0e,rt_sigprocmask
1,55734140800,55734141000,00000000200,ae4,clock_gettime
1,55734141600,55734146900,00000005300,a01,write
1,55734147200,55734148800,00000001600,a10,ioctl
1,55734150200,55734150300,00000000100,ae4,clock_gettime
1,55734150800,55734256200,00000105400,a17,select
1,55734258100,55734258900,00000000800,a0e,rt_sigprocmask
1,55734259000,55734259200,00000000200,a0e,rt_sigprocmask
1,55734260300,55734260800,00000000500,ae4,clock_gettime
1,55734261800,55734265100,00000003300,a00,read
1,55734275100,55734275300,00000000200,ae4,clock_gettime
1,55734276500,55734278600,00000002100,a17,select
1,55734278800,55734279100,00000000300,a0e,rt_sigprocmask
1,55734279200,55734279400,00000000200,a0e,rt_sigprocmask
1,55734279600,55734279700,00000000100,ae4,clock_gettime
1,55734280500,55734296500,00000016000,a01,write
1,55734297500,55734297600,00000000100,ae4,clock_gettime
1,55734298100,55734430900,00000132800,a17,select
1,55734433300,55734434400,00000001100,a0e,rt_sigprocmask
1,55734434700,55734434900,00000000200,a0e,rt_sigprocmask
1,55734436500,55734437200,00000000700,ae4,clock_gettime
1,55734438800,55734445200,00000006400,a00,read
1,55734458800,55734459000,00000000200,ae4,clock_gettime
1,55734460700,55734464900,00000004200,a17,select
1,55734465200,55734465600,00000000400,a0e,rt_sigprocmask
1,55734465800,55734466100,00000000300,a0e,rt_sigprocmask
1,55734466300,55734466500,00000000200,ae4,clock_gettime
1,55734467400,55734474600,00000007200,a01,write
1,55734475000,55734477100,00000002100,a10,ioctl
1,55734479000,55734479300,00000000300,ae4,clock_gettime
1,55741774400,55741797600,00000023200,ae4,clock_gettime
1,55741799000,55741803300,00000004300,a17,select
1,55741803900,55741804400,00000000500,a0e,rt_sigprocmask
1,55741804600,55741804900,00000000300,a0e,rt_sigprocmask
1,55741805200,55741805400,00000000200,ae4,clock_gettime
1,55741806000,55741808400,00000002400,a00,read
1,55741815300,55741815500,00000000200,ae4,clock_gettime
1,55741816100,55741818000,00000001900,a17,select
1,55741818400,55741818700,00000000300,a0e,rt_sigprocmask
1,55741818900,55741819200,00000000300,a0e,rt_sigprocmask
1,55741819400,55741819600,00000000200,ae4,clock_gettime
1,55741820200,55741823800,00000003600,a01,write
1,55741824700,55741824800,00000000100,ae4,clock_gettime
1,55741825400,55741882800,00000057400,a17,select
1,55741885400,55741886500,00000001100,a0e,rt_sigprocmask
1,55741886700,55741887000,00000000300,a0e,rt_sigprocmask
1,55741888600,55741889300,00000000700,ae4,clock_gettime
1,55741890900,55741897200,00000006300,a00,read
1,55741910800,55741911200,00000000400,ae4,clock_gettime
1,55741912800,55741917000,00000004200,a17,select
1,55741917400,55741917600,00000000200,a0e,rt_sigprocmask
1,55741917800,55741918200,00000000400,a0e,rt_sigprocmask
1,55741918500,55741918700,00000000200,ae4,clock_gettime
1,55741919600,55741926600,00000007000,a01,write
1,55741928400,55741928700,00000000300,ae4,clock_gettime
1,55741929300,55742022300,00000093000,a17,select
1,55742025000,55742026200,00000001200,a0e,rt_sigprocmask
1,55742026500,55742026900,00000000400,a0e,rt_sigprocmask
1,55741929300,55744936900,00003007600,a17,select
1,55744938700,55744939500,00000000800,a0e,rt_sigprocmask
1,55744939600,55744939900,00000000300,a0e,rt_sigprocmask
1,55744941000,55744941500,00000000500,ae4,clock_gettime
1,55744942600,55744947200,00000004600,a00,read
1,55744957000,55744957200,00000000200,ae4,clock_gettime
1,55744958400,55744961500,00000003100,a17,select
1,55744961800,55744962100,00000000300,a0e,rt_sigprocmask
1,55744962300,55744962400,00000000100,a0e,rt_sigprocmask
1,55744962600,55744962700,00000000100,ae4,clock_gettime
1,55744963400,55744968300,00000004900,a01,write
1,55744969700,55744969900,00000000200,ae4,clock_gettime
1,55744970400,55745077500,00000107100,a17,select
1,55745079500,55745080300,00000000800,a0e,rt_sigprocmask
1,55745080500,55745080800,00000000300,a0e,rt_sigprocmask
1,55745082100,55745082600,00000000500,ae4,clock_gettime
1,55745083700,55745087200,00000003500,a00,read
1,55745100000,55745100400,00000000400,ae4,clock_gettime
1,55745101900,55745104800,00000002900,a17,select
1,55745105100,55745105600,00000000500,a0e,rt_sigprocmask
1,55745105800,55745106000,00000000200,a0e,rt_sigprocmask
1,55745106300,55745106500,00000000200,ae4,clock_gettime
1,55745107400,55745127200,00000019800,a01,write
1,55745128600,55745128900,00000000300,ae4,clock_gettime
1,55745129700,55745132500,00000002800,a17,select
1,55745132800,55745133000,00000000200,a0e,rt_sigprocmask
1,55745133200,55745133400,00000000200,a0e,rt_sigprocmask
1,55745133500,55745133700,00000000200,ae4,clock_gettime
1,55745134000,55745135400,00000001400,a00,read
1,55745139700,55745139800,00000000100,ae4,clock_gettime
1,55745140200,55745141400,00000001200,a17,select
1,55745141600,55745141800,00000000200,a0e,rt_sigprocmask
1,55745142000,55745142100,00000000100,a0e,rt_sigprocmask
1,55745142300,55745142400,00000000100,ae4,clock_gettime
1,55745142900,55745144900,00000002000,a01,write
1,55745145500,55745145600,00000000100,ae4,clock_gettime
1,55745536000,55745541200,00000005200,aca,futex
1,55745551000,55745570400,00000019400,a00,read
1,55745583700,55745591800,00000008100,a00,read
1,55745715000,55745717600,00000002600,a01,write
1,55745719300,55745723000,00000003700,a00,read
1,55745732600,55745733100,00000000500,a01,write
1,55745734100,55745734500,00000000400,a01,write
1,55745738000,55745740200,00000002200,a07,poll
1,55745742100,55745743000,00000000900,a07,poll
1,55745743500,55745744300,00000000800,a00,read
1,55745146000,55749699100,00004553100,a17,select
1,55749699700,55749699900,00000000200,a0e,rt_sigprocmask
1,55749700000,55749700000,00000000000,a0e,rt_sigprocmask
1,55749700400,55749700600,00000000200,ae4,clock_gettime
1,55749700900,55749702300,00000001400,a00,read
1,55749705400,55749705500,00000000100,ae4,clock_gettime
1,55749705900,55749706900,00000001000,a17,select
1,55749707000,55749707100,00000000100,a0e,rt_sigprocmask
1,55749707000,55749707100,00000000100,a0e,rt_sigprocmask
1,55749707200,55749707300,00000000100,ae4,clock_gettime
1,55749707500,55749709000,00000001500,a01,write
1,55749709200,55749709600,00000000400,a10,ioctl
1,55749710000,55749710100,00000000100,ae4,clock_gettime
1,55749710300,55749789200,00000078900,a17,select
1,55749789800,55749790100,00000000300,a0e,rt_sigprocmask
1,55749790100,55749790200,00000000100,a0e,rt_sigprocmask
1,55749790600,55749790700,00000000100,ae4,clock_gettime
1,55749791000,55749792000,00000001000,a00,read
1,55749795200,55749795200,00000000000,ae4,clock_gettime
1,55749795600,55749796300,00000000700,a17,select
1,55749796300,55749796400,00000000100,a0e,rt_sigprocmask
1,55749796500,55749796500,00000000000,a0e,rt_sigprocmask
1,55749796600,55749796600,00000000000,ae4,clock_gettime
1,55749796800,55749802000,00000005200,a01,write
1,55749802200,55749802200,00000000000,ae4,clock_gettime
1,55749802500,55754033000,00004230500,a17,select
1,55754034300,55754035000,00000000700,a0e,rt_sigprocmask
1,55754035100,55754035300,00000000200,a0e,rt_sigprocmask
1,55754036200,55754036600,00000000400,ae4,clock_gettime
1,55754037600,55754041300,00000003700,a00,read
1,55754049200,55754049400,00000000200,ae4,clock_gettime
1,55754050300,55754052700,00000002400,a17,select
1,55754053000,55754053100,00000000100,a0e,rt_sigprocmask
1,55754053300,55754053400,00000000100,a0e,rt_sigprocmask
1,55754053500,55754053700,00000000200,ae4,clock_gettime
1,55754054200,55754058600,00000004400,a01,write
1,55754058800,55754060000,00000001200,a10,ioctl
1,55754061100,55754061200,00000000100,ae4,clock_gettime
1,55754061600,55754178200,00000116600,a17,select
1,55754179600,55754180200,00000000600,a0e,rt_sigprocmask
1,55754180300,55754180500,00000000200,a0e,rt_sigprocmask
1,55754181400,55754181800,00000000400,ae4,clock_gettime
1,55754182500,55754185100,00000002600,a00,read
1,55754192900,55754193000,00000000100,ae4,clock_gettime
1,55754194100,55754195700,00000001600,a17,select
1,55754195900,55754196100,00000000200,a0e,rt_sigprocmask
1,55754196300,55754196300,00000000000,a0e,rt_sigprocmask
1,55754196500,55754196600,00000000100,ae4,clock_gettime
1,55754197100,55754209800,00000012700,a01,write
1,55754210500,55754210600,00000000100,ae4,clock_gettime
1,55754211000,55754273900,00000062900,a17,select
1,55754276100,55754277100,00000001000,a0e,rt_sigprocmask
1,55754277400,55754277600,00000000200,a0e,rt_sigprocmask
1,55754279000,55754279600,00000000600,ae4,clock_gettime
1,55754281000,55754286600,00000005600,a00,read
1,55754298800,55754299000,00000000200,ae4,clock_gettime
1,55754300500,55754304400,00000003900,a17,select
1,55754304700,55754305000,00000000300,a0e,rt_sigprocmask
1,55754305200,55754305400,00000000200,a0e,rt_sigprocmask
1,55754305600,55754305800,00000000200,ae4,clock_gettime
1,55754306600,55754312900,00000006300,a01,write
1,55754314700,55754314900,00000000200,ae4,clock_gettime
1,55754315500,55754399200,00000083700,a17,select
1,55754402200,55754403200,00000001000,a0e,rt_sigprocmask
1,55754403400,55754403800,00000000400,a0e,rt_sigprocmask
1,55754405300,55754406000,00000000700,ae4,clock_gettime
1,55754407400,55754411500,00000004100,a00,read
1,55754426600,55754426900,00000000300,ae4,clock_gettime
1,55754428800,55754432300,00000003500,a17,select
1,55754432800,55754433100,00000000300,a0e,rt_sigprocmask
1,55754433400,55754433700,00000000300,a0e,rt_sigprocmask
1,55754434000,55754434300,00000000300,ae4,clock_gettime
1,55754435400,55754459400,00000024000,a01,write
1,55754465400,55754465800,00000000400,ae4,clock_gettime
1,55754466700,55754470200,00000003500,a17,select
1,55754470700,55754471200,00000000500,a0e,rt_sigprocmask
1,55754471500,55754471700,00000000200,a0e,rt_sigprocmask
1,55754472000,55754472300,00000000300,ae4,clock_gettime
1,55754472700,55754475000,00000002300,a00,read
1,55754483600,55754483800,00000000200,ae4,clock_gettime
1,55754484400,55754485900,00000001500,a17,select
1,55754486200,55754486400,00000000200,a0e,rt_sigprocmask
1,55754486700,55754486900,00000000200,a0e,rt_sigprocmask
1,55754487100,55754487300,00000000200,ae4,clock_gettime
1,55754487800,55754490900,00000003100,a01,write
1,55754491500,55754491800,00000000300,ae4,clock_gettime
1,55754492300,55759367100,00004874800,a17,select
1,55759367800,55759368200,00000000400,a0e,rt_sigprocmask
1,55759368200,55759368300,00000000100,a0e,rt_sigprocmask
1,55759368700,55759369000,00000000300,ae4,clock_gettime
1,55759369400,55759371200,00000001800,a00,read
1,55759375100,55759375200,00000000100,ae4,clock_gettime
1,55759375700,55759376800,00000001100,a17,select
1,55759376900,55759377100,00000000200,a0e,rt_sigprocmask
1,55759377100,55759377200,00000000100,a0e,rt_sigprocmask
1,55759377300,55759377400,00000000100,ae4,clock_gettime
1,55759377600,55759379600,00000002000,a01,write
1,55759379700,55759380300,00000000600,a10,ioctl
1,55759380800,55759380900,00000000100,ae4,clock_gettime
1,55759381100,55759466900,00000085800,a17,select
1,55759467700,55759468000,00000000300,a0e,rt_sigprocmask
1,55759468000,55759468100,00000000100,a0e,rt_sigprocmask
1,55759468500,55759468800,00000000300,ae4,clock_gettime
1,55759469100,55759470400,00000001300,a00,read
1,55759474300,55759474400,00000000100,ae4,clock_gettime
1,55759474900,55759475700,00000000800,a17,select
1,55759475800,55759475900,00000000100,a0e,rt_sigprocmask
1,55759475900,55759476000,00000000100,a0e,rt_sigprocmask
1,55759476100,55759476100,00000000000,ae4,clock_gettime
1,55759476400,55759482600,00000006200,a01,write
1,55759483100,55759483100,00000000000,ae4,clock_gettime
1,55759483300,55766115000,00006631700,a17,select
1,55766117300,55766118200,00000000900,a0e,rt_sigprocmask
1,55766118500,55766118700,00000000200,a0e,rt_sigprocmask
1,55766120100,55766120700,00000000600,ae4,clock_gettime
1,55766122000,55766127700,00000005700,a00,read
1,55766139900,55766140100,00000000200,ae4,clock_gettime
1,55766141500,55766145400,00000003900,a17,select
1,55766145700,55766146000,00000000300,a0e,rt_sigprocmask
1,55766146200,55766146400,00000000200,a0e,rt_sigprocmask
1,55766146700,55766146800,00000000100,ae4,clock_gettime
1,55766147600,55766153700,00000006100,a01,write
1,55766154100,55766156000,00000001900,a10,ioctl
1,55766157700,55766158000,00000000300,ae4,clock_gettime
1,55766158600,55766280700,00000122100,a17,select
1,55766282900,55766283900,00000001000,a0e,rt_sigprocmask
1,55766284100,55766284300,00000000200,a0e,rt_sigprocmask
1,55766285700,55766286300,00000000600,ae4,clock_gettime
1,55766287500,55766291500,00000004000,a00,read
1,55766303700,55766303900,00000000200,ae4,clock_gettime
1,55766305400,55766308000,00000002600,a17,select
1,55766308200,55766308600,00000000400,a0e,rt_sigprocmask
1,55766308800,55766309000,00000000200,a0e,rt_sigprocmask
1,55766309200,55766309400,00000000200,ae4,clock_gettime
1,55766310200,55766330200,00000020000,a01,write
1,55766331400,55766331600,00000000200,ae4,clock_gettime
1,55745745900,55768932000,00023186100,a07,poll
1,55768934400,55768936800,00000002400,a00,read
1,55768941500,55768942600,00000001100,a01,write
1,55768943900,55768946900,00000003000,a00,read
1,55768956400,55768956900,00000000500,a01,write
1,55768960400,55768962600,00000002200,a07,poll
1,55768964400,55768965300,00000000900,a07,poll
1,55768965600,55768966300,00000000700,a00,read
1,55766332300,55772677500,00006345200,a17,select
1,55772680200,55772681200,00000001000,a0e,rt_sigprocmask
1,55772681400,55772681600,00000000200,a0e,rt_sigprocmask
1,55772683300,55772683900,00000000600,ae4,clock_gettime
1,55772685200,55772690200,00000005000,a00,read
1,55772703500,55772703700,00000000200,ae4,clock_gettime
1,55772705000,55772708200,00000003200,a17,select
1,55772708400,55772708700,00000000300,a0e,rt_sigprocmask
1,55772708900,55772709100,00000000200,a0e,rt_sigprocmask
1,55772709200,55772709400,00000000200,ae4,clock_gettime
1,55772710200,55772716700,00000006500,a01,write
1,55772717100,55772719300,00000002200,a10,ioctl
1,55772720700,55772720900,00000000200,ae4,clock_gettime
1,55772721300,55772826700,00000105400,a17,select
1,55772828600,55772829300,00000000700,a0e,rt_sigprocmask
1,55772829500,55772829700,00000000200,a0e,rt_sigprocmask
1,55772830800,55772831300,00000000500,ae4,clock_gettime
1,55772832400,55772835900,00000003500,a00,read
1,55772846400,55772846600,00000000200,ae4,clock_gettime
1,55772847900,55772849900,00000002000,a17,select
1,55772850200,55772850500,00000000300,a0e,rt_sigprocmask
1,55772850600,55772850800,00000000200,a0e,rt_sigprocmask
1,55772851000,55772851100,00000000100,ae4,clock_gettime
1,55772851800,55772870700,00000018900,a01,write
1,55772871600,55772871800,00000000200,ae4,clock_gettime
1,55772872400,55782599100,00009726700,a17,select
1,55782601300,55782602200,00000000900,a0e,rt_sigprocmask
1,55782602500,55782602700,00000000200,a0e,rt_sigprocmask
1,55782604100,55782604700,00000000600,ae4,clock_gettime
1,55782606100,55782611700,00000005600,a00,read
1,55782623900,55782624100,00000000200,ae4,clock_gettime
1,55782625600,55782629500,00000003900,a17,select
1,55782629800,55782630100,00000000300,a0e,rt_sigprocmask
1,55782630300,55782630600,00000000300,a0e,rt_sigprocmask
1,55782630800,55782630900,00000000100,ae4,clock_gettime
1,55782631700,55782637900,00000006200,a01,write
1,55782638300,55782640100,00000001800,a10,ioctl
1,55782642000,55782642200,00000000200,ae4,clock_gettime
1,55782642800,55782765800,00000123000,a17,select
1,55782768100,55782769000,00000000900,a0e,rt_sigprocmask
1,55782769300,55782769500,00000000200,a0e,rt_sigprocmask
1,55782770800,55782771400,00000000600,ae4,clock_gettime
1,55782772500,55782776600,00000004100,a00,read
1,55782788800,55782789000,00000000200,ae4,clock_gettime
1,55782790500,55782793100,00000002600,a17,select
1,55782793400,55782793700,00000000300,a0e,rt_sigprocmask
1,55782793900,55782794200,00000000300,a0e,rt_sigprocmask
1,55782794400,55782794500,00000000100,ae4,clock_gettime
1,55782795300,55782815300,00000020000,a01,write
1,55782816500,55782816600,00000000100,ae4,clock_gettime
1,55768967700,55785215600,00016247900,a07,poll
1,55785217800,55785219800,00000002000,a00,read
1,55785225100,55785229400,00000004300,afe,inotify_add_watch
1,55785230300,55785231300,00000001000,afe,inotify_add_watch
1,55785231600,55785232400,00000000800,afe,inotify_add_watch
1,55785236800,55788948900,00003712100,a07,poll
1,55788957400,55788961900,00000004500,afe,inotify_add_watch
1,55788963200,55788963900,00000000700,afe,inotify_add_watch
1,55788964400,55788965100,00000000700,afe,inotify_add_watch
1,55790126600,55790129100,00000002500,a00,read
1,55790134600,55790135500,00000000900,a01,write
1,55790140700,55790144700,00000004000,a2f,recvmsg
1,55790162300,55790163100,00000000800,a07,poll
1,55790163600,55790168800,00000005200,a2f,recvmsg
1,55790184500,55790185100,00000000600,a01,write
1,55790189100,55790189400,00000000300,a01,write
1,55790202100,55790202900,00000000800,a07,poll
1,55790436000,55790445100,00000009100,a0a,mprotect
1,55790477600,55790485600,00000008000,a01,write
1,55790496500,55790497700,00000001200,a07,poll
1,55790515400,55790516200,00000000800,a01,write
1,55790528400,55790530900,00000002500,a07,poll
1,55790531400,55790532800,00000001400,a00,read
1,55782817400,55792051500,00009234100,a17,select
1,55792053000,55792053600,00000000600,a0e,rt_sigprocmask
1,55792053800,55792053900,00000000100,a0e,rt_sigprocmask
1,55792054900,55792055200,00000000300,ae4,clock_gettime
1,55792056200,55792059700,00000003500,a00,read
1,55792067600,55792067700,00000000100,ae4,clock_gettime
1,55792068700,55792071100,00000002400,a17,select
1,55792071300,55792071400,00000000100,a0e,rt_sigprocmask
1,55792071600,55792071700,00000000100,a0e,rt_sigprocmask
1,55792071900,55792072000,00000000100,ae4,clock_gettime
1,55792072500,55792076500,00000004000,a01,write
1,55792076800,55792077900,00000001100,a10,ioctl
1,55792079000,55792079200,00000000200,ae4,clock_gettime
1,55790534900,55792156300,00001621400,a07,poll
1,55792158700,55792161100,00000002400,a00,read
1,55792166000,55792167000,00000001000,a01,write
1,55792079600,55792169000,00000089400,a17,select
1,55792168300,55792169300,00000001000,a00,read
1,55792171200,55792171600,00000000400,a01,write
1,55792171600,55792172600,00000001000,a0e,rt_sigprocmask
1,55792172900,55792173100,00000000200,a0e,rt_sigprocmask
1,55792172800,55792173200,00000000400,a01,write
1,55792174700,55792175400,00000000700,ae4,clock_gettime
1,55792176600,55792178700,00000002100,a07,poll
1,55792176700,55792181300,00000004600,a00,read
1,55792180600,55792181500,00000000900,a07,poll
1,55792181800,55792182700,00000000900,a00,read
1,55792195000,55792195300,00000000300,ae4,clock_gettime
1,55792197100,55792200000,00000002900,a17,select
1,55792200300,55792200600,00000000300,a0e,rt_sigprocmask
1,55792200800,55792201100,00000000300,a0e,rt_sigprocmask
1,55792201400,55792201700,00000000300,ae4,clock_gettime
1,55792202500,55792224700,00000022200,a01,write
1,55792226100,55792226300,00000000200,ae4,clock_gettime
1,55794071700,55794076400,00000004700,a01,write
1,55792226900,55794333300,00002106400,a17,select
1,55794334800,55794335400,00000000600,a0e,rt_sigprocmask
1,55794335500,55794335700,00000000200,a0e,rt_sigprocmask
1,55794336700,55794337100,00000000400,ae4,clock_gettime
1,55794337900,55794341600,00000003700,a00,read
1,55794349300,55794349500,00000000200,ae4,clock_gettime
1,55794350500,55794353000,00000002500,a17,select
1,55794353200,55794353300,00000000100,a0e,rt_sigprocmask
1,55794353500,55794353600,00000000100,a0e,rt_sigprocmask
1,55794353800,55794353900,00000000100,ae4,clock_gettime
1,55794354400,55794358500,00000004100,a01,write
1,55794358700,55794360000,00000001300,a10,ioctl
1,55794361100,55794361200,00000000100,ae4,clock_gettime
1,55794361600,55794481500,00000119900,a17,select
1,55794483100,55794483600,00000000500,a0e,rt_sigprocmask
1,55794483800,55794483900,00000000100,a0e,rt_sigprocmask
1,55794484800,55794485200,00000000400,ae4,clock_gettime
1,55794486000,55794488500,00000002500,a00,read
1,55794496400,55794496600,00000000200,ae4,clock_gettime
1,55794497600,55794499300,00000001700,a17,select
1,55794499400,55794499600,00000000200,a0e,rt_sigprocmask
1,55794499800,55794499900,00000000100,a0e,rt_sigprocmask
1,55794500100,55794500100,00000000000,ae4,clock_gettime
1,55794500700,55794513600,00000012900,a01,write
1,55794514300,55794514500,00000000200,ae4,clock_gettime
1,55794514900,55795871400,00001356500,a17,select
1,55795872200,55795872500,00000000300,a0e,rt_sigprocmask
1,55795872600,55795872700,00000000100,a0e,rt_sigprocmask
1,55795873100,55795873300,00000000200,ae4,clock_gettime
1,55795873800,55795875600,00000001800,a00,read
1,55795879500,55795879600,00000000100,ae4,clock_gettime
1,55795880100,55795881300,00000001200,a17,select
1,55795881400,55795881500,00000000100,a0e,rt_sigprocmask
1,55795881600,55795881700,00000000100,a0e,rt_sigprocmask
1,55795879500,55795881700,00000002200,ae4,clock_gettime
1,55795882000,55795884000,00000002000,a01,write
1,55795884100,55795884700,00000000600,a10,ioctl
1,55795885300,55795885400,00000000100,ae4,clock_gettime
1,55795885600,55795954900,00000069300,a17,select
1,55795956300,55795956700,00000000400,a0e,rt_sigprocmask
1,55795956800,55795956900,00000000100,a0e,rt_sigprocmask
1,55795957700,55795958000,00000000300,ae4,clock_gettime
1,55795958600,55795960500,00000001900,a00,read
1,55795975300,55795975300,00000000000,ae4,clock_gettime
1,55795975800,55795976700,00000000900,a17,select
1,55795976900,55795976900,00000000000,a0e,rt_sigprocmask
1,55795976900,55795977000,00000000100,a0e,rt_sigprocmask
1,55795977100,55795977200,00000000100,ae4,clock_gettime
1,55795977400,55795983700,00000006300,a01,write
1,55795984100,55795984200,00000000100,ae4,clock_gettime
0,55738300900,55738302100,00000001200,a0e,rt_sigprocmask
0,55738302300,55738302600,00000000300,a0e,rt_sigprocmask
0,55738304700,55738305500,00000000800,ae4,clock_gettime
0,55738307200,55738311900,00000004700,a00,read
0,55738325800,55738326100,00000000300,ae4,clock_gettime
0,55738327900,55738330700,00000002800,a17,select
0,55738331200,55738331500,00000000300,a0e,rt_sigprocmask
0,55738331700,55738332000,00000000300,a0e,rt_sigprocmask
0,55738332200,55738332400,00000000200,ae4,clock_gettime
0,55738333300,55738355200,00000021900,a01,write
0,55738356700,55738356900,00000000200,ae4,clock_gettime
0,55749260900,55749280900,00000020000,ae4,clock_gettime
0,55749284800,55749290400,00000005600,a00,read
0,55749363100,55749366800,00000003700,b1e,timerfd_settime
0,55749367700,55749369600,00000001900,ae8,epoll_wait
0,55749370500,55749371000,00000000500,ae4,clock_gettime
0,55749372300,55749376400,00000004100,a00,read
0,55749426700,55749428000,00000001300,ae8,epoll_wait
0,55749428600,55749429100,00000000500,ae4,clock_gettime
0,55749430300,55749434200,00000003900,a00,read
0,55749480400,55749481600,00000001200,ae8,epoll_wait
0,55749482300,55749482700,00000000400,ae4,clock_gettime
0,55749483800,55749487600,00000003800,a00,read
0,55749532300,55749533300,00000001000,ae8,epoll_wait
0,55749533900,55749534200,00000000300,ae4,clock_gettime
0,55749535400,55749538900,00000003500,a00,read
0,55749577100,55749577900,00000000800,ae8,epoll_wait
0,55749578300,55749578600,00000000300,ae4,clock_gettime
0,55749579300,55749581300,00000002000,a00,read
0,55749605900,55749606400,00000000500,ae8,epoll_wait
0,55749606900,55749607100,00000000200,ae4,clock_gettime
0,55749607700,55749609300,00000001600,a00,read
0,55749631500,55749632100,00000000600,ae8,epoll_wait
0,55749632500,55749632700,00000000200,ae4,clock_gettime
0,55749633200,55749634900,00000001700,a00,read
0,55749658900,55749659400,00000000500,ae8,epoll_wait
0,55749659800,55749660000,00000000200,ae4,clock_gettime
0,55749660600,55749662200,00000001600,a00,read
0,55749695400,55749696100,00000000700,ae8,epoll_wait
0,55749696500,55749696700,00000000200,ae4,clock_gettime
0,55749697300,55749698900,00000001600,a00,read
0,55749722100,55749722600,00000000500,ae8,epoll_wait
0,55749723000,55749723200,00000000200,ae4,clock_gettime
0,55749723800,55749725400,00000001600,a00,read
0,55749747600,55749748200,00000000600,ae8,epoll_wait
0,55749748700,55749748800,00000000100,ae4,clock_gettime
0,55749749400,55749751000,00000001600,a00,read
0,55792991400,55792993900,00000002500,a00,read
0,55793000900,55793002000,00000001100,a01,write
0,55793003700,55793005200,00000001500,a00,read
0,55793071700,55793073500,00000001800,a4f,getcwd
0,55793204600,55793205300,00000000700,a4f,getcwd
0,55793262700,55793263200,00000000500,a4f,getcwd
0,55793314800,55793315200,00000000400,a4f,getcwd
0,55793359400,55793360900,00000001500,a01,write
0,55793365500,55793367000,00000001500,a07,poll
0,55793596000,55793602900,00000006900,a01,write
0,55793610900,55793613500,00000002600,a07,poll
0,55793614000,55793615300,00000001300,a00,read
0,55793694100,55793702400,00000008300,a2f,recvmsg
0,55793776500,55793777500,00000001000,a2f,recvmsg
0,55793824300,55793835500,00000011200,a2e,sendmsg
0,55793845200,55797615100,00003769900,ae8,epoll_wait
0,55797617700,55797618400,00000000700,ae4,clock_gettime
0,55797619200,55797621500,00000002300,a00,read
0,55797627500,55797632300,00000004800,a4d,ftruncate
0,55797634600,55797636400,00000001800,b1e,timerfd_settime
0,55797847200,55797849700,00000002500,a00,read
0,55799258100,55799273500,00000015400,a04,stat
0,55799285600,55799287700,00000002100,a04,stat
0,55799288100,55799290000,00000001900,a04,stat
0,55799290400,55799292100,00000001700,a04,stat
0,55799297100,55799299200,00000002100,a04,stat
0,55799300800,55799302600,00000001800,a04,stat
2,55749360800,55749392700,00000031900,aca,futex
2,55749432600,55749472500,00000039900,a01,write
2,55749476000,55749490000,00000014000,a01,write
2,55749538900,55749571700,00000032800,a01,write
2,55749574400,55749585600,00000011200,a01,write
2,55793674900,55793676700,00000001800,a00,read
2,55793700100,55793715400,00000015300,a2e,sendmsg
2,55793729500,55793731100,00000001600,a07,poll
2,55793731500,55793732400,00000000900,a00,read
2,55795699600,55795701500,00000001900,a26,setitimer
2,55795704800,55795711000,00000006200,a2f,recvmsg
2,55795727700,55795739400,00000011700,a14,writev
2,55795777800,55795782500,00000004700,a10,ioctl
2,55795794600,55795795300,00000000700,a10,ioctl
2,55795816500,55795846200,00000029700,a10,ioctl
2,55795847200,55795848800,00000001600,a10,ioctl
2,55795873600,55795874500,00000000900,a10,ioctl
2,55795875600,55795876000,00000000400,a10,ioctl
2,55795899700,55795900100,00000000400,a0e,rt_sigprocmask
2,55795907000,55795907100,00000000100,a0e,rt_sigprocmask
2,55795910000,55795917800,00000007800,a14,writev
2,55795929500,55795931400,00000001900,a10,ioctl
2,55795932700,55795932900,00000000200,a0e,rt_sigprocmask
2,55795984400,55795986200,00000001800,a10,ioctl
2,55795988800,55796007600,00000018800,a10,ioctl
2,55796008800,55796009500,00000000700,a10,ioctl
2,55796021400,55796026800,00000005400,a14,writev
2,55796028100,55796029400,00000001300,a2f,recvmsg
2,55796030900,55796032000,00000001100,a26,setitimer
2,55796034100,55796034700,00000000600,a10,ioctl
2,55796035700,55796036200,00000000500,a10,ioctl
2,55796037500,55796037900,00000000400,a10,ioctl
2,55796039000,55796050500,00000011500,a10,ioctl
2,55796051600,55796052300,00000000700,a10,ioctl
2,55796053700,55796054300,00000000600,a10,ioctl
2,55796054800,55796055200,00000000400,a10,ioctl
2,55796058800,55804145900,00008087100,a17,select
2,55804155400,55804160300,00000004900,a10,ioctl
2,55804161000,55804162100,00000001100,a10,ioctl
2,55804163200,55804164500,00000001300,a10,ioctl
2,55804164900,55804168400,00000003500,a10,ioctl
2,55804168700,55804169500,00000000800,a10,ioctl
