1,40719650000,40719669000,00000019000,7ef,local_timer_vector
1,40719724600,40719731400,00000006800,a02,open
1,40719736800,40719754700,00000017900,a01,write
1,40719755900,40719762100,00000006200,a01,write
1,40716460700,40720268400,00003807700,a17,select
1,40720270700,40720360200,00000089500,a00,read
1,40720283900,40720451300,00000167400,a17,select
1,40720468300,40723304800,00002836500,a17,select
1,40723307200,40723395900,00000088700,a00,read
1,40723319400,40723489300,00000169900,a17,select
1,40723506500,40729252800,00005746300,a17,select
1,40729258600,40729359300,00000100700,a00,read
1,40729430300,40729503700,00000073400,a38,clone
1,40729820900,40729821000,00000000100,a0c,brk
1,40729829200,40729832000,00000002800,a15,access
1,40729832700,40729833500,00000000800,a09,mmap
1,40729838000,40729838900,00000000900,a15,access
1,40729845500,40729846400,00000000900,a09,mmap
1,40729850000,40729850500,00000000500,a15,access
1,40729855700,40729856700,00000001000,a00,read
1,40729857900,40729860300,00000002400,a09,mmap
1,40729864700,40729868700,00000004000,a09,mmap
1,40729870900,40729872300,00000001400,a09,mmap
1,40729878700,40729879300,00000000600,a15,access
1,40729883200,40729884100,00000000900,a00,read
1,40729885100,40729887100,00000002000,a09,mmap
1,40729890900,40729893700,00000002800,a09,mmap
1,40729895800,40729896900,00000001100,a09,mmap
1,40729910000,40729910700,00000000700,a09,mmap
1,40729913000,40729913800,00000000800,a09,mmap
1,40729914800,40729915100,00000000300,a09,mmap
1,40729988800,40729989100,00000000300,ada,set_tid_address
1,40730042100,40730042200,00000000100,a0c,brk
1,40730047100,40730047800,00000000700,a09,mmap
1,40730053000,40730061000,00000008000,a38,clone
1,40730061300,40730062100,00000000800,a09,mmap
1,40730065900,40730068800,00000002900,a38,clone
1,40729278900,40730081800,00000802900,a17,select
1,40730084200,40730173000,00000088800,a00,read
1,40730096400,40730268000,00000171600,a17,select
1,40741628900,40741671700,00000042800,a00,read
1,40741688400,40741706000,00000017600,a00,read
1,40741711400,40741711600,00000000200,a00,read
1,40741718100,40741721800,00000003700,a02,open
1,40730285100,40745206300,00014921200,a17,select
1,40745208700,40745297200,00000088500,a00,read
1,40745221000,40745392300,00000171300,a17,select
1,40745409400,40746107700,00000698300,a17,select
1,40746110100,40746199200,00000089100,a00,read
1,40746122300,40746290900,00000168600,a17,select
1,40746122300,40746298500,00000176200,a17,select
1,40746300900,40746394500,00000093600,a00,read
1,40746317900,40746488400,00000170500,a17,select
1,40751919600,40752100800,00000181200,a17,select
1,40764473700,40764630400,00000156700,a17,select
1,40764640000,40766823000,00002183000,a17,select
1,40766825300,40766914100,00000088800,a00,read
1,40766837500,40767006000,00000168500,a17,select
1,40767023100,40769421900,00002398800,a17,select
1,40769424200,40769513000,00000088800,a00,read
1,40769436500,40769606700,00000170200,a17,select
1,40769748400,40769749500,00000001100,a00,read
1,40770070400,40770074100,00000003700,a2f,recvmsg
1,40770097700,40770097800,00000000100,a2f,recvmsg
1,40770119200,40770123800,00000004600,a2e,sendmsg
1,40770462400,40770463600,00000001200,a2f,recvmsg
1,40770824600,40770831600,00000007000,a14,writev
1,40770832800,40770922200,00000089400,a07,poll
1,40770928200,40771022400,00000094200,a07,poll
1,40771026300,40771042100,00000015800,a07,poll
1,40771046500,40771046800,00000000300,a2f,recvmsg
1,40771060900,40771061800,00000000900,a00,read
1,40771073300,40771073700,00000000400,a2f,recvmsg
1,40771074800,40771075000,00000000200,a2f,recvmsg
1,40769623800,40772645600,00003021800,a17,select
1,40772647900,40772736800,00000088900,a00,read
1,40772660400,40772830800,00000170400,a17,select
1,40772848100,40783439800,00010591700,a17,select
1,40783442100,40783531300,00000089200,a00,read
1,40783454400,40783625700,00000171300,a17,select
1,40783642800,40784015900,00000373100,a17,select
1,40784018400,40784108100,00000089700,a00,read
1,40784031600,40784201800,00000170200,a17,select
1,40784219000,40784538900,00000319900,a17,select
1,40784541300,40784630300,00000089000,a00,read
1,40784672600,40784674700,00000002100,a04,stat
1,40784675300,40784676100,00000000800,a04,stat
1,40784676400,40784677200,00000000800,a04,stat
1,40784677500,40784678500,00000001000,a04,stat
1,40784678800,40784679500,00000000700,a04,stat
1,40784682200,40784682400,00000000200,a6b,geteuid
1,40784682500,40784682500,00000000000,a6c,getegid
1,40784682600,40784682800,00000000200,a66,getuid
1,40784682900,40784683000,00000000100,a68,getgid
1,40784685400,40784685400,00000000000,a6b,geteuid
1,40784685400,40784685500,00000000100,a6c,getegid
1,40784685500,40784685600,00000000100,a66,getuid
1,40784685600,40784685700,00000000100,a68,getgid
1,40784685400,40784687400,00000002000,a6b,geteuid
1,40784687500,40784687500,00000000000,a6c,getegid
1,40784687600,40784687600,00000000000,a66,getuid
1,40784687700,40784687700,00000000000,a68,getgid
1,40784688600,40784688700,00000000100,a6b,geteuid
1,40784687600,40784688800,00000001200,a66,getuid
1,40784688700,40784688800,00000000100,a6c,getegid
1,40784687700,40784688900,00000001200,a68,getgid
1,40784697000,40784767400,00000070400,a38,clone
1,40784552700,40784824200,00000271500,a17,select
1,40784842400,40785541600,00000699200,a17,select
1,40785545300,40785547000,00000001700,a00,read
1,40785557100,40785567100,00000010000,a01,write
1,40784818700,40785637000,00000818300,a3d,wait4
1,40785669900,40785670100,00000000200,a3d,wait4
1,40785567800,40785855000,00000287200,a17,select
1,40785872200,40786114500,00000242300,a17,select
1,40786116700,40786205300,00000088600,a00,read
1,40786129100,40786296900,00000167800,a17,select
1,40786314100,40787174800,00000860700,a17,select
1,40787177100,40787266600,00000089500,a00,read
1,40787288500,40787291800,00000003300,a0c,brk
1,40787304400,40787311700,00000007300,a4e,getdents
1,40787319400,40787319600,00000000200,a6b,geteuid
1,40787319700,40787319700,00000000000,a6c,getegid
1,40787319800,40787320000,00000000200,a66,getuid
1,40787320100,40787320200,00000000100,a68,getgid
1,40787322400,40787322400,00000000000,a6b,geteuid
1,40787319700,40787322500,00000002800,a6c,getegid
1,40787322600,40787322600,00000000000,a66,getuid
1,40787320100,40787322700,00000002600,a68,getgid
1,40787322400,40787327100,00000004700,a6b,geteuid
1,40787327200,40787327200,00000000000,a6c,getegid
1,40787327300,40787327300,00000000000,a66,getuid
1,40787327400,40787327400,00000000000,a68,getgid
1,40787327100,40787328400,00000001300,a6b,geteuid
1,40787327200,40787328500,00000001300,a6c,getegid
1,40787327300,40787328600,00000001300,a66,getuid
1,40787327400,40787328700,00000001300,a68,getgid
1,40787330100,40787339600,00000009500,a0c,brk
1,40787189400,40787375000,00000185600,a17,select
1,40787391900,40792842700,00005450800,a17,select
1,40792846700,40792940400,00000093700,a00,read
1,40792861600,40793039400,00000177800,a17,select
1,40793057500,40798625200,00005567700,a17,select
1,40798627500,40798716300,00000088800,a00,read
1,40798639700,40798810500,00000170800,a17,select
1,40805993900,40806036700,00000042800,a00,read
1,40806053300,40806071100,00000017800,a00,read
1,40806075700,40806076000,00000000300,a00,read
1,40806082500,40806086400,00000003900,a02,open
1,40798831400,40808386700,00009555300,a17,select
1,40808389000,40808478200,00000089200,a00,read
1,40808401300,40808571700,00000170400,a17,select
1,40808589000,40811166000,00002577000,a17,select
1,40811168300,40811256800,00000088500,a00,read
1,40811180700,40811351200,00000170500,a17,select
1,40811368300,40813254300,00001886000,a17,select
1,40813256500,40813345400,00000088900,a00,read
1,40813268900,40813403700,00000134800,a17,select
1,40813418300,40813438700,00000020400,a17,select
1,40813441000,40813495900,00000054900,a00,read
1,40813512000,40813514200,00000002200,a0c,brk
1,40813524800,40813530400,00000005600,a4e,getdents
1,40813536000,40813536400,00000000400,a6b,geteuid
1,40813536400,40813536500,00000000100,a6c,getegid
1,40813536600,40813536700,00000000100,a66,getuid
1,40787328700,40813536800,00026208100,a68,getgid
1,40813536000,40813538400,00000002400,a6b,geteuid
1,40813536400,40813538500,00000002100,a6c,getegid
1,40813536600,40813538600,00000002000,a66,getuid
1,40813536800,40813538700,00000001900,a68,getgid
1,40813540300,40813546400,00000006100,a0c,brk
1,40813456200,40813650500,00000194300,a17,select
1,40813667900,40814223300,00000555400,a17,select
0,40719861100,40720349900,00000488800,a07,poll
0,40720350600,40720351300,00000000700,a00,read
0,40720353600,40720353900,00000000300,a00,read
0,40720358500,40721748800,00001390300,a07,poll
0,40721749400,40721750100,00000000700,a00,read
0,40721752700,40721754900,00000002200,afe,inotify_add_watch
0,40721755200,40721755500,00000000300,afe,inotify_add_watch
0,40721755700,40721756000,00000000300,afe,inotify_add_watch
0,40721757600,40722019300,00000261700,a07,poll
0,40730444000,40730445100,00000001100,a00,read
0,40730447900,40730550700,00000102800,a07,poll
0,40730447900,40730557000,00000109100,a07,poll
0,40719819200,40733568100,00013748900,ae8,epoll_wait
0,40730560100,40739252400,00008692300,a07,poll
0,40739259000,40739261400,00000002400,afe,inotify_add_watch
0,40739261900,40739262200,00000000300,afe,inotify_add_watch
0,40739262700,40739263000,00000000300,afe,inotify_add_watch
0,40739266200,40740079700,00000813500,a07,poll
0,40750920000,40753347100,00002427100,a07,poll
0,40753350700,40753352300,00000001600,afe,inotify_add_watch
0,40753352600,40753353000,00000000400,afe,inotify_add_watch
0,40753353100,40753353400,00000000300,afe,inotify_add_watch
0,40753355200,40767351300,00013996100,a07,poll
0,40767443600,40767444800,00000001200,a07,poll
0,40767448700,40767450600,00000001900,afe,inotify_add_watch
0,40767451100,40767451400,00000000300,afe,inotify_add_watch
0,40767451800,40767452000,00000000200,afe,inotify_add_watch
0,40770111500,40770118700,00000007200,a2e,sendmsg
0,40770123700,40770123900,00000000200,a00,read
0,40770226900,40770228400,00000001500,a00,read
0,40770256300,40770258200,00000001900,a2f,recvmsg
0,40770966000,40770968900,00000002900,a2f,recvmsg
0,40771111300,40771111700,00000000400,a2f,recvmsg
0,40770369200,40777339900,00006970700,a07,poll
0,40770369200,40777346900,00006977700,a07,poll
0,40777350300,40781540100,00004189800,a07,poll
0,40781543700,40781545500,00000001800,afe,inotify_add_watch
0,40781546000,40781546200,00000000200,afe,inotify_add_watch
0,40781546400,40781546700,00000000300,afe,inotify_add_watch
0,40785100400,40785100500,00000000100,a0c,brk
0,40785109700,40785111600,00000001900,a15,access
0,40785112400,40785113300,00000000900,a09,mmap
0,40785118100,40785119000,00000000900,a15,access
0,40785125000,40785126100,00000001100,a09,mmap
0,40785129900,40785130400,00000000500,a15,access
0,40785134400,40785135300,00000000900,a00,read
0,40785136800,40785138800,00000002000,a09,mmap
0,40785143900,40785147900,00000004000,a09,mmap
0,40785150000,40785151200,00000001200,a09,mmap
0,40785157600,40785158200,00000000600,a15,access
0,40785161900,40785162500,00000000600,a00,read
0,40785163400,40785165400,00000002000,a09,mmap
0,40785169700,40785172600,00000002900,a09,mmap
0,40785174600,40785175700,00000001100,a09,mmap
0,40785184500,40785185000,00000000500,a15,access
0,40785187600,40785188400,00000000800,a00,read
0,40785188900,40785189700,00000000800,a09,mmap
0,40785191200,40785192800,00000001600,a09,mmap
0,40785197900,40785199800,00000001900,a09,mmap
0,40785207900,40785208500,00000000600,a15,access
0,40785211400,40785211800,00000000400,a00,read
0,40785212500,40785214100,00000001600,a09,mmap
0,40785217400,40785219600,00000002200,a09,mmap
0,40785227100,40785227700,00000000600,a15,access
0,40785230200,40785230900,00000000700,a00,read
0,40785231700,40785233500,00000001800,a09,mmap
0,40785236800,40785239700,00000002900,a09,mmap
0,40785241700,40785242700,00000001000,a09,mmap
0,40785250000,40785251000,00000001000,a09,mmap
0,40785260500,40785261000,00000000500,a09,mmap
0,40785361000,40785361200,00000000200,ada,set_tid_address
0,40785390100,40785397500,00000007400,a89,statfs
0,40785398400,40785399100,00000000700,a89,statfs
0,40785434500,40785434700,00000000200,a0c,brk
0,40785434700,40785435600,00000000900,a0c,brk
0,40781548800,40785444800,00003896000,a07,poll
0,40785448400,40785458200,00000009800,a00,read
0,40785486000,40785488200,00000002200,a09,mmap
0,40785556600,40785564600,00000008000,a4e,getdents
0,40785511400,40795601900,00010090500,a07,poll
0,40795608000,40795610700,00000002700,afe,inotify_add_watch
0,40795611500,40795611900,00000000400,afe,inotify_add_watch
0,40795612100,40795612400,00000000300,afe,inotify_add_watch
0,40795615600,40803541000,00007925400,a07,poll
0,40803615600,40803770500,00000154900,a07,poll
0,40803615600,40803776200,00000160600,a07,poll
1,01330957900,01331986500,00001028600,a17,select
1,01390604200,01390711100,00000106900,a17,select
1,40806087100,01392106500,-39413980600,a23,nanosleep
1,01392124100,01392168900,00000044800,a00,read
1,01392186000,01392203400,00000017400,a00,read
1,01392208100,01392208300,00000000200,a00,read
1,01392215300,01392219800,00000004500,a02,open
1,01419502800,01419517900,00000015100,7ef,local_timer_vector
1,01392220400,01427346300,00035125900,a23,nanosleep
1,01427357700,01427395800,00000038100,a00,read
1,01427409300,01427426400,00000017100,a00,read
1,01427430600,01427430800,00000000200,a00,read
1,01427436100,01427439500,00000003400,a02,open
0,40803779400,04719393600,-36084385800,a07,poll
0,04719395600,04719396500,00000000900,afe,inotify_add_watch
0,04719396700,04719397000,00000000300,afe,inotify_add_watch
0,04719397200,04719397500,00000000300,afe,inotify_add_watch
0,04719398800,04733489200,00014090400,a07,poll
0,04733491300,04733492400,00000001100,afe,inotify_add_watch
0,04733492500,04733492900,00000000400,afe,inotify_add_watch
0,04733493000,04733493300,00000000300,afe,inotify_add_watch
0,04733494500,04747585600,00014091100,a07,poll
0,04747587200,04747587800,00000000600,afe,inotify_add_watch
0,04747588100,04747588400,00000000300,afe,inotify_add_watch
0,04747588500,04747588700,00000000200,afe,inotify_add_watch
0,04747590000,04752195200,00004605200,a07,poll
0,04747590000,04752198400,00004608400,a07,poll
0,04752200400,04753390200,00001189800,a07,poll
0,04753446100,04771483900,00018037800,a07,poll
0,04771527600,04778625200,00007097600,a07,poll
0,04771527600,04778628500,00007100900,a07,poll
0,04778631100,04789578800,00010947700,a07,poll
0,04791489200,04791502400,00000013200,7ef,local_timer_vector
0,04789627700,04804912500,00015284800,a07,poll
0,04804915100,04804916600,00000001500,afe,inotify_add_watch
0,04804916900,04804917200,00000000300,afe,inotify_add_watch
0,04804917300,04804917600,00000000300,afe,inotify_add_watch
0,04804919200,04807673500,00002754300,a07,poll
1,17380714400,17380715600,00000001200,a36,setsockopt
1,17380812300,17380825200,00000012900,a00,read
1,17380852300,17380858200,00000005900,a00,read
1,01427440100,17398969800,15971529700,a23,nanosleep
1,17398976600,17399009700,00000033100,a00,read
1,17399019800,17399035700,00000015900,a00,read
1,17399038900,17399039100,00000000200,a00,read
1,17399043300,17399045700,00000002400,a02,open
1,17399046200,17434209700,00035163500,a23,nanosleep
1,17434225400,17434265800,00000040400,a00,read
1,17434280600,17434297500,00000016900,a00,read
1,17434302400,17434302600,00000000200,a00,read
1,17434308900,17434312300,00000003400,a02,open
1,17448259300,17448272600,00000013300,7ef,local_timer_vector
0,04807715500,20566154200,15758438700,a07,poll
0,20566202100,20571872300,00005670200,a07,poll
0,20566202100,20571877700,00005675600,a07,poll
0,20571880500,20584251800,00012371300,a07,poll
0,20584349800,20601681900,00017332100,a07,poll
0,20601683500,20601684300,00000000800,afe,inotify_add_watch
0,20601684500,20601684800,00000000300,afe,inotify_add_watch
0,20601685000,20601685200,00000000200,afe,inotify_add_watch
0,20601686300,20602343600,00000657300,a07,poll
0,20602387700,20615778000,00013390300,a07,poll
0,20615779900,20615780800,00000000900,afe,inotify_add_watch
0,20615781000,20615781300,00000000300,afe,inotify_add_watch
0,20615781500,20615781700,00000000200,afe,inotify_add_watch
0,20615782900,20620437500,00004654600,a07,poll
0,20627541300,20627554600,00000013300,7ef,local_timer_vector
0,20620480900,20629875900,00009395000,a07,poll
0,20629881200,20629883600,00000002400,afe,inotify_add_watch
0,20629884100,20629884600,00000000500,afe,inotify_add_watch
0,20629884700,20629885000,00000000300,afe,inotify_add_watch
0,20640022500,20640095400,00000072900,a17,select
0,20640096000,20640168200,00000072200,a17,select
0,20640168400,20640240200,00000071800,a17,select
0,20640240400,20640311900,00000071500,a17,select
0,20640312000,20640383500,00000071500,a17,select
0,20640383700,20640455200,00000071500,a17,select
0,20640455400,20640526900,00000071500,a17,select
0,20640527100,20640598500,00000071400,a17,select
0,20640598700,20640670200,00000071500,a17,select
0,20640670400,20640742100,00000071700,a17,select
0,20640742400,20640813800,00000071400,a17,select
0,20640814000,20640885500,00000071500,a17,select
0,20640885700,20640957400,00000071700,a17,select
0,20640957700,20641029000,00000071300,a17,select
0,20641029200,20641100600,00000071400,a17,select
0,20641100700,20641172000,00000071300,a17,select
0,20641172200,20641243600,00000071400,a17,select
0,20641243700,20641315000,00000071300,a17,select
0,20641315200,20641386700,00000071500,a17,select
0,20641386900,20641458300,00000071400,a17,select
0,20641458400,20641529800,00000071400,a17,select
0,20641530000,20641601400,00000071400,a17,select
0,20641601600,20641673200,00000071600,a17,select
0,20641673400,20641745100,00000071700,a17,select
0,20641738100,20641746500,00000008400,aca,futex
0,20641745300,20641817100,00000071800,a17,select
0,20641817500,20641819500,00000002000,aca,futex
0,20641864200,20641867700,00000003500,a18,sched_yield
0,20641868800,20641869600,00000000800,aca,futex
0,20641873800,20641875200,00000001400,aca,futex
0,20641877200,20641878300,00000001100,aca,futex
0,20641878700,20641950800,00000072100,a17,select
0,20641880100,20641952400,00000072300,aca,futex
0,20641951200,20642023100,00000071900,a17,select
0,20642023400,20642095100,00000071700,a17,select
0,20642095300,20642167100,00000071800,a17,select
0,20642167400,20642239100,00000071700,a17,select
0,20642239300,20642311000,00000071700,a17,select
0,20642311300,20642383100,00000071800,a17,select
0,20642383300,20642456600,00000073300,a17,select
0,20629887900,20643969600,00014081700,a07,poll
0,20643971400,20643972200,00000000800,afe,inotify_add_watch
0,20643972500,20643972800,00000000300,afe,inotify_add_watch
0,20643972900,20643973200,00000000300,afe,inotify_add_watch
0,20643974300,20645056000,00001081700,a07,poll
0,20643974300,20645059300,00001085000,a07,poll
1,17434312900,33521834800,16087521900,a23,nanosleep
1,33521842800,33521876200,00000033400,a00,read
1,33521887400,33521903700,00000016300,a00,read
1,33521907200,33521907400,00000000200,a00,read
1,33521911800,33521914600,00000002800,a02,open
1,17377780600,33529813400,16152032800,a17,select
1,40771075800,33533816200,-7237259600,a07,poll
1,33533821500,33533917000,00000095500,a00,read
1,33533940100,33533945000,00000004900,a01,write
1,33533945500,33537107100,00003161600,a17,select
1,33552463900,33577797400,00025333500,a17,select
1,33577806000,33579693100,00001887100,a17,select
1,33533914500,33579701100,00045786600,a07,poll
1,33579759100,33579762700,00000003600,a09,mmap
1,33579762800,33579763000,00000000200,a08,lseek
1,33579799400,33579803200,00000003800,a01,write
1,33579702500,33579808000,00000105500,a00,read
1,33579813900,33579827600,00000013700,a00,read
1,33579804900,33579862000,00000057100,a07,poll
1,33579890400,33579891700,00000001300,a00,read
1,33579897800,33579898500,00000000700,a00,read
1,33579924000,33579924800,00000000800,a00,read
1,33579927500,33579930900,00000003400,a09,mmap
1,33579937400,33579940400,00000003000,a09,mmap
1,33580083800,33580084500,00000000700,a00,read
1,33580086100,33580088700,00000002600,a09,mmap
1,33580093000,33580096600,00000003600,a09,mmap
1,33580099000,33580100600,00000001600,a09,mmap
1,33580188000,33580188700,00000000700,a00,read
1,33580189900,33580191800,00000001900,a09,mmap
1,33580195100,33580196500,00000001400,a09,mmap
1,33580218000,33580218600,00000000600,a00,read
1,33580219800,33580221500,00000001700,a09,mmap
1,33580224300,33580225600,00000001300,a09,mmap
1,33580255000,33580255600,00000000600,a00,read
1,33580262400,33580264000,00000001600,a09,mmap
1,33580291100,33580291800,00000000700,a00,read
1,33580310900,33580311500,00000000600,a00,read
1,33580312900,33580314700,00000001800,a09,mmap
1,33580318000,33580319900,00000001900,a09,mmap
1,33580363000,33580363700,00000000700,a00,read
1,33580365000,33580366700,00000001700,a09,mmap
1,33580369800,33580371500,00000001700,a09,mmap
1,33580401000,33580401700,00000000700,a00,read
1,33580402800,33580404500,00000001700,a09,mmap
1,33580406800,33580408500,00000001700,a09,mmap
1,33580435700,33580436400,00000000700,a00,read
1,33580450000,33580450500,00000000500,a00,read
1,33580451700,33580453600,00000001900,a09,mmap
1,33580456300,33580458200,00000001900,a09,mmap
1,33580494700,33580495600,00000000900,a00,read
1,33580497100,33580498600,00000001500,a09,mmap
1,33580498700,33580501700,00000003000,a09,mmap
1,33580517500,33580518500,00000001000,a09,mmap
1,33580522200,33580523700,00000001500,a15,access
1,33580527700,33580528200,00000000500,a00,read
1,33580530600,33580532600,00000002000,a09,mmap
1,33580535500,33580537200,00000001700,a09,mmap
1,33580696500,33580697200,00000000700,a00,read
1,33580699000,33580701000,00000002000,a09,mmap
1,33580704000,33580705600,00000001600,a09,mmap
1,33580737700,33580738300,00000000600,a00,read
1,33580739700,33580741300,00000001600,a09,mmap
1,33580743800,33580745600,00000001800,a09,mmap
1,33580774900,33580775600,00000000700,a00,read
1,33580778200,33580779600,00000001400,a09,mmap
1,33580782300,33580783900,00000001600,a09,mmap
1,33580823000,33580823700,00000000700,a00,read
1,33580824900,33580826500,00000001600,a09,mmap
1,33580829100,33580830700,00000001600,a09,mmap
1,33580872000,33580872700,00000000700,a00,read
1,33580889100,33580889600,00000000500,a00,read
1,33580891900,33580893800,00000001900,a09,mmap
1,33580896700,33580898700,00000002000,a09,mmap
1,33580957600,33580958000,00000000400,a00,read
1,33580963300,33580963600,00000000300,a00,read
1,33580984400,33580984900,00000000500,a00,read
1,33580996600,33580996900,00000000300,a00,read
1,33581010900,33581011200,00000000300,a00,read
1,33579859900,33581175900,00001316000,a17,select
1,33581176400,33581177900,00000001500,a00,read
1,33581211000,33581211900,00000000900,a01,write
1,33581038200,33581214200,00000176000,a07,poll
1,33581215900,33581217400,00000001500,a00,read
1,33581242500,33581249800,00000007300,a2a,connect
1,33581253900,33581255800,00000001900,a2a,connect
1,33581272000,33581274200,00000002200,a09,mmap
1,33581274300,33581274500,00000000200,a08,lseek
1,33581304300,33581306600,00000002300,a02,open
1,33581315400,33581316200,00000000800,a02,open
1,33581338900,33581352600,00000013700,a59,readlink
1,33581232000,33581382100,00000150100,a00,read
1,33586088900,33586217000,00000128100,a38,clone
1,33586245600,33586246400,00000000800,a01,write
1,33586324600,33586340100,00000015500,a02,open
1,33586369400,33586375800,00000006400,60e,page_fault
1,33586398800,33586403500,00000004700,a70,setsid
1,33586275500,33589391100,00003115600,a17,select
1,33589391600,33589393000,00000001400,a00,read
1,33581379000,33589404200,00008025200,a07,poll
1,33589493000,33589494300,00000001300,a00,read
1,33589627700,33589630300,00000002600,a09,mmap
1,33589630400,33589630500,00000000100,a08,lseek
1,33589694300,33589697500,00000003200,a04,stat
1,33589735100,33589736000,00000000900,a00,read
1,33589736600,33589736800,00000000200,a08,lseek
1,33589737000,33589737300,00000000300,a00,read
1,33589739900,33589742600,00000002700,a0c,brk
1,33589763800,33589765500,00000001700,a02,open
1,33589790800,33589795800,00000005000,a2f,recvmsg
1,33589796400,33589798000,00000001600,a2f,recvmsg
1,33589807400,33589812200,00000004800,a2a,connect
1,33589827500,33589828700,00000001200,a00,read
1,33589836000,33589836400,00000000400,a00,read
1,33589855700,33589857700,00000002000,a09,mmap
1,33589861600,33589862900,00000001300,a15,access
1,33589866500,33589867300,00000000800,a00,read
1,33589869800,33589871900,00000002100,a09,mmap
1,33589876700,33589879700,00000003000,a09,mmap
1,33589913500,33589914300,00000000800,a09,mmap
1,33589916600,33589917200,00000000600,a15,access
1,33589919700,33589920200,00000000500,a00,read
1,33589922000,33589923700,00000001700,a09,mmap
1,33589927300,33589928600,00000001300,a09,mmap
1,33589964200,33589964700,00000000500,a00,read
1,33590512200,33590512600,00000000400,a6a,setgid
1,33590513000,33590513300,00000000300,a77,setresgid
1,33590508900,33590513400,00000004500,a68,getgid
1,33590513600,33590513600,00000000000,a6c,getegid
1,33590513800,33590514000,00000000200,a69,setuid
1,33590514300,33590514500,00000000200,a75,setresuid
1,33590551300,33590555100,00000003800,a01,write
1,33590067800,33591488900,00001421100,a07,poll
1,33591490700,33591491500,00000000800,a2d,recvfrom
1,33591496400,33591501200,00000004800,a2e,sendmsg
1,33591506700,33591509200,00000002500,a07,poll
1,33591513700,33591514200,00000000500,a2d,recvfrom
1,33590556300,33591816800,00001260500,a17,select
1,33591817200,33591818600,00000001400,a00,read
1,33591521700,33591910300,00000388600,a07,poll
1,33591921700,33591923700,00000002000,a07,poll
1,33591953000,33591955900,00000002900,a2c,sendto
1,33591959800,33596200800,00004241000,a07,poll
1,33596202400,33596203000,00000000600,a2d,recvfrom
1,33596238700,33596239800,00000001100,a00,read
1,33596255800,33596258900,00000003100,a07,poll
1,33596275600,33597446600,00001171000,a07,poll
1,33597458400,33597460300,00000001900,a07,poll
1,33597472200,33597472900,00000000700,a00,read
1,33597483100,33597485500,00000002400,a07,poll
1,33597497900,33598461600,00000963700,a07,poll
1,33598472500,33598474500,00000002000,a07,poll
1,33605717200,33605720500,00000003300,a2f,recvmsg
1,33605721100,33605722300,00000001200,a2f,recvmsg
1,33605733500,33605734600,00000001100,a00,read
1,33605746000,33605755200,00000009200,a07,poll
1,33605770600,33606979500,00001208900,a07,poll
1,33606980800,33606981600,00000000800,a2d,recvfrom
1,33606984800,33606987500,00000002700,a2e,sendmsg
1,33605746700,33606995100,00001248400,b33,sendmmsg
1,33606991100,33606996400,00000005300,a07,poll
1,33607009400,33607009800,00000000400,a2d,recvfrom
1,33607011200,33607961300,00000950100,a07,poll
1,33607970900,33607972900,00000002000,a07,poll
1,33607985600,33607987900,00000002300,a2c,sendto
1,33609364200,33609379500,00000015300,7ef,local_timer_vector
1,33607990400,33611663100,00003672700,a07,poll
1,33611681700,33611682700,00000001000,a00,read
1,33611694800,33611697400,00000002600,a07,poll
1,33611711700,33612645500,00000933800,a07,poll
1,33612656000,33612657900,00000001900,a07,poll
1,33612667100,33612667900,00000000800,a00,read
1,33612677300,33612679400,00000002100,a07,poll
1,33612690300,33613627800,00000937500,a07,poll
0,20641872700,36012747100,15370874400,ae8,epoll_wait
0,36012805900,36012822000,00000016100,a00,read
0,36012834700,36012839200,00000004500,a4e,getdents
0,36012879300,36012893700,00000014400,a00,read
0,36012911100,36012916800,00000005700,a00,read
0,36012988900,36012996200,00000007300,aca,futex
0,20645061200,36013030500,15367969300,a07,poll
0,36012962000,36013643700,00000681700,ae8,epoll_wait
0,36013673700,36013684700,00000011000,a00,read
0,36013711800,36013724000,00000012200,a00,read
0,36013738000,36013741900,00000003900,a00,read
0,36012993300,36013783100,00000789800,a17,select
0,36013799600,36013805500,00000005900,aca,futex
0,36013778300,36014225600,00000447300,ae8,epoll_wait
0,36014244600,36014251600,00000007000,a00,read
0,36014273300,36014284500,00000011200,a00,read
0,36014297000,36014301000,00000004000,a00,read
0,36013803400,36014332600,00000529200,a17,select
0,36014345800,36014350800,00000005000,aca,futex
0,36014444700,36014448300,00000003600,a2c,sendto
0,36014465300,36014466300,00000001000,a2f,recvmsg
0,36014476300,36014476500,00000000200,a2f,recvmsg
0,36014525300,36014529000,00000003700,a02,open
0,36014650800,36014656200,00000005400,a2e,sendmsg
0,36014658200,36014661400,00000003200,a2e,sendmsg
0,36014662600,36014665800,00000003200,a2e,sendmsg
0,36014667100,36014670500,00000003400,a2e,sendmsg
0,36014674200,36014674800,00000000600,a2e,sendmsg
0,36014685600,36014686700,00000001100,a00,read
0,36014694800,36014696800,00000002000,a2f,recvmsg
0,36014707400,36014707600,00000000200,a2f,recvmsg
0,36014745800,36014747000,00000001200,a2f,recvmsg
0,36014855600,36014857300,00000001700,a2f,recvmsg
0,36014867300,36014867500,00000000200,a2f,recvmsg
0,36014677400,36014885300,00000207900,ae8,epoll_wait
0,36014889100,36014890300,00000001200,a2f,recvmsg
0,36014900900,36014901100,00000000200,a2f,recvmsg
0,36014943600,36014948900,00000005300,a2e,sendmsg
0,36014953200,36015007900,00000054700,ae8,epoll_wait
0,36015009900,36015011000,00000001100,a2f,recvmsg
0,36015017100,36015017300,00000000200,a2f,recvmsg
0,36015058400,36015061400,00000003000,a2e,sendmsg
0,36015063700,36015169400,00000105700,ae8,epoll_wait
0,36015171200,36015172300,00000001100,a2f,recvmsg
0,36015182400,36015182600,00000000200,a2f,recvmsg
0,36015214600,36015218000,00000003400,a2e,sendmsg
0,36015221100,36015253400,00000032300,ae8,epoll_wait
0,36015255200,36015256200,00000001000,a2f,recvmsg
0,36015261600,36015261800,00000000200,a2f,recvmsg
0,36015298900,36015301100,00000002200,a2e,sendmsg
0,36015303300,36015670700,00000367400,ae8,epoll_wait
0,36015672600,36015673600,00000001000,a2f,recvmsg
0,36015679300,36015679400,00000000100,a2f,recvmsg
0,36015720800,36015723100,00000002300,a2e,sendmsg
0,36015725200,36015738900,00000013700,ae8,epoll_wait
0,36015740700,36015741500,00000000800,a2f,recvmsg
0,36015746700,36015746900,00000000200,a2f,recvmsg
0,36015780600,36015782800,00000002200,a2e,sendmsg
0,36015784700,36015794100,00000009400,ae8,epoll_wait
0,36015800700,36015801400,00000000700,a2f,recvmsg
0,36015805800,36015806400,00000000600,a2f,recvmsg
0,36015810900,36015811000,00000000100,a2f,recvmsg
0,36015846200,36015956700,00000110500,ae8,epoll_wait
0,36015963400,36015965500,00000002100,a2f,recvmsg
0,36014348800,36016060900,00001712100,a17,select
0,36016081700,36016088700,00000007000,aca,futex
0,36016052800,36016117900,00000065100,ae8,epoll_wait
0,36016123100,36016125200,00000002100,a2f,recvmsg
0,36016141800,36016142000,00000000200,a2f,recvmsg
0,36016231200,36016236100,00000004900,a2e,sendmsg
0,36016237800,36016240400,00000002600,a2e,sendmsg
0,36016241500,36016244100,00000002600,a2e,sendmsg
0,36016381100,36016383900,00000002800,a2e,sendmsg
0,36016054200,36016390900,00000336700,a07,poll
0,36016403900,36016405600,00000001700,a2e,sendmsg
0,36016410800,36016411000,00000000200,a00,read
0,36016489800,36016492300,00000002500,a01,write
0,36016524100,36016525600,00000001500,a01,write
0,36016554400,36016556400,00000002000,a2f,recvmsg
0,36016571400,36016571600,00000000200,a2f,recvmsg
0,36016577000,36016577200,00000000200,a2f,recvmsg
0,36016587400,36016587600,00000000200,a2f,recvmsg
0,36016590400,36016590500,00000000100,a2f,recvmsg
0,36016595800,36016596200,00000000400,a00,read
0,36016608500,36016609500,00000001000,a2f,recvmsg
0,36016676000,36016683500,00000007500,a07,poll
0,36016687100,36016712800,00000025700,ae8,epoll_wait
0,36016717400,36016719100,00000001700,a2f,recvmsg
0,36016726600,36016726900,00000000300,a2f,recvmsg
0,36016728600,36016730500,00000001900,a2f,recvmsg
0,36016739300,36016739500,00000000200,a2f,recvmsg
0,36016818900,36016822200,00000003300,a2e,sendmsg
0,36016823900,36016826900,00000003000,a2e,sendmsg
0,36016828000,36016831000,00000003000,a2e,sendmsg
0,36016859700,36016862500,00000002800,a2e,sendmsg
0,36016886500,36016887500,00000001000,a2e,sendmsg
0,36016910300,36016911600,00000001300,a2f,recvmsg
0,36016989400,36016989800,00000000400,a00,read
0,36017004100,36017005200,00000001100,a2f,recvmsg
0,36017018100,36017041900,00000023800,a07,poll
0,36017056100,36017057700,00000001600,aca,futex
0,36017063600,36017064600,00000001000,aca,futex
0,36017086500,36017088300,00000001800,a07,poll
0,36017088700,36017088900,00000000200,a00,read
0,36017096300,36017097300,00000001000,a2f,recvmsg
0,36017139700,36017144800,00000005100,a07,poll
0,36017304600,36017310500,00000005900,a07,poll
0,36017315100,36017317600,00000002500,a2e,sendmsg
0,36017320800,36017321000,00000000200,a00,read
0,36017322800,36017323800,00000001000,a2e,sendmsg
0,36017329700,36017330400,00000000700,a2e,sendmsg
0,36017147000,36017344500,00000197500,ae8,epoll_wait
0,36017348600,36017351600,00000003000,a2f,recvmsg
0,36017373800,36017374100,00000000300,a2f,recvmsg
0,36017375500,36017376900,00000001400,a2f,recvmsg
0,36017397200,36017397400,00000000200,a2f,recvmsg
0,36017424000,36017427900,00000003900,a2e,sendmsg
0,36017448500,36017449300,00000000800,a2e,sendmsg
0,36017472200,36017480700,00000008500,a01,write
0,36017534800,36017538100,00000003300,a2e,sendmsg
0,36017539500,36017542400,00000002900,a2e,sendmsg
0,36017571600,36017573500,00000001900,a2e,sendmsg
0,36017599500,36017600300,00000000800,a2e,sendmsg
0,36017609600,36017610500,00000000900,a00,read
0,36017624500,36017626000,00000001500,a2f,recvmsg
0,36017684800,36017688600,00000003800,a07,poll
0,36017699900,36017703500,00000003600,a07,poll
0,36017715700,36017716700,00000001000,a2f,recvmsg
0,36017784200,36017787000,00000002800,a01,write
0,36017795100,36017795800,00000000700,a2f,recvmsg
0,36017798000,36017798200,00000000200,a00,read
0,36017820200,36017822200,00000002000,aca,futex
0,36017824000,36017824400,00000000400,aca,futex
0,36017849400,36017849700,00000000300,aca,futex
0,36017850200,36017850400,00000000200,aca,futex
0,36017854400,36017857200,00000002800,a07,poll
0,36017982000,36017984200,00000002200,a07,poll
0,36017989800,36017991600,00000001800,a2e,sendmsg
0,36017994600,36017994800,00000000200,a00,read
0,36017604300,36018000300,00000396000,ae8,epoll_wait
0,36018004700,36018006300,00000001600,a2f,recvmsg
0,36018015300,36018015500,00000000200,a2f,recvmsg
0,36018016600,36018017200,00000000600,a2f,recvmsg
0,36018022300,36018022500,00000000200,a2f,recvmsg
0,36018053300,36018055800,00000002500,a2e,sendmsg
0,36017998000,36018121500,00000123500,a07,poll
0,36018159500,36018161600,00000002100,a01,write
0,36018170300,36018173200,00000002900,a07,poll
0,36018183100,36018184100,00000001000,a2f,recvmsg
0,36018247700,36018255100,00000007400,a07,poll
0,36018321300,36018324100,00000002800,a07,poll
0,36018328100,36018331200,00000003100,a2e,sendmsg
0,36018335400,36018335600,00000000200,a00,read
0,36018258500,36018340400,00000081900,ae8,epoll_wait
0,36018344800,36018346100,00000001300,a2f,recvmsg
0,36018354200,36018354400,00000000200,a2f,recvmsg
0,36018338500,36018406900,00000068400,a07,poll
0,36018454500,36018456500,00000002000,a07,poll
0,36018454500,36018476800,00000022300,a07,poll
0,36018478600,36018479600,00000001000,afe,inotify_add_watch
0,36018479800,36018480100,00000000300,afe,inotify_add_watch
0,36018480300,36018480600,00000000300,afe,inotify_add_watch
0,36018504400,36018506500,00000002100,a07,poll
0,36018509700,36018512000,00000002300,a2e,sendmsg
0,36018514400,36018514500,00000000100,a00,read
0,36018404600,36018518800,00000114200,ae8,epoll_wait
0,36018522200,36018523200,00000001000,a2f,recvmsg
0,36018530600,36018530800,00000000200,a2f,recvmsg
0,36018517100,36018579300,00000062200,a07,poll
0,36018623500,36018625400,00000001900,a07,poll
0,36018653700,36018654100,00000000400,a48,fcntl
0,36018664000,36018672000,00000008000,a00,read
0,36019128200,36019136900,00000008700,a07,poll
0,36019141500,36019144900,00000003400,a2e,sendmsg
0,36019151200,36019151400,00000000200,a00,read
0,36019153400,36019154300,00000000900,a2e,sendmsg
0,36019162700,36019163600,00000000900,a2e,sendmsg
0,36019170200,36019171000,00000000800,a2e,sendmsg
0,36019176900,36019177700,00000000800,a2e,sendmsg
0,36019183800,36019184500,00000000700,a2e,sendmsg
0,36019191300,36019192300,00000001000,a2e,sendmsg
0,36019198000,36019198700,00000000700,a2e,sendmsg
0,36019204400,36019205300,00000000900,a2e,sendmsg
0,36019211100,36019211900,00000000800,a2e,sendmsg
0,36019217800,36019218500,00000000700,a2e,sendmsg
0,36018577200,36019232400,00000655200,ae8,epoll_wait
0,36019236100,36019239300,00000003200,a2f,recvmsg
0,36019279600,36019281400,00000001800,a2f,recvmsg
0,36019360600,36019363700,00000003100,a2e,sendmsg
0,36019392500,36019393100,00000000600,a2e,sendmsg
0,36019418000,36019418600,00000000600,a2e,sendmsg
0,36019442800,36019443500,00000000700,a2e,sendmsg
0,36019467400,36019468200,00000000800,a2e,sendmsg
0,36019492700,36019493400,00000000700,a2e,sendmsg
0,36019518200,36019518700,00000000500,a2e,sendmsg
0,36019543100,36019543700,00000000600,a2e,sendmsg
0,36019567800,36019568400,00000000600,a2e,sendmsg
0,36019592500,36019593200,00000000700,a2e,sendmsg
0,36019617800,36019618500,00000000700,a2e,sendmsg
0,36019229700,36019625000,00000395300,a07,poll
0,36019626300,36019626700,00000000400,a00,read
0,36019635800,36019636600,00000000800,a2f,recvmsg
0,36019701300,36019701900,00000000600,a2f,recvmsg
0,36019704000,36019704200,00000000200,a00,read
0,36019744500,36019745000,00000000500,a2f,recvmsg
0,36019784400,36019784900,00000000500,a2f,recvmsg
0,36019824800,36019825400,00000000600,a2f,recvmsg
0,36019862300,36019862900,00000000600,a2f,recvmsg
0,36019899400,36019900000,00000000600,a2f,recvmsg
0,36019936000,36019936400,00000000400,a2f,recvmsg
0,36019972700,36019973300,00000000600,a2f,recvmsg
0,36020009100,36020009600,00000000500,a2f,recvmsg
0,36020045200,36020045700,00000000500,a2f,recvmsg
0,36020085600,36032572800,00012487200,a07,poll
0,36032574400,36032575200,00000000800,afe,inotify_add_watch
0,36032575300,36032575600,00000000300,afe,inotify_add_watch
0,36032575700,36032576000,00000000300,afe,inotify_add_watch
0,36019622500,36034271100,00014648600,ae8,epoll_wait
0,36034275600,36034278200,00000002600,a2f,recvmsg
0,36034291800,36034292000,00000000200,a2f,recvmsg
0,36034330500,36034335300,00000004800,a2e,sendmsg
0,36032577000,36035151100,00002574100,a07,poll
0,36035165800,36035166000,00000000200,a00,read
0,36034387500,36035176400,00000788900,ae8,epoll_wait
0,36035190500,36035190700,00000000200,a2f,recvmsg
0,36035173800,36035230800,00000057000,a07,poll
0,36035306300,36035314800,00000008500,a07,poll
0,36035344200,36035349400,00000005200,a07,poll
0,36035355300,36035358200,00000002900,a2e,sendmsg
0,36035320000,36035367100,00000047100,ae8,epoll_wait
0,36035371000,36035372100,00000001100,a2f,recvmsg
0,36035380400,36035380600,00000000200,a2f,recvmsg
0,36035436300,36035439000,00000002700,a2f,recvmsg
0,36035447100,36035447300,00000000200,a2f,recvmsg
0,36035484500,36035489700,00000005200,a2e,sendmsg
0,36035365600,36035495500,00000129900,a07,poll
0,36035496100,36035496600,00000000500,a00,read
0,36035492600,36035695000,00000202400,ae8,epoll_wait
0,36035802500,36035807100,00000004600,a2e,sendmsg
0,36035809000,36035812100,00000003100,a2e,sendmsg
0,36035813100,36035814400,00000001300,a2e,sendmsg
0,36035815700,36035818400,00000002700,a2e,sendmsg
0,36035554100,36035852400,00000298300,a07,poll
0,36035854800,36035856200,00000001400,a00,read
0,36035864100,36035866100,00000002000,a2f,recvmsg
0,36035876700,36035877000,00000000300,a2f,recvmsg
0,36035890100,36035893800,00000003700,a07,poll
0,36035895100,36035895300,00000000200,a00,read
0,36035905900,36035906600,00000000700,a2f,recvmsg
0,36035964200,36035973400,00000009200,a07,poll
0,36035980400,36035982100,00000001700,a2f,recvmsg
0,36035991900,36035992200,00000000300,a2f,recvmsg
0,36035847400,36036054100,00000206700,ae8,epoll_wait
0,36036058700,36036061100,00000002400,a2f,recvmsg
0,36036083400,36036083700,00000000300,a2f,recvmsg
0,36036246700,36036251100,00000004400,a2e,sendmsg
0,36036345600,36036346700,00000001100,a2e,sendmsg
0,36036007900,36036777500,00000769600,a07,poll
0,36036793600,36036793800,00000000200,a00,read
0,36036349200,36036803600,00000454400,ae8,epoll_wait
0,36036816000,36036816200,00000000200,a2f,recvmsg
0,36036801600,36036852100,00000050500,a07,poll
0,36036853500,36036854100,00000000600,a00,read
0,36036938000,36036947100,00000009100,a07,poll
0,36036938000,36046669800,00009731800,a07,poll
0,36046676600,36046678400,00000001800,afe,inotify_add_watch
0,36046679100,36046679400,00000000300,afe,inotify_add_watch
0,36046679900,36046680100,00000000200,afe,inotify_add_watch
0,36046683500,36058326000,00011642500,a07,poll
0,36046683500,36058328700,00011645200,a07,poll
0,36078627300,36078627400,00000000100,a0c,brk
0,36078639100,36078641600,00000002500,a15,access
0,36078646400,36078647200,00000000800,a15,access
0,36078653800,36078654800,00000001000,a09,mmap
0,36078658600,36078659100,00000000500,a15,access
0,36078664100,36078665000,00000000900,a00,read
0,36078666400,36078668100,00000001700,a09,mmap
0,36078672800,36078676100,00000003300,a09,mmap
0,36078678300,36078679600,00000001300,a09,mmap
0,36078686000,36078686600,00000000600,a15,access
0,36078690700,36078691400,00000000700,a00,read
0,36078692100,36078694000,00000001900,a09,mmap
0,36078697800,36078700700,00000002900,a09,mmap
0,36078703000,36078704100,00000001100,a09,mmap
0,36078710400,36078711000,00000000600,a15,access
0,36078713600,36078714300,00000000700,a00,read
0,36078714800,36078715500,00000000700,a09,mmap
0,36078716800,36078718400,00000001600,a09,mmap
0,36078721400,36078723400,00000002000,a09,mmap
0,36078731000,36078731500,00000000500,a15,access
0,36078733800,36078734500,00000000700,a00,read
0,36078735200,36078736900,00000001700,a09,mmap
0,36078740100,36078742900,00000002800,a09,mmap
0,36078745000,36078745900,00000000900,a09,mmap
0,36078752100,36078752700,00000000600,a15,access
0,36078755200,36078755800,00000000600,a00,read
0,36078756600,36078758100,00000001500,a09,mmap
0,36078758200,36078762300,00000004100,a09,mmap
0,36078764300,36078765700,00000001400,a09,mmap
0,36078772900,36078773400,00000000500,a15,access
0,36078775700,36078776500,00000000800,a00,read
0,36078777000,36078777700,00000000700,a09,mmap
0,36078779200,36078780700,00000001500,a09,mmap
0,36078784600,36078786800,00000002200,a09,mmap
0,36078788800,36078789700,00000000900,a09,mmap
0,36078802200,36078802700,00000000500,a15,access
0,36078805100,36078805700,00000000600,a00,read
0,36078806300,36078807600,00000001300,a09,mmap
0,36078810000,36078811700,00000001700,a09,mmap
0,36078818000,36078818500,00000000500,a15,access
0,36078820700,36078821400,00000000700,a00,read
0,36078822000,36078823600,00000001600,a09,mmap
0,36078826500,36078828500,00000002000,a09,mmap
0,36078836900,36078837400,00000000500,a15,access
0,36078839400,36078840100,00000000700,a00,read
0,36078840500,36078841300,00000000800,a09,mmap
0,36078842500,36078844200,00000001700,a09,mmap
0,36078846700,36078848900,00000002200,a09,mmap
0,36078850800,36078851800,00000001000,a09,mmap
0,36078857700,36078858400,00000000700,a15,access
0,36078862500,36078863000,00000000500,a00,read
0,36078863700,36078865100,00000001400,a09,mmap
0,36078868500,36078870300,00000001800,a09,mmap
0,36078878600,36078879300,00000000700,a15,access
0,36078882000,36078882600,00000000600,a00,read
0,36078883200,36078884700,00000001500,a09,mmap
0,36078887800,36078889400,00000001600,a09,mmap
0,36078898900,36078899400,00000000500,a15,access
0,36078901600,36078902100,00000000500,a00,read
0,36078902600,36078903100,00000000500,a09,mmap
0,36078904600,36078906100,00000001500,a09,mmap
0,36078909000,36078911000,00000002000,a09,mmap
0,36078918200,36078918700,00000000500,a15,access
0,36078921100,36078921800,00000000700,a00,read
0,36078922600,36078924400,00000001800,a09,mmap
0,36078928800,36078931700,00000002900,a09,mmap
0,36078933600,36078934700,00000001100,a09,mmap
0,36078944600,36078945100,00000000500,a15,access
0,36078947700,36078948200,00000000500,a00,read
0,36078948900,36078950900,00000002000,a09,mmap
0,36078954600,36078957400,00000002800,a09,mmap
0,36078959500,36078960300,00000000800,a09,mmap
0,36078969600,36078970400,00000000800,a15,access
0,36078973700,36078974300,00000000600,a00,read
0,36078974900,36078975300,00000000400,a09,mmap
0,36078976600,36078978200,00000001600,a09,mmap
0,36078981800,36078984200,00000002400,a09,mmap
0,36078991700,36078992300,00000000600,a15,access
0,36078994400,36078995000,00000000600,a00,read
0,36078995700,36078997100,00000001400,a09,mmap
0,36079001800,36079003200,00000001400,a09,mmap
0,36079014300,36079014900,00000000600,a15,access
0,36079017200,36079017700,00000000500,a00,read
0,36079018400,36079020000,00000001600,a09,mmap
0,36079023200,36079025000,00000001800,a09,mmap
0,36079032600,36079033100,00000000500,a15,access
0,36079035700,36079036300,00000000600,a00,read
0,36079036900,36079037500,00000000600,a09,mmap
0,36079038800,36079040200,00000001400,a09,mmap
0,36079043000,36079044800,00000001800,a09,mmap
0,36079053200,36079053600,00000000400,a15,access
0,36079056300,36079056900,00000000600,a00,read
0,36079057600,36079059100,00000001500,a09,mmap
0,36079062000,36079064600,00000002600,a09,mmap
0,36079066500,36079067500,00000001000,a09,mmap
0,36079075400,36079075800,00000000400,a15,access
0,36079078200,36079079000,00000000800,a00,read
0,36079079700,36079081300,00000001600,a09,mmap
0,36079085100,36079088000,00000002900,a09,mmap
0,36079090100,36079091000,00000000900,a09,mmap
0,36079103900,36079104400,00000000500,a15,access
0,36079108400,36079109000,00000000600,a00,read
0,36079109900,36079111400,00000001500,a09,mmap
0,36079115300,36079117500,00000002200,a09,mmap
0,36079119500,36079120500,00000001000,a09,mmap
0,36079128900,36079129400,00000000500,a15,access
0,36079131800,36079132400,00000000600,a00,read
0,36079133000,36079134500,00000001500,a09,mmap
0,36079137500,36079139200,00000001700,a09,mmap
0,36079151300,36079151800,00000000500,a15,access
0,36079153700,36079154300,00000000600,a00,read
0,36079155100,36079156300,00000001200,a09,mmap
0,36079159400,36079161200,00000001800,a09,mmap
0,36079168100,36079168600,00000000500,a15,access
0,36079170600,36079171100,00000000500,a00,read
0,36079171800,36079172200,00000000400,a09,mmap
0,36079173500,36079174900,00000001400,a09,mmap
0,36079179600,36079181400,00000001800,a09,mmap
0,36079183400,36079184100,00000000700,a09,mmap
0,36079197500,36079198100,00000000600,a15,access
0,36079200400,36079200900,00000000500,a00,read
0,36079201600,36079203400,00000001800,a09,mmap
0,36079207900,36079209200,00000001300,a09,mmap
0,36079233700,36079234200,00000000500,a09,mmap
0,36079256300,36079256700,00000000400,a09,mmap
0,36079272600,36079273000,00000000400,a09,mmap
0,36079275300,36079275600,00000000300,a09,mmap
0,36080113300,36080114000,00000000700,ada,set_tid_address
0,36080172500,36080172700,00000000200,a0c,brk
0,36080172800,36080174000,00000001200,a0c,brk
0,36080199300,36080208100,00000008800,a89,statfs
0,36080209100,36080209600,00000000500,a89,statfs
0,36080227700,36080238600,00000010900,a00,read
0,36080322700,36080331600,00000008900,a4e,getdents
0,36080457500,36080459200,00000001700,a00,read
0,36080505900,36080506600,00000000700,a00,read
0,36080545900,36080546400,00000000500,a00,read
0,36080607400,36080609800,00000002400,a00,read
0,36080684600,36080685500,00000000900,a00,read
0,36080715900,36080721500,00000005600,a2f,recvmsg
0,36080723500,36080725000,00000001500,a2f,recvmsg
0,36080728800,36080736200,00000007400,a2a,connect
0,36080773200,36080775800,00000002600,a2a,connect
0,36080777600,36080779200,00000001600,a2a,connect
0,36080786800,36080787700,00000000900,a00,read
0,36080802400,36080805400,00000003000,a09,mmap
0,36080808800,36080810400,00000001600,a15,access
0,36080814600,36080815400,00000000800,a00,read
0,36080817500,36080820500,00000003000,a09,mmap
0,36080825800,36080829400,00000003600,a09,mmap
0,36080866300,36080866900,00000000600,a09,mmap
0,36080869200,36080869700,00000000500,a15,access
0,36080872600,36080873200,00000000600,a00,read
0,36080874800,36080877200,00000002400,a09,mmap
0,36080880800,36080883100,00000002300,a09,mmap
0,36080893900,36080894500,00000000600,a15,access
0,36080896900,36080897500,00000000600,a00,read
0,36080898700,36080901000,00000002300,a09,mmap
0,36080904200,36080907200,00000003000,a09,mmap
0,36080909100,36080910400,00000001300,a09,mmap
0,36080954100,36080955100,00000001000,a09,mmap
0,36080955200,36080955400,00000000200,a08,lseek
0,36080976200,36080976900,00000000700,a00,read
0,36080978000,36080978300,00000000300,a00,read
0,36081646300,36081647000,00000000700,a00,read
0,36081651000,36081651300,00000000300,a00,read
0,36081673200,36081673700,00000000500,a00,read
0,36081691700,36081692100,00000000400,a00,read
0,36081695300,36081695700,00000000400,a00,read
0,36081714900,36081715300,00000000400,a00,read
0,36081860000,36081860600,00000000600,a00,read
0,36081864100,36081864500,00000000400,a00,read
0,36081998400,36081999000,00000000600,a00,read
0,36082017900,36082018100,00000000200,a00,read
0,36082063500,36082065300,00000001800,a09,mmap
0,36082068000,36082068800,00000000800,a15,access
0,36082069800,36082071100,00000001300,a02,open
0,36082071300,36082071800,00000000500,a04,stat
0,36082071900,36082072400,00000000500,a02,open
0,36082072500,36082072800,00000000300,a04,stat
0,36082073000,36082074100,00000001100,a02,open
0,36082074200,36082074500,00000000300,a04,stat
0,36082074600,36082075600,00000001000,a02,open
0,36082076500,36082077800,00000001300,a02,open
0,36082077800,36082078100,00000000300,a04,stat
0,36082078200,36082078800,00000000600,a02,open
0,36082078900,36082079200,00000000300,a04,stat
0,36082079300,36082079900,00000000600,a02,open
0,36082080000,36082080300,00000000300,a04,stat
0,36082080400,36082081300,00000000900,a02,open
0,36082081900,36082082700,00000000800,a02,open
0,36082082700,36082083000,00000000300,a04,stat
0,36082083100,36082083500,00000000400,a02,open
0,36082083500,36082083700,00000000200,a04,stat
0,36082083800,36082084500,00000000700,a02,open
0,36082084600,36082084800,00000000200,a04,stat
0,36082084900,36082085500,00000000600,a02,open
0,36082086100,36082086900,00000000800,a02,open
0,36082086900,36082087300,00000000400,a04,stat
0,36082087300,36082087800,00000000500,a02,open
0,36082087800,36082088100,00000000300,a04,stat
0,36082088200,36082088900,00000000700,a02,open
0,36082089000,36082089200,00000000200,a04,stat
0,36082089300,36082090100,00000000800,a02,open
0,36082110100,36082111100,00000001000,a00,read
0,36082137500,36082138100,00000000600,a00,read
0,36082144400,36082144900,00000000500,a00,read
0,36082215300,36082217100,00000001800,a09,mmap
0,36082218000,36082341300,00000123300,a38,clone
0,36082360000,36098558000,00016198000,a07,poll
1,33612690300,47175483200,13562792900,a07,poll
1,47175487800,47175488700,00000000900,a00,read
1,47175504700,47175505400,00000000700,a00,read
1,47175518100,47175520600,00000002500,a07,poll
1,47175535300,47176495400,00000960100,a07,poll
1,47176508300,47176510400,00000002100,a07,poll
1,47176581700,47176583900,00000002200,a02,open
1,47176598200,47176601200,00000003000,a09,mmap
1,47176601200,47176601400,00000000200,a08,lseek
1,47176631000,47176631800,00000000800,a09,mmap
1,47176631800,47176631900,00000000100,a08,lseek
1,47176646300,47176648600,00000002300,a15,access
1,47176674700,47176680600,00000005900,a2c,sendto
1,47176694800,47176725400,00000030600,a02,open
1,47176790100,47176791200,00000001100,a01,write
1,47176818500,47176821900,00000003400,a2f,recvmsg
1,47176823400,47176824500,00000001100,a2f,recvmsg
1,47176835500,47176838300,00000002800,a2c,sendto
1,47176784800,47176854400,00000069600,a00,read
1,47176857800,47176861900,00000004100,a00,read
1,47176874800,47176879500,00000004700,a02,open
1,47176879700,47176880500,00000000800,a02,open
1,47176887100,47176888400,00000001300,a00,read
1,47176898800,47176899800,00000001000,a00,read
1,47176909800,47176910700,00000000900,a00,read
1,47176918700,47176921100,00000002400,a09,mmap
1,47176921200,47176921400,00000000200,a08,lseek
1,47176953700,47176954500,00000000800,a09,mmap
1,47176954600,47176954600,00000000000,a08,lseek
1,47177034600,47177035000,00000000400,a00,read
1,47177035600,47177035800,00000000200,a00,read
1,47177040000,47177040200,00000000200,a00,read
1,47177045600,47177046800,00000001200,a09,mmap
1,47177046900,47177047000,00000000100,a08,lseek
1,47177064500,47177064900,00000000400,a09,mmap
1,47177065000,47177065000,00000000000,a08,lseek
1,47177076100,47177077400,00000001300,a15,access
1,47177095200,47177098400,00000003200,a2f,recvmsg
1,47177099500,47177100500,00000001000,a2f,recvmsg
1,47177107300,47177109100,00000001800,a2c,sendto
1,47177040000,47177121600,00000081600,a00,read
1,47177123600,47177127000,00000003400,a00,read
1,47177157600,47177158400,00000000800,a01,write
1,47177305300,47177314100,00000008800,60e,page_fault
1,47177570800,47177577300,00000006500,a2c,sendto
1,47177582900,47177584000,00000001100,a00,read
1,47177590200,47177590300,00000000100,a03,close
1,47177591700,47177597800,00000006100,a09,mmap
1,47177612700,47177618100,00000005400,a3d,wait4
1,47177687200,47177688900,00000001700,a09,mmap
1,47177689000,47177689100,00000000100,a08,lseek
1,47177737700,47177738100,00000000400,a00,read
1,47177739000,47177739200,00000000200,a00,read
1,47177740300,47177740500,00000000200,a00,read
1,47177745700,47177745900,00000000200,a00,read
1,47177746500,47177746800,00000000300,a00,read
1,47177748800,47177749100,00000000300,a00,read
1,47177749400,47177749500,00000000100,a08,lseek
1,47177796700,47177797800,00000001100,a01,write
1,47177808200,47177808500,00000000300,a00,read
1,47177808700,47177808800,00000000100,a08,lseek
1,47177825800,47177826900,00000001100,a01,write
1,47177853100,47177856700,00000003600,a2f,recvmsg
1,47177858400,47177859600,00000001200,a2f,recvmsg
1,47177867600,47177869400,00000001800,a2c,sendto
1,47177879600,47177881400,00000001800,a09,mmap
1,47177881500,47177881700,00000000200,a08,lseek
1,47177922000,47177923000,00000001000,a09,mmap
1,47177923000,47177923200,00000000200,a08,lseek
1,47177940200,47177945400,00000005200,afa,keyctl
1,47177954400,47177955700,00000001300,a00,read
1,47177965400,47177965900,00000000500,a00,read
1,47177971100,47177971400,00000000300,a00,read
1,47177978900,47177979200,00000000300,a00,read
1,47177988700,47177989600,00000000900,a09,mmap
1,47177989600,47177989700,00000000100,a08,lseek
1,47178024200,47178025000,00000000800,a09,mmap
1,47178023700,47178025100,00000001400,a08,lseek
1,47178039200,47178039400,00000000200,a5f,umask
1,47178094900,47178095800,00000000900,a00,read
1,47178105000,47178105500,00000000500,a00,read
1,47178115200,47178115800,00000000600,a00,read
1,47178121900,47178125700,00000003800,a15,access
1,47178132900,47178134500,00000001600,a00,read
1,47178134500,47178134800,00000000300,a00,read
1,47178134900,47178135100,00000000200,a00,read
1,47178135300,47178135600,00000000300,a00,read
1,47178135700,47178135900,00000000200,a00,read
1,47178136200,47178136200,00000000000,a00,read
1,47178136200,47178136400,00000000200,a00,read
1,47178136400,47178136600,00000000200,a00,read
1,47178136700,47178136900,00000000200,a00,read
1,47178137000,47178137200,00000000200,a00,read
1,47178137300,47178138000,00000000700,a00,read
1,47178138100,47178138300,00000000200,a00,read
1,47178156700,47178161100,00000004400,a2c,sendto
1,47178171000,47178172500,00000001500,a09,mmap
1,47178172500,47178172600,00000000100,a08,lseek
1,47178202100,47178207000,00000004900,a02,open
1,47178233400,47178233700,00000000300,aba,gettid
1,47178269200,47178269900,00000000700,a2f,recvmsg
1,17380865300,47178277000,29797411700,ae8,epoll_wait
1,47178300000,47178310800,00000010800,a00,read
1,33591844400,47178340800,13586496400,a17,select
1,47178270600,47178388800,00000118200,b0f,ppoll
1,47178394400,47178395800,00000001400,a2e,sendmsg
1,47178397900,47178398100,00000000200,a2f,recvmsg
1,47178605800,47178606800,00000001000,a00,read
1,47178614600,47178616100,00000001500,a2f,recvmsg
1,47178627300,47178627700,00000000400,a2f,recvmsg
1,47178398600,47178655100,00000256500,b0f,ppoll
1,47178669200,47178672500,00000003300,a2e,sendmsg
1,47178673600,47178674100,00000000500,a2f,recvmsg
1,47178676200,47178676400,00000000200,a2f,recvmsg
1,47178900500,47178901300,00000000800,a36,setsockopt
1,47178919700,47178920800,00000001100,a2f,recvmsg
1,47178941200,47178943700,00000002500,a2e,sendmsg
1,47178944200,47178944400,00000000200,a2f,recvmsg
1,47178333800,47178948400,00000614600,ae8,epoll_wait
1,47178966600,47178976200,00000009600,a00,read
1,47178945100,47179000900,00000055800,b0f,ppoll
1,47179022500,47179028400,00000005900,a00,read
1,47179036600,47179041900,00000005300,a00,read
1,47179059600,47179063600,00000004000,a09,mmap
1,47179063600,47179063700,00000000100,a08,lseek
1,47179102500,47179106100,00000003600,a2e,sendmsg
1,47179106800,47179107300,00000000500,a2f,recvmsg
1,47178991200,47179158200,00000167000,ae8,epoll_wait
1,47179163400,47179164400,00000001000,a2f,recvmsg
1,47179187700,47179190000,00000002300,a2e,sendmsg
1,47179190700,47179190900,00000000200,a2f,recvmsg
1,47179191600,47179240600,00000049000,b0f,ppoll
1,47179299200,47179299500,00000000300,a48,fcntl
1,47179302300,47179302400,00000000100,a5f,umask
1,47179327100,47179327700,00000000600,a53,mkdir
1,47179332600,47179332600,00000000000,a48,fcntl
1,47179333500,47179333600,00000000100,a5f,umask
1,47179351300,47179351900,00000000600,a53,mkdir
1,47179356900,47179357000,00000000100,a48,fcntl
1,47179357200,47179357800,00000000600,a5f,umask
1,47179375500,47179376100,00000000600,a53,mkdir
1,47179380400,47179380500,00000000100,a48,fcntl
1,47179381200,47179381200,00000000000,a5f,umask
1,47179394200,47179394600,00000000400,a53,mkdir
1,47179399300,47179399300,00000000000,a48,fcntl
1,47179400000,47179400000,00000000000,a5f,umask
1,47179413400,47179413800,00000000400,a53,mkdir
1,47179418100,47179418200,00000000100,a48,fcntl
1,47179418400,47179418900,00000000500,a5f,umask
1,47179427600,47179434700,00000007100,a02,open
1,47179435800,47179437200,00000001400,a02,open
1,47179437900,47179439300,00000001400,a02,open
1,47179439800,47179441200,00000001400,a02,open
1,47179441700,47179444600,00000002900,a02,open
1,47179445100,47179446200,00000001100,a02,open
1,47179446700,47179448500,00000001800,a02,open
1,47179448900,47179449900,00000001000,a02,open
1,47179450500,47179456800,00000006300,a02,open
1,47179457300,47179459800,00000002500,a02,open
1,47179460400,47179461800,00000001400,a02,open
1,47179462200,47179462800,00000000600,a02,open
1,47179463400,47179465100,00000001700,a02,open
1,47179465600,47179466900,00000001300,a02,open
1,47179475500,47179476900,00000001400,a06,lstat
1,47179481400,47179482400,00000001000,a06,lstat
1,47179484200,47179484700,00000000500,a06,lstat
1,47179486300,47179487800,00000001500,a06,lstat
1,47179489500,47179489800,00000000300,a06,lstat
1,47179491300,47179492100,00000000800,a06,lstat
1,47179493000,47179493800,00000000800,a02,open
1,47179496200,47179497600,00000001400,a4e,getdents
1,47179509800,47179511300,00000001500,a02,open
1,47179511400,47179512000,00000000600,a02,open
1,47179512100,47179512700,00000000600,a02,open
1,47179512800,47179513600,00000000800,a02,open
1,47179513700,47179514600,00000000900,a02,open
1,47179602800,47179607000,00000004200,a2e,sendmsg
1,47179607500,47179608100,00000000600,a2f,recvmsg
1,47179608600,47179663100,00000054500,b0f,ppoll
1,47179673600,47179675500,00000001900,a2e,sendmsg
1,47179675900,47179676100,00000000200,a2f,recvmsg
1,47179676400,47179721900,00000045500,b0f,ppoll
1,47179729100,47179730600,00000001500,a2e,sendmsg
1,47179737600,47179738300,00000000700,a2e,sendmsg
1,47179741500,47179742300,00000000800,a2e,sendmsg
1,47179806000,47179807200,00000001200,a4e,getdents
1,47179816600,47179817200,00000000600,a4e,getdents
1,47179825500,47179826100,00000000600,a4e,getdents
1,47179833300,47179833800,00000000500,a4e,getdents
1,47179841100,47179841600,00000000500,a4e,getdents
1,47179848800,47179849300,00000000500,a4e,getdents
1,47179857800,47179857900,00000000100,a48,fcntl
1,47179676400,47179865100,00000188700,b0f,ppoll
1,47179885900,47179891900,00000006000,a2e,sendmsg
1,47179893500,47179894900,00000001400,a53,mkdir
1,47179902600,47179902800,00000000200,a48,fcntl
1,47179910600,47179914600,00000004000,a01,write
1,47179928000,47179928700,00000000700,a53,mkdir
1,47179933000,47179933100,00000000100,a48,fcntl
1,47179938100,47179939800,00000001700,a01,write
1,47179955600,47179958500,00000002900,a2e,sendmsg
1,47179977500,47179978800,00000001300,a2e,sendmsg
1,47178652400,47179988700,00001336300,a07,poll
1,47179990800,47179991300,00000000500,a00,read
1,47180094100,47180095400,00000001300,a00,read
1,47180111100,47180111800,00000000700,a00,read
1,47180179500,47180180000,00000000500,a00,read
1,47180198100,47180199800,00000001700,a2f,recvmsg
1,47180289700,47180290000,00000000300,a00,read
1,47180305500,47180306700,00000001200,a2f,recvmsg
1,47180369100,47180370600,00000001500,aca,futex
1,47180377500,47180378400,00000000900,aca,futex
1,47180394100,47180432100,00000038000,a07,poll
1,47180438600,47180441100,00000002500,a2e,sendmsg
1,47180444500,47180444600,00000000100,a00,read
1,47180451100,47180465100,00000014000,a07,poll
1,47180467900,47180469500,00000001600,a2e,sendmsg
1,47179983500,47180802900,00000819400,ae8,epoll_wait
1,47180810900,47180811900,00000001000,a2f,recvmsg
1,47180842200,47180845100,00000002900,a2e,sendmsg
1,47180850500,47180851100,00000000600,a2f,recvmsg
1,47180863900,47180865400,00000001500,a2e,sendmsg
1,47180476000,47181367800,00000891800,a07,poll
1,47181368300,47181368500,00000000200,a00,read
1,47181375400,47181376200,00000000800,a2f,recvmsg
1,47181458400,47181459200,00000000800,a2f,recvmsg
1,47181461400,47181461500,00000000100,a00,read
1,47181530800,47181531200,00000000400,a00,read
1,47181545500,47181546800,00000001300,a2f,recvmsg
1,47181686600,47181687600,00000001000,a2f,recvmsg
1,47181693200,47181693300,00000000100,a2f,recvmsg
1,47181693900,47181697000,00000003100,a07,poll
1,47181701200,47181704200,00000003000,a2e,sendmsg
1,47181706700,47181706900,00000000200,a00,read
1,47181711600,47181727900,00000016300,a07,poll
1,47181757000,47181761400,00000004400,aca,futex
1,47181761500,47181761800,00000000300,aca,futex
1,47181854600,47182101400,00000246800,a07,poll
1,47182136300,47182143200,00000006900,a09,mmap
1,47182143400,47182143500,00000000100,a08,lseek
1,47182164000,47182164800,00000000800,a09,mmap
1,47182164800,47182164900,00000000100,a08,lseek
1,47182104100,47198042000,00015937900,a01,write
1,47198062000,47198067200,00000005200,a02,open
1,47198069800,47198071400,00000001600,a02,open
1,47198073100,47198074500,00000001400,a02,open
1,47198079700,47198080000,00000000300,a48,fcntl
1,47198090300,47198092000,00000001700,a02,open
1,47198093900,47198095100,00000001200,a02,open
1,47198096700,47198098000,00000001300,a02,open
1,47198101100,47198101100,00000000000,a48,fcntl
1,47198107400,47198109500,00000002100,a02,open
1,47198111300,47198112600,00000001300,a02,open
1,47198114100,47198115300,00000001200,a02,open
1,47198118800,47198118900,00000000100,a48,fcntl
1,47198124700,47198126600,00000001900,a02,open
1,47198128400,47198129700,00000001300,a02,open
1,47198131500,47198132600,00000001100,a02,open
1,47198136300,47198136300,00000000000,a48,fcntl
1,47198136300,47198144900,00000008600,a48,fcntl
1,47198159600,47198159600,00000000000,a48,fcntl
1,47198182400,47198187300,00000004900,a2e,sendmsg
1,47198201800,47198206200,00000004400,a2e,sendmsg
1,47198214200,47198215100,00000000900,a2e,sendmsg
1,47198215700,47198216300,00000000600,a2f,recvmsg
1,47182230300,47198233000,00016002700,a00,read
1,47198281600,47198295700,00000014100,a00,read
1,47198311500,47198316500,00000005000,a00,read
1,47198366100,47198369000,00000002900,a2f,recvmsg
1,47198400400,47198406700,00000006300,a00,read
1,47198427100,47198438100,00000011000,a00,read
1,47198449300,47198453000,00000003700,a00,read
1,47198449300,47198495000,00000045700,a00,read
1,47198508500,47198512300,00000003800,a00,read
1,47198537400,47198539500,00000002100,a00,read
1,47198552700,47198553100,00000000400,a00,read
1,47198565200,47198565800,00000000600,a00,read
1,47198581200,47198586200,00000005000,a09,mmap
1,47198586300,47198586500,00000000200,a08,lseek
1,47198606100,47198606800,00000000700,a09,mmap
1,47198606900,47198607000,00000000100,a08,lseek
1,47198635200,47198635700,00000000500,a09,mmap
1,47198635700,47198635800,00000000100,a08,lseek
1,47198653700,47198654200,00000000500,a09,mmap
1,47198654300,47198654400,00000000100,a08,lseek
1,47199082200,47199086600,00000004400,a01,write
1,47198480900,47199199800,00000718900,ae8,epoll_wait
1,47199210600,47199212200,00000001600,a2f,recvmsg
1,47199228300,47199231500,00000003200,a53,mkdir
1,47199252300,47199252800,00000000500,a53,mkdir
1,47199259900,47199260300,00000000400,a48,fcntl
1,47199272100,47199280300,00000008200,a01,write
1,47199309700,47199312600,00000002900,a2e,sendmsg
1,47199315500,47199316300,00000000800,a53,mkdir
1,47199321000,47199321100,00000000100,a48,fcntl
1,47199326500,47199329000,00000002500,a01,write
1,47199335400,47199336000,00000000600,a53,mkdir
1,47199340300,47199340300,00000000000,a48,fcntl
1,47199345500,47199347000,00000001500,a01,write
1,47178351700,47199363200,00021011500,a17,select
1,47199385600,47199393200,00000007600,aca,futex
1,47198217200,47199461700,00001244500,b0f,ppoll
1,47199481900,47199483100,00000001200,a00,read
1,47199497900,47199498500,00000000600,a00,read
1,47199468300,47199510000,00000041700,a07,poll
1,47199511100,47199511400,00000000300,a00,read
1,47199499200,47199545100,00000045900,b0f,ppoll
1,47199552000,47199553300,00000001300,a2f,recvmsg
1,47199571300,47199576300,00000005000,a15,access
1,47199577800,47199580300,00000002500,a02,open
1,47199588600,47199592400,00000003800,a00,read
1,47199606900,47199608100,00000001200,a15,access
1,47199615500,47199619100,00000003600,a02,open
1,47199619700,47199622300,00000002600,a15,access
1,47199640800,47199817400,00000176600,a38,clone
1,47199539000,47199827300,00000288300,a07,poll
1,47199829200,47199829900,00000000700,a00,read
1,47199836800,47199838700,00000001900,a2f,recvmsg
1,47199849600,47199849800,00000000200,a2f,recvmsg
1,47199499200,47199876300,00000377100,b0f,ppoll
1,47199947100,47199952100,00000005000,a2e,sendmsg
1,47199974600,47199976400,00000001800,a2e,sendmsg
1,47199871900,47199985700,00000113800,a07,poll
1,47200030500,47200036400,00000005900,a09,mmap
1,47200036500,47200036700,00000000200,a08,lseek
1,47200062800,47200070500,00000007700,a2a,connect
1,47200075300,47200076300,00000001000,a09,mmap
1,47200076300,47200076400,00000000100,a08,lseek
1,47200150900,47200166100,00000015200,a00,read
1,47200175100,47200181100,00000006000,a00,read
1,47200199200,47200200500,00000001300,a00,read
1,47200212900,47200213200,00000000300,a00,read
1,47200225500,47200226100,00000000600,a00,read
1,47200237100,47200238500,00000001400,a09,mmap
1,47200238600,47200238700,00000000100,a08,lseek
1,47200251800,47200252300,00000000500,a09,mmap
1,47200252400,47200252400,00000000000,a08,lseek
1,47200278100,47200278500,00000000400,a09,mmap
1,47200278600,47200278700,00000000100,a08,lseek
1,47200295600,47200296100,00000000500,a09,mmap
1,47200296100,47200296200,00000000100,a08,lseek
1,47200707600,47200712500,00000004900,a01,write
1,47199980900,47200816600,00000835700,ae8,epoll_wait
1,47200828100,47200829500,00000001400,a2f,recvmsg
1,47200850000,47200850700,00000000700,a2f,recvmsg
1,47201098200,47201098300,00000000100,a0c,brk
1,47201110400,47201113000,00000002600,a15,access
1,47201113700,47201114700,00000001000,a09,mmap
1,47201116500,47201117200,00000000700,a15,access
1,47201124100,47201125200,00000001100,a09,mmap
1,47201128900,47201129400,00000000500,a15,access
1,47201135700,47201136700,00000001000,a00,read
1,47201138500,47201140800,00000002300,a09,mmap
1,47201146700,47201150400,00000003700,a09,mmap
1,47201153000,47201154000,00000001000,a09,mmap
1,47201169100,47201169900,00000000800,a09,mmap
1,47201173300,47201173600,00000000300,a09,mmap
1,47201282100,47201282300,00000000200,a27,getpid
1,47201319700,47201319800,00000000100,a0c,brk
1,47201319900,47201320400,00000000500,a0c,brk
1,47201333500,47201333600,00000000100,a6e,getppid
1,47201363300,47201392400,00000029100,a38,clone
1,47200854000,47201408300,00000554300,a07,poll
1,47201451300,47201454200,00000002900,a09,mmap
1,47201454300,47201454400,00000000100,a08,lseek
1,47201471700,47201472400,00000000700,a09,mmap
1,47201472400,47201472500,00000000100,a08,lseek
1,47201531300,47201545300,00000014000,a00,read
1,47201554400,47201560700,00000006300,a00,read
1,47201577600,47201578900,00000001300,a00,read
1,47201591400,47201591800,00000000400,a00,read
1,47201603800,47201604400,00000000600,a00,read
1,47201615300,47201616700,00000001400,a09,mmap
1,47201616800,47201616900,00000000100,a08,lseek
1,47201629700,47201630100,00000000400,a09,mmap
1,47201630200,47201630300,00000000100,a08,lseek
1,47201655400,47201655900,00000000500,a09,mmap
1,47201655900,47201656000,00000000100,a08,lseek
1,47201672800,47201673300,00000000500,a09,mmap
1,47201673400,47201673500,00000000100,a08,lseek
1,47202352900,47202353000,00000000100,a0c,brk
1,47202363200,47202364700,00000001500,a15,access
1,47202365200,47202366100,00000000900,a09,mmap
1,47202368600,47202370500,00000001900,a15,access
1,47202376000,47202377000,00000001000,a09,mmap
1,47202380400,47202380900,00000000500,a15,access
1,47202386400,47202387200,00000000800,a00,read
1,47202388700,47202390700,00000002000,a09,mmap
1,47202394600,47202398000,00000003400,a09,mmap
1,47202399900,47202401100,00000001200,a09,mmap
1,47202412200,47202413000,00000000800,a09,mmap
1,47202414500,47202415200,00000000700,a09,mmap
1,47202416400,47202416600,00000000200,a09,mmap
1,47202522900,47202523200,00000000300,a27,getpid
1,47202560900,47202560900,00000000000,a0c,brk
1,47202561000,47202561700,00000000700,a0c,brk
1,47202568500,47202568500,00000000000,a6e,getppid
1,47202581800,47202582900,00000001100,a00,read
1,47202634700,47202665600,00000030900,a38,clone
1,47202220800,47202685800,00000465000,a07,poll
1,47202725100,47202728100,00000003000,a09,mmap
1,47202728200,47202728300,00000000100,a08,lseek
1,47202745800,47202746500,00000000700,a09,mmap
1,47202746600,47202746700,00000000100,a08,lseek
1,47202802700,47202816700,00000014000,a00,read
1,47202825500,47202831500,00000006000,a00,read
1,47202848600,47202849900,00000001300,a00,read
1,47202862100,47202862500,00000000400,a00,read
1,47202874700,47202875300,00000000600,a00,read
1,47202886200,47202887700,00000001500,a09,mmap
1,47202887700,47202887800,00000000100,a08,lseek
1,47202901000,47202901300,00000000300,a09,mmap
1,47202901400,47202901500,00000000100,a08,lseek
1,47202926700,47202927200,00000000500,a09,mmap
1,47202927200,47202927300,00000000100,a08,lseek
1,47202943800,47202944200,00000000400,a09,mmap
1,47202944300,47202944400,00000000100,a08,lseek
1,47203368200,47203372900,00000004700,a01,write
1,47203584900,47203585000,00000000100,a0c,brk
1,47203591600,47203593500,00000001900,a15,access
1,47203594100,47203594900,00000000800,a09,mmap
1,47203598900,47203599600,00000000700,a15,access
1,47203604900,47203605900,00000001000,a09,mmap
1,47203609900,47203610400,00000000500,a15,access
1,47203616300,47203617300,00000001000,a00,read
1,47203618800,47203620700,00000001900,a09,mmap
1,47203625400,47203628700,00000003300,a09,mmap
1,47203630800,47203632300,00000001500,a09,mmap
1,47203644100,47203645100,00000001000,a09,mmap
1,47203646800,47203647600,00000000800,a09,mmap
1,47203648700,47203649000,00000000300,a09,mmap
1,47203757400,47203757500,00000000100,a0c,brk
1,47203757700,47203758400,00000000700,a0c,brk
1,47203616300,47203786000,00000169700,a00,read
1,47203787600,47203793700,00000006100,a00,read
1,47203799300,47203842700,00000043400,a3d,wait4
1,47203852900,47203878600,00000025700,a38,clone
1,47203477700,47203894200,00000416500,a07,poll
1,47203931600,47203934800,00000003200,a09,mmap
1,47203934900,47203935000,00000000100,a08,lseek
1,47203951300,47203951900,00000000600,a09,mmap
1,47203952000,47203952100,00000000100,a08,lseek
1,47204008900,47204022900,00000014000,a00,read
1,47204031900,47204037600,00000005700,a00,read
1,47204054300,47204055600,00000001300,a00,read
1,47204068100,47204068400,00000000300,a00,read
1,47204080500,47204081100,00000000600,a00,read
1,47204092200,47204093700,00000001500,a09,mmap
1,47204093800,47204093800,00000000000,a08,lseek
1,47204106900,47204107400,00000000500,a09,mmap
1,47204106300,47204107500,00000001200,a08,lseek
1,47204132200,47204132700,00000000500,a09,mmap
1,47204132700,47204132800,00000000100,a08,lseek
1,47204148700,47204149200,00000000500,a09,mmap
1,47204149200,47204149300,00000000100,a08,lseek
1,47204568400,47204573100,00000004700,a01,write
1,47204826000,47204826100,00000000100,a0c,brk
1,47204836600,47204838500,00000001900,a15,access
1,47204839100,47204840100,00000001000,a09,mmap
1,47204841700,47204842500,00000000800,a15,access
1,47204847300,47204848300,00000001000,a09,mmap
1,47204851200,47204851800,00000000600,a15,access
1,47204857300,47204858000,00000000700,a00,read
1,47204859700,47204861800,00000002100,a09,mmap
1,47204866600,47204870200,00000003600,a09,mmap
1,47204872500,47204873700,00000001200,a09,mmap
1,47204886000,47204886800,00000000800,a09,mmap
1,47204888200,47204888800,00000000600,a09,mmap
1,47204890100,47204890300,00000000200,a09,mmap
1,47204995500,47204995800,00000000300,a27,getpid
1,47205041800,47205041900,00000000100,a0c,brk
1,47205042000,47205042700,00000000700,a0c,brk
1,47205051500,47205051800,00000000300,a6e,getppid
1,47205062300,47205063300,00000001000,a00,read
1,47203799300,47205141800,00001342500,a3d,wait4
1,47205151000,47205177500,00000026500,a38,clone
1,47204674500,47205188800,00000514300,a07,poll
1,47205226800,47205230200,00000003400,a09,mmap
1,47205230300,47205230400,00000000100,a08,lseek
1,47205247200,47205247900,00000000700,a09,mmap
1,47205248000,47205248100,00000000100,a08,lseek
1,47205308900,47205322800,00000013900,a00,read
1,47205332500,47205339700,00000007200,a00,read
1,47205357200,47205358400,00000001200,a00,read
1,47205371900,47205372300,00000000400,a00,read
1,47205384900,47205385800,00000000900,a00,read
1,47205398600,47205400400,00000001800,a09,mmap
1,47205400600,47205400700,00000000100,a08,lseek
1,47205414700,47205415300,00000000600,a09,mmap
1,47205415400,47205415500,00000000100,a08,lseek
1,47205441300,47205441700,00000000400,a09,mmap
1,47205441800,47205441900,00000000100,a08,lseek
1,47205458800,47205459400,00000000600,a09,mmap
1,47205459500,47205459600,00000000100,a08,lseek
1,47206108800,47206108900,00000000100,a0c,brk
1,47206119600,47206121700,00000002100,a15,access
1,47206126100,47206127000,00000000900,a15,access
1,47206131600,47206132500,00000000900,a09,mmap
1,47206136200,47206136800,00000000600,a15,access
1,47206142800,47206143600,00000000800,a00,read
1,47206146100,47206148100,00000002000,a09,mmap
1,47206153100,47206156800,00000003700,a09,mmap
1,47206159000,47206160300,00000001300,a09,mmap
1,47206173700,47206174500,00000000800,a09,mmap
1,47206175800,47206176600,00000000800,a09,mmap
1,47206177600,47206177900,00000000300,a09,mmap
1,47206282600,47206282900,00000000300,a27,getpid
1,47206325800,47206325900,00000000100,a0c,brk
1,47206326000,47206326700,00000000700,a0c,brk
1,47206333000,47206333300,00000000300,a6e,getppid
1,47206370400,47206372300,00000001900,a04,stat
1,47206372500,47206373600,00000001100,a04,stat
1,47206373700,47206374500,00000000800,a04,stat
1,47206374700,47206375900,00000001200,a04,stat
1,47206376100,47206376700,00000000600,a04,stat
1,47206381700,47206412100,00000030400,a38,clone
1,47206544800,47206545000,00000000200,a0c,brk
1,47206553300,47206554700,00000001400,a15,access
1,47206555100,47206555900,00000000800,a09,mmap
1,47206558900,47206559800,00000000900,a15,access
1,47206564600,47206565600,00000001000,a09,mmap
1,47206569200,47206569700,00000000500,a15,access
1,47206574800,47206575500,00000000700,a00,read
1,47206576800,47206578900,00000002100,a09,mmap
1,47206584400,47206587800,00000003400,a09,mmap
1,47206589800,47206591000,00000001200,a09,mmap
1,47206605100,47206605800,00000000700,a09,mmap
1,47206609500,47206609700,00000000200,a09,mmap
1,47206718600,47206718900,00000000300,a0c,brk
1,47206719000,47206719800,00000000800,a0c,brk
1,47206734700,47206735700,00000001000,a09,mmap
1,47206737300,47206739000,00000001700,a00,read
1,47206424900,47206802700,00000377800,a3d,wait4
1,47206424900,47206848700,00000423800,a3d,wait4
1,47206857700,47206883900,00000026200,a38,clone
1,47205987900,47206896100,00000908200,a07,poll
1,47206937700,47206940900,00000003200,a09,mmap
1,47206941000,47206941100,00000000100,a08,lseek
1,47206959000,47206959800,00000000800,a09,mmap
1,47206959900,47206960000,00000000100,a08,lseek
1,47207024000,47207037800,00000013800,a00,read
1,47207048300,47207056300,00000008000,a00,read
1,47207075400,47207076800,00000001400,a00,read
1,47207090600,47207091100,00000000500,a00,read
1,47207104700,47207105500,00000000800,a00,read
1,47207117900,47207119600,00000001700,a09,mmap
1,47207119700,47207119800,00000000100,a08,lseek
1,47207134200,47207134600,00000000400,a09,mmap
1,47207134700,47207134800,00000000100,a08,lseek
1,47207161200,47207161800,00000000600,a09,mmap
1,47207161800,47207161900,00000000100,a08,lseek
1,47207180800,47207181400,00000000600,a09,mmap
1,47207181500,47207181600,00000000100,a08,lseek
1,47207619300,47207623800,00000004500,a01,write
1,47207843600,47207843700,00000000100,a0c,brk
1,47207856200,47207858400,00000002200,a15,access
1,47207859000,47207860000,00000001000,a09,mmap
1,47207863000,47207865700,00000002700,a15,access
1,47207871900,47207872900,00000001000,a09,mmap
1,47207877100,47207877600,00000000500,a15,access
1,47207883900,47207885000,00000001100,a00,read
1,47207886600,47207888800,00000002200,a09,mmap
1,47207894200,47207898000,00000003800,a09,mmap
1,47207900600,47207901800,00000001200,a09,mmap
1,47207915500,47207916400,00000000900,a09,mmap
1,47207917800,47207918700,00000000900,a09,mmap
1,47207919900,47207920200,00000000300,a09,mmap
1,47208046900,47208047200,00000000300,a27,getpid
1,47208088000,47208088100,00000000100,a0c,brk
1,47208088200,47208088900,00000000700,a0c,brk
1,47208096000,47208096300,00000000300,a6e,getppid
1,47208111600,47208112400,00000000800,a00,read
1,47208128900,47208157100,00000028200,a38,clone
1,47207730500,47208172600,00000442100,a07,poll
1,47208209000,47208211700,00000002700,a09,mmap
1,47208211800,47208211900,00000000100,a08,lseek
1,47208227700,47208228900,00000001200,a09,mmap
1,47208228900,47208229000,00000000100,a08,lseek
1,47208286100,47208301700,00000015600,a00,read
1,47208311400,47208319000,00000007600,a00,read
1,47208336700,47208338200,00000001500,a00,read
1,47208351000,47208351400,00000000400,a00,read
1,47208363700,47208364400,00000000700,a00,read
1,47208375800,47208377400,00000001600,a09,mmap
1,47208377500,47208377600,00000000100,a08,lseek
1,47208391700,47208392100,00000000400,a09,mmap
1,47208392200,47208392300,00000000100,a08,lseek
1,47208416500,47208417100,00000000600,a09,mmap
1,47208417200,47208417300,00000000100,a08,lseek
1,47208435700,47208436200,00000000500,a09,mmap
1,47208436200,47208436300,00000000100,a08,lseek
1,47210119100,47210119200,00000000100,a0c,brk
1,47210129600,47210131300,00000001700,a15,access
1,47210131900,47210133000,00000001100,a09,mmap
1,47210137200,47210139300,00000002100,a15,access
1,47210144400,47210145400,00000001000,a09,mmap
1,47210149000,47210149500,00000000500,a15,access
1,47210154000,47210155100,00000001100,a00,read
1,47210156300,47210158600,00000002300,a09,mmap
1,47210163600,47210167600,00000004000,a09,mmap
1,47210169800,47210171000,00000001200,a09,mmap
1,47210178200,47210178900,00000000700,a15,access
1,47210183000,47210183500,00000000500,a00,read
1,47210184600,47210186200,00000001600,a09,mmap
1,47210190400,47210192900,00000002500,a09,mmap
1,47210194900,47210195700,00000000800,a09,mmap
1,47210204400,47210205200,00000000800,a15,access
1,47210208000,47210208500,00000000500,a00,read
1,47210209100,47210210000,00000000900,a09,mmap
1,47210211400,47210213000,00000001600,a09,mmap
1,47210217200,47210219500,00000002300,a09,mmap
1,47210226300,47210227000,00000000700,a15,access
1,47210230300,47210231100,00000000800,a00,read
1,47210231700,47210233500,00000001800,a09,mmap
1,47210237100,47210239000,00000001900,a09,mmap
1,47210245600,47210246200,00000000600,a15,access
1,47210248500,47210249100,00000000600,a00,read
1,47210250000,47210251700,00000001700,a09,mmap
1,47210255700,47210256800,00000001100,a09,mmap
1,47210265400,47210265900,00000000500,a15,access
1,47210268200,47210268800,00000000600,a00,read
1,47210269200,47210270100,00000000900,a09,mmap
1,47210271400,47210273200,00000001800,a09,mmap
1,47210276800,47210278900,00000002100,a09,mmap
1,47210287200,47210287700,00000000500,a15,access
1,47210290900,47210291600,00000000700,a00,read
1,47210292200,47210293600,00000001400,a09,mmap
1,47210295900,47210297400,00000001500,a09,mmap
1,47210322900,47210323500,00000000600,a09,mmap
1,47210328800,47210329100,00000000300,a09,mmap
1,47210330300,47210330500,00000000200,a09,mmap
1,47210469700,47210470200,00000000500,ada,set_tid_address
1,47210546000,47210546200,00000000200,a0c,brk
1,47210546300,47210547100,00000000800,a0c,brk
1,47210624800,47210625400,00000000600,a10,ioctl
1,47210658500,47210659700,00000001200,a09,mmap
1,47211736000,47211737800,00000001800,a09,mmap
1,47211828300,47211829300,00000001000,a0c,brk
1,47211933500,47211934200,00000000700,a59,readlink
1,47211941900,47211944600,00000002700,a02,open
1,47211947800,47211948900,00000001100,a02,open
1,47211955700,47211956400,00000000700,a04,stat
1,47211959800,47211960500,00000000700,a04,stat
1,47211963500,47211963800,00000000300,a04,stat
1,47211976800,47211977300,00000000500,a04,stat
1,47211979900,47211980200,00000000300,a04,stat
1,47212981900,47212984300,00000002400,a09,mmap
1,47213366200,47213367700,00000001500,a0c,brk
1,47213941900,47213943500,00000001600,a0c,brk
1,47208593500,47214050200,00005456700,a07,poll
1,47214120900,47214125500,00000004600,a09,mmap
1,47214125600,47214125800,00000000200,a08,lseek
1,47214147300,47214148200,00000000900,a09,mmap
1,47214148300,47214148400,00000000100,a08,lseek
1,47214187300,47214203000,00000015700,a00,read
1,47214212700,47214219500,00000006800,a00,read
1,47214237500,47214239400,00000001900,a00,read
1,47214252700,47214253100,00000000400,a00,read
1,47214265500,47214266300,00000000800,a00,read
1,47214277900,47214279300,00000001400,a09,mmap
1,47214279400,47214279500,00000000100,a08,lseek
1,47214293100,47214293500,00000000400,a09,mmap
1,47214293600,47214293700,00000000100,a08,lseek
1,47214318900,47214319800,00000000900,a09,mmap
1,47214319800,47214319900,00000000100,a08,lseek
1,47214336800,47214337300,00000000500,a09,mmap
1,47214337300,47214337400,00000000100,a08,lseek
1,47214779800,47214785800,00000006000,a01,write
1,47214899800,47215210100,00000310300,a07,poll
1,47215214200,47215214900,00000000700,aca,futex
1,47215237900,47215240700,00000002800,a09,mmap
1,47215240900,47215241100,00000000200,a08,lseek
1,47215255000,47215255900,00000000900,a09,mmap
1,47215256000,47215256100,00000000100,a08,lseek
1,47215299400,47215310800,00000011400,a00,read
1,47215319200,47215325300,00000006100,a00,read
1,47215339900,47215340800,00000000900,a00,read
1,47215352300,47215352600,00000000300,a00,read
1,47215363800,47215364400,00000000600,a00,read
1,47215374900,47215376400,00000001500,a09,mmap
1,47215376500,47215376600,00000000100,a08,lseek
1,47215388100,47215388600,00000000500,a09,mmap
1,47215388600,47215388700,00000000100,a08,lseek
1,47215411300,47215411800,00000000500,a09,mmap
1,47215411800,47215411900,00000000100,a08,lseek
1,47215427600,47215427900,00000000300,a09,mmap
1,47215428000,47215428100,00000000100,a08,lseek
1,47215809900,47215813400,00000003500,a01,write
1,47215903200,47218028100,00002124900,a07,poll
1,47218054700,47218057300,00000002600,a09,mmap
1,47218057300,47218057400,00000000100,a08,lseek
1,47218070400,47218071000,00000000600,a09,mmap
1,47218071100,47218071200,00000000100,a08,lseek
1,47218109400,47218119000,00000009600,a00,read
1,47218127300,47218133200,00000005900,a00,read
1,47218147400,47218148400,00000001000,a00,read
1,47218160400,47218160800,00000000400,a00,read
1,47218171800,47218172300,00000000500,a00,read
1,47218182900,47218184200,00000001300,a09,mmap
1,47218184300,47218184400,00000000100,a08,lseek
1,47218203100,47218203600,00000000500,a09,mmap
1,47218203600,47218203700,00000000100,a08,lseek
1,47218225700,47218226100,00000000400,a09,mmap
1,47218226200,47218226300,00000000100,a08,lseek
1,47218241300,47218241700,00000000400,a09,mmap
1,47218241700,47218241800,00000000100,a08,lseek
1,47218612500,47218616300,00000003800,a01,write
1,47218705300,47218911900,00000206600,a07,poll
1,47218935500,47218937800,00000002300,a09,mmap
1,47218937800,47218938000,00000000200,a08,lseek
1,47218949600,47218950200,00000000600,a09,mmap
1,47218950300,47218950300,00000000000,a08,lseek
1,47218987900,47218997600,00000009700,a00,read
1,47219005300,47219010600,00000005300,a00,read
1,47219024100,47219025100,00000001000,a00,read
1,47219036600,47219037000,00000000400,a00,read
1,47219048300,47219048900,00000000600,a00,read
1,47219059000,47219060400,00000001400,a09,mmap
1,47219060400,47219060500,00000000100,a08,lseek
1,47219071900,47219072300,00000000400,a09,mmap
1,47219072300,47219072400,00000000100,a08,lseek
1,47219094200,47219094700,00000000500,a09,mmap
1,47219094700,47219094700,00000000000,a08,lseek
1,47219109000,47219109400,00000000400,a09,mmap
1,47219109500,47219109600,00000000100,a08,lseek
1,47219466200,47219469400,00000003200,a01,write
1,47219555000,47219747400,00000192400,a07,poll
1,47219770400,47219772600,00000002200,a09,mmap
1,47219772700,47219772800,00000000100,a08,lseek
1,47219785000,47219785700,00000000700,a09,mmap
1,47219785700,47219785800,00000000100,a08,lseek
1,47219822000,47219831700,00000009700,a00,read
1,47219839200,47219844200,00000005000,a00,read
1,47219857400,47219858300,00000000900,a00,read
1,47219869700,47219870000,00000000300,a00,read
1,47219881100,47219881500,00000000400,a00,read
1,47219891700,47219893100,00000001400,a09,mmap
1,47219893200,47219893300,00000000100,a08,lseek
1,47219904500,47219904900,00000000400,a09,mmap
1,47219905000,47219905100,00000000100,a08,lseek
1,47219926600,47219927000,00000000400,a09,mmap
1,47219927100,47219927200,00000000100,a08,lseek
1,47219941500,47219941900,00000000400,a09,mmap
1,47219942000,47219942100,00000000100,a08,lseek
1,47220292600,47220295600,00000003000,a01,write
1,47220350500,47220660300,00000309800,a07,poll
1,47220677400,47220679200,00000001800,a2f,recvmsg
1,47220765000,47220769500,00000004500,a07,poll
1,47220828900,47220829700,00000000800,a2f,recvmsg
1,47220833300,47221355900,00000522600,a07,poll
1,47221357100,47221357500,00000000400,a00,read
1,47221364800,47221365800,00000001000,a2f,recvmsg
1,47221412500,47221414900,00000002400,a07,poll
1,47221482700,47221483300,00000000600,a2f,recvmsg
1,47221485900,47221489900,00000004000,a07,poll
1,47221494000,47221498200,00000004200,a2e,sendmsg
1,47221500600,47221501100,00000000500,a00,read
1,47221505800,47221601900,00000096100,a07,poll
1,47221625200,47221626100,00000000900,aca,futex
1,47221642400,47221642600,00000000200,aca,futex
1,47221702300,47221830400,00000128100,a07,poll
1,47221858600,47221862800,00000004200,a09,mmap
1,47221862900,47221863000,00000000100,a08,lseek
1,47221879000,47221879800,00000000800,a09,mmap
1,47221879800,47221880000,00000000200,a08,lseek
1,47221928000,47221939500,00000011500,a00,read
1,47221948500,47221954900,00000006400,a00,read
1,47221970500,47221971900,00000001400,a00,read
1,47221984600,47221984800,00000000200,a00,read
1,47221996900,47221997700,00000000800,a00,read
1,47222047400,47222049300,00000001900,a09,mmap
1,47222049400,47222049500,00000000100,a08,lseek
1,47222063300,47222063900,00000000600,a09,mmap
1,47222064000,47222064000,00000000000,a08,lseek
1,47222088800,47222089400,00000000600,a09,mmap
1,47222089500,47222089600,00000000100,a08,lseek
1,47222105000,47222105600,00000000600,a09,mmap
1,47222105600,47222105700,00000000100,a08,lseek
1,47222106000,47222608900,00000502900,60e,page_fault
1,47223088400,47223092000,00000003600,a04,stat
1,47223107500,47223108000,00000000500,a04,stat
1,47223183300,47223252600,00000069300,a4e,getdents
1,47223383800,47223385400,00000001600,a04,stat
1,47223397300,47223398200,00000000900,a04,stat
1,47223405300,47223406100,00000000800,a04,stat
1,47223521700,47223523700,00000002000,a00,read
1,47223717800,47223730600,00000012800,a00,read
1,47223857300,47223862100,00000004800,a09,mmap
1,47223874400,47223875100,00000000700,a09,mmap
1,47222591500,47224076800,00001485300,a07,poll
1,47224121500,47224125400,00000003900,a09,mmap
1,47224125500,47224125700,00000000200,a08,lseek
1,47224144900,47224146400,00000001500,a09,mmap
1,47224146500,47224146600,00000000100,a08,lseek
1,47224215200,47224229500,00000014300,a00,read
1,47224239400,47224245800,00000006400,a00,read
1,47224264100,47224265400,00000001300,a00,read
1,47224277900,47224278300,00000000400,a00,read
1,47224291200,47224291700,00000000500,a00,read
1,47224303600,47224305600,00000002000,a09,mmap
1,47224305700,47224305800,00000000100,a08,lseek
1,47224319400,47224320000,00000000600,a09,mmap
1,47224320100,47224320200,00000000100,a08,lseek
1,47224345100,47224345700,00000000600,a09,mmap
1,47224345800,47224345800,00000000000,a08,lseek
1,47224362500,47224362900,00000000400,a09,mmap
1,47224363000,47224363100,00000000100,a08,lseek
1,47224771800,47224776100,00000004300,a01,write
1,47224799800,47224800500,00000000700,aca,futex
1,47224883300,47225117500,00000234200,a07,poll
1,47225144100,47225146700,00000002600,a09,mmap
1,47225146800,47225147000,00000000200,a08,lseek
1,47225159600,47225160300,00000000700,a09,mmap
1,47225160400,47225160500,00000000100,a08,lseek
1,47225201000,47225211300,00000010300,a00,read
1,47225219400,47225225300,00000005900,a00,read
1,47225239500,47225240600,00000001100,a00,read
1,47225251900,47225252300,00000000400,a00,read
1,47225263200,47225263800,00000000600,a00,read
1,47225274300,47225275700,00000001400,a09,mmap
1,47225275800,47225275900,00000000100,a08,lseek
1,47225286800,47225287200,00000000400,a09,mmap
1,47225287300,47225287400,00000000100,a08,lseek
1,47225309900,47225310300,00000000400,a09,mmap
1,47225310400,47225310500,00000000100,a08,lseek
1,47225324700,47225325000,00000000300,a09,mmap
1,47225325000,47225325100,00000000100,a08,lseek
1,47225699000,47225703000,00000004000,a01,write
1,47225718100,47225718500,00000000400,aca,futex
1,47225791600,47225993300,00000201700,a07,poll
1,47226026000,47226028500,00000002500,a09,mmap
1,47226028600,47226028700,00000000100,a08,lseek
1,47226041000,47226041600,00000000600,a09,mmap
1,47226041700,47226041800,00000000100,a08,lseek
1,47226079000,47226088600,00000009600,a00,read
1,47226096200,47226101800,00000005600,a00,read
1,47226116200,47226117100,00000000900,a00,read
1,47226128700,47226129100,00000000400,a00,read
1,47226140800,47226141200,00000000400,a00,read
1,47226151700,47226153200,00000001500,a09,mmap
1,47226153200,47226153300,00000000100,a08,lseek
1,47226164600,47226165000,00000000400,a09,mmap
1,47226165000,47226165100,00000000100,a08,lseek
1,47226187400,47226187900,00000000500,a09,mmap
1,47226187900,47226188000,00000000100,a08,lseek
1,47226202600,47226202900,00000000300,a09,mmap
1,47226203000,47226203100,00000000100,a08,lseek
1,47226561800,47226565400,00000003600,a01,write
1,47226651200,47226848200,00000197000,a07,poll
1,47226872200,47226874600,00000002400,a09,mmap
1,47226874700,47226874800,00000000100,a08,lseek
1,47226886800,47226887400,00000000600,a09,mmap
1,47226887500,47226887600,00000000100,a08,lseek
1,47226924400,47226933300,00000008900,a00,read
1,47226941700,47226946600,00000004900,a00,read
1,47226960200,47226961000,00000000800,a00,read
1,47226972300,47226972700,00000000400,a00,read
1,47226983500,47226983800,00000000300,a00,read
1,47226994300,47226995500,00000001200,a09,mmap
1,47226995600,47226995700,00000000100,a08,lseek
1,47227006700,47227007200,00000000500,a09,mmap
1,47227007300,47227007400,00000000100,a08,lseek
1,47227029000,47227029400,00000000400,a09,mmap
1,47227029400,47227029500,00000000100,a08,lseek
1,47227043100,47227043600,00000000500,a09,mmap
1,47227042700,47227043700,00000001000,a08,lseek
1,47227396400,47227399600,00000003200,a01,write
1,47227483500,47227672800,00000189300,a07,poll
1,47227696100,47227698500,00000002400,a09,mmap
1,47227698600,47227698700,00000000100,a08,lseek
1,47227710300,47227710900,00000000600,a09,mmap
1,47227711000,47227711000,00000000000,a08,lseek
1,47227748000,47227756800,00000008800,a00,read
1,47227764500,47227769600,00000005100,a00,read
1,47227782800,47227783600,00000000800,a00,read
1,47227796200,47227796600,00000000400,a00,read
1,47227808000,47227808300,00000000300,a00,read
1,47227818600,47227819800,00000001200,a09,mmap
1,47227819800,47227819900,00000000100,a08,lseek
1,47227831000,47227831500,00000000500,a09,mmap
1,47227831600,47227831700,00000000100,a08,lseek
1,47227853800,47227854200,00000000400,a09,mmap
1,47227854300,47227854400,00000000100,a08,lseek
1,47227868700,47227869100,00000000400,a09,mmap
1,47227869100,47227869200,00000000100,a08,lseek
1,47228217500,47228220800,00000003300,a01,write
1,47228305800,47228492000,00000186200,a07,poll
1,47228515800,47228518000,00000002200,a09,mmap
1,47228518100,47228518200,00000000100,a08,lseek
1,47228529500,47228530100,00000000600,a09,mmap
1,47228530200,47228530200,00000000000,a08,lseek
1,47228566100,47228574700,00000008600,a00,read
1,47228582100,47228587100,00000005000,a00,read
1,47228600400,47228601300,00000000900,a00,read
1,47228612700,47228613000,00000000300,a00,read
1,47228623600,47228624000,00000000400,a00,read
1,47228634400,47228635700,00000001300,a09,mmap
1,47228635800,47228635900,00000000100,a08,lseek
1,47228647000,47228647500,00000000500,a09,mmap
1,47228647600,47228647700,00000000100,a08,lseek
1,47228669400,47228669900,00000000500,a09,mmap
1,47228670000,47228670000,00000000000,a08,lseek
1,47228683500,47228683900,00000000400,a09,mmap
1,47228684000,47228684000,00000000000,a08,lseek
1,47229029000,47229032400,00000003400,a01,write
1,47229116100,47229300300,00000184200,a07,poll
1,47229324000,47229326200,00000002200,a09,mmap
1,47229326200,47229326300,00000000100,a08,lseek
1,47229337600,47229338300,00000000700,a09,mmap
1,47229338400,47229338500,00000000100,a08,lseek
1,47229373900,47229382400,00000008500,a00,read
1,47229389600,47229394500,00000004900,a00,read
1,47229407800,47229408700,00000000900,a00,read
1,47229420000,47229420300,00000000300,a00,read
1,47229431300,47229431800,00000000500,a00,read
1,47229442100,47229443600,00000001500,a09,mmap
1,47229443700,47229443800,00000000100,a08,lseek
1,47229455400,47229455800,00000000400,a09,mmap
1,47229455900,47229456000,00000000100,a08,lseek
1,47229477900,47229478200,00000000300,a09,mmap
1,47229478300,47229478400,00000000100,a08,lseek
1,47229492400,47229492800,00000000400,a09,mmap
1,47229492900,47229493000,00000000100,a08,lseek
1,47229536200,47229539300,00000003100,a01,write
1,47229621700,47229800600,00000178900,a07,poll
1,47229822600,47229824300,00000001700,a09,mmap
1,47229824400,47229824500,00000000100,a08,lseek
1,47229835600,47229836200,00000000600,a09,mmap
1,47229836300,47229836500,00000000200,a08,lseek
1,47229856900,47229864100,00000007200,a00,read
1,47229870500,47229875000,00000004500,a00,read
1,47229887000,47229887900,00000000900,a00,read
1,47229898900,47229899200,00000000300,a00,read
1,47229910000,47229910400,00000000400,a00,read
1,47229920300,47229921400,00000001100,a09,mmap
1,47229921500,47229921600,00000000100,a08,lseek
1,47229931700,47229932200,00000000500,a09,mmap
1,47229932200,47229932300,00000000100,a08,lseek
1,47229953200,47229953500,00000000300,a09,mmap
1,47229953600,47229953700,00000000100,a08,lseek
1,47229967300,47229967700,00000000400,a09,mmap
1,47229967800,47229967900,00000000100,a08,lseek
1,47230340700,47230343300,00000002600,a01,write
1,47230426400,47230611300,00000184900,a07,poll
1,47230635300,47230637500,00000002200,a09,mmap
1,47230637600,47230637700,00000000100,a08,lseek
1,47230649900,47230650500,00000000600,a09,mmap
1,47230650500,47230650600,00000000100,a08,lseek
1,47230687600,47230696100,00000008500,a00,read
1,47230703200,47230708100,00000004900,a00,read
1,47230721100,47230722100,00000001000,a00,read
1,47230733500,47230734000,00000000500,a00,read
1,47230744800,47230745300,00000000500,a00,read
1,47230755500,47230757000,00000001500,a09,mmap
1,47230757200,47230757300,00000000100,a08,lseek
1,47230768800,47230769300,00000000500,a09,mmap
1,47230769400,47230769500,00000000100,a08,lseek
1,47230791300,47230791800,00000000500,a09,mmap
1,47230791900,47230792000,00000000100,a08,lseek
1,47230805900,47230806300,00000000400,a09,mmap
1,47230806300,47230806400,00000000100,a08,lseek
1,47231147800,47231150800,00000003000,a01,write
1,47231233500,47231420500,00000187000,a07,poll
1,47231444100,47231446500,00000002400,a09,mmap
1,47231446600,47231446600,00000000000,a08,lseek
1,47231458700,47231459300,00000000600,a09,mmap
1,47231459400,47231459500,00000000100,a08,lseek
1,47231495500,47231503900,00000008400,a00,read
1,47231511000,47231515900,00000004900,a00,read
1,47231529300,47231530200,00000000900,a00,read
1,47231541800,47231542100,00000000300,a00,read
1,47231552800,47231553200,00000000400,a00,read
1,47231563600,47231565000,00000001400,a09,mmap
1,47231565100,47231565200,00000000100,a08,lseek
1,47231576000,47231576400,00000000400,a09,mmap
1,47231576500,47231576600,00000000100,a08,lseek
1,47231598300,47231598600,00000000300,a09,mmap
1,47231598700,47231598800,00000000100,a08,lseek
1,47231612500,47231612900,00000000400,a09,mmap
1,47231613000,47231613100,00000000100,a08,lseek
1,47231951600,47231954800,00000003200,a01,write
1,47232038300,47234006800,00001968500,a07,poll
1,47234031000,47234033200,00000002200,a09,mmap
1,47234033300,47234033400,00000000100,a08,lseek
1,47234045500,47234046100,00000000600,a09,mmap
1,47234046100,47234046200,00000000100,a08,lseek
1,47234082700,47234090900,00000008200,a00,read
1,47234098300,47234103000,00000004700,a00,read
1,47234116200,47234117200,00000001000,a00,read
1,47234128600,47234129000,00000000400,a00,read
1,47234139500,47234139900,00000000400,a00,read
1,47234150300,47234151800,00000001500,a09,mmap
1,47234151800,47234151900,00000000100,a08,lseek
1,47234162900,47234163300,00000000400,a09,mmap
1,47234163400,47234163500,00000000100,a08,lseek
1,47234185100,47234185600,00000000500,a09,mmap
1,47234185700,47234185800,00000000100,a08,lseek
1,47234199700,47234200300,00000000600,a09,mmap
1,47234200400,47234200500,00000000100,a08,lseek
1,47234537600,47234540900,00000003300,a01,write
1,47234624700,47234830200,00000205500,a07,poll
1,47234862000,47234866000,00000004000,a09,mmap
1,47234866200,47234866400,00000000200,a08,lseek
1,47234881200,47234881800,00000000600,a09,mmap
1,47234881900,47234882000,00000000100,a08,lseek
1,47234924200,47234934300,00000010100,a00,read
1,47234942400,47234947600,00000005200,a00,read
1,47234962100,47234963300,00000001200,a00,read
1,47234974900,47234975100,00000000200,a00,read
1,47234986200,47234986600,00000000400,a00,read
1,47234997800,47234999300,00000001500,a09,mmap
1,47234999400,47234999500,00000000100,a08,lseek
1,47235011000,47235011500,00000000500,a09,mmap
1,47235011600,47235011700,00000000100,a08,lseek
1,47235034300,47235034800,00000000500,a09,mmap
1,47235034900,47235035000,00000000100,a08,lseek
1,47235049200,47235049600,00000000400,a09,mmap
1,47235049700,47235049800,00000000100,a08,lseek
1,47235407800,47235411500,00000003700,a01,write
1,47235427100,47235802900,00000375800,a07,poll
1,47235819300,47235821200,00000001900,a2f,recvmsg
1,47235902900,47235907000,00000004100,a07,poll
1,47235975600,47235976400,00000000800,a2f,recvmsg
1,47236027800,47236031800,00000004000,a0c,brk
1,47236035100,47236076900,00000041800,a4e,getdents
1,47236124700,47236129000,00000004300,a0c,brk
1,47236274900,47236277700,00000002800,a00,read
1,47236662100,47236663300,00000001200,a00,read
1,47237112500,47237113700,00000001200,a00,read
1,47237328200,47237329200,00000001000,a00,read
1,47237588000,47237589300,00000001300,a00,read
1,47237714700,47237717700,00000003000,a00,read
1,47237868800,47237870900,00000002100,a00,read
1,47242524100,47242524600,00000000500,a10,ioctl
1,47242532900,47242533000,00000000100,a10,ioctl
1,47242536400,47242536400,00000000000,a10,ioctl
1,47242645100,47242646400,00000001300,a00,read
1,47242825100,47242825600,00000000500,a10,ioctl
1,47242829500,47242829500,00000000000,a08,lseek
1,47242836000,47242836100,00000000100,a10,ioctl
1,47242838100,47242838200,00000000100,a10,ioctl
1,47242845000,47242845000,00000000000,a08,lseek
1,47242850900,47242850900,00000000000,a10,ioctl
1,47242850900,47242854300,00000003400,a10,ioctl
1,47242855700,47242855800,00000000100,a10,ioctl
1,47242962500,47242969600,00000007100,a00,read
1,47242990500,47242993600,00000003100,a0c,brk
1,47243192100,47243197500,00000005400,a00,read
1,47243359800,47243363200,00000003400,a09,mmap
1,47243673800,47243675600,00000001800,a00,read
1,47244004500,47244010400,00000005900,a00,read
1,47244200800,47244202000,00000001200,a00,read
1,47244581300,47244587500,00000006200,a00,read
1,47244618000,47244621000,00000003000,a09,mmap
1,47254035200,47254038400,00000003200,a09,mmap
1,47254062300,47254062800,00000000500,a09,mmap
1,47254351700,47254353900,00000002200,a00,read
1,47254714300,47254715900,00000001600,a04,stat
1,47254725100,47254725600,00000000500,a04,stat
1,47254789900,47254849800,00000059900,a4e,getdents
1,47255016100,47255020500,00000004400,a00,read
1,47255251800,47255252800,00000001000,a04,stat
1,47255260800,47255261200,00000000400,a04,stat
1,47255387100,47255388200,00000001100,a00,read
1,47255478800,47255485400,00000006600,a4e,getdents
1,47255557700,47255561900,00000004200,a00,read
1,47255820900,47255823700,00000002800,a0c,brk
1,47255957100,47255968300,00000011200,a2a,connect
1,47255973600,47255975600,00000002000,a2a,connect
1,47255990800,47255992100,00000001300,a00,read
1,47256010100,47256013800,00000003700,a09,mmap
1,47256017900,47256020400,00000002500,a15,access
1,47256025100,47256025900,00000000800,a00,read
1,47256028800,47256032600,00000003800,a09,mmap
1,47256039100,47256044000,00000004900,a09,mmap
1,47256058300,47256059200,00000000900,a15,access
1,47256062600,47256063100,00000000500,a00,read
1,47256064600,47256067300,00000002700,a09,mmap
1,47256070700,47256074500,00000003800,a09,mmap
1,47256079000,47256080400,00000001400,a09,mmap
1,47256125400,47256126200,00000000800,a09,mmap
1,47256129300,47256129900,00000000600,a15,access
1,47256133000,47256133600,00000000600,a00,read
1,47256134800,47256137300,00000002500,a09,mmap
1,47256140500,47256142800,00000002300,a09,mmap
1,47256152300,47256152900,00000000600,a15,access
1,47256155400,47256156000,00000000600,a00,read
1,47256157100,47256159100,00000002000,a09,mmap
1,47256169100,47256170400,00000001300,a09,mmap
1,47256210000,47256210200,00000000200,a08,lseek
1,47256631500,47256679300,00000047800,a4e,getdents
1,47256762200,47256763500,00000001300,a04,stat
1,47256914300,47256915400,00000001100,a00,read
1,47257019800,47257037100,00000017300,a4e,getdents
1,47257128200,47257171700,00000043500,a4e,getdents
1,47257308300,47257309800,00000001500,a00,read
1,47257418900,47257420600,00000001700,a59,readlink
1,47257444000,47257445300,00000001300,a00,read
1,47257466600,47257467000,00000000400,a10,ioctl
1,47257472800,47257473500,00000000700,a00,read
1,47257642200,47257644300,00000002100,a0c,brk
1,47257647400,47257648100,00000000700,a00,read
1,47257810100,47257812500,00000002400,a09,mmap
1,47258106800,47258108900,00000002100,a0c,brk
1,47258461800,47258731500,00000269700,a4e,getdents
1,47258990700,47259176700,00000186000,a4e,getdents
1,47259254800,47259257600,00000002800,a09,mmap
1,47259477800,47259479400,00000001600,a09,mmap
1,47259656000,47259666200,00000010200,a00,read
1,47260096300,47260099400,00000003100,a00,read
1,47260281600,47260284800,00000003200,a00,read
1,47260467200,47260469600,00000002400,a00,read
1,47260755900,47260760200,00000004300,a00,read
1,47262206300,47262209200,00000002900,a00,read
1,47262397300,47262403400,00000006100,a09,mmap
1,47262837200,47262839300,00000002100,a00,read
1,47264153400,47264154400,00000001000,a04,stat
1,47264166300,47264166700,00000000400,a04,stat
1,47264170800,47264171200,00000000400,a04,stat
1,47264174500,47264174900,00000000400,a04,stat
1,47264177900,47264178300,00000000400,a04,stat
1,47264269900,47264276200,00000006300,a00,read
1,47264289800,47264292100,00000002300,a0c,brk
1,47264448600,47264449400,00000000800,a04,stat
1,47264457100,47264457400,00000000300,a04,stat
1,47264461100,47264461500,00000000400,a04,stat
1,47264464600,47264464800,00000000200,a04,stat
1,47264467800,47264468200,00000000400,a04,stat
1,47264551600,47264564600,00000013000,a00,read
1,47264975800,47264977100,00000001300,a04,stat
1,47264984800,47264985700,00000000900,a04,stat
1,47264989700,47264990500,00000000800,a04,stat
1,47265046500,47265055200,00000008700,a00,read
1,47265244400,47265248300,00000003900,a09,mmap
1,47265561700,47265564900,00000003200,a00,read
1,47266038000,47266039300,00000001300,a00,read
1,47266200100,47266203500,00000003400,a00,read
1,47266615700,47266617600,00000001900,a00,read
1,47267529400,47267532800,00000003400,a0c,brk
1,47267535000,47267544600,00000009600,a00,read
1,47267718500,47267723700,00000005200,a0c,brk
1,47267548900,47269597700,00002048800,a03,close
1,47269600500,47269602300,00000001800,a07,poll
1,47269624000,47269626700,00000002700,a2f,recvmsg
1,47269627100,47269628300,00000001200,a2f,recvmsg
1,47269631000,47269639300,00000008300,a04,stat
1,47269643400,47269644700,00000001300,a00,read
1,47269661400,47269664300,00000002900,a07,poll
1,47269685200,47270935400,00001250200,a07,poll
1,47270936700,47270937200,00000000500,a2d,recvfrom
1,47270940000,47270943100,00000003100,a2e,sendmsg
1,47270950800,47270952700,00000001900,a07,poll
1,47270953500,47270953900,00000000400,a2d,recvfrom
1,47270967200,47270976100,00000008900,a2a,connect
1,47270977400,47272216500,00001239100,a07,poll
1,47272220400,47272224700,00000004300,a14,writev
0,36098603100,47208890300,11110287200,a07,poll
0,47208913500,47211179400,00002265900,a07,poll
0,47211181700,47211182600,00000000900,a00,read
0,47211208700,47211210400,00000001700,a00,read
0,47211214800,47211214900,00000000100,a08,lseek
0,47211215900,47211216000,00000000100,a08,lseek
0,47211216600,47211216700,00000000100,a08,lseek
0,47211217400,47211217400,00000000000,a08,lseek
0,47211218200,47211218200,00000000000,a08,lseek
0,47211219100,47211219200,00000000100,a08,lseek
0,47211219100,47211219900,00000000800,a08,lseek
0,47211220600,47211220700,00000000100,a08,lseek
0,47211221400,47211221500,00000000100,a08,lseek
0,47211222100,47211222200,00000000100,a08,lseek
0,47211222800,47211222900,00000000100,a08,lseek
0,47211223700,47211223700,00000000000,a08,lseek
0,47211224400,47211224500,00000000100,a08,lseek
0,47211225300,47211225400,00000000100,a08,lseek
0,47211226000,47211226100,00000000100,a08,lseek
0,47211226800,47211226800,00000000000,a08,lseek
0,47211227700,47211227700,00000000000,a08,lseek
0,47211228500,47211228500,00000000000,a08,lseek
0,47211229500,47211229600,00000000100,a08,lseek
0,47211230300,47211230400,00000000100,a08,lseek
0,47211231100,47211231200,00000000100,a08,lseek
0,47211231900,47211232000,00000000100,a08,lseek
0,47211232800,47211232900,00000000100,a08,lseek
0,47211233500,47211233600,00000000100,a08,lseek
0,47211234400,47211234400,00000000000,a08,lseek
0,47211235200,47211235300,00000000100,a08,lseek
0,47211236000,47211236100,00000000100,a08,lseek
0,47211236800,47211236900,00000000100,a08,lseek
0,47211237600,47211237700,00000000100,a08,lseek
0,47211238500,47211238600,00000000100,a08,lseek
0,47211239200,47211239300,00000000100,a08,lseek
0,47211240100,47211240200,00000000100,a08,lseek
0,47211241000,47211241000,00000000000,a08,lseek
0,47211241800,47211241800,00000000000,a08,lseek
0,47211242700,47211242700,00000000000,a08,lseek
0,47211243400,47211243500,00000000100,a08,lseek
0,47211244200,47211244300,00000000100,a08,lseek
0,47211244900,47211244900,00000000000,a08,lseek
0,47211245700,47211245800,00000000100,a08,lseek
0,47211258100,47211263600,00000005500,a09,mmap
0,47211263700,47211263800,00000000100,a08,lseek
0,47211278300,47211278900,00000000600,a09,mmap
0,47211279000,47211279000,00000000000,a08,lseek
0,47211293000,47211293500,00000000500,a09,mmap
0,47211293500,47211293600,00000000100,a08,lseek
0,47211313200,47211313700,00000000500,a09,mmap
0,47211313800,47211313900,00000000100,a08,lseek
0,47211331400,47211331900,00000000500,a09,mmap
0,47211332000,47211332100,00000000100,a08,lseek
0,47211347000,47211347100,00000000100,a08,lseek
0,47211348000,47211348100,00000000100,a08,lseek
0,47211348900,47211349000,00000000100,a08,lseek
0,47211352100,47211352700,00000000600,a09,mmap
0,47211352800,47211352900,00000000100,a08,lseek
0,47211358400,47211358800,00000000400,a09,mmap
0,47211358800,47211358900,00000000100,a08,lseek
0,47211369600,47211370100,00000000500,a09,mmap
0,47211370200,47211370200,00000000000,a08,lseek
0,47211385800,47211386300,00000000500,a09,mmap
0,47211386300,47211386400,00000000100,a08,lseek
0,47211406200,47211406700,00000000500,a09,mmap
0,47211406700,47211406800,00000000100,a08,lseek
0,47211418700,47211418800,00000000100,a08,lseek
0,47211421500,47211422000,00000000500,a09,mmap
0,47211422100,47211422100,00000000000,a08,lseek
0,47211427300,47211427800,00000000500,a09,mmap
0,47211427900,47211428000,00000000100,a08,lseek
0,47211438000,47211438400,00000000400,a09,mmap
0,47211438500,47211438600,00000000100,a08,lseek
0,47211453200,47211453600,00000000400,a09,mmap
0,47211453700,47211453800,00000000100,a08,lseek
0,47211467500,47211468000,00000000500,a09,mmap
0,47211468000,47211468100,00000000100,a08,lseek
0,47211479500,47211479500,00000000000,a08,lseek
0,47211482300,47211482700,00000000400,a09,mmap
0,47211482800,47211482900,00000000100,a08,lseek
0,47211487900,47211488300,00000000400,a09,mmap
0,47211488400,47211488500,00000000100,a08,lseek
0,47216271400,47216273100,00000001700,a04,stat
0,47216273600,47216274300,00000000700,a04,stat
0,47216274700,47216275400,00000000700,a04,stat
0,47216275800,47216276600,00000000800,a04,stat
0,47216276900,47216277700,00000000800,a04,stat
0,47216280100,47216280300,00000000200,a6b,geteuid
0,47216280400,47216280500,00000000100,a6c,getegid
0,47216280500,47216280700,00000000200,a66,getuid
0,47216280800,47216280900,00000000100,a68,getgid
0,47216283000,47216283000,00000000000,a6b,geteuid
0,47216283000,47216283100,00000000100,a6c,getegid
0,47216283100,47216283200,00000000100,a66,getuid
0,47216283200,47216283200,00000000000,a68,getgid
0,47216284800,47216284800,00000000000,a6b,geteuid
0,47216284800,47216284900,00000000100,a6c,getegid
0,47216283200,47216285000,00000001800,a68,getgid
0,47216284900,47216285000,00000000100,a66,getuid
0,47216284800,47216286100,00000001300,a6c,getegid
0,47216286000,47216286100,00000000100,a6b,geteuid
0,47216286200,47216286200,00000000000,a66,getuid
0,47216286300,47216286300,00000000000,a68,getgid
0,47216332200,47216389400,00000057200,a38,clone
0,47216618300,47216618400,00000000100,a0c,brk
0,47216627700,47216629400,00000001700,a15,access
0,47216630000,47216630900,00000000900,a09,mmap
0,47216635700,47216636700,00000001000,a15,access
0,47216643600,47216644600,00000001000,a09,mmap
0,47216648400,47216649200,00000000800,a15,access
0,47216653200,47216654200,00000001000,a00,read
0,47216655800,47216657900,00000002100,a09,mmap
0,47216662700,47216666600,00000003900,a09,mmap
0,47216668700,47216669800,00000001100,a09,mmap
0,47216676900,47216677500,00000000600,a15,access
0,47216682200,47216682800,00000000600,a00,read
0,47216683900,47216685900,00000002000,a09,mmap
0,47216690300,47216693400,00000003100,a09,mmap
0,47216695300,47216696300,00000001000,a09,mmap
0,47216705100,47216705800,00000000700,a15,access
0,47216708400,47216709000,00000000600,a00,read
0,47216709500,47216710300,00000000800,a09,mmap
0,47216711700,47216713500,00000001800,a09,mmap
0,47216718300,47216720000,00000001700,a09,mmap
0,47216728200,47216728700,00000000500,a15,access
0,47216731800,47216732200,00000000400,a00,read
0,47216732900,47216734500,00000001600,a09,mmap
0,47216737500,47216739600,00000002100,a09,mmap
0,47216746900,47216747300,00000000400,a15,access
0,47216749900,47216750700,00000000800,a00,read
0,47216751300,47216753000,00000001700,a09,mmap
0,47216756100,47216758900,00000002800,a09,mmap
0,47216760800,47216761800,00000001000,a09,mmap
0,47216769200,47216770100,00000000900,a09,mmap
0,47216780100,47216780600,00000000500,a09,mmap
0,47216881300,47216881600,00000000300,ada,set_tid_address
0,47216909000,47216917500,00000008500,a89,statfs
0,47216918300,47216918800,00000000500,a89,statfs
0,47216955000,47216955100,00000000100,a0c,brk
0,47216955200,47216956000,00000000800,a0c,brk
0,47216969500,47216980600,00000011100,a00,read
0,47217007600,47217008200,00000000600,a10,ioctl
0,47217007600,47217009300,00000001700,a10,ioctl
0,47217025800,47217034100,00000008300,a4e,getdents
0,47216984400,47217056900,00000072500,a00,read
0,47216479700,47217124900,00000645200,a3d,wait4
0,47217132900,47217133100,00000000200,a3d,wait4
0,47217059700,47217301200,00000241500,a00,read
0,47217307400,47217313100,00000005700,a3d,wait4
0,47217315000,47217315100,00000000100,a3d,wait4
0,47217408400,47217410300,00000001900,a0c,brk
0,47217413000,47217415200,00000002200,a00,read
0,47218290300,47218291300,00000001000,a00,read
0,47218370600,47218372400,00000001800,a04,stat
0,47218372900,47218373600,00000000700,a04,stat
0,47218373800,47218374700,00000000900,a04,stat
0,47218376900,47218377100,00000000200,a6b,geteuid
0,47218377200,47218377200,00000000000,a6c,getegid
0,47218377300,47218377400,00000000100,a66,getuid
0,47218377500,47218377600,00000000100,a68,getgid
0,47218379200,47218379200,00000000000,a6b,geteuid
0,47218379300,47218379300,00000000000,a6c,getegid
0,47218379300,47218379300,00000000000,a66,getuid
0,47218379400,47218379400,00000000000,a68,getgid
0,47218381200,47218381200,00000000000,a6b,geteuid
0,47218381200,47218381200,00000000000,a6c,getegid
0,47218379300,47218381300,00000002000,a66,getuid
0,47218381300,47218381400,00000000100,a68,getgid
0,47218382600,47218382600,00000000000,a6b,geteuid
0,47218382700,47218382700,00000000000,a6c,getegid
0,47218382800,47218382800,00000000000,a66,getuid
0,47218382900,47218382900,00000000000,a68,getgid
0,47218483200,47218484800,00000001600,a0c,brk
0,47218489000,47218491700,00000002700,a00,read
0,47219013000,47219014000,00000001000,a04,stat
0,47219014600,47219015300,00000000700,a04,stat
0,47219017000,47219017100,00000000100,a6b,geteuid
0,47218382700,47219017200,00000634500,a6c,getegid
0,47219017300,47219017400,00000000100,a66,getuid
0,47219017400,47219017500,00000000100,a68,getgid
0,47219017000,47219019300,00000002300,a6b,geteuid
0,47219017200,47219019400,00000002200,a6c,getegid
0,47219019400,47219019500,00000000100,a66,getuid
0,47219019500,47219019500,00000000000,a68,getgid
0,47219021400,47219021400,00000000000,a6b,geteuid
0,47219021500,47219021500,00000000000,a6c,getegid
0,47219021500,47219021500,00000000000,a66,getuid
0,47219021500,47219021600,00000000100,a68,getgid
0,47219023200,47219023200,00000000000,a6b,geteuid
0,47219023300,47219023300,00000000000,a6c,getegid
0,47219023400,47219023400,00000000000,a66,getuid
0,47219023400,47219023400,00000000000,a68,getgid
0,47219118600,47219119200,00000000600,a04,stat
0,47219119700,47219120300,00000000600,a04,stat
0,47219122000,47219122100,00000000100,a6b,geteuid
0,47219122200,47219122200,00000000000,a6c,getegid
0,47219023400,47219122200,00000098800,a66,getuid
0,47219023400,47219122300,00000098900,a68,getgid
0,47219122000,47219123700,00000001700,a6b,geteuid
0,47219123800,47219123800,00000000000,a6c,getegid
0,47219123800,47219123900,00000000100,a66,getuid
0,47219123900,47219124000,00000000100,a68,getgid
0,47219123700,47219125600,00000001900,a6b,geteuid
0,47219125700,47219125700,00000000000,a6c,getegid
0,47219123800,47219125800,00000002000,a66,getuid
0,47219123900,47219125900,00000002000,a68,getgid
0,47219125600,47219127000,00000001400,a6b,geteuid
0,47219125700,47219127100,00000001400,a6c,getegid
0,47219125800,47219127200,00000001400,a66,getuid
0,47219127200,47219127300,00000000100,a68,getgid
0,47219268000,47219268500,00000000500,a04,stat
0,47219269000,47219269500,00000000500,a04,stat
0,47219269900,47219270400,00000000500,a04,stat
0,47219127000,47219272100,00000145100,a6b,geteuid
0,47219127100,47219272200,00000145100,a6c,getegid
0,47219127200,47219272300,00000145100,a66,getuid
0,47219127200,47219272300,00000145100,a68,getgid
0,47219272100,47219273700,00000001600,a6b,geteuid
0,47219272200,47219273800,00000001600,a6c,getegid
0,47219272300,47219273900,00000001600,a66,getuid
0,47219272300,47219274000,00000001700,a68,getgid
0,47219273700,47219275600,00000001900,a6b,geteuid
0,47219273800,47219275700,00000001900,a6c,getegid
0,47219273900,47219275800,00000001900,a66,getuid
0,47219274000,47219275900,00000001900,a68,getgid
0,47219275600,47219277000,00000001400,a6b,geteuid
0,47219277100,47219277100,00000000000,a6c,getegid
0,47219277100,47219277200,00000000100,a66,getuid
0,47219277200,47219277300,00000000100,a68,getgid
0,47219401000,47219401600,00000000600,a04,stat
0,47219402100,47219402700,00000000600,a04,stat
0,47219404300,47219404400,00000000100,a6b,geteuid
0,47219404400,47219404500,00000000100,a6c,getegid
0,47219404500,47219404600,00000000100,a66,getuid
0,47219404700,47219404700,00000000000,a68,getgid
0,47219404300,47219406000,00000001700,a6b,geteuid
0,47219406000,47219406100,00000000100,a6c,getegid
0,47219406100,47219406100,00000000000,a66,getuid
0,47219406200,47219406200,00000000000,a68,getgid
0,47219406000,47219407900,00000001900,a6b,geteuid
0,47219408000,47219408000,00000000000,a6c,getegid
0,47219408000,47219408100,00000000100,a66,getuid
0,47219408100,47219408100,00000000000,a68,getgid
0,47219409600,47219409700,00000000100,a6b,geteuid
0,47219409700,47219409800,00000000100,a6c,getegid
0,47219409800,47219409800,00000000000,a66,getuid
0,47219409900,47219409900,00000000000,a68,getgid
0,47219570300,47219571200,00000000900,a04,stat
0,47219571700,47219572200,00000000500,a04,stat
0,47219572500,47219573000,00000000500,a04,stat
0,47219573300,47219573800,00000000500,a04,stat
0,47219574200,47219574800,00000000600,a04,stat
0,47219575200,47219576100,00000000900,a04,stat
0,47219576400,47219577200,00000000800,a04,stat
0,47219577500,47219578500,00000001000,a04,stat
0,47219578800,47219579800,00000001000,a04,stat
0,47219580100,47219580300,00000000200,a04,stat
0,47219580600,47219580800,00000000200,a04,stat
0,47219581200,47219581500,00000000300,a04,stat
0,47219659200,47219659900,00000000700,a04,stat
0,47219660300,47219661100,00000000800,a04,stat
0,47219661400,47219661800,00000000400,a04,stat
0,47219662100,47219662800,00000000700,a04,stat
0,47219663200,47219663600,00000000400,a04,stat
0,47219663800,47219664400,00000000600,a04,stat
0,47219664800,47219665500,00000000700,a04,stat
0,47219665800,47219666400,00000000600,a04,stat
0,47219666700,47219667000,00000000300,a04,stat
0,47219667300,47219667500,00000000200,a04,stat
0,47219667800,47219668100,00000000300,a04,stat
0,47219668400,47219668800,00000000400,a04,stat
0,47219844800,47219845400,00000000600,a04,stat
0,47219845800,47219846200,00000000400,a04,stat
0,47219848000,47219848000,00000000000,a6b,geteuid
0,47219848100,47219848200,00000000100,a6c,getegid
0,47219848200,47219848300,00000000100,a66,getuid
0,47219848400,47219848400,00000000000,a68,getgid
0,47219849900,47219849900,00000000000,a6b,geteuid
0,47219848100,47219850000,00000001900,a6c,getegid
0,47219850100,47219850100,00000000000,a66,getuid
0,47219850100,47219850200,00000000100,a68,getgid
0,47219851900,47219851900,00000000000,a6b,geteuid
0,47219851900,47219852000,00000000100,a6c,getegid
0,47219852000,47219852100,00000000100,a66,getuid
0,47219852100,47219852100,00000000000,a68,getgid
0,47219853400,47219853400,00000000000,a6b,geteuid
0,47219853400,47219853500,00000000100,a6c,getegid
0,47219853500,47219853500,00000000000,a66,getuid
0,47219853600,47219853600,00000000000,a68,getgid
0,47219974900,47219975600,00000000700,a04,stat
0,47219976000,47219976600,00000000600,a04,stat
0,47219977000,47219977500,00000000500,a04,stat
0,47219979100,47219979100,00000000000,a6b,geteuid
0,47219979200,47219979200,00000000000,a6c,getegid
0,47219979300,47219979400,00000000100,a66,getuid
0,47219979400,47219979500,00000000100,a68,getgid
0,47219980800,47219980900,00000000100,a6b,geteuid
0,47219980900,47219980900,00000000000,a6c,getegid
0,47219981000,47219981000,00000000000,a66,getuid
0,47219979400,47219981000,00000001600,a68,getgid
0,47219982800,47219982800,00000000000,a6b,geteuid
0,47219982900,47219982900,00000000000,a6c,getegid
0,47219982900,47219982900,00000000000,a66,getuid
0,47219982900,47219982900,00000000000,a68,getgid
0,47219984500,47219984500,00000000000,a6b,geteuid
0,47219984600,47219984600,00000000000,a6c,getegid
0,47219984700,47219984700,00000000000,a66,getuid
0,47219984800,47219984800,00000000000,a68,getgid
0,47220132400,47220133000,00000000600,a04,stat
0,47220133300,47220134100,00000000800,a04,stat
0,47220134500,47220134900,00000000400,a04,stat
0,47220136600,47220136700,00000000100,a6b,geteuid
0,47220136700,47220136800,00000000100,a6c,getegid
0,47220136800,47220136800,00000000000,a66,getuid
0,47220136800,47220136900,00000000100,a68,getgid
0,47220138300,47220138300,00000000000,a6b,geteuid
0,47220138400,47220138400,00000000000,a6c,getegid
0,47220138400,47220138500,00000000100,a66,getuid
0,47220138500,47220138600,00000000100,a68,getgid
0,47220140200,47220140200,00000000000,a6b,geteuid
0,47220140200,47220140300,00000000100,a6c,getegid
0,47220140300,47220140300,00000000000,a66,getuid
0,47220140400,47220140400,00000000000,a68,getgid
0,47220141500,47220141600,00000000100,a6b,geteuid
0,47220141600,47220141700,00000000100,a6c,getegid
0,47220141700,47220141700,00000000000,a66,getuid
0,47220141800,47220141800,00000000000,a68,getgid
0,47220328500,47220329600,00000001100,a04,stat
0,47220330100,47220330700,00000000600,a04,stat
0,47220331000,47220331500,00000000500,a04,stat
0,47220333100,47220333200,00000000100,a6b,geteuid
0,47220333200,47220333300,00000000100,a6c,getegid
0,47220333300,47220333400,00000000100,a66,getuid
0,47220333500,47220333500,00000000000,a68,getgid
0,47220334800,47220334900,00000000100,a6b,geteuid
0,47220334900,47220335000,00000000100,a6c,getegid
0,47220335000,47220335000,00000000000,a66,getuid
0,47220335100,47220335100,00000000000,a68,getgid
0,47220336700,47220336800,00000000100,a6b,geteuid
0,47220336800,47220336800,00000000000,a6c,getegid
0,47220336900,47220336900,00000000000,a66,getuid
0,47220337000,47220337000,00000000000,a68,getgid
0,47220338200,47220338200,00000000000,a6b,geteuid
0,47220336800,47220338200,00000001400,a6c,getegid
0,47220338300,47220338300,00000000000,a66,getuid
0,47220338400,47220338400,00000000000,a68,getgid
0,47220463100,47220463700,00000000600,a04,stat
0,47220464200,47220465000,00000000800,a04,stat
0,47220465300,47220465800,00000000500,a04,stat
0,47220467500,47220467600,00000000100,a6b,geteuid
0,47220467600,47220467700,00000000100,a6c,getegid
0,47220467700,47220467800,00000000100,a66,getuid
0,47220467900,47220467900,00000000000,a68,getgid
0,47220469300,47220469400,00000000100,a6b,geteuid
0,47220469400,47220469400,00000000000,a6c,getegid
0,47220467700,47220469500,00000001800,a66,getuid
0,47220469600,47220469600,00000000000,a68,getgid
0,47220471200,47220471300,00000000100,a6b,geteuid
0,47220469500,47220471400,00000001900,a66,getuid
0,47220471300,47220471400,00000000100,a6c,getegid
0,47220471500,47220471500,00000000000,a68,getgid
0,47220472700,47220472800,00000000100,a6b,geteuid
0,47220472800,47220472800,00000000000,a6c,getegid
0,47220472900,47220472900,00000000000,a66,getuid
0,47220473000,47220473000,00000000000,a68,getgid
0,47220645700,47220646200,00000000500,a04,stat
0,47220646700,47220647300,00000000600,a04,stat
0,47220649100,47220649200,00000000100,a6b,geteuid
0,47220649200,47220649300,00000000100,a6c,getegid
0,47220649300,47220649400,00000000100,a66,getuid
0,47220649500,47220649500,00000000000,a68,getgid
0,47220650800,47220650900,00000000100,a6b,geteuid
0,47220650900,47220651000,00000000100,a6c,getegid
0,47220651000,47220651100,00000000100,a66,getuid
0,47220651100,47220651100,00000000000,a68,getgid
0,47220653200,47220653200,00000000000,a6b,geteuid
0,47220653200,47220653300,00000000100,a6c,getegid
0,47220653300,47220653300,00000000000,a66,getuid
0,47220653400,47220653400,00000000000,a68,getgid
0,47220654800,47220654800,00000000000,a6c,getegid
0,47220654700,47220654800,00000000100,a6b,geteuid
0,47220654900,47220654900,00000000000,a66,getuid
0,47220655000,47220655000,00000000000,a68,getgid
0,47220777300,47220778000,00000000700,a04,stat
0,47220778400,47220778900,00000000500,a04,stat
0,47220779100,47220779700,00000000600,a04,stat
0,47220781500,47220781500,00000000000,a6b,geteuid
0,47220654800,47220781600,00000126800,a6c,getegid
0,47220781700,47220781800,00000000100,a66,getuid
0,47220781800,47220781900,00000000100,a68,getgid
0,47220783600,47220783600,00000000000,a6b,geteuid
0,47220783700,47220783700,00000000000,a6c,getegid
0,47220781700,47220783800,00000002100,a66,getuid
0,47220783800,47220783900,00000000100,a68,getgid
0,47220785600,47220785600,00000000000,a6b,geteuid
0,47220785600,47220785700,00000000100,a6c,getegid
0,47220785800,47220785800,00000000000,a68,getgid
0,47220785700,47220785800,00000000100,a66,getuid
0,47220787000,47220787000,00000000000,a6b,geteuid
0,47220787100,47220787100,00000000000,a6c,getegid
0,47220787200,47220787200,00000000000,a66,getuid
0,47220785800,47220787300,00000001500,a68,getgid
0,47220864700,47220865700,00000001000,a00,read
0,47220987400,47220988100,00000000700,a04,stat
0,47220988600,47220989100,00000000500,a04,stat
0,47220989500,47220989900,00000000400,a04,stat
0,47220990200,47220990600,00000000400,a04,stat
0,47220991000,47220991500,00000000500,a04,stat
0,47220991800,47220992100,00000000300,a04,stat
0,47220992500,47220993000,00000000500,a04,stat
0,47220993400,47220993900,00000000500,a04,stat
0,47220994200,47220994600,00000000400,a04,stat
0,47220994900,47220995100,00000000200,a04,stat
0,47220995400,47220995600,00000000200,a04,stat
0,47220995900,47220996300,00000000400,a04,stat
0,47221065800,47221067800,00000002000,b0d,faccessat
0,47221152600,47221153500,00000000900,a04,stat
0,47221158200,47221158300,00000000100,a48,fcntl
0,47221203000,47221203700,00000000700,a04,stat
0,47221209900,47221210800,00000000900,a15,access
0,47221217900,47221218800,00000000900,a00,read
0,47221323400,47221324500,00000001100,a04,stat
0,47221329500,47221330500,00000001000,a00,read
0,47221359700,47221361200,00000001500,a0c,brk
0,47208913500,47229985900,00021072400,a07,poll
0,47231830400,47231830600,00000000200,a00,read
0,47231838900,47231845100,00000006200,a07,poll
0,47231852600,47231855500,00000002900,a2e,sendmsg
0,47231831300,47231864800,00000033500,ae8,epoll_wait
0,47231869300,47231870700,00000001400,a2f,recvmsg
0,47231878900,47231879100,00000000200,a2f,recvmsg
0,47231863100,47231938600,00000075500,a07,poll
0,47231939100,47231939500,00000000400,a00,read
0,47232435700,47232437600,00000001900,a15,access
0,47232438200,47232439200,00000001000,a09,mmap
0,47232444100,47232444800,00000000700,a15,access
0,47232448700,47232449800,00000001100,a09,mmap
0,47232453100,47232453600,00000000500,a15,access
0,47232459100,47232459900,00000000800,a00,read
0,47232461600,47232463600,00000002000,a09,mmap
0,47232467500,47232470900,00000003400,a09,mmap
0,47232473200,47232474500,00000001300,a09,mmap
0,47232486300,47232487000,00000000700,a09,mmap
0,47232488600,47232489400,00000000800,a09,mmap
0,47232490600,47232490800,00000000200,a09,mmap
0,47232601300,47232602400,00000001100,a0c,brk
0,47232608900,47232610700,00000001800,a09,mmap
0,47232646500,47232649600,00000003100,a3b,execve
0,47232649700,47232651600,00000001900,a3b,execve
0,47232651700,47232653000,00000001300,a3b,execve
0,47232653100,47232654500,00000001400,a3b,execve
0,47232654600,47232655900,00000001300,a3b,execve
0,47232737800,47232737900,00000000100,a0c,brk
0,47232744100,47232745000,00000000900,a15,access
0,47232745400,47232746100,00000000700,a09,mmap
0,47232749400,47232750000,00000000600,a15,access
0,47232754200,47232755000,00000000800,a09,mmap
0,47232757600,47232758000,00000000400,a15,access
0,47232762300,47232762900,00000000600,a00,read
0,47232764300,47232765600,00000001300,a09,mmap
0,47232768100,47232770700,00000002600,a09,mmap
0,47232772400,47232773700,00000001300,a09,mmap
0,47232787600,47232788200,00000000600,a09,mmap
0,47232789200,47232789500,00000000300,a09,mmap
0,47232878700,47232878800,00000000100,a0c,brk
0,47232878900,47232879700,00000000800,a0c,brk
0,47232956600,47232965900,00000009300,a4e,getdents
0,47233011100,47233039200,00000028100,a38,clone
0,47231993800,47233056800,00001063000,a07,poll
0,47233082000,47233082200,00000000200,a00,read
0,47231936200,47233094100,00001157900,ae8,epoll_wait
0,47233121500,47233121800,00000000300,a2f,recvmsg
0,47233090800,47233187400,00000096600,a07,poll
0,47233188800,47233189500,00000000700,a00,read
0,47233282100,47233291700,00000009600,a07,poll
0,47233330600,47233336700,00000006100,a07,poll
0,47233345100,47233348800,00000003700,a2e,sendmsg
0,47233328700,47233359800,00000031100,ae8,epoll_wait
0,47233367000,47233368500,00000001500,a2f,recvmsg
0,47233378100,47233378600,00000000500,a2f,recvmsg
0,47233357600,47233450900,00000093300,a07,poll
0,47233451400,47233451800,00000000400,a00,read
0,47233630600,47233632900,00000002300,a04,stat
0,47233633300,47233634100,00000000800,a04,stat
0,47233634200,47233635100,00000000900,a04,stat
0,47233635300,47233636200,00000000900,a04,stat
0,47233636300,47233637100,00000000800,a04,stat
0,47233711200,47233711400,00000000200,a0c,brk
0,47233719400,47233720600,00000001200,a15,access
0,47233721200,47233721900,00000000700,a09,mmap
0,47233725100,47233725700,00000000600,a15,access
0,47233729400,47233730300,00000000900,a09,mmap
0,47233734100,47233734700,00000000600,a15,access
0,47233739800,47233740700,00000000900,a00,read
0,47233742100,47233743800,00000001700,a09,mmap
0,47233747800,47233750900,00000003100,a09,mmap
0,47233752900,47233754300,00000001400,a09,mmap
0,47233769900,47233770700,00000000800,a09,mmap
0,47233771800,47233772100,00000000300,a09,mmap
0,47233871900,47233872000,00000000100,a0c,brk
0,47233872100,47233872900,00000000800,a0c,brk
0,47233739800,47233897700,00000157900,a00,read
0,47233898700,47233904300,00000005600,a00,read
0,47233909600,47233953600,00000044000,a3d,wait4
0,47233962600,47233985400,00000022800,a38,clone
0,47234041300,47234043500,00000002200,a04,stat
0,47234043700,47234044400,00000000700,a04,stat
0,47234044500,47234045000,00000000500,a04,stat
0,47234045100,47234045600,00000000500,a04,stat
0,47234045800,47234046200,00000000400,a04,stat
0,47234070300,47234070400,00000000100,a0c,brk
0,47234082700,47234083800,00000001100,a15,access
0,47234084200,47234085700,00000001500,a09,mmap
0,47234088400,47234088900,00000000500,a15,access
0,47234092100,47234093300,00000001200,a09,mmap
0,47234096300,47234096800,00000000500,a15,access
0,47234101100,47234102000,00000000900,a00,read
0,47234103400,47234106000,00000002600,a09,mmap
0,47234112600,47234116400,00000003800,a09,mmap
0,47234118800,47234120000,00000001200,a09,mmap
0,47234126800,47234127500,00000000700,a15,access
0,47234130300,47234130900,00000000600,a00,read
0,47234131800,47234134000,00000002200,a09,mmap
0,47234137800,47234140400,00000002600,a09,mmap
0,47234147800,47234148600,00000000800,a15,access
0,47234151100,47234151800,00000000700,a00,read
0,47234152400,47234153100,00000000700,a09,mmap
0,47234154400,47234156300,00000001900,a09,mmap
0,47234159200,47234162200,00000003000,a09,mmap
0,47234164200,47234165200,00000001000,a09,mmap
0,47234171200,47234171800,00000000600,a15,access
0,47234174800,47234175100,00000000300,a00,read
0,47234175900,47234177500,00000001600,a09,mmap
0,47234180300,47234182400,00000002100,a09,mmap
0,47234193800,47234194500,00000000700,a15,access
0,47234196700,47234197100,00000000400,a00,read
0,47234198000,47234199900,00000001900,a09,mmap
0,47234204000,47234205400,00000001400,a09,mmap
0,47234214200,47234214700,00000000500,a15,access
0,47234217900,47234218400,00000000500,a00,read
0,47234218900,47234219900,00000001000,a09,mmap
0,47234221200,47234222600,00000001400,a09,mmap
0,47234225600,47234228000,00000002400,a09,mmap
0,47234247400,47234248000,00000000600,a09,mmap
0,47234250400,47234250700,00000000300,a09,mmap
0,47234283100,47234286000,00000002900,60e,page_fault
0,47233511600,47234289900,00000778300,a07,poll
0,47234313800,47234314000,00000000200,a00,read
0,47233448200,47234326700,00000878500,ae8,epoll_wait
0,47234352900,47234353100,00000000200,a2f,recvmsg
0,47234322700,47234412900,00000090200,a07,poll
0,47234414700,47234415300,00000000600,a00,read
0,47234501900,47234511600,00000009700,a07,poll
0,47234541900,47234547500,00000005600,a07,poll
0,47234554000,47234557000,00000003000,a2e,sendmsg
0,47234517100,47234566500,00000049400,ae8,epoll_wait
0,47234571100,47234572300,00000001200,a2f,recvmsg
0,47234581600,47234581800,00000000200,a2f,recvmsg
0,47234564600,47234644600,00000080000,a07,poll
0,47234645100,47234645400,00000000300,a00,read
0,47234846900,47234849500,00000002600,a04,stat
0,47234849800,47234850600,00000000800,a04,stat
0,47234850700,47234851400,00000000700,a04,stat
0,47234851600,47234852300,00000000700,a04,stat
0,47234852400,47234853000,00000000600,a04,stat
0,47234948600,47234948700,00000000100,a0c,brk
0,47234955900,47234957400,00000001500,a15,access
0,47234957900,47234958700,00000000800,a09,mmap
0,47234962000,47234962900,00000000900,a15,access
0,47234966600,47234967600,00000001000,a09,mmap
0,47234970900,47234971400,00000000500,a15,access
0,47234976300,47234977000,00000000700,a00,read
0,47234979500,47234981100,00000001600,a09,mmap
0,47234985600,47234988900,00000003300,a09,mmap
0,47234990500,47234991900,00000001400,a09,mmap
0,47235004300,47235004900,00000000600,a09,mmap
0,47235006200,47235006800,00000000600,a09,mmap
0,47235008000,47235008200,00000000200,a09,mmap
0,47235113500,47235113600,00000000100,a0c,brk
0,47235113700,47235114500,00000000800,a0c,brk
0,47234976300,47235139800,00000163500,a00,read
0,47235140800,47235146800,00000006000,a00,read
0,47235150900,47235191900,00000041000,a3d,wait4
0,47235150900,47235251200,00000100300,a3d,wait4
0,47235263300,47235292100,00000028800,a38,clone
0,47235439900,47235440300,00000000400,ada,set_tid_address
0,47235472300,47235480200,00000007900,a89,statfs
0,47235481200,47235481800,00000000600,a89,statfs
0,47235482800,47235485800,00000003000,60e,page_fault
0,47234701400,47235489500,00000788100,a07,poll
0,47235513600,47235513900,00000000300,a00,read
0,47234642100,47235525900,00000883800,ae8,epoll_wait
0,47235550400,47235550600,00000000200,a2f,recvmsg
0,47235522600,47235608600,00000086000,a07,poll
0,47235610100,47235610600,00000000500,a00,read
0,47235702200,47235711900,00000009700,a07,poll
0,47235747500,47235754600,00000007100,a07,poll
0,47235761300,47235764400,00000003100,a2e,sendmsg
0,47235718200,47235773800,00000055600,ae8,epoll_wait
0,47235778200,47235779500,00000001300,a2f,recvmsg
0,47235788500,47235788700,00000000200,a2f,recvmsg
0,47235771900,47235857400,00000085500,a07,poll
0,47235857900,47235858400,00000000500,a00,read
0,47236176300,47236176500,00000000200,a0c,brk
0,47236176600,47236178500,00000001900,a0c,brk
0,47236196400,47236208000,00000011600,a00,read
0,47236240500,47236246300,00000005800,a00,read
0,47236263000,47236265700,00000002700,a15,access
0,47236266300,47236269200,00000002900,a02,open
0,47236278300,47236281700,00000003400,a00,read
0,47236295600,47236296500,00000000900,a15,access
0,47236302300,47236302500,00000000200,a10,ioctl
0,47236321100,47236324800,00000003700,a02,open
0,47235855000,47236345500,00000490500,ae8,epoll_wait
0,47236368000,47236368300,00000000300,a48,fcntl
0,47236374300,47236375300,00000001000,a2f,recvmsg
0,47235915000,47237305400,00001390400,a07,poll
0,47237331500,47237331800,00000000300,a00,read
0,47237335000,47237336400,00000001400,a2e,sendmsg
0,47237299700,47237351700,00000052000,ae8,epoll_wait
0,47237361900,47237364500,00000002600,a2f,recvmsg
0,47237382800,47237383100,00000000300,a2f,recvmsg
0,47237348300,47237504800,00000156500,a07,poll
0,47237506600,47237507300,00000000700,a00,read
0,47237603500,47237613000,00000009500,a07,poll
0,47237648100,47237656700,00000008600,a07,poll
0,47237618300,47237880900,00000262600,ae8,epoll_wait
0,47237938700,47237940900,00000002200,a2e,sendmsg
0,47237913200,47237942300,00000029100,ae8,epoll_wait
0,47237955500,47237956000,00000000500,a2f,recvmsg
0,47238004800,47238008400,00000003600,a2e,sendmsg
0,47238013100,47238016200,00000003100,ae8,epoll_wait
0,47238024700,47238026400,00000001700,a2f,recvmsg
0,47238037100,47238037400,00000000300,a2f,recvmsg
0,47238050300,47238061800,00000011500,ae8,epoll_wait
0,47237723500,47238539000,00000815500,a07,poll
0,47238559300,47238559500,00000000200,a00,read
0,47238393900,47238571300,00000177400,ae8,epoll_wait
0,47238589600,47238589700,00000000100,a2f,recvmsg
0,47238568200,47238649200,00000081000,a07,poll
0,47238650500,47238651200,00000000700,a00,read
0,47238740400,47238749200,00000008800,a07,poll
0,47238786500,47238793900,00000007400,a07,poll
0,47238800500,47238803600,00000003100,a2e,sendmsg
0,47238755900,47238813300,00000057400,ae8,epoll_wait
0,47238818900,47238820500,00000001600,a2f,recvmsg
0,47238829400,47238829600,00000000200,a2f,recvmsg
0,47238811000,47238903200,00000092200,a07,poll
0,47238903600,47238904000,00000000400,a00,read
0,47239127400,47239130700,00000003300,a04,stat
0,47239131100,47239132200,00000001100,a04,stat
0,47239132300,47239133100,00000000800,a04,stat
0,47239139200,47239170000,00000030800,a38,clone
0,47239181600,47239183000,00000001400,a04,stat
0,47239183300,47239183900,00000000600,a04,stat
0,47239184000,47239184600,00000000600,a04,stat
0,47239186200,47239214300,00000028100,a38,clone
0,47239223900,47239224000,00000000100,a03,close
0,47239381800,47239381900,00000000100,a0c,brk
0,47239389300,47239391100,00000001800,a15,access
0,47239391600,47239392500,00000000900,a09,mmap
0,47239395600,47239396400,00000000800,a15,access
0,47239401400,47239402500,00000001100,a09,mmap
0,47239406600,47239406900,00000000300,a15,access
0,47239412300,47239413100,00000000800,a00,read
0,47239414600,47239417000,00000002400,a09,mmap
0,47239421800,47239425500,00000003700,a09,mmap
0,47239442700,47239443700,00000001000,a09,mmap
0,47239445100,47239445900,00000000800,a09,mmap
0,47239562400,47239562400,00000000000,a0c,brk
0,47239562500,47239563400,00000000900,a0c,brk
0,47239574300,47239574700,00000000400,add,fadvise64
0,47238960200,47239645100,00000684900,a07,poll
0,47239663100,47239663200,00000000100,a00,read
0,47239665300,47239666100,00000000800,a2e,sendmsg
0,47238900800,47239679800,00000779000,ae8,epoll_wait
0,47239686900,47239689300,00000002400,a2f,recvmsg
0,47239704900,47239705200,00000000300,a2f,recvmsg
0,47239676800,47239808100,00000131300,a07,poll
0,47239809300,47239809700,00000000400,a00,read
0,47239889200,47239896900,00000007700,a07,poll
0,47239926300,47239932600,00000006300,a07,poll
0,47239989400,47245702000,00005712600,a07,poll
0,47245723200,47245723400,00000000200,a00,read
0,47239901700,47245734800,00005833100,ae8,epoll_wait
0,47245765000,47245765400,00000000400,a2f,recvmsg
0,47245731000,47245838100,00000107100,a07,poll
0,47245839500,47245840000,00000000500,a00,read
0,47245925200,47245933800,00000008600,a07,poll
0,47245964600,47245971500,00000006900,a07,poll
0,47245978700,47245981600,00000002900,a2e,sendmsg
0,47245939200,47245991700,00000052500,ae8,epoll_wait
0,47245998000,47245999300,00000001300,a2f,recvmsg
0,47246008600,47246008800,00000000200,a2f,recvmsg
0,47245989700,47246073800,00000084100,a07,poll
0,47246074400,47246074700,00000000300,a00,read
0,47246116300,47246118800,00000002500,a01,write
0,47246130200,47246727400,00000597200,a07,poll
0,47246736400,47246736500,00000000100,a00,read
0,47246741000,47246741600,00000000600,aca,futex
0,47246071600,47246745400,00000673800,ae8,epoll_wait
0,47246759100,47246759300,00000000200,a2f,recvmsg
0,47246743700,47246802700,00000059000,a07,poll
0,47246803500,47246803900,00000000400,a00,read
0,47246871600,47246878400,00000006800,a07,poll
0,47246905700,47246910900,00000005200,a07,poll
0,47246916800,47246919200,00000002400,a2e,sendmsg
0,47246882100,47246928300,00000046200,ae8,epoll_wait
0,47246932500,47246933600,00000001100,a2f,recvmsg
0,47246941500,47246941700,00000000200,a2f,recvmsg
0,47246926300,47246995900,00000069600,a07,poll
0,47246996400,47246996800,00000000400,a00,read
0,47247044800,47249530200,00002485400,a07,poll
0,47249538900,47249539100,00000000200,a00,read
0,47246993800,47249547300,00002553500,ae8,epoll_wait
0,47249560200,47249560300,00000000100,a2f,recvmsg
0,47249545400,47249599500,00000054100,a07,poll
0,47249600100,47249600500,00000000400,a00,read
0,47249663900,47249670400,00000006500,a07,poll
0,47249694300,47249699900,00000005600,a07,poll
0,47249705000,47249707500,00000002500,a2e,sendmsg
0,47249673700,47249716200,00000042500,ae8,epoll_wait
0,47249720500,47249721600,00000001100,a2f,recvmsg
0,47249729300,47249729400,00000000100,a2f,recvmsg
0,47249714400,47249782500,00000068100,a07,poll
0,47249783000,47249783500,00000000500,a00,read
0,47249819300,47249821400,00000002100,a01,write
0,47249830900,47250383300,00000552400,a07,poll
0,47250390800,47250390900,00000000100,a00,read
0,47249780500,47250397800,00000617300,ae8,epoll_wait
0,47250409600,47250409800,00000000200,a2f,recvmsg
0,47250396200,47250445600,00000049400,a07,poll
0,47250446300,47250446800,00000000500,a00,read
0,47250506100,47250511700,00000005600,a07,poll
0,47250534500,47250539000,00000004500,a07,poll
0,47250544300,47250546800,00000002500,a2e,sendmsg
0,47250514700,47250555000,00000040300,ae8,epoll_wait
0,47250558900,47250559800,00000000900,a2f,recvmsg
0,47250567200,47250567300,00000000100,a2f,recvmsg
0,47250553500,47250618500,00000065000,a07,poll
0,47250618900,47250619300,00000000400,a00,read
0,47250655100,47250656900,00000001800,a01,write
0,47250666200,47251209600,00000543400,a07,poll
0,47251217100,47251217400,00000000300,a00,read
0,47250616400,47251226100,00000609700,ae8,epoll_wait
0,47251237600,47251237800,00000000200,a2f,recvmsg
0,47251224600,47251273300,00000048700,a07,poll
0,47251274000,47251274200,00000000200,a00,read
0,47251332600,47251337700,00000005100,a07,poll
0,47251362200,47251362400,00000000200,a00,read
0,47251470300,47251476700,00000006400,a07,poll
0,47251481200,47251484300,00000003100,a2e,sendmsg
0,47251487100,47251487200,00000000100,a00,read
0,47251496000,47251498200,00000002200,a07,poll
0,47251503400,47251504300,00000000900,a2e,sendmsg
0,47251363000,47251514200,00000151200,ae8,epoll_wait
0,47251518900,47251520400,00000001500,a2f,recvmsg
0,47251529800,47251530000,00000000200,a2f,recvmsg
0,47251531200,47251531600,00000000400,a2f,recvmsg
0,47251535800,47251536000,00000000200,a2f,recvmsg
0,47251563400,47251568200,00000004800,a2e,sendmsg
0,47251651100,47251652700,00000001600,a2e,sendmsg
0,47251654000,47251657100,00000003100,a2e,sendmsg
0,47251658400,47251661200,00000002800,a2e,sendmsg
0,47251512400,47251667300,00000154900,a07,poll
0,47251669200,47251669900,00000000700,a00,read
0,47251684700,47251686100,00000001400,a2f,recvmsg
0,47251748400,47251750800,00000002400,a07,poll
0,47251768300,47251771800,00000003500,a07,poll
0,47251773300,47251773700,00000000400,a00,read
0,47251788100,47251789200,00000001100,a2f,recvmsg
0,47251802200,47251838000,00000035800,a07,poll
0,47251841100,47251842900,00000001800,aca,futex
0,47251849500,47251850800,00000001300,aca,futex
0,47251874500,47251876300,00000001800,a07,poll
0,47251884900,47251885600,00000000700,a2f,recvmsg
0,47251929800,47251934900,00000005100,a07,poll
0,47252097100,47252102400,00000005300,a07,poll
0,47252106900,47252110200,00000003300,a2e,sendmsg
0,47252113500,47252113700,00000000200,a00,read
0,47252115500,47252116600,00000001100,a2e,sendmsg
0,47252122600,47252123400,00000000800,a2e,sendmsg
0,47252095100,47252137800,00000042700,ae8,epoll_wait
0,47252142000,47252144400,00000002400,a2f,recvmsg
0,47252168200,47252168400,00000000200,a2f,recvmsg
0,47252192900,47252200900,00000008000,a01,write
0,47252261000,47252265100,00000004100,a2e,sendmsg
0,47252267200,47252269800,00000002600,a2e,sendmsg
0,47252301500,47252303400,00000001900,a2e,sendmsg
0,47252329500,47252330900,00000001400,a2e,sendmsg
0,47252135500,47252338500,00000203000,a07,poll
0,47252340100,47252341100,00000001000,a00,read
0,47252356200,47252357800,00000001600,a2f,recvmsg
0,47252418700,47252422200,00000003500,a07,poll
0,47252433900,47252437300,00000003400,a07,poll
0,47252438300,47252438700,00000000400,a00,read
0,47252446800,47252447900,00000001100,a2f,recvmsg
0,47252508500,47252511100,00000002600,a01,write
0,47252519600,47252520400,00000000800,a2f,recvmsg
0,47252522600,47252522700,00000000100,a00,read
0,47252334500,47252577000,00000242500,ae8,epoll_wait
0,47252581300,47252582800,00000001500,a2f,recvmsg
0,47252590700,47252590900,00000000200,a2f,recvmsg
0,47252620500,47252623700,00000003200,a2e,sendmsg
0,47252573900,47252629700,00000055800,a07,poll
0,47252635600,47252637000,00000001400,a2e,sendmsg
0,47252640100,47252640100,00000000000,a00,read
0,47252627900,47252644900,00000017000,ae8,epoll_wait
0,47252647300,47252648200,00000000900,a2f,recvmsg
0,47252654900,47252655100,00000000200,a2f,recvmsg
0,47252643500,47252703300,00000059800,a07,poll
0,47252738900,47252740500,00000001600,a01,write
0,47252749100,47252751200,00000002100,a07,poll
0,47252759800,47252760300,00000000500,a2f,recvmsg
0,47252819100,47252824600,00000005500,a07,poll
0,47252887900,47252890900,00000003000,a07,poll
0,47252894700,47252897100,00000002400,a2e,sendmsg
0,47252899700,47252899900,00000000200,a00,read
0,47252827100,47252904500,00000077400,ae8,epoll_wait
0,47252908500,47252909900,00000001400,a2f,recvmsg
0,47252952200,47252952500,00000000300,a2f,recvmsg
0,47252902600,47253007200,00000104600,a07,poll
0,47253057900,47253060100,00000002200,a07,poll
0,47253111300,47253113500,00000002200,a07,poll
0,47253117000,47253119500,00000002500,a2e,sendmsg
0,47253122000,47253122100,00000000100,a00,read
0,47253004700,47253126500,00000121800,ae8,epoll_wait
0,47253130100,47253131200,00000001100,a2f,recvmsg
0,47253138800,47253139000,00000000200,a2f,recvmsg
0,47253124500,47253190200,00000065700,a07,poll
0,47253236700,47253238600,00000001900,a07,poll
0,47253269000,47253269400,00000000400,a48,fcntl
0,47253279500,47253287100,00000007600,a00,read
0,47253757400,47253767500,00000010100,a07,poll
0,47253772500,47253777400,00000004900,a2e,sendmsg
0,47253785500,47253785700,00000000200,a00,read
0,47253787600,47253788600,00000001000,a2e,sendmsg
0,47253798500,47253799800,00000001300,a2e,sendmsg
0,47253807900,47253808900,00000001000,a2e,sendmsg
0,47253816500,47253817400,00000000900,a2e,sendmsg
0,47253826100,47253827000,00000000900,a2e,sendmsg
0,47253835800,47253836700,00000000900,a2e,sendmsg
0,47253845600,47253846600,00000001000,a2e,sendmsg
0,47253855300,47253856100,00000000800,a2e,sendmsg
0,47253864700,47253865600,00000000900,a2e,sendmsg
0,47253873700,47253874800,00000001100,a2e,sendmsg
0,47253888500,47253891800,00000003300,a07,poll
0,47253907700,47253907900,00000000200,a00,read
0,47253909800,47253910500,00000000700,a2e,sendmsg
0,47253187800,47253923900,00000736100,ae8,epoll_wait
0,47253930300,47253935400,00000005100,a2f,recvmsg
0,47253978000,47253980700,00000002700,a2f,recvmsg
0,47254027700,47254028800,00000001100,a2f,recvmsg
0,47254039100,47254039500,00000000400,a2f,recvmsg
0,47254091200,47254094300,00000003100,a2e,sendmsg
0,47254130500,47254131500,00000001000,a2e,sendmsg
0,47254160700,47254161500,00000000800,a2e,sendmsg
0,47254188600,47254189500,00000000900,a2e,sendmsg
0,47254215100,47254215700,00000000600,a2e,sendmsg
0,47254241500,47254242100,00000000600,a2e,sendmsg
0,47254268600,47254269300,00000000700,a2e,sendmsg
0,47254294800,47254295500,00000000700,a2e,sendmsg
0,47254320700,47254321500,00000000800,a2e,sendmsg
0,47254346700,47254347300,00000000600,a2e,sendmsg
0,47254372400,47254373100,00000000700,a2e,sendmsg
0,47253921100,47254446500,00000525400,a07,poll
0,47254457800,47254458800,00000001000,a2f,recvmsg
0,47254536600,47254537400,00000000800,a2f,recvmsg
0,47254540000,47254540100,00000000100,a00,read
0,47254585700,47254586400,00000000700,a2f,recvmsg
0,47254630300,47254630900,00000000600,a2f,recvmsg
0,47254674000,47254674600,00000000600,a2f,recvmsg
0,47254714100,47254714700,00000000600,a2f,recvmsg
0,47254755600,47254756400,00000000800,a2f,recvmsg
0,47254798200,47254798700,00000000500,a2f,recvmsg
0,47254839300,47254839900,00000000600,a2f,recvmsg
0,47254880200,47254880700,00000000500,a2f,recvmsg
0,47254918300,47254918900,00000000600,a2f,recvmsg
0,47254978100,47254982400,00000004300,a01,write
0,47254994600,47254998300,00000003700,a07,poll
0,47255075000,47255083400,00000008400,a07,poll
0,47255117500,47255691100,00000573600,a07,poll
0,47255706300,47255706500,00000000200,a00,read
0,47255088600,47255717800,00000629200,ae8,epoll_wait
0,47255738100,47255738300,00000000200,a2f,recvmsg
0,47255714700,47255789600,00000074900,a07,poll
0,47255790200,47255790600,00000000400,a00,read
0,47255851700,47255857600,00000005900,a07,poll
0,47255883300,47255883400,00000000100,a00,read
0,47255890500,47255895500,00000005000,a07,poll
0,47255901200,47255903900,00000002700,a2e,sendmsg
0,47255884100,47255912600,00000028500,ae8,epoll_wait
0,47255917100,47255918100,00000001000,a2f,recvmsg
0,47255926800,47255927000,00000000200,a2f,recvmsg
0,47255910800,47255986100,00000075300,a07,poll
0,47255986600,47255987000,00000000400,a00,read
0,47256024700,47256026600,00000001900,a01,write
0,47256036500,47256616900,00000580400,a07,poll
0,47256625400,47256625700,00000000300,a00,read
0,47255984000,47256634000,00000650000,ae8,epoll_wait
0,47256646700,47256646800,00000000100,a2f,recvmsg
0,47256632200,47256685800,00000053600,a07,poll
0,47256686300,47256686600,00000000300,a00,read
0,47256747700,47256753200,00000005500,a07,poll
0,47256778100,47256782400,00000004300,a07,poll
0,47256787800,47256790200,00000002400,a2e,sendmsg
0,47256776500,47256798700,00000022200,ae8,epoll_wait
0,47256802700,47256803800,00000001100,a2f,recvmsg
0,47256811700,47256811900,00000000200,a2f,recvmsg
0,47256797000,47256864200,00000067200,a07,poll
0,47256864800,47256865200,00000000400,a00,read
0,47256900800,47256902700,00000001900,a01,write
0,47256908900,47256909400,00000000500,aca,futex
0,47256923100,47257479100,00000556000,a07,poll
0,47257488000,47257488200,00000000200,a00,read
0,47256862200,47257496000,00000633800,ae8,epoll_wait
0,47257508600,47257508800,00000000200,a2f,recvmsg
0,47257494300,47257544600,00000050300,a07,poll
0,47257545200,47257545900,00000000700,a00,read
0,47257606200,47257611400,00000005200,a07,poll
0,47257632600,47257637600,00000005000,a07,poll
0,47257643000,47257645500,00000002500,a2e,sendmsg
0,47257613900,47257653800,00000039900,ae8,epoll_wait
0,47257657800,47257658800,00000001000,a2f,recvmsg
0,47257666400,47257666500,00000000100,a2f,recvmsg
0,47257652200,47257718900,00000066700,a07,poll
0,47257719400,47257719800,00000000400,a00,read
0,47257755900,47257757700,00000001800,a01,write
0,47257766200,47257766700,00000000500,aca,futex
0,47257769400,47258313500,00000544100,a07,poll
0,47258321900,47258322100,00000000200,a00,read
0,47257716900,47258329600,00000612700,ae8,epoll_wait
0,47258341600,47258341800,00000000200,a2f,recvmsg
0,47258328000,47258376200,00000048200,a07,poll
0,47258376800,47258377100,00000000300,a00,read
0,47258435100,47258440300,00000005200,a07,poll
0,47258460300,47258464900,00000004600,a07,poll
0,47258470100,47258472500,00000002400,a2e,sendmsg
0,47258442700,47258480700,00000038000,ae8,epoll_wait
0,47258484300,47258485200,00000000900,a2f,recvmsg
0,47258492900,47258493100,00000000200,a2f,recvmsg
0,47258479100,47258543600,00000064500,a07,poll
0,47258544100,47258544500,00000000400,a00,read
0,47258580700,47258582300,00000001600,a01,write
0,47258744500,47258747400,00000002900,7ef,local_timer_vector
0,47258591500,47259134600,00000543100,a07,poll
0,47259142300,47259142500,00000000200,a00,read
0,47258541500,47259149600,00000608100,ae8,epoll_wait
0,47259161000,47259161100,00000000100,a2f,recvmsg
0,47259148000,47259195100,00000047100,a07,poll
0,47259195600,47259196000,00000000400,a00,read
0,47259254200,47259258800,00000004600,a07,poll
0,47259279700,47259284500,00000004800,a07,poll
0,47259289800,47259292300,00000002500,a2e,sendmsg
0,47259261200,47259300600,00000039400,ae8,epoll_wait
0,47259304400,47259305400,00000001000,a2f,recvmsg
0,47259313100,47259313200,00000000100,a2f,recvmsg
0,47259299100,47259363800,00000064700,a07,poll
0,47259364200,47259364500,00000000300,a00,read
0,47259399900,47259401600,00000001700,a01,write
0,47259410400,47259946200,00000535800,a07,poll
0,47259954400,47259954500,00000000100,a00,read
0,47259361700,47259961800,00000600100,ae8,epoll_wait
0,47259973200,47259973400,00000000200,a2f,recvmsg
0,47259960300,47260007100,00000046800,a07,poll
0,47260007700,47260008000,00000000300,a00,read
0,47260064300,47260069000,00000004700,a07,poll
0,47260089700,47260094200,00000004500,a07,poll
0,47260099500,47260101700,00000002200,a2e,sendmsg
0,47260071200,47260109800,00000038600,ae8,epoll_wait
0,47260113200,47260114400,00000001200,a2f,recvmsg
0,47260121900,47260122100,00000000200,a2f,recvmsg
0,47260108200,47260172300,00000064100,a07,poll
0,47260172800,47260173100,00000000300,a00,read
0,47260208400,47260210100,00000001700,a01,write
0,47260218900,47260452900,00000234000,a07,poll
0,47260460600,47260460700,00000000100,a00,read
0,47260170300,47260468100,00000297800,ae8,epoll_wait
0,47260479300,47260479400,00000000100,a2f,recvmsg
0,47260466600,47260512500,00000045900,a07,poll
0,47260512900,47260513200,00000000300,a00,read
0,47260567900,47260572600,00000004700,a07,poll
0,47260591700,47260596100,00000004400,a07,poll
0,47260601100,47260603400,00000002300,a2e,sendmsg
0,47260574800,47260611500,00000036700,ae8,epoll_wait
0,47260614900,47260616000,00000001100,a2f,recvmsg
0,47260623300,47260623500,00000000200,a2f,recvmsg
0,47260610100,47260673200,00000063100,a07,poll
0,47260673500,47260673900,00000000400,a00,read
0,47260708500,47260710200,00000001700,a01,write
0,47260719100,47261256900,00000537800,a07,poll
0,47261265600,47261265800,00000000200,a00,read
0,47260671200,47261273700,00000602500,ae8,epoll_wait
0,47261285300,47261285500,00000000200,a2f,recvmsg
0,47261271800,47261320000,00000048200,a07,poll
0,47261320600,47261320900,00000000300,a00,read
0,47261377100,47261381800,00000004700,a07,poll
0,47261401900,47261406600,00000004700,a07,poll
0,47261411700,47261414300,00000002600,a2e,sendmsg
0,47261384000,47261422400,00000038400,ae8,epoll_wait
0,47261425800,47261426800,00000001000,a2f,recvmsg
0,47261434200,47261434500,00000000300,a2f,recvmsg
0,47261420900,47261483900,00000063000,a07,poll
0,47261484300,47261484600,00000000300,a00,read
0,47261519200,47261521200,00000002000,a01,write
0,47261530000,47262065000,00000535000,a07,poll
0,47262072200,47262072400,00000000200,a00,read
0,47261481800,47262079900,00000598100,ae8,epoll_wait
0,47262090800,47262091000,00000000200,a2f,recvmsg
0,47262078300,47262126300,00000048000,a07,poll
0,47262126800,47262127100,00000000300,a00,read
0,47262184500,47262189300,00000004800,a07,poll
0,47262210700,47262215500,00000004800,a07,poll
0,47262220500,47262222800,00000002300,a2e,sendmsg
0,47262191500,47262231000,00000039500,ae8,epoll_wait
0,47262234300,47262235300,00000001000,a2f,recvmsg
0,47262242700,47262242900,00000000200,a2f,recvmsg
0,47262229400,47262293000,00000063600,a07,poll
0,47262293400,47262293700,00000000300,a00,read
0,47262328500,47262330300,00000001800,a01,write
0,47262336100,47262336700,00000000600,aca,futex
0,47262339900,47262868500,00000528600,a07,poll
0,47262876600,47262876700,00000000100,a00,read
0,47262291000,47262884300,00000593300,ae8,epoll_wait
0,47262895300,47262895400,00000000100,a2f,recvmsg
0,47262882700,47262929500,00000046800,a07,poll
0,47262930200,47262930500,00000000300,a00,read
0,47262985500,47262990100,00000004600,a07,poll
0,47263010300,47263014500,00000004200,a07,poll
0,47263019600,47263022000,00000002400,a2e,sendmsg
0,47262992300,47263030000,00000037700,ae8,epoll_wait
0,47263033400,47263034400,00000001000,a2f,recvmsg
0,47263041700,47263041800,00000000100,a2f,recvmsg
0,47263028600,47263091800,00000063200,a07,poll
0,47263092200,47263092500,00000000300,a00,read
0,47263137200,47265454500,00002317300,a07,poll
0,47265462700,47265462900,00000000200,a00,read
0,47263089800,47265470300,00002380500,ae8,epoll_wait
0,47265481600,47265481700,00000000100,a2f,recvmsg
0,47265468600,47265516000,00000047400,a07,poll
0,47265516400,47265516700,00000000300,a00,read
0,47265575300,47265580700,00000005400,a07,poll
0,47265604200,47265609800,00000005600,a07,poll
0,47265615200,47265617900,00000002700,a2e,sendmsg
0,47265583100,47265626600,00000043500,ae8,epoll_wait
0,47265630500,47265631700,00000001200,a2f,recvmsg
0,47265639300,47265639500,00000000200,a2f,recvmsg
0,47265624900,47265694900,00000070000,a07,poll
0,47265695300,47265695700,00000000400,a00,read
0,47265735700,47265738100,00000002400,a01,write
0,47265747200,47266325100,00000577900,a07,poll
0,47266333300,47266333400,00000000100,a00,read
0,47265692500,47266342800,00000650300,ae8,epoll_wait
0,47266355300,47266355500,00000000200,a2f,recvmsg
0,47266340900,47266396100,00000055200,a07,poll
0,47266396700,47266397100,00000000400,a00,read
0,47266460700,47266466500,00000005800,a07,poll
0,47266494400,47266494600,00000000200,a00,read
0,47266619800,47266626000,00000006200,a07,poll
0,47266631400,47266634500,00000003100,a2e,sendmsg
0,47266637600,47266637800,00000000200,a00,read
0,47266495300,47266650900,00000155600,ae8,epoll_wait
0,47266656500,47266658500,00000002000,a2f,recvmsg
0,47266669100,47266669300,00000000200,a2f,recvmsg
0,47266703400,47266708700,00000005300,a2e,sendmsg
0,47267292900,47267302800,00000009900,a02,open
0,47267303200,47267308900,00000005700,a70,setsid
0,47267309000,47267310000,00000001000,a02,open
0,47267338800,47267340700,00000001900,a04,stat
0,47267362400,47267367600,00000005200,a01,write
0,47267424600,47267424700,00000000100,a66,getuid
0,47267424800,47267425000,00000000200,a6b,geteuid
0,47267425100,47267425100,00000000000,a66,getuid
0,47267425200,47267425300,00000000100,a6b,geteuid
0,47267425800,47267426300,00000000500,a04,stat
0,47267481500,47267491200,00000009700,a4e,getdents
0,47267498100,47267499100,00000001000,a4e,getdents
0,47267500300,47267500900,00000000600,a04,stat
0,47267501000,47267502100,00000001100,a04,stat
0,47268985000,47268986600,00000001600,a04,stat
0,47268987200,47268988000,00000000800,a04,stat
0,47268988400,47268989300,00000000900,a04,stat
0,47269009700,47269009800,00000000100,a6b,geteuid
0,47269009900,47269010000,00000000100,a6c,getegid
0,47269010100,47269010100,00000000000,a66,getuid
0,47269010200,47269010300,00000000100,a68,getgid
0,47269012100,47269012200,00000000100,a6b,geteuid
0,47269012200,47269012300,00000000100,a6c,getegid
0,47269012300,47269012400,00000000100,a66,getuid
0,47269012400,47269012400,00000000000,a68,getgid
0,47269014100,47269014200,00000000100,a6b,geteuid
0,47269014200,47269014300,00000000100,a6c,getegid
0,47269014300,47269014300,00000000000,a66,getuid
0,47269014300,47269014300,00000000000,a68,getgid
0,47269015500,47269015500,00000000000,a6b,geteuid
0,47269014200,47269015600,00000001400,a6c,getegid
0,47269015700,47269015700,00000000000,a66,getuid
0,47269015800,47269015800,00000000000,a68,getgid
0,47269020500,47269070500,00000050000,a38,clone
0,47269259700,47269271900,00000012200,60e,page_fault
0,47269274500,47269274600,00000000100,a0c,brk
0,47269283600,47269285000,00000001400,a15,access
0,47269285700,47269286600,00000000900,a09,mmap
0,47269290500,47269292400,00000001900,a15,access
0,47269296400,47269297400,00000001000,a09,mmap
0,47269300600,47269301100,00000000500,a15,access
0,47269306700,47269307600,00000000900,a00,read
0,47269309100,47269311100,00000002000,a09,mmap
0,47269316000,47269319200,00000003200,a09,mmap
0,47269321100,47269322500,00000001400,a09,mmap
0,47269333500,47269334200,00000000700,a09,mmap
0,47269335500,47269336300,00000000800,a09,mmap
0,47269337400,47269337700,00000000300,a09,mmap
0,47269451300,47269451400,00000000100,a0c,brk
0,47269460900,47269462500,00000001600,a09,mmap
0,47269492500,47269492600,00000000100,a66,getuid
0,47269493000,47269493000,00000000000,a6c,getegid
0,47269493400,47269493400,00000000000,a68,getgid
0,47269502600,47269511600,00000009000,a2a,connect
0,47269515800,47269517700,00000001900,a2a,connect
0,47269533700,47269534800,00000001100,a00,read
0,47269546600,47269547800,00000001200,a09,mmap
0,47269550200,47269550900,00000000700,a15,access
0,47269554500,47269555200,00000000700,a00,read
0,47269557400,47269559900,00000002500,a09,mmap
0,47269563700,47269566700,00000003000,a09,mmap
0,47269575000,47269575800,00000000800,a15,access
0,47269578600,47269579100,00000000500,a00,read
0,47269580400,47269582500,00000002100,a09,mmap
0,47269586000,47269588900,00000002900,a09,mmap
0,47269590900,47269592000,00000001100,a09,mmap
0,47269622600,47269623500,00000000900,a09,mmap
0,47269625800,47269626500,00000000700,a15,access
0,47269629500,47269630000,00000000500,a00,read
0,47269632400,47269634500,00000002100,a09,mmap
0,47269637500,47269639600,00000002100,a09,mmap
0,47269648000,47269648600,00000000600,a15,access
0,47269650900,47269651300,00000000400,a00,read
0,47269652400,47269654600,00000002200,a09,mmap
0,47269657400,47269659700,00000002300,a09,mmap
0,47269661400,47269662600,00000001200,a09,mmap
0,47269691800,47269692600,00000000800,a09,mmap
0,47269692700,47269692900,00000000200,a08,lseek
0,47269650900,47269723100,00000072200,a00,read
0,47269097300,47269794800,00000697500,a3d,wait4
0,47269805000,47269805200,00000000200,a3d,wait4
0,47269726100,47269920300,00000194200,a00,read
0,47269927800,47269933700,00000005900,a3d,wait4
0,47269935600,47269935800,00000000200,a3d,wait4
0,47270040200,47270041900,00000001700,b0d,faccessat
0,47270054800,47270056700,00000001900,a0c,brk
0,47270109800,47270110600,00000000800,a0c,brk
0,47270120300,47270129200,00000008900,a4e,getdents
0,47270135000,47270140800,00000005800,a0c,brk
0,47270241800,47270242800,00000001000,a0c,brk
0,47270244300,47270245000,00000000700,a00,read
0,47270369600,47270371400,00000001800,b0d,faccessat
0,47270390000,47270391000,00000001000,a0c,brk
0,47270408700,47270421500,00000012800,a00,read
0,47270532000,47270532600,00000000600,a0c,brk
0,47270606100,47270606500,00000000400,a0c,brk
0,47270755100,47270755600,00000000500,a0c,brk
0,47270772800,47270773100,00000000300,a0c,brk
0,47270793700,47270794000,00000000300,a0c,brk
0,47270887700,47270888000,00000000300,a0c,brk
0,47270955300,47270955600,00000000300,a0c,brk
0,47271017400,47271017700,00000000300,a0c,brk
0,47271053000,47271053300,00000000300,a0c,brk
0,47271085100,47271085300,00000000200,a0c,brk
0,47271104500,47271104900,00000000400,a0c,brk
0,47271109600,47271109800,00000000200,a0c,brk
0,47271114500,47271114700,00000000200,a0c,brk
0,47271119400,47271119500,00000000100,a0c,brk
0,47271123500,47271123700,00000000200,a0c,brk
0,47271128300,47271128500,00000000200,a0c,brk
0,47271335900,47271336200,00000000300,a0c,brk
0,47271345900,47271346200,00000000300,a0c,brk
0,47271350500,47271350700,00000000200,a0c,brk
0,47271355800,47271356000,00000000200,a0c,brk
0,47271363200,47271363400,00000000200,a0c,brk
0,47271366600,47271366800,00000000200,a0c,brk
0,47271371300,47271371500,00000000200,a0c,brk
0,47271522900,47271523300,00000000400,a0c,brk
0,47271528000,47271528200,00000000200,a0c,brk
0,47271533900,47271534100,00000000200,a0c,brk
0,47271538600,47271538800,00000000200,a0c,brk
0,47271543000,47271543200,00000000200,a0c,brk
0,47271694800,47271695200,00000000400,a0c,brk
0,47271742000,47271742300,00000000300,a0c,brk
0,47271748200,47271748400,00000000200,a0c,brk
0,47271753900,47271754100,00000000200,a0c,brk
0,47271758600,47271758800,00000000200,a0c,brk
0,47271763200,47271763400,00000000200,a0c,brk
0,47271768400,47271768600,00000000200,a0c,brk
0,47271777700,47271777900,00000000200,a0c,brk
0,47271960900,47271961200,00000000300,a0c,brk
0,47271966300,47271966500,00000000200,a0c,brk
0,47271971100,47271971300,00000000200,a0c,brk
0,47271975600,47271975800,00000000200,a0c,brk
0,47272091400,47272091700,00000000300,a0c,brk
0,47272197800,47272198100,00000000300,a0c,brk
0,47272203600,47272203800,00000000200,a0c,brk
0,47272208600,47272208900,00000000300,a0c,brk
0,47272258800,47272259100,00000000300,a0c,brk
0,47272332100,47272332300,00000000200,a0c,brk
0,47272342000,47272342300,00000000300,a0c,brk
0,47272346900,47272347100,00000000200,a0c,brk
0,47272352200,47272352400,00000000200,a0c,brk
0,47272355000,47272355200,00000000200,a0c,brk
0,47272365200,47272365400,00000000200,a0c,brk
0,47272437400,47272437800,00000000400,a0c,brk
0,47272569200,47272569600,00000000400,a0c,brk
0,47272614300,47272614500,00000000200,a0c,brk
0,47272650900,47272651100,00000000200,a0c,brk
0,47272681500,47272681800,00000000300,a0c,brk
0,47272689200,47272689400,00000000200,a0c,brk
0,47272694800,47272695000,00000000200,a0c,brk
0,47272699300,47272699500,00000000200,a0c,brk
0,47272704200,47272704400,00000000200,a0c,brk
0,47272708700,47272708900,00000000200,a0c,brk
0,47272713700,47272713900,00000000200,a0c,brk
0,47272718700,47272718900,00000000200,a0c,brk
0,47272724100,47272724300,00000000200,a0c,brk
0,47272728300,47272728500,00000000200,a0c,brk
0,47272900300,47272900700,00000000400,a0c,brk
0,47272906500,47272906800,00000000300,a0c,brk
0,47272987500,47272987800,00000000300,a0c,brk
0,47273006800,47273007100,00000000300,a0c,brk
0,47273012500,47273012700,00000000200,a0c,brk
0,47273018100,47273018300,00000000200,a0c,brk
0,47273022900,47273023100,00000000200,a0c,brk
0,47273038600,47273038800,00000000200,a0c,brk
0,47273209900,47273210300,00000000400,a0c,brk
0,47273223200,47273223500,00000000300,a0c,brk
0,47273310800,47273311300,00000000500,a0c,brk
0,47273315800,47273316000,00000000200,a0c,brk
0,47273338200,47273338600,00000000400,a0c,brk
0,47273393700,47273393900,00000000200,a0c,brk
0,47273418800,47273419100,00000000300,a0c,brk
0,47273560800,47273561100,00000000300,a0c,brk
0,47273580100,47273580400,00000000300,a0c,brk
0,47273585500,47273585700,00000000200,a0c,brk
0,47273603200,47273603500,00000000300,a0c,brk
0,47273773500,47273773900,00000000400,a0c,brk
0,47273787600,47273787900,00000000300,a0c,brk
0,47273870100,47273870400,00000000300,a0c,brk
0,47273875400,47273875600,00000000200,a0c,brk
0,47273897400,47273897700,00000000300,a0c,brk
0,47273926800,47273927100,00000000300,a0c,brk
0,47273928400,47273928600,00000000200,a0c,brk
0,47273994300,47273994700,00000000400,a0c,brk
0,47273998500,47273998800,00000000300,a0c,brk
0,47274000800,47274001000,00000000200,a0c,brk
0,47274013700,47274013900,00000000200,a0c,brk
0,47274036100,47274037500,00000001400,a04,stat
0,47274049300,47274049800,00000000500,a04,stat
0,47274104200,47274124900,00000020700,a4e,getdents
0,47275280400,47275280800,00000000400,a0c,brk
0,47275619300,47275619900,00000000600,a0c,brk
0,47275736000,47275736400,00000000400,a0c,brk
0,47275738000,47275738900,00000000900,b0d,faccessat
0,47275794900,47275795800,00000000900,b0d,faccessat
0,47275858000,47275858200,00000000200,a0c,brk
0,47275931800,47275932200,00000000400,a0c,brk
0,47276105800,47276106200,00000000400,a0c,brk
0,47276110800,47276111000,00000000200,a0c,brk
0,47276115100,47276115300,00000000200,a0c,brk
0,47276119900,47276120200,00000000300,a0c,brk
0,47276137700,47276138000,00000000300,a0c,brk
0,47276214200,47276214500,00000000300,a0c,brk
0,47276241400,47276241700,00000000300,a0c,brk
0,47276283600,47276283800,00000000200,a0c,brk
0,47276339600,47276339900,00000000300,a0c,brk
0,47276344700,47276345000,00000000300,a0c,brk
0,47276426200,47276426400,00000000200,a0c,brk
0,47276438700,47276439000,00000000300,a0c,brk
0,47276500200,47276500400,00000000200,a0c,brk
0,47276568900,47276569200,00000000300,a0c,brk
0,47276575200,47276575400,00000000200,a0c,brk
0,47276594700,47276594900,00000000200,a0c,brk
0,47276652600,47276652900,00000000300,a0c,brk
0,47276658200,47276658400,00000000200,a0c,brk
0,47276744600,47276744900,00000000300,a0c,brk
0,47276766400,47276766600,00000000200,a0c,brk
0,47276816300,47276816600,00000000300,a0c,brk
0,47276840600,47276840800,00000000200,a0c,brk
0,47276931700,47276932000,00000000300,a0c,brk
0,47276990700,47276990900,00000000200,a0c,brk
0,47277001900,47277002100,00000000200,a0c,brk
0,47277204000,47277204300,00000000300,a0c,brk
0,47277210300,47277210500,00000000200,a0c,brk
0,47277215500,47277215700,00000000200,a0c,brk
0,47277220300,47277220400,00000000100,a0c,brk
0,47277226100,47277226300,00000000200,a0c,brk
0,47277231400,47277231600,00000000200,a0c,brk
0,47277236000,47277236200,00000000200,a0c,brk
0,47277237700,47277237900,00000000200,a0c,brk
0,47277242300,47277242500,00000000200,a0c,brk
0,47277247400,47277247600,00000000200,a0c,brk
0,47277252900,47277253100,00000000200,a0c,brk
0,47281267300,47281267900,00000000600,a0c,brk
0,47281273000,47281273200,00000000200,a0c,brk
0,47281276500,47281276700,00000000200,a0c,brk
0,47281283000,47281283300,00000000300,a0c,brk
0,47281291000,47281291200,00000000200,a0c,brk
0,47281296200,47281296500,00000000300,a0c,brk
0,47281624800,47281625700,00000000900,a0c,brk
0,47281648000,47281648300,00000000300,a0c,brk
0,47281707400,47281707700,00000000300,a0c,brk
0,47281763000,47281763300,00000000300,a0c,brk
0,47281780100,47281780300,00000000200,a0c,brk
0,47281808000,47281808300,00000000300,a0c,brk
0,47281813400,47281813700,00000000300,a0c,brk
0,47281819300,47281819500,00000000200,a0c,brk
0,47281824100,47281824200,00000000100,a0c,brk
0,47281828800,47281829000,00000000200,a0c,brk
0,47281833500,47281833700,00000000200,a0c,brk
0,47281838800,47281839000,00000000200,a0c,brk
0,47281843100,47281843300,00000000200,a0c,brk
0,47281974600,47281975100,00000000500,a0c,brk
0,47282042900,47282043200,00000000300,a0c,brk
0,47282046700,47282046900,00000000200,a0c,brk
0,47282053900,47282054000,00000000100,a0c,brk
0,47282056400,47282056600,00000000200,a0c,brk
0,47282112600,47282112900,00000000300,a0c,brk
0,47282139000,47282139300,00000000300,a0c,brk
0,47282141900,47282142100,00000000200,a0c,brk
0,47282170500,47282170700,00000000200,a0c,brk
0,47282181200,47282181300,00000000100,a0c,brk
0,47282201000,47282201300,00000000300,a0c,brk
0,47282301900,47282302300,00000000400,a0c,brk
0,47282312400,47282312600,00000000200,a0c,brk
0,47282315300,47282315600,00000000300,a0c,brk
0,47282676500,47282677200,00000000700,a0c,brk
0,47283087500,47283088000,00000000500,a0c,brk
0,47283114100,47283114400,00000000300,a0c,brk
0,47283422200,47283422700,00000000500,a0c,brk
0,47283458600,47283459000,00000000400,a0c,brk
0,47283873600,47283874100,00000000500,a0c,brk
0,47283877300,47283877700,00000000400,a0c,brk
0,47284116300,47284116800,00000000500,a0c,brk
0,47284474300,47284474600,00000000300,a0c,brk
0,47284541000,47284541400,00000000400,a0c,brk
0,47284731400,47284732000,00000000600,a0c,brk
0,47284787200,47284787500,00000000300,a0c,brk
0,47284792700,47284792900,00000000200,a0c,brk
0,47284845100,47284845400,00000000300,a0c,brk
0,47284857600,47284857900,00000000300,a0c,brk
0,47284873500,47284928700,00000055200,a38,clone
0,47290614400,47290615500,00000001100,a04,stat
0,47290616100,47290616800,00000000700,a04,stat
0,47290617200,47290617800,00000000600,a04,stat
0,47290620400,47290620500,00000000100,a6b,geteuid
0,47290620600,47290620700,00000000100,a6c,getegid
0,47290620700,47290620800,00000000100,a66,getuid
0,47290620900,47290620900,00000000000,a68,getgid
0,47290623100,47290623100,00000000000,a6b,geteuid
0,47290623200,47290623200,00000000000,a6c,getegid
0,47290620700,47290623300,00000002600,a66,getuid
0,47290623300,47290623400,00000000100,a68,getgid
0,47290625500,47290625500,00000000000,a6b,geteuid
0,47290625600,47290625600,00000000000,a6c,getegid
0,47290625600,47290625700,00000000100,a66,getuid
0,47290625700,47290625700,00000000000,a68,getgid
0,47290627200,47290627200,00000000000,a6b,geteuid
0,47290625600,47290627300,00000001700,a6c,getegid
0,47290625700,47290627400,00000001700,a68,getgid
0,47290627300,47290627400,00000000100,a66,getuid
0,47290669800,47290723500,00000053700,a38,clone
0,47293481200,47293481300,00000000100,a0c,brk
0,47293492400,47293494100,00000001700,a15,access
0,47293494800,47293495700,00000000900,a09,mmap
0,47293498400,47293499200,00000000800,a15,access
0,47293504100,47293505100,00000001000,a09,mmap
0,47293508700,47293509100,00000000400,a15,access
0,47293514300,47293515100,00000000800,a00,read
0,47293516600,47293518600,00000002000,a09,mmap
0,47293524000,47293527700,00000003700,a09,mmap
0,47293529900,47293531100,00000001200,a09,mmap
0,47293543400,47293544200,00000000800,a09,mmap
0,47293545500,47293546200,00000000700,a09,mmap
0,47293547300,47293547600,00000000300,a09,mmap
0,47293650100,47293650400,00000000300,a66,getuid
0,47293650400,47293650500,00000000100,a68,getgid
0,47293650600,47293650800,00000000200,a27,getpid
0,47290627200,47293652100,00003024900,a6b,geteuid
0,47293687200,47293687300,00000000100,a0c,brk
0,47293709200,47293709300,00000000100,a6e,getppid
0,47293717300,47293717300,00000000000,a6b,geteuid
0,47293717400,47293717500,00000000100,a6c,getegid
0,47293719600,47293722300,00000002700,a00,read
0,47293742300,47293764400,00000022100,a38,clone
0,47293902000,47293902000,00000000000,a0c,brk
0,47293908200,47293909600,00000001400,a15,access
0,47293910000,47293910700,00000000700,a09,mmap
0,47293915100,47293915800,00000000700,a15,access
0,47293918900,47293919900,00000001000,a09,mmap
0,47293922500,47293923300,00000000800,a15,access
0,47293927600,47293928200,00000000600,a00,read
0,47293930500,47293931600,00000001100,a09,mmap
0,47293939900,47293941000,00000001100,a09,mmap
0,47293951300,47293952000,00000000700,a09,mmap
0,47293953400,47293953900,00000000500,a09,mmap
0,47293955100,47293955400,00000000300,a09,mmap
0,47294050100,47294050200,00000000100,a0c,brk
0,47294050300,47294051000,00000000700,a0c,brk
0,47294053400,47294058900,00000005500,a02,open
0,47294059500,47294061400,00000001900,a09,mmap
0,47293927600,47294151600,00000224000,a00,read
0,47294160200,47294165200,00000005000,a3d,wait4
0,47294331100,47294351700,00000020600,a38,clone
0,47294468800,47294470700,00000001900,a04,stat
0,47294471000,47294471600,00000000600,a04,stat
0,47294471800,47294472400,00000000600,a04,stat
0,47294361300,47294865600,00000504300,a00,read
0,47294867000,47294892800,00000025800,a00,read
0,47294898100,47294900900,00000002800,a3d,wait4
0,47294867000,47294922400,00000055400,a00,read
0,47294925900,47294931700,00000005800,a00,read
0,47294898100,47294990600,00000092500,a3d,wait4
0,47295005000,47295005200,00000000200,a3d,wait4
0,47294945500,47295171100,00000225600,a00,read
0,47295172600,47295174600,00000002000,a3d,wait4
0,47295175100,47295175200,00000000100,a3d,wait4
0,47295297400,47295300000,00000002600,b0d,faccessat
0,47295490400,47295491800,00000001400,b0d,faccessat
0,47295524900,47295573300,00000048400,a38,clone
1,47272660400,47272663800,00000003400,a00,read
1,47272758000,47272762800,00000004800,a09,mmap
1,47273175700,47273180100,00000004400,a00,read
1,47273450400,47273453000,00000002600,a0c,brk
1,47274370900,47274383000,00000012100,a00,read
1,47274704200,47274708200,00000004000,a00,read
1,47274939100,47274940400,00000001300,a00,read
1,47275089200,47275093000,00000003800,a00,read
1,47272225500,47275411500,00003186000,a07,poll
1,47275414000,47275415100,00000001100,a00,read
1,47275535000,47275536400,00000001400,a00,read
1,47275559000,47275564400,00000005400,a09,mmap
1,47275437700,47275896600,00000458900,a07,poll
1,47275899300,47275900500,00000001200,a00,read
1,47275906300,47275908300,00000002000,a00,read
1,47275927900,47275930400,00000002500,a01,write
1,47277285400,47277292200,00000006800,a00,read
1,47277532700,47277534000,00000001300,a00,read
1,47277537300,47277543000,00000005700,a09,mmap
1,47277547600,47277551900,00000004300,a09,mmap
1,47277855300,47277856200,00000000900,a10,ioctl
1,47277862500,47277862600,00000000100,a10,ioctl
1,47277896400,47277897700,00000001300,a00,read
1,47278596600,47278596900,00000000300,a10,ioctl
1,47278604000,47278604100,00000000100,a10,ioctl
1,47278638300,47278683400,00000045100,a00,read
1,47282180300,47282180900,00000000600,a00,read
1,47282199800,47282201500,00000001700,a2f,recvmsg
1,47282269000,47282270600,00000001600,aca,futex
1,47282291000,47282292200,00000001200,aca,futex
1,47282379300,47282383500,00000004200,a2e,sendmsg
1,47282386600,47282386700,00000000100,a00,read
1,47282391600,47282395800,00000004200,a07,poll
1,47282397400,47282397700,00000000300,a00,read
1,47282415200,47282416800,00000001600,a2f,recvmsg
1,47282504800,47282505500,00000000700,a00,read
1,47282518500,47282520400,00000001900,a2f,recvmsg
1,47282590700,47282595300,00000004600,a07,poll
1,47282597100,47282597400,00000000300,a00,read
1,47282611700,47282613200,00000001500,a2f,recvmsg
1,47282625400,47282667200,00000041800,a07,poll
1,47282669600,47282671000,00000001400,aca,futex
1,47282683100,47282684100,00000001000,aca,futex
1,47282747400,47282750300,00000002900,a2e,sendmsg
1,47282752400,47282752700,00000000300,a00,read
1,47282754900,47282826000,00000071100,a07,poll
1,47282828000,47282829200,00000001200,aca,futex
1,47282832300,47282833100,00000000800,aca,futex
1,47282836100,47282836900,00000000800,aca,futex
1,47282840700,47282844100,00000003400,a2e,sendmsg
1,47282847600,47282847800,00000000200,a00,read
1,47282855200,47282859200,00000004000,a07,poll
1,47282855200,47282921500,00000066300,a07,poll
1,47282923100,47282924300,00000001200,aca,futex
1,47282926600,47282927500,00000000900,aca,futex
1,47282930500,47282931400,00000000900,aca,futex
1,47282935200,47282938400,00000003200,a2e,sendmsg
1,47282941800,47282942000,00000000200,a00,read
1,47282949000,47282967400,00000018400,a07,poll
1,47282968500,47282969500,00000001000,aca,futex
1,47283036200,47283038800,00000002600,a07,poll
1,47283043600,47283046700,00000003100,a2e,sendmsg
1,47283049300,47283049400,00000000100,a00,read
1,47283023000,47283085800,00000062800,a38,clone
1,47283054300,47283117600,00000063300,a07,poll
1,47283130300,47283156100,00000025800,a07,poll
1,47283157400,47283158300,00000000900,aca,futex
1,47283173600,47283174800,00000001200,aca,futex
1,47283212300,47283215100,00000002800,a2e,sendmsg
1,47283217200,47283217300,00000000100,a00,read
1,47283221400,47283269800,00000048400,a07,poll
1,47283217200,47285574800,00002357600,a00,read
1,47285583600,47285584300,00000000700,a08,lseek
1,47283217200,47285650300,00002433100,a00,read
1,47206891700,47285661900,00078770200,a3d,wait4
1,47285673100,47285683400,00000010300,a3d,wait4
1,47285652200,47285719200,00000067000,a00,read
1,47285723400,47285727600,00000004200,a3d,wait4
1,47285891400,47285891400,00000000000,a0c,brk
1,47285904100,47285905800,00000001700,a15,access
1,47285906400,47285907200,00000000800,a09,mmap
1,47285911000,47285911800,00000000800,a15,access
1,47285918100,47285919200,00000001100,a09,mmap
1,47285923000,47285923600,00000000600,a15,access
1,47285929100,47285930000,00000000900,a00,read
1,47285931700,47285933600,00000001900,a09,mmap
1,47285939200,47285942800,00000003600,a09,mmap
1,47285945000,47285946300,00000001300,a09,mmap
1,47285960700,47285961600,00000000900,a09,mmap
1,47285963100,47285963800,00000000700,a09,mmap
1,47285965000,47285965300,00000000300,a09,mmap
1,47286076800,47286077100,00000000300,a27,getpid
1,47286117300,47286117400,00000000100,a0c,brk
1,47286117500,47286118300,00000000800,a0c,brk
1,47286132100,47286132200,00000000100,a6e,getppid
1,47286141500,47286143700,00000002200,a00,read
1,47286181000,47286209900,00000028900,a38,clone
1,47286267800,47286269400,00000001600,a04,stat
1,47286269700,47286270500,00000000800,a04,stat
1,47286270600,47286271400,00000000800,a04,stat
1,47286271500,47286272100,00000000600,a04,stat
1,47286272300,47286273000,00000000700,a04,stat
1,47286344200,47286344300,00000000100,a0c,brk
1,47286352400,47286353600,00000001200,a15,access
1,47286354100,47286355000,00000000900,a09,mmap
1,47286359200,47286360000,00000000800,a15,access
1,47286363500,47286364500,00000001000,a09,mmap
1,47286367100,47286367900,00000000800,a15,access
1,47286372300,47286372900,00000000600,a00,read
1,47286378700,47286381400,00000002700,a09,mmap
1,47286383000,47286384200,00000001200,a09,mmap
1,47286394500,47286395200,00000000700,a09,mmap
1,47286396600,47286397300,00000000700,a09,mmap
1,47286398400,47286398700,00000000300,a09,mmap
1,47286493600,47286493700,00000000100,a0c,brk
1,47286493800,47286494500,00000000700,a0c,brk
1,47286517700,47286518600,00000000900,a00,read
1,47286519500,47286520100,00000000600,a08,lseek
1,47286520300,47286520500,00000000200,a00,read
1,47286520300,47286546800,00000026500,a00,read
1,47286547200,47286551800,00000004600,a00,read
1,47286555700,47286597600,00000041900,a3d,wait4
1,47286614100,47286633500,00000019400,a38,clone
1,47286687200,47286688300,00000001100,a04,stat
1,47286688500,47286689000,00000000500,a04,stat
1,47286689200,47286689800,00000000600,a04,stat
1,47286765200,47286766300,00000001100,a15,access
1,47286771300,47286771800,00000000500,a15,access
1,47286774800,47286775700,00000000900,a09,mmap
1,47286778300,47286778800,00000000500,a15,access
1,47286782500,47286783500,00000001000,a00,read
1,47286785700,47286787700,00000002000,a09,mmap
1,47286792100,47286795500,00000003400,a09,mmap
1,47286797500,47286798700,00000001200,a09,mmap
1,47286805000,47286805600,00000000600,a15,access
1,47286808600,47286808900,00000000300,a00,read
1,47286809800,47286810800,00000001000,a09,mmap
1,47286813200,47286815100,00000001900,a09,mmap
1,47286816700,47286817700,00000001000,a09,mmap
1,47286825200,47286825900,00000000700,a15,access
1,47286828500,47286829100,00000000600,a00,read
1,47286829700,47286830400,00000000700,a09,mmap
1,47286831900,47286833900,00000002000,a09,mmap
1,47286849300,47286850100,00000000800,a15,access
1,47286853200,47286853700,00000000500,a00,read
1,47286854500,47286856000,00000001500,a09,mmap
1,47286868300,47286869000,00000000700,a15,access
1,47286871400,47286872000,00000000600,a00,read
1,47286872700,47286874600,00000001900,a09,mmap
1,47286877500,47286880100,00000002600,a09,mmap
1,47286882000,47286883200,00000001200,a09,mmap
1,47286890100,47286891000,00000000900,a09,mmap
1,47286899700,47286900200,00000000500,a09,mmap
1,47286980500,47286980700,00000000200,ada,set_tid_address
1,47287007700,47287014800,00000007100,a89,statfs
1,47287015700,47287016100,00000000400,a89,statfs
1,47287043700,47287044600,00000000900,a0c,brk
1,47287058300,47287068800,00000010500,a00,read
1,47287072700,47287117100,00000044400,a00,read
1,47287117500,47287122500,00000005000,a00,read
1,47287125300,47287183500,00000058200,a3d,wait4
1,47287193300,47287213600,00000020300,a38,clone
1,47287268100,47287269600,00000001500,a04,stat
1,47287269800,47287270600,00000000800,a04,stat
1,47287270800,47287271300,00000000500,a04,stat
1,47287344300,47287344400,00000000100,a0c,brk
1,47287350800,47287351800,00000001000,a15,access
1,47287352200,47287353000,00000000800,a09,mmap
1,47287357100,47287357800,00000000700,a15,access
1,47287362200,47287363000,00000000800,a09,mmap
1,47287365700,47287366100,00000000400,a15,access
1,47287369900,47287370500,00000000600,a00,read
1,47287371900,47287373100,00000001200,a09,mmap
1,47287381000,47287382200,00000001200,a09,mmap
1,47287392800,47287393500,00000000700,a09,mmap
1,47287394700,47287395400,00000000700,a09,mmap
1,47287396400,47287396700,00000000300,a09,mmap
1,47287489300,47287489400,00000000100,a0c,brk
1,47287489500,47287490200,00000000700,a0c,brk
1,47287369900,47287514400,00000144500,a00,read
1,47287514900,47287519300,00000004400,a00,read
1,47287522500,47287560700,00000038200,a3d,wait4
1,47287522500,47287616500,00000094000,a3d,wait4
1,47287625800,47287648200,00000022400,a38,clone
1,47287756100,47287756100,00000000000,a0c,brk
1,47287763700,47287764900,00000001200,a15,access
1,47287768500,47287769200,00000000700,a15,access
1,47287773300,47287774300,00000001000,a09,mmap
1,47287776900,47287777600,00000000700,a15,access
1,47287781600,47287782200,00000000600,a00,read
1,47287783500,47287784600,00000001100,a09,mmap
1,47287787300,47287790000,00000002700,a09,mmap
1,47287791600,47287792800,00000001200,a09,mmap
1,47287802800,47287803500,00000000700,a09,mmap
1,47287804800,47287805300,00000000500,a09,mmap
1,47287806500,47287806700,00000000200,a09,mmap
1,47287887800,47287888000,00000000200,a27,getpid
1,47287926800,47287926800,00000000000,a0c,brk
1,47287926900,47287927800,00000000900,a0c,brk
1,47287932400,47287932500,00000000100,a6e,getppid
1,47287944900,47287945500,00000000600,a00,read
1,47288036900,47288036900,00000000000,a0c,brk
1,47288044700,47288045700,00000001000,a15,access
1,47288046200,47288046900,00000000700,a09,mmap
1,47288048200,47288049800,00000001600,a15,access
1,47288052700,47288053700,00000001000,a09,mmap
1,47288056000,47288056500,00000000500,a15,access
1,47288061300,47288061900,00000000600,a00,read
1,47288063300,47288064200,00000000900,a09,mmap
1,47288066900,47288069300,00000002400,a09,mmap
1,47288071100,47288072200,00000001100,a09,mmap
1,47288081700,47288082300,00000000600,a09,mmap
1,47288083500,47288084200,00000000700,a09,mmap
1,47288085200,47288085500,00000000300,a09,mmap
1,47288162800,47288162900,00000000100,a27,getpid
1,47288194800,47288194900,00000000100,a0c,brk
1,47288195000,47288195600,00000000600,a0c,brk
1,47288203000,47288203100,00000000100,a6e,getppid
1,47288212500,47288214500,00000002000,a00,read
1,47288246500,47288270900,00000024400,a38,clone
1,47288317900,47288330500,00000012600,60e,page_fault
1,47288339600,47288340800,00000001200,a04,stat
1,47288341100,47288341600,00000000500,a04,stat
1,47288341800,47288342300,00000000500,a04,stat
1,47288413800,47288413900,00000000100,a0c,brk
1,47288422000,47288423200,00000001200,a15,access
1,47288423800,47288424500,00000000700,a09,mmap
1,47288427700,47288428500,00000000800,a15,access
1,47288435000,47288435600,00000000600,a15,access
1,47288438600,47288439400,00000000800,a00,read
1,47288440700,47288442200,00000001500,a09,mmap
1,47288446300,47288449200,00000002900,a09,mmap
1,47288451200,47288452500,00000001300,a09,mmap
1,47288459400,47288460100,00000000700,a15,access
1,47288462900,47288463200,00000000300,a00,read
1,47288464200,47288465100,00000000900,a09,mmap
1,47288468000,47288469800,00000001800,a09,mmap
1,47288471300,47288472400,00000001100,a09,mmap
1,47288479500,47288480100,00000000600,a15,access
1,47288482600,47288483100,00000000500,a00,read
1,47288483600,47288484400,00000000800,a09,mmap
1,47288485900,47288487400,00000001500,a09,mmap
1,47288491500,47288492900,00000001400,a09,mmap
1,47288501100,47288501700,00000000600,a15,access
1,47199390600,47288503100,00089112500,a17,select
1,47288504200,47288504700,00000000500,a00,read
1,47288505400,47288506500,00000001100,a09,mmap
1,47288510200,47288512000,00000001800,a09,mmap
1,47288519000,47288519500,00000000500,a15,access
1,47288521300,47288521800,00000000500,a00,read
1,47288522400,47288524000,00000001600,a09,mmap
1,47288527100,47288528900,00000001800,a09,mmap
1,47288530700,47288531900,00000001200,a09,mmap
1,47288538400,47288539400,00000001000,a09,mmap
1,47288548000,47288548500,00000000500,a09,mmap
1,47288626000,47288626100,00000000100,ada,set_tid_address
1,47288655900,47288662600,00000006700,a89,statfs
1,47288663200,47288663600,00000000400,a89,statfs
1,47288690600,47288690700,00000000100,a0c,brk
1,47288690800,47288691800,00000001000,a0c,brk
1,47288703000,47288711700,00000008700,a00,read
1,47288715400,47288760100,00000044700,a00,read
1,47288760900,47288765800,00000004900,a00,read
1,47288769300,47288832300,00000063000,a3d,wait4
1,47288848900,47288870700,00000021800,a38,clone
1,47288916400,47288935100,00000018700,a38,clone
1,47288983900,47288985600,00000001700,a04,stat
1,47288985800,47288986600,00000000800,a04,stat
1,47288986700,47288987400,00000000700,a04,stat
1,47289065500,47289065600,00000000100,a0c,brk
1,47289073700,47289074900,00000001200,a15,access
1,47289075400,47289076400,00000001000,a09,mmap
1,47289080500,47289081300,00000000800,a15,access
1,47289084900,47289085900,00000001000,a09,mmap
1,47289089100,47289089700,00000000600,a15,access
1,47289094000,47289094900,00000000900,a00,read
1,47289097100,47289098500,00000001400,a09,mmap
1,47289102500,47289104600,00000002100,a09,mmap
1,47289113400,47289114300,00000000900,a15,access
1,47289117300,47289117800,00000000500,a00,read
1,47289118900,47289120100,00000001200,a09,mmap
1,47289122900,47289125500,00000002600,a09,mmap
1,47289127300,47289128500,00000001200,a09,mmap
1,47289139400,47289140200,00000000800,a09,mmap
1,47289143000,47289143800,00000000800,a09,mmap
1,47289144800,47289145100,00000000300,a09,mmap
1,47289251900,47289252000,00000000100,a0c,brk
1,47289252100,47289252900,00000000800,a0c,brk
1,47289293300,47289294000,00000000700,a10,ioctl
1,47289297100,47289315400,00000018300,a00,read
1,47289317600,47289321300,00000003700,a00,read
1,47289324100,47289374000,00000049900,a3d,wait4
1,47289388300,47289389500,00000001200,a04,stat
1,47289389900,47289390500,00000000600,a04,stat
1,47289390700,47289391100,00000000400,a04,stat
1,47289391200,47289391500,00000000300,a04,stat
1,47289391700,47289392300,00000000600,a04,stat
1,47289463500,47289463600,00000000100,a0c,brk
1,47289472900,47289473900,00000001000,a15,access
1,47289474300,47289475000,00000000700,a09,mmap
1,47289478000,47289478700,00000000700,a15,access
1,47289485400,47289486000,00000000600,a15,access
1,47289490100,47289490600,00000000500,a00,read
1,47289492000,47289493100,00000001100,a09,mmap
1,47289496600,47289499200,00000002600,a09,mmap
1,47289501000,47289502200,00000001200,a09,mmap
1,47289511900,47289512600,00000000700,a09,mmap
1,47289513800,47289514500,00000000700,a09,mmap
1,47289515500,47289515800,00000000300,a09,mmap
1,47289607500,47289607500,00000000000,a0c,brk
1,47289607600,47289608500,00000000900,a0c,brk
1,47289627900,47289628900,00000001000,a00,read
1,47289629600,47289630200,00000000600,a08,lseek
1,47289630300,47289630600,00000000300,a00,read
1,47289630300,47289707500,00000077200,a00,read
1,47289714200,47289717000,00000002800,a3d,wait4
1,47289728600,47289750500,00000021900,a38,clone
1,47289799500,47289800600,00000001100,a04,stat
1,47289800900,47289801400,00000000500,a04,stat
1,47289801600,47289801900,00000000300,a04,stat
1,47289802000,47289802300,00000000300,a04,stat
1,47289802500,47289802800,00000000300,a04,stat
1,47289876400,47289877700,00000001300,a15,access
1,47289878000,47289878700,00000000700,a09,mmap
1,47289882100,47289883800,00000001700,a15,access
1,47289887200,47289888100,00000000900,a09,mmap
1,47289890700,47289891100,00000000400,a15,access
1,47289895200,47289895800,00000000600,a00,read
1,47289898000,47289898900,00000000900,a09,mmap
1,47289902300,47289904700,00000002400,a09,mmap
1,47289906300,47289907500,00000001200,a09,mmap
1,47289917400,47289918000,00000000600,a09,mmap
1,47289919300,47289919800,00000000500,a09,mmap
1,47289920900,47289921200,00000000300,a09,mmap
1,47290010400,47290011100,00000000700,a0c,brk
1,47290030900,47290031600,00000000700,a00,read
1,47290032000,47290032500,00000000500,a08,lseek
1,47290032700,47290033000,00000000300,a00,read
1,47290032700,47290055600,00000022900,a00,read
1,47290057000,47290061400,00000004400,a00,read
1,47290064000,47290102900,00000038900,a3d,wait4
1,47290180500,47290182000,00000001500,a04,stat
1,47290182200,47290182900,00000000700,a04,stat
1,47290183000,47290183600,00000000600,a04,stat
1,47290183700,47290184300,00000000600,a04,stat
1,47290184400,47290184900,00000000500,a04,stat
1,47290186600,47290206500,00000019900,a38,clone
1,47290308600,47290308700,00000000100,a0c,brk
1,47290315800,47290317000,00000001200,a15,access
1,47290317400,47290318200,00000000800,a09,mmap
1,47290322100,47290322600,00000000500,a15,access
1,47290325500,47290326400,00000000900,a09,mmap
1,47290329100,47290329700,00000000600,a15,access
1,47290333500,47290334000,00000000500,a00,read
1,47290335300,47290336300,00000001000,a09,mmap
1,47290339800,47290342600,00000002800,a09,mmap
1,47290344100,47290345400,00000001300,a09,mmap
1,47290355500,47290356100,00000000600,a09,mmap
1,47290357300,47290358000,00000000700,a09,mmap
1,47290359000,47290359200,00000000200,a09,mmap
1,47290451300,47290451400,00000000100,a0c,brk
1,47290451600,47290452300,00000000700,a0c,brk
1,47290464000,47290464900,00000000900,a09,mmap
1,47290216300,47290511000,00000294700,a3d,wait4
1,47290216300,47290549800,00000333500,a3d,wait4
1,47290559000,47290580300,00000021300,a38,clone
1,47290685900,47290686000,00000000100,a0c,brk
1,47290694100,47290695200,00000001100,a15,access
1,47290695600,47290696600,00000001000,a09,mmap
1,47290699100,47290699700,00000000600,a15,access
1,47290702800,47290703800,00000001000,a09,mmap
1,47290706300,47290706700,00000000400,a15,access
1,47290710600,47290711300,00000000700,a00,read
1,47290716000,47290718800,00000002800,a09,mmap
1,47290720300,47290721400,00000001100,a09,mmap
1,47290731300,47290732400,00000001100,a09,mmap
1,47290733500,47290734200,00000000700,a09,mmap
1,47290735200,47290735500,00000000300,a09,mmap
1,47290815600,47290815700,00000000100,a27,getpid
1,47290853400,47290853500,00000000100,a0c,brk
1,47290853600,47290854400,00000000800,a0c,brk
1,47290861000,47290861100,00000000100,a6e,getppid
1,47290870400,47290871300,00000000900,a00,read
1,47290961300,47290961400,00000000100,a0c,brk
1,47290969900,47290970800,00000000900,a15,access
1,47290971300,47290972100,00000000800,a09,mmap
1,47290974400,47290974900,00000000500,a15,access
1,47290977900,47290978800,00000000900,a09,mmap
1,47290981300,47290982200,00000000900,a15,access
1,47290986100,47290986700,00000000600,a00,read
1,47290987900,47290989000,00000001100,a09,mmap
1,47290991300,47290993900,00000002600,a09,mmap
1,47290995400,47290996400,00000001000,a09,mmap
1,47291005900,47291006500,00000000600,a09,mmap
1,47291007800,47291008300,00000000500,a09,mmap
1,47291009400,47291009700,00000000300,a09,mmap
1,47291085500,47291085700,00000000200,a27,getpid
1,47290961300,47291117100,00000155800,a0c,brk
1,47291117200,47291117900,00000000700,a0c,brk
1,47291129000,47291129100,00000000100,a6e,getppid
1,47291152300,47291153000,00000000700,a04,stat
1,47291153200,47291153700,00000000500,a04,stat
1,47291153900,47291154300,00000000400,a04,stat
1,47291154500,47291154800,00000000300,a04,stat
1,47291155000,47291155300,00000000300,a04,stat
1,47291156700,47291177900,00000021200,a38,clone
1,47291117200,47291277300,00000160100,a0c,brk
1,47291283400,47291284500,00000001100,a15,access
1,47291284900,47291285700,00000000800,a09,mmap
1,47291289800,47291290300,00000000500,a15,access
1,47291294100,47291295200,00000001100,a09,mmap
1,47291297500,47291298000,00000000500,a15,access
1,47291302200,47291302800,00000000600,a00,read
1,47291308000,47291310500,00000002500,a09,mmap
1,47291312200,47291313500,00000001300,a09,mmap
1,47291323100,47291323700,00000000600,a09,mmap
1,47291325000,47291325600,00000000600,a09,mmap
1,47291326600,47291326900,00000000300,a09,mmap
1,47291415700,47291415800,00000000100,a0c,brk
1,47291415900,47291416700,00000000800,a0c,brk
1,47291429400,47291430200,00000000800,a09,mmap
1,47291431800,47291433900,00000002100,a00,read
1,47291187600,47291484800,00000297200,a3d,wait4
1,47291187600,47291521000,00000333400,a3d,wait4
1,47291187600,47291578000,00000390400,a3d,wait4
1,47291187600,47291620100,00000432500,a3d,wait4
1,47291649100,47291650100,00000001000,a00,read
1,47291671400,47291673300,00000001900,a09,mmap
1,47291673300,47291673500,00000000200,a08,lseek
1,47291710600,47291710900,00000000300,a7b,setfsgid
1,47291712700,47291712900,00000000200,a7a,setfsuid
1,47291717000,47291717300,00000000300,a7a,setfsuid
1,47291717600,47291718000,00000000400,a7b,setfsgid
1,47291720800,47291722100,00000001300,a02,open
1,47291725500,47291726300,00000000800,a09,mmap
1,47291726400,47291726500,00000000100,a08,lseek
1,47291743600,47291744100,00000000500,a7b,setfsgid
1,47291744800,47291745100,00000000300,a7a,setfsuid
1,47291746600,47291747000,00000000400,a7a,setfsuid
1,47291747400,47291747600,00000000200,a7b,setfsgid
1,47291751700,47291752300,00000000600,a09,mmap
1,47291751400,47291752400,00000001000,a08,lseek
1,47291768000,47291768200,00000000200,a7b,setfsgid
1,47291768500,47291768700,00000000200,a7a,setfsuid
1,47291768800,47291770000,00000001200,a04,stat
1,47291770100,47291770300,00000000200,a7a,setfsuid
1,47291770600,47291770900,00000000300,a7b,setfsgid
1,47291777500,47291777900,00000000400,a09,mmap
1,47291777900,47291778000,00000000100,a08,lseek
1,47291801700,47291810900,00000009200,a00,read
1,47291816400,47291816600,00000000200,a00,read
1,47291825400,47291826500,00000001100,a00,read
1,47291855600,47291856200,00000000600,a00,read
1,47291869400,47291869700,00000000300,a00,read
1,47291879400,47291880400,00000001000,a09,mmap
1,47291880400,47291880500,00000000100,a08,lseek
1,47291897600,47291898600,00000001000,a04,stat
1,47291926800,47291933600,00000006800,a2f,recvmsg
1,47291934800,47291936300,00000001500,a2f,recvmsg
1,47291949700,47291952400,00000002700,a2c,sendto
1,47291963500,47292099500,00000136000,a38,clone
1,47292354500,47292362800,00000008300,a02,open
1,47292393300,47292395600,00000002300,a09,mmap
1,47292395700,47292395800,00000000100,a08,lseek
1,47292439300,47292439300,00000000000,a68,getgid
1,47292439500,47292439500,00000000000,a6c,getegid
1,47292572000,47292575700,00000003700,a2f,recvmsg
1,47292578100,47292579400,00000001300,a2f,recvmsg
1,47292597600,47292599400,00000001800,a2c,sendto
1,47292603500,47292603600,00000000100,a68,getgid
1,47292606500,47292606500,00000000000,a68,getgid
1,47292606800,47292606900,00000000100,a6c,getegid
1,47292607100,47292607500,00000000400,a69,setuid
1,47292608000,47292608300,00000000300,a75,setresuid
1,47292608400,47292608500,00000000100,a66,getuid
1,47292439000,47292608600,00000169600,a6b,geteuid
1,47292608400,47292608700,00000000300,a66,getuid
1,47292608600,47292608800,00000000200,a6b,geteuid
1,47292701700,47292716400,00000014700,a01,write
1,47200854300,47325794100,00124939800,ae8,epoll_wait
1,47292729500,47333709200,00040979700,a17,select
1,47333710900,47333712200,00000001300,a00,read
1,47292599600,47333726200,00041126600,a07,poll
1,47333746200,47333774000,00000027800,a02,open
1,47333798200,47333800700,00000002500,a09,mmap
1,47333800800,47333800900,00000000100,a08,lseek
1,47333838300,47333839300,00000001000,a09,mmap
1,47333839300,47333839400,00000000100,a08,lseek
1,47333858000,47333858600,00000000600,a09,mmap
1,47333858700,47333858800,00000000100,a08,lseek
1,47333880800,47333880900,00000000100,a08,lseek
1,47333881100,47333890700,00000009600,a00,read
1,47333909800,47333910600,00000000800,a09,mmap
1,47333910700,47333910700,00000000000,a08,lseek
1,47333938800,47333942200,00000003400,a15,access
1,47333946300,47333947200,00000000900,a15,access
1,47333954400,47333955900,00000001500,a00,read
1,47333955900,47333956200,00000000300,a00,read
1,47333956300,47333956500,00000000200,a00,read
1,47333956700,47333956900,00000000200,a00,read
1,47333957000,47333957200,00000000200,a00,read
1,47333957300,47333957500,00000000200,a00,read
1,47333957600,47333957800,00000000200,a00,read
1,47333957800,47333958000,00000000200,a00,read
1,47333958100,47333958300,00000000200,a00,read
1,47333958400,47333958600,00000000200,a00,read
1,47333958700,47333959400,00000000700,a00,read
1,47333959500,47333959700,00000000200,a00,read
1,47333962300,47333962400,00000000100,a08,lseek
1,47333962500,47333965000,00000002500,a01,write
1,47333968800,47333969500,00000000700,a15,access
1,47333972600,47333972800,00000000200,a08,lseek
1,47333972900,47333983200,00000010300,a01,write
1,47333988200,47333988200,00000000000,a08,lseek
1,47333988400,47333991500,00000003100,a01,write
1,47334005300,47334008800,00000003500,a2f,recvmsg
1,47334009400,47334010700,00000001300,a2f,recvmsg
1,47334024400,47334026600,00000002200,a2c,sendto
1,47334072700,47334282000,00000209300,a38,clone
1,47334307600,47334307700,00000000100,a48,fcntl
1,47334308000,47334308100,00000000100,a48,fcntl
1,47334355100,47334417900,00000062800,a17,select
1,47334419100,47334420900,00000001800,a00,read
1,47334426100,47334427100,00000001000,a01,write
1,47334427500,47334431100,00000003600,a17,select
1,47334431800,47334432200,00000000400,a00,read
1,47334436300,47334436600,00000000300,a01,write
1,47334789200,47334789300,00000000100,a0c,brk
1,47334800400,47334802600,00000002200,a15,access
1,47334803400,47334804300,00000000900,a09,mmap
1,47334809200,47334809900,00000000700,a15,access
1,47334818300,47334819300,00000001000,a09,mmap
1,47334823000,47334823500,00000000500,a15,access
1,47334828500,47334829400,00000000900,a00,read
1,47334830800,47334832100,00000001300,a09,mmap
1,47334835600,47334837800,00000002200,a09,mmap
1,47334847600,47334848300,00000000700,a15,access
1,47334852600,47334853200,00000000600,a00,read
1,47334854000,47334855700,00000001700,a09,mmap
1,47334859400,47334862000,00000002600,a09,mmap
1,47334868300,47334869000,00000000700,a15,access
1,47334871700,47334872400,00000000700,a00,read
1,47334873100,47334873900,00000000800,a09,mmap
1,47334875500,47334877000,00000001500,a09,mmap
1,47334881000,47334884000,00000003000,a09,mmap
1,47334886000,47334887100,00000001100,a09,mmap
1,47334904000,47334905000,00000001000,a09,mmap
1,47334906400,47334906700,00000000300,a09,mmap
1,47334907800,47334908100,00000000300,a09,mmap
1,47335063800,47335063900,00000000100,a0c,brk
1,47335064100,47335064900,00000000800,a0c,brk
1,47335071000,47335073000,00000002000,a09,mmap
1,47335081200,47335082000,00000000800,a0c,brk
1,47335086900,47335087200,00000000300,a0c,brk
1,47335117400,47335117500,00000000100,a66,getuid
1,47335118100,47335118200,00000000100,a68,getgid
1,47333924700,47335118700,00001194000,a6b,geteuid
1,47292606800,47335119200,00042512400,a6c,getegid
1,47335134300,47335134400,00000000100,a48,fcntl
1,47335134300,47335134600,00000000300,a48,fcntl
1,47335134600,47335134700,00000000100,a48,fcntl
1,47335134700,47335134800,00000000100,a48,fcntl
1,47335134800,47335134900,00000000100,a48,fcntl
1,47335134900,47335135000,00000000100,a48,fcntl
1,47335135100,47335135100,00000000000,a48,fcntl
1,47335135100,47335135200,00000000100,a48,fcntl
1,47335135200,47335135300,00000000100,a48,fcntl
1,47335135400,47335135400,00000000000,a48,fcntl
1,47335135400,47335135500,00000000100,a48,fcntl
1,47335135600,47335135600,00000000000,a48,fcntl
1,47335135700,47335135700,00000000000,a48,fcntl
1,47335135800,47335135800,00000000000,a48,fcntl
1,47335135800,47335135800,00000000000,a48,fcntl
1,47335135900,47335135900,00000000000,a48,fcntl
1,47335135900,47335136000,00000000100,a48,fcntl
1,47335136300,47335136700,00000000400,a0c,brk
1,47335143800,47335144100,00000000300,a0c,brk
1,47335190800,47335198800,00000008000,a2a,connect
1,47335202800,47335204900,00000002100,a2a,connect
1,47335217200,47335217700,00000000500,a0c,brk
1,47335221000,47335222000,00000001000,a00,read
1,47335236300,47335237400,00000001100,a09,mmap
1,47335240000,47335240800,00000000800,a15,access
1,47335244400,47335245100,00000000700,a00,read
1,47335246500,47335249200,00000002700,a09,mmap
1,47335253500,47335256700,00000003200,a09,mmap
1,47335265000,47335265700,00000000700,a15,access
1,47335268300,47335268900,00000000600,a00,read
1,47335270000,47335272200,00000002200,a09,mmap
1,47335275800,47335279300,00000003500,a09,mmap
1,47335281300,47335282700,00000001400,a09,mmap
1,47335315800,47335316600,00000000800,a09,mmap
1,47335318800,47335319500,00000000700,a15,access
1,47335322400,47335323300,00000000900,a00,read
1,47335324200,47335326600,00000002400,a09,mmap
1,47335330100,47335332300,00000002200,a09,mmap
1,47335341000,47335341600,00000000600,a15,access
1,47335344500,47335345100,00000000600,a00,read
1,47335346100,47335348300,00000002200,a09,mmap
1,47335351400,47335354200,00000002800,a09,mmap
1,47335356100,47335357200,00000001100,a09,mmap
1,47335384600,47335385100,00000000500,a0c,brk
1,47335391300,47335392100,00000000800,a09,mmap
1,47335392200,47335392300,00000000100,a08,lseek
1,47335423000,47335423700,00000000700,a0c,brk
1,47335431800,47335432000,00000000200,a27,getpid
1,47335439800,47335441100,00000001300,a09,mmap
1,47335444700,47335445100,00000000400,a0c,brk
1,47335451300,47335451500,00000000200,a6e,getppid
1,47335475400,47335475600,00000000200,a0c,brk
1,47335478000,47335478200,00000000200,a6f,getpgrp
1,47335480200,47335480300,00000000100,a48,fcntl
1,47335480900,47335481900,00000001000,a21,dup2
1,47335497400,47335497800,00000000400,a0c,brk
1,47335548800,47335549800,00000001000,a00,read
1,47335566000,47335566500,00000000500,a0c,brk
1,47335615300,47335615600,00000000300,a0c,brk
1,47335654700,47335655100,00000000400,a0c,brk
1,47335656500,47335657400,00000000900,a00,read
1,47335677700,47335678000,00000000300,a0c,brk
1,47335737000,47335738800,00000001800,b0d,faccessat
1,47335816400,47335816900,00000000500,a0c,brk
1,47335824700,47335825700,00000001000,a04,stat
1,47335831800,47335832400,00000000600,a04,stat
1,47335836900,47335837100,00000000200,a0c,brk
1,47335853600,47335900000,00000046400,a38,clone
1,47352178500,47352180300,00000001800,a04,stat
1,47352180700,47352181600,00000000900,a04,stat
1,47352182000,47352182700,00000000700,a04,stat
1,47352183100,47352183900,00000000800,a04,stat
1,47352184300,47352185000,00000000700,a04,stat
1,47352208100,47352208500,00000000400,a6b,geteuid
1,47335119200,47352208600,00017089400,a6c,getegid
1,47352208700,47352208900,00000000200,a66,getuid
1,47335118100,47352209000,00017090900,a68,getgid
1,47352210800,47352210900,00000000100,a6b,geteuid
1,47352210900,47352211000,00000000100,a6c,getegid
1,47352211000,47352211000,00000000000,a66,getuid
1,47352209000,47352211100,00000002100,a68,getgid
1,47352212700,47352212700,00000000000,a6b,geteuid
1,47352210900,47352212800,00000001900,a6c,getegid
1,47352212800,47352212900,00000000100,a66,getuid
1,47352212900,47352213000,00000000100,a68,getgid
1,47352214100,47352214200,00000000100,a6b,geteuid
1,47352214200,47352214200,00000000000,a6c,getegid
1,47352214300,47352214300,00000000000,a66,getuid
1,47352214400,47352214400,00000000000,a68,getgid
1,47352244100,47352303800,00000059700,a38,clone
1,47352518600,47352518700,00000000100,a0c,brk
1,47352528600,47352530300,00000001700,a15,access
1,47352530900,47352531800,00000000900,a09,mmap
1,47352535200,47352536000,00000000800,a15,access
1,47352542900,47352543900,00000001000,a09,mmap
1,47352547400,47352548000,00000000600,a15,access
1,47352552700,47352553700,00000001000,a00,read
1,47352555900,47352558000,00000002100,a09,mmap
1,47352563100,47352567100,00000004000,a09,mmap
1,47352569300,47352570500,00000001200,a09,mmap
1,47352577700,47352578400,00000000700,a15,access
1,47352582800,47352583400,00000000600,a00,read
1,47352584400,47352586700,00000002300,a09,mmap
1,47352591100,47352593900,00000002800,a09,mmap
1,47352595900,47352596800,00000000900,a09,mmap
1,47352604700,47352605300,00000000600,a15,access
1,47352608100,47352608600,00000000500,a00,read
1,47352609200,47352610100,00000000900,a09,mmap
1,47352611400,47352613500,00000002100,a09,mmap
1,47352618300,47352620100,00000001800,a09,mmap
1,47352628700,47352629100,00000000400,a15,access
1,47352632200,47352632600,00000000400,a00,read
1,47352633200,47352634800,00000001600,a09,mmap
1,47352638400,47352640600,00000002200,a09,mmap
1,47352647700,47352648200,00000000500,a15,access
1,47352650900,47352651700,00000000800,a00,read
1,47352652300,47352654100,00000001800,a09,mmap
1,47352657600,47352660700,00000003100,a09,mmap
1,47352681600,47352682100,00000000500,a09,mmap
1,47352780500,47352780700,00000000200,ada,set_tid_address
1,47352810900,47352819700,00000008800,a89,statfs
1,47352820600,47352821000,00000000400,a89,statfs
1,47352853800,47352854000,00000000200,a0c,brk
1,47352854100,47352854800,00000000700,a0c,brk
1,47352868400,47352879100,00000010700,a00,read
1,47352906900,47352907700,00000000800,a10,ioctl
1,47352908600,47352908700,00000000100,a10,ioctl
1,47352924700,47352932600,00000007900,a4e,getdents
1,47352882900,47352955500,00000072600,a00,read
1,47352374500,47353023900,00000649400,a3d,wait4
1,47353033300,47353033500,00000000200,a3d,wait4
1,47352958900,47353174800,00000215900,a00,read
1,47353180400,47353186000,00000005600,a3d,wait4
1,47353188100,47353188300,00000000200,a3d,wait4
1,47353284100,47353286300,00000002200,a00,read
1,47353362500,47353363100,00000000600,a0c,brk
1,47353370900,47353371200,00000000300,a0c,brk
1,47353399200,47353399400,00000000200,a0c,brk
1,47353515400,47353515700,00000000300,a0c,brk
1,47353541000,47353541100,00000000100,a0c,brk
1,47353560000,47353560300,00000000300,a0c,brk
1,47353565400,47353565600,00000000200,a0c,brk
1,47353570200,47353570500,00000000300,a0c,brk
1,47353575300,47353575400,00000000100,a0c,brk
1,47353607000,47353607300,00000000300,a0c,brk
1,47353764100,47353764400,00000000300,a0c,brk
1,47353785300,47353785600,00000000300,a0c,brk
1,47353804700,47353805000,00000000300,a0c,brk
1,47353810500,47353810700,00000000200,a0c,brk
1,47353814500,47353814700,00000000200,a0c,brk
1,47353821100,47353821400,00000000300,a0c,brk
1,47353829000,47353829200,00000000200,a0c,brk
1,47353833000,47353833200,00000000200,a0c,brk
1,47353866100,47353866400,00000000300,a0c,brk
1,47354072100,47354073100,00000001000,a00,read
1,47354150800,47354152400,00000001600,a04,stat
1,47354152900,47354153600,00000000700,a04,stat
1,47354153900,47354154800,00000000900,a04,stat
1,47354157700,47354157900,00000000200,a6b,geteuid
1,47354158000,47354158000,00000000000,a6c,getegid
1,47354158100,47354158300,00000000200,a66,getuid
1,47354158400,47354158400,00000000000,a68,getgid
1,47354160000,47354160100,00000000100,a6b,geteuid
1,47354160100,47354160100,00000000000,a6c,getegid
1,47354158100,47354160200,00000002100,a66,getuid
1,47354160300,47354160300,00000000000,a68,getgid
1,47354162100,47354162100,00000000000,a6b,geteuid
1,47354162200,47354162200,00000000000,a66,getuid
1,47354162100,47354162200,00000000100,a6c,getegid
1,47354162300,47354162300,00000000000,a68,getgid
1,47354163700,47354163700,00000000000,a6b,geteuid
1,47354163800,47354163800,00000000000,a6c,getegid
1,47354163800,47354163900,00000000100,a66,getuid
1,47354163900,47354163900,00000000000,a68,getgid
1,47354168800,47354170100,00000001300,a0c,brk
1,47354177200,47354177500,00000000300,a0c,brk
1,47354179500,47354180600,00000001100,a00,read
1,47354185500,47354185700,00000000200,a0c,brk
1,47354193400,47354193600,00000000200,a0c,brk
1,47354225300,47354226700,00000001400,a02,open
1,47354226900,47354227600,00000000700,a02,open
1,47354227600,47354228600,00000001000,a02,open
1,47354228700,47354230200,00000001500,a02,open
1,47354230300,47354231100,00000000800,a02,open
1,47354231100,47354232600,00000001500,a02,open
1,47354232700,47354233900,00000001200,a02,open
1,47354233900,47354234600,00000000700,a02,open
1,47354234700,47354236000,00000001300,a02,open
1,47354236100,47354237200,00000001100,a02,open
1,47354237300,47354238400,00000001100,a02,open
1,47354238400,47354240100,00000001700,a02,open
1,47354337000,47354338000,00000001000,a0c,brk
1,47354342700,47354345500,00000002800,a00,read
1,47354488800,47354489200,00000000400,a0c,brk
1,47354551100,47354551400,00000000300,a0c,brk
1,47354635100,47354635400,00000000300,a0c,brk
1,47354660300,47354660600,00000000300,a0c,brk
1,47354680200,47354680500,00000000300,a0c,brk
1,47354682800,47354683000,00000000200,a0c,brk
1,47354769900,47354770300,00000000400,a0c,brk
1,47354775300,47354775500,00000000200,a0c,brk
1,47354780400,47354780700,00000000300,a0c,brk
1,47354815600,47354816000,00000000400,a0c,brk
1,47354851600,47354852600,00000001000,a04,stat
1,47354853200,47354853800,00000000600,a04,stat
1,47354855500,47354855600,00000000100,a6b,geteuid
1,47354163800,47354855700,00000691900,a6c,getegid
1,47354855800,47354855900,00000000100,a66,getuid
1,47354855900,47354855900,00000000000,a68,getgid
1,47354855500,47354857700,00000002200,a6b,geteuid
1,47354855700,47354857800,00000002100,a6c,getegid
1,47354855800,47354857800,00000002000,a66,getuid
1,47354855900,47354857900,00000002000,a68,getgid
1,47354857700,47354859700,00000002000,a6b,geteuid
1,47354857800,47354859700,00000001900,a6c,getegid
1,47354857800,47354859800,00000002000,a66,getuid
1,47354857900,47354859900,00000002000,a68,getgid
1,47354859700,47354861300,00000001600,a6b,geteuid
1,47354859800,47354861400,00000001600,a66,getuid
1,47354861300,47354861400,00000000100,a6c,getegid
1,47354859900,47354861500,00000001600,a68,getgid
1,47354870900,47354871500,00000000600,a0c,brk
1,47354960300,47354961000,00000000700,a04,stat
1,47354961500,47354962100,00000000600,a04,stat
1,47354963700,47354963800,00000000100,a6b,geteuid
1,47354861300,47354963900,00000102600,a6c,getegid
1,47354861400,47354964000,00000102600,a66,getuid
1,47354861500,47354964100,00000102600,a68,getgid
1,47354963700,47354965400,00000001700,a6b,geteuid
1,47354963900,47354965500,00000001600,a6c,getegid
1,47354964000,47354965600,00000001600,a66,getuid
1,47354964100,47354965700,00000001600,a68,getgid
1,47354965400,47354967300,00000001900,a6b,geteuid
1,47354965500,47354967400,00000001900,a6c,getegid
1,47354965600,47354967500,00000001900,a66,getuid
1,47354965700,47354967600,00000001900,a68,getgid
1,47354967300,47354968700,00000001400,a6b,geteuid
1,47354967400,47354968800,00000001400,a6c,getegid
1,47354967500,47354968900,00000001400,a66,getuid
1,47354967600,47354969000,00000001400,a68,getgid
1,47355076200,47355077200,00000001000,a0c,brk
1,47355090000,47355090300,00000000300,a0c,brk
1,47355096900,47355097200,00000000300,a0c,brk
1,47355111000,47355111600,00000000600,a04,stat
1,47355112100,47355112600,00000000500,a04,stat
1,47355112900,47355113500,00000000600,a04,stat
1,47355115100,47355115200,00000000100,a6b,geteuid
1,47355115300,47355115300,00000000000,a6c,getegid
1,47355115400,47355115400,00000000000,a66,getuid
1,47354969000,47355115500,00000146500,a68,getgid
1,47355116900,47355116900,00000000000,a6b,geteuid
1,47355117000,47355117000,00000000000,a6c,getegid
1,47355117000,47355117100,00000000100,a66,getuid
1,47355117100,47355117200,00000000100,a68,getgid
1,47355118800,47355118800,00000000000,a6b,geteuid
1,47355118800,47355118900,00000000100,a6c,getegid
1,47355118900,47355118900,00000000000,a66,getuid
1,47355119000,47355119000,00000000000,a68,getgid
1,47355118800,47355120700,00000001900,a6b,geteuid
1,47355120800,47355120800,00000000000,a6c,getegid
1,47355120900,47355120900,00000000000,a66,getuid
1,47355120900,47355121000,00000000100,a68,getgid
1,47355128400,47355128900,00000000500,a0c,brk
1,47355243100,47355243700,00000000600,a04,stat
1,47355244200,47355244800,00000000600,a04,stat
1,47355246600,47355246600,00000000000,a6b,geteuid
1,47355246700,47355246700,00000000000,a6c,getegid
1,47355246800,47355246800,00000000000,a66,getuid
1,47355246900,47355246900,00000000000,a68,getgid
1,47355248300,47355248400,00000000100,a6b,geteuid
1,47355248400,47355248500,00000000100,a6c,getegid
1,47355248500,47355248500,00000000000,a66,getuid
1,47355248600,47355248600,00000000000,a68,getgid
1,47355250300,47355250300,00000000000,a6b,geteuid
1,47355250300,47355250400,00000000100,a6c,getegid
1,47355250400,47355250400,00000000000,a66,getuid
1,47355250500,47355250500,00000000000,a68,getgid
1,47355250300,47355251700,00000001400,a6c,getegid
1,47355251600,47355251700,00000000100,a6b,geteuid
1,47355250400,47355251800,00000001400,a66,getuid
1,47355250500,47355251900,00000001400,a68,getgid
1,47355345200,47355346200,00000001000,a0c,brk
1,47355378600,47355379100,00000000500,a0c,brk
1,47355407800,47355408700,00000000900,a04,stat
1,47355409100,47355409800,00000000700,a04,stat
1,47355410100,47355410600,00000000500,a04,stat
1,47355410900,47355411400,00000000500,a04,stat
1,47355411800,47355412400,00000000600,a04,stat
1,47355412700,47355413500,00000000800,a04,stat
1,47355413900,47355414500,00000000600,a04,stat
1,47355414900,47355415900,00000001000,a04,stat
1,47355416200,47355417000,00000000800,a04,stat
1,47355417200,47355417600,00000000400,a04,stat
1,47355417800,47355418100,00000000300,a04,stat
1,47355418300,47355418700,00000000400,a04,stat
1,47355502400,47355503300,00000000900,a04,stat
1,47355503700,47355504400,00000000700,a04,stat
1,47355504700,47355505200,00000000500,a04,stat
1,47355505500,47355506000,00000000500,a04,stat
1,47355506400,47355506800,00000000400,a04,stat
1,47355507100,47355507600,00000000500,a04,stat
1,47355508000,47355508600,00000000600,a04,stat
1,47355509000,47355509500,00000000500,a04,stat
1,47355509800,47355510100,00000000300,a04,stat
1,47355510400,47355510700,00000000300,a04,stat
1,47355511000,47355511300,00000000300,a04,stat
1,47355511500,47355511900,00000000400,a04,stat
1,47355614300,47355615200,00000000900,a0c,brk
1,47355620800,47355621000,00000000200,a0c,brk
1,47355625800,47355626100,00000000300,a0c,brk
1,47355655400,47355655700,00000000300,a0c,brk
1,47355683000,47355683600,00000000600,a04,stat
1,47355684100,47355684500,00000000400,a04,stat
1,47355686200,47355686300,00000000100,a6b,geteuid
1,47355686300,47355686400,00000000100,a6c,getegid
1,47355686400,47355686500,00000000100,a66,getuid
1,47355251900,47355686600,00000434700,a68,getgid
1,47355686200,47355688100,00000001900,a6b,geteuid
1,47355688100,47355688200,00000000100,a6c,getegid
1,47355688200,47355688200,00000000000,a66,getuid
1,47355686600,47355688300,00000001700,a68,getgid
1,47355690000,47355690000,00000000000,a6b,geteuid
1,47355690100,47355690100,00000000000,a6c,getegid
1,47355690200,47355690200,00000000000,a66,getuid
1,47355690300,47355690300,00000000000,a68,getgid
1,47355691500,47355691500,00000000000,a6b,geteuid
1,47355690100,47355691600,00000001500,a6c,getegid
1,47355691600,47355691700,00000000100,a66,getuid
1,47355691700,47355691800,00000000100,a68,getgid
1,47355698900,47355699500,00000000600,a0c,brk
1,47355812100,47355813000,00000000900,a04,stat
1,47355813400,47355813900,00000000500,a04,stat
1,47355814300,47355814800,00000000500,a04,stat
1,47355816500,47355816500,00000000000,a6b,geteuid
1,47355816600,47355816600,00000000000,a6c,getegid
1,47355816700,47355816800,00000000100,a66,getuid
1,47355816800,47355816900,00000000100,a68,getgid
1,47355816500,47355818200,00000001700,a6b,geteuid
1,47355818300,47355818300,00000000000,a66,getuid
1,47355818200,47355818300,00000000100,a6c,getegid
1,47355818400,47355818400,00000000000,a68,getgid
1,47355820100,47355820100,00000000000,a6b,geteuid
1,47355820200,47355820200,00000000000,a6c,getegid
1,47355820200,47355820300,00000000100,a66,getuid
1,47355820300,47355820400,00000000100,a68,getgid
1,47355821500,47355821500,00000000000,a6b,geteuid
1,47355821500,47355821600,00000000100,a6c,getegid
1,47355821600,47355821600,00000000000,a66,getuid
1,47355821700,47355821700,00000000000,a68,getgid
1,47355910200,47355911000,00000000800,a0c,brk
1,47355939000,47355939300,00000000300,a0c,brk
1,47355967100,47355967600,00000000500,a04,stat
1,47355968000,47355968700,00000000700,a04,stat
1,47355969100,47355969600,00000000500,a04,stat
1,47355971200,47355971200,00000000000,a6b,geteuid
1,47355971300,47355971300,00000000000,a6c,getegid
1,47355971400,47355971400,00000000000,a66,getuid
1,47355971500,47355971500,00000000000,a68,getgid
1,47355972900,47355972900,00000000000,a6b,geteuid
1,47355973000,47355973000,00000000000,a6c,getegid
1,47355973100,47355973100,00000000000,a66,getuid
1,47355971500,47355973100,00000001600,a68,getgid
1,47355974800,47355974900,00000000100,a6b,geteuid
1,47355974900,47355975000,00000000100,a6c,getegid
1,47355975000,47355975000,00000000000,a66,getuid
1,47355973100,47355975000,00000001900,a68,getgid
1,47355976200,47355976200,00000000000,a6b,geteuid
1,47355976300,47355976300,00000000000,a6c,getegid
1,47355976400,47355976400,00000000000,a66,getuid
1,47355976500,47355976500,00000000000,a68,getgid
1,47355983700,47355984300,00000000600,a0c,brk
1,47356098800,47356099500,00000000700,a0c,brk
1,47356104600,47356104800,00000000200,a0c,brk
1,47356106500,47356106700,00000000200,a0c,brk
1,47356162500,47356163300,00000000800,a04,stat
1,47356163800,47356164400,00000000600,a04,stat
1,47356164700,47356165100,00000000400,a04,stat
1,47356166900,47356166900,00000000000,a6b,geteuid
1,47355976300,47356166900,00000190600,a6c,getegid
1,47356167000,47356167000,00000000000,a66,getuid
1,47356167100,47356167100,00000000000,a68,getgid
1,47356168600,47356168600,00000000000,a6b,geteuid
1,47356168700,47356168700,00000000000,a6c,getegid
1,47356168700,47356168800,00000000100,a66,getuid
1,47356168800,47356168800,00000000000,a68,getgid
1,47356170500,47356170500,00000000000,a6b,geteuid
1,47356170600,47356170600,00000000000,a6c,getegid
1,47356170700,47356170700,00000000000,a66,getuid
1,47356170700,47356170700,00000000000,a68,getgid
1,47356172200,47356172300,00000000100,a6b,geteuid
1,47356172300,47356172300,00000000000,a6c,getegid
1,47356172400,47356172400,00000000000,a66,getuid
1,47356170700,47356172500,00000001800,a68,getgid
1,47356179700,47356180300,00000000600,a0c,brk
1,47356314300,47356315000,00000000700,a04,stat
1,47356315400,47356316300,00000000900,a04,stat
1,47356316600,47356317100,00000000500,a04,stat
1,47356319000,47356319000,00000000000,a6b,geteuid
1,47356319100,47356319100,00000000000,a6c,getegid
1,47356319200,47356319300,00000000100,a66,getuid
1,47356319300,47356319400,00000000100,a68,getgid
1,47356321200,47356321200,00000000000,a6b,geteuid
1,47356321300,47356321300,00000000000,a6c,getegid
1,47356321400,47356321400,00000000000,a66,getuid
1,47356321500,47356321500,00000000000,a68,getgid
1,47356321200,47356323600,00000002400,a6b,geteuid
1,47356323700,47356323700,00000000000,a6c,getegid
1,47356323800,47356323800,00000000000,a66,getuid
1,47356323800,47356323900,00000000100,a68,getgid
1,47356325300,47356325300,00000000000,a6b,geteuid
1,47356325400,47356325400,00000000000,a6c,getegid
1,47356325400,47356325500,00000000100,a66,getuid
1,47356325500,47356325500,00000000000,a68,getgid
1,47356437900,47356439100,00000001200,a0c,brk
1,47356441800,47356442200,00000000400,a0c,brk
1,47356475000,47356475300,00000000300,a0c,brk
1,47356504100,47356504800,00000000700,a04,stat
1,47356505100,47356505700,00000000600,a04,stat
1,47356325400,47356507600,00000182200,a6c,getegid
1,47356507500,47356507600,00000000100,a6b,geteuid
1,47356507700,47356507800,00000000100,a66,getuid
1,47356507800,47356507900,00000000100,a68,getgid
1,47356509300,47356509300,00000000000,a6b,geteuid
1,47356509400,47356509400,00000000000,a6c,getegid
1,47356509500,47356509500,00000000000,a66,getuid
1,47356509500,47356509600,00000000100,a68,getgid
1,47356511200,47356511300,00000000100,a6b,geteuid
1,47356511300,47356511300,00000000000,a6c,getegid
1,47356511400,47356511400,00000000000,a66,getuid
1,47356511500,47356511500,00000000000,a68,getgid
1,47356512600,47356512700,00000000100,a6b,geteuid
1,47356512700,47356512700,00000000000,a6c,getegid
1,47356511400,47356512700,00000001300,a66,getuid
1,47356511500,47356512800,00000001300,a68,getgid
1,47356637500,47356638200,00000000700,a04,stat
1,47356638600,47356639200,00000000600,a04,stat
1,47356639500,47356640000,00000000500,a04,stat
1,47356641900,47356641900,00000000000,a6b,geteuid
1,47356641900,47356641900,00000000000,a6c,getegid
1,47356642000,47356642000,00000000000,a66,getuid
1,47356642100,47356642100,00000000000,a68,getgid
1,47356643600,47356643600,00000000000,a6c,getegid
1,47356643500,47356643600,00000000100,a6b,geteuid
1,47356643700,47356643700,00000000000,a66,getuid
1,47356643800,47356643800,00000000000,a68,getgid
1,47356645800,47356645800,00000000000,a6b,geteuid
1,47356645800,47356645900,00000000100,a6c,getegid
1,47356645900,47356645900,00000000000,a66,getuid
1,47356646000,47356646000,00000000000,a68,getgid
1,47356647500,47356647500,00000000000,a6b,geteuid
1,47356647600,47356647600,00000000000,a6c,getegid
1,47356647600,47356647600,00000000000,a66,getuid
1,47356647700,47356647700,00000000000,a68,getgid
1,47356654900,47356655700,00000000800,a0c,brk
1,47356728400,47356729400,00000001000,a00,read
1,47356849500,47356850400,00000000900,a04,stat
1,47356850800,47356851300,00000000500,a04,stat
1,47356851700,47356852100,00000000400,a04,stat
1,47356852500,47356852900,00000000400,a04,stat
1,47356853200,47356853700,00000000500,a04,stat
1,47356854100,47356854600,00000000500,a04,stat
1,47356854900,47356855300,00000000400,a04,stat
1,47356855700,47356856400,00000000700,a04,stat
1,47356856700,47356857100,00000000400,a04,stat
1,47356857300,47356857600,00000000300,a04,stat
1,47356857900,47356858200,00000000300,a04,stat
1,47356858500,47356858900,00000000400,a04,stat
1,47356866600,47356867700,00000001100,a0c,brk
1,47356930700,47356932600,00000001900,b0d,faccessat
1,47357026900,47357027900,00000001000,a00,read
1,47357148600,47357149400,00000000800,a00,read
1,47357252800,47357254600,00000001800,a02,open
1,47357255900,47357256600,00000000700,a02,open
1,47357259400,47357260000,00000000600,a00,read
1,47357316100,47357317400,00000001300,a0c,brk
1,47357319000,47357320100,00000001100,a00,read
1,47357444000,47357498500,00000054500,a38,clone
1,47360861300,47360862900,00000001600,a04,stat
1,47360863200,47360863800,00000000600,a04,stat
1,47360864000,47360864600,00000000600,a04,stat
1,47361436500,47361460400,00000023900,a38,clone
1,47361610100,47361610200,00000000100,a0c,brk
1,47361617800,47361619300,00000001500,a15,access
1,47361619800,47361620600,00000000800,a09,mmap
1,47361625000,47361626100,00000001100,a15,access
1,47361629700,47361630700,00000001000,a09,mmap
1,47361632500,47361633000,00000000500,a15,access
1,47361638900,47361639500,00000000600,a00,read
1,47361640800,47361642300,00000001500,a09,mmap
1,47361647000,47361649900,00000002900,a09,mmap
1,47361653300,47361654700,00000001400,a09,mmap
1,47361665700,47361666300,00000000600,a09,mmap
1,47361667500,47361668300,00000000800,a09,mmap
1,47361669400,47361669700,00000000300,a09,mmap
1,47361768800,47361768900,00000000100,a0c,brk
1,47361769000,47361769900,00000000900,a0c,brk
1,47361775600,47361777100,00000001500,a09,mmap
1,47361638900,47361858200,00000219300,a00,read
1,47361867700,47361871700,00000004000,a3d,wait4
1,47361904000,47361906800,00000002800,a01,write
1,47362757800,47362759200,00000001400,a04,stat
1,47362759800,47362760900,00000001100,a04,stat
1,47362761300,47362761800,00000000500,a04,stat
1,47362763700,47362763800,00000000100,a6b,geteuid
1,47356647600,47362763900,00006116300,a6c,getegid
1,47362764000,47362764200,00000000200,a66,getuid
1,47362764300,47362764400,00000000100,a68,getgid
1,47362766200,47362766200,00000000000,a6b,geteuid
1,47362766300,47362766300,00000000000,a6c,getegid
1,47362766400,47362766400,00000000000,a66,getuid
1,47362766500,47362766500,00000000000,a68,getgid
1,47362768200,47362768200,00000000000,a6b,geteuid
1,47362768300,47362768300,00000000000,a6c,getegid
1,47362768400,47362768400,00000000000,a66,getuid
1,47362768400,47362768500,00000000100,a68,getgid
1,47362769800,47362769800,00000000000,a6b,geteuid
1,47362769900,47362769900,00000000000,a6c,getegid
1,47362768400,47362770000,00000001600,a66,getuid
1,47362770100,47362770100,00000000000,a68,getgid
1,47362779100,47362830700,00000051600,a38,clone
1,47363027700,47363027800,00000000100,a0c,brk
1,47363035100,47363036500,00000001400,a15,access
1,47363037200,47363037900,00000000700,a09,mmap
1,47363041000,47363041600,00000000600,a15,access
1,47363045600,47363046700,00000001100,a09,mmap
1,47363050100,47363050600,00000000500,a15,access
1,47363056000,47363056700,00000000700,a00,read
1,47363059200,47363061000,00000001800,a09,mmap
1,47363065400,47363068500,00000003100,a09,mmap
1,47363084100,47363084800,00000000700,a09,mmap
1,47363086200,47363086900,00000000700,a09,mmap
1,47363199100,47363199200,00000000100,a0c,brk
1,47363199300,47363200200,00000000900,a0c,brk
1,47363206800,47363208500,00000001700,a09,mmap
1,47363296600,47363301200,00000004600,a01,write
1,47363056000,47363303500,00000247500,a00,read
1,47363308500,47363309000,00000000500,a00,read
1,47363310400,47363310600,00000000200,a00,read
1,47363310900,47363311100,00000000200,a00,read
1,47363313100,47363313300,00000000200,a00,read
1,47363313700,47363313900,00000000200,a00,read
1,47363314200,47363314400,00000000200,a00,read
1,47363314700,47363314800,00000000100,a00,read
1,47363315700,47363317000,00000001300,a0c,brk
1,47363318500,47363318600,00000000100,a00,read
1,47363319000,47363319200,00000000200,a00,read
1,47363319600,47363319700,00000000100,a00,read
1,47362863400,47363370000,00000506600,a3d,wait4
1,47363379900,47363380100,00000000200,a3d,wait4
1,47363320500,47363523900,00000203400,a00,read
1,47363529500,47363535000,00000005500,a3d,wait4
1,47363537600,47363537700,00000000100,a3d,wait4
1,47363540900,47363542000,00000001100,a0c,brk
1,47363806300,47363808400,00000002100,a04,stat
1,47363863500,47363864300,00000000800,a0c,brk
1,47363881900,47363895400,00000013500,a00,read
1,47363850500,47365861400,00002010900,a04,stat
1,47365873000,47365875600,00000002600,a00,read
1,47366199600,47366209000,00000009400,a4e,getdents
1,47366286800,47366287800,00000001000,a00,read
1,47366480200,47366484200,00000004000,a00,read
1,47366579600,47366583700,00000004100,a09,mmap
1,47367658800,47367660300,00000001500,a04,stat
1,47367672000,47367672600,00000000600,a04,stat
1,47367718800,47367720100,00000001300,a0c,brk
1,47367730600,47367754900,00000024300,a4e,getdents
1,47368108000,47368111200,00000003200,a00,read
1,47368146400,47368151500,00000005100,a09,mmap
1,47368805400,47368806700,00000001300,a00,read
1,47368932600,47368939300,00000006700,a0c,brk
1,47369405100,47369406000,00000000900,b0d,faccessat
1,47369462700,47369463500,00000000800,b0d,faccessat
1,47369569100,47369570100,00000001000,a04,stat
1,47369581600,47369582200,00000000600,a04,stat
1,47369586200,47369586600,00000000400,a04,stat
1,47369590000,47369590400,00000000400,a04,stat
1,47369593500,47369593900,00000000400,a04,stat
1,47369740500,47369744300,00000003800,a00,read
1,47369758700,47369761700,00000003000,a0c,brk
1,47369963200,47369964900,00000001700,a00,read
1,47370147500,47370161300,00000013800,a00,read
1,47370455000,47370456100,00000001100,a00,read
1,47370457200,47370457400,00000000200,a08,lseek
1,47370457600,47370457800,00000000200,a00,read
1,47370628600,47370629700,00000001100,a00,read
1,47370800700,47370804600,00000003900,a00,read
0,47294059500,47888725700,00594666200,a09,mmap
0,47888726000,47888726000,00000000000,a08,lseek
0,47888740600,47888741100,00000000500,a09,mmap
0,47888741100,47888741200,00000000100,a08,lseek
0,47888755100,47888755500,00000000400,a09,mmap
0,47888755600,47888755700,00000000100,a08,lseek
0,47888767200,47888767300,00000000100,a08,lseek
0,47888769700,47888770100,00000000400,a09,mmap
0,47888770200,47888770300,00000000100,a08,lseek
0,47888775300,47888775800,00000000500,a09,mmap
0,47888775800,47888775800,00000000000,a08,lseek
0,47888785600,47888786000,00000000400,a09,mmap
0,47888786100,47888786200,00000000100,a08,lseek
0,47888800700,47888801100,00000000400,a09,mmap
0,47888801100,47888801200,00000000100,a08,lseek
0,47888815200,47888815600,00000000400,a09,mmap
0,47888815700,47888815700,00000000000,a08,lseek
0,47888827200,47888827300,00000000100,a08,lseek
0,47888829700,47888830200,00000000500,a09,mmap
0,47888830200,47888830300,00000000100,a08,lseek
0,47888835200,47888835700,00000000500,a09,mmap
0,47888835800,47888835900,00000000100,a08,lseek
0,47888845400,47888845900,00000000500,a09,mmap
0,47888846000,47888846000,00000000000,a08,lseek
0,47888860300,47888860800,00000000500,a09,mmap
0,47888860800,47888860900,00000000100,a08,lseek
0,47888874600,47888875100,00000000500,a09,mmap
0,47888875100,47888875200,00000000100,a08,lseek
0,47888886800,47888886900,00000000100,a08,lseek
0,47888889400,47888889800,00000000400,a09,mmap
0,47888889900,47888890000,00000000100,a08,lseek
0,47888895300,47888895700,00000000400,a09,mmap
0,47888895700,47888895800,00000000100,a08,lseek
0,47888905400,47888905900,00000000500,a09,mmap
0,47888905900,47888906000,00000000100,a08,lseek
0,47888920400,47888920800,00000000400,a09,mmap
0,47888920900,47888921000,00000000100,a08,lseek
0,47888934800,47888935200,00000000400,a09,mmap
0,47888935300,47888935400,00000000100,a08,lseek
0,47888946900,47888947000,00000000100,a08,lseek
0,47888949300,47888949800,00000000500,a09,mmap
0,47888949900,47888950000,00000000100,a08,lseek
0,47888954900,47888955300,00000000400,a09,mmap
0,47888955400,47888955500,00000000100,a08,lseek
0,47888965000,47888965400,00000000400,a09,mmap
0,47888965500,47888965600,00000000100,a08,lseek
0,47888979800,47888980300,00000000500,a09,mmap
0,47888980300,47888980400,00000000100,a08,lseek
0,47888994100,47888994500,00000000400,a09,mmap
0,47888994500,47888994600,00000000100,a08,lseek
0,47889007600,47889007600,00000000000,a08,lseek
0,47889010200,47889010700,00000000500,a09,mmap
0,47889010800,47889010800,00000000000,a08,lseek
0,47889015900,47889016300,00000000400,a09,mmap
0,47889016400,47889016500,00000000100,a08,lseek
0,47889025800,47889026200,00000000400,a09,mmap
0,47889026300,47889026400,00000000100,a08,lseek
0,47889040500,47889041000,00000000500,a09,mmap
0,47889041000,47889041100,00000000100,a08,lseek
0,47889055000,47889055400,00000000400,a09,mmap
0,47889055400,47889055500,00000000100,a08,lseek
0,47889067300,47889067400,00000000100,a08,lseek
0,47889075200,47889083400,00000008200,a2a,connect
0,47889088800,47889089500,00000000700,a09,mmap
0,47889089500,47889089600,00000000100,a08,lseek
0,47889095100,47889095600,00000000500,a09,mmap
0,47889095600,47889095700,00000000100,a08,lseek
0,47889105200,47889105700,00000000500,a09,mmap
0,47889105700,47889105800,00000000100,a08,lseek
0,47889120500,47889120900,00000000400,a09,mmap
0,47889121000,47889121000,00000000000,a08,lseek
0,47889134900,47889135300,00000000400,a09,mmap
0,47889135400,47889135500,00000000100,a08,lseek
0,47889148100,47889148200,00000000100,a08,lseek
0,47889150700,47889151200,00000000500,a09,mmap
0,47889151300,47889151300,00000000000,a08,lseek
0,47889156500,47889157000,00000000500,a09,mmap
0,47889157100,47889157100,00000000000,a08,lseek
0,47889166600,47889167100,00000000500,a09,mmap
0,47889167100,47889167200,00000000100,a08,lseek
0,47889181600,47889182000,00000000400,a09,mmap
0,47889182100,47889182200,00000000100,a08,lseek
0,47889196000,47889196500,00000000500,a09,mmap
0,47889196500,47889196600,00000000100,a08,lseek
0,47889209000,47889209000,00000000000,a08,lseek
0,47889211400,47889211900,00000000500,a09,mmap
0,47889212000,47889212100,00000000100,a08,lseek
0,47889217000,47889217500,00000000500,a09,mmap
0,47889217500,47889217600,00000000100,a08,lseek
0,47889226900,47889227400,00000000500,a09,mmap
0,47889227400,47889227500,00000000100,a08,lseek
0,47889241800,47889242200,00000000400,a09,mmap
0,47889242300,47889242300,00000000000,a08,lseek
0,47889256500,47889256800,00000000300,a09,mmap
0,47889256900,47889257000,00000000100,a08,lseek
0,47889269600,47889269700,00000000100,a08,lseek
0,47889272700,47889273200,00000000500,a09,mmap
0,47889273300,47889273400,00000000100,a08,lseek
0,47889278300,47889278700,00000000400,a09,mmap
0,47889278800,47889278900,00000000100,a08,lseek
0,47889288300,47889288700,00000000400,a09,mmap
0,47889288800,47889288800,00000000000,a08,lseek
0,47889303400,47889303900,00000000500,a09,mmap
0,47889303900,47889304000,00000000100,a08,lseek
0,47889317800,47889318200,00000000400,a09,mmap
0,47889318300,47889318400,00000000100,a08,lseek
0,47889331000,47889331100,00000000100,a08,lseek
0,47889333300,47889333800,00000000500,a09,mmap
0,47889333800,47889333900,00000000100,a08,lseek
0,47889338800,47889339200,00000000400,a09,mmap
0,47889339300,47889339400,00000000100,a08,lseek
0,47889349100,47889349500,00000000400,a09,mmap
0,47889349600,47889349600,00000000000,a08,lseek
0,47889364100,47889364500,00000000400,a09,mmap
0,47889364600,47889364600,00000000000,a08,lseek
0,47889378300,47889378700,00000000400,a09,mmap
0,47889378800,47889378800,00000000000,a08,lseek
0,47889391600,47889391600,00000000000,a08,lseek
0,47889394200,47889394700,00000000500,a09,mmap
0,47889394800,47889394900,00000000100,a08,lseek
0,47889399800,47889400300,00000000500,a09,mmap
0,47889400400,47889400400,00000000000,a08,lseek
0,47889409800,47889410200,00000000400,a09,mmap
0,47889410300,47889410400,00000000100,a08,lseek
0,47889424500,47889424900,00000000400,a09,mmap
0,47889425000,47889425100,00000000100,a08,lseek
0,47889438900,47889439200,00000000300,a09,mmap
0,47889439300,47889439300,00000000000,a08,lseek
0,47889452300,47889452300,00000000000,a08,lseek
0,47889454600,47889455100,00000000500,a09,mmap
0,47889455200,47889455300,00000000100,a08,lseek
0,47889460100,47889460600,00000000500,a09,mmap
0,47889460700,47889460800,00000000100,a08,lseek
0,47889470500,47889470900,00000000400,a09,mmap
0,47889471000,47889471100,00000000100,a08,lseek
0,47889485500,47889485900,00000000400,a09,mmap
0,47889486000,47889486100,00000000100,a08,lseek
0,47889499900,47889500300,00000000400,a09,mmap
0,47889500400,47889500500,00000000100,a08,lseek
0,47889513600,47889513700,00000000100,a08,lseek
0,47889516000,47889516500,00000000500,a09,mmap
0,47889516500,47889516600,00000000100,a08,lseek
0,47889521500,47889522000,00000000500,a09,mmap
0,47889522100,47889522200,00000000100,a08,lseek
0,47889531600,47889532000,00000000400,a09,mmap
0,47889532000,47889532100,00000000100,a08,lseek
0,47889546500,47889546900,00000000400,a09,mmap
0,47889547000,47889547100,00000000100,a08,lseek
0,47889560700,47889561100,00000000400,a09,mmap
0,47889561200,47889561300,00000000100,a08,lseek
0,47889574400,47889574500,00000000100,a08,lseek
0,47889576800,47889577300,00000000500,a09,mmap
0,47889577400,47889577500,00000000100,a08,lseek
0,47889582400,47889582800,00000000400,a09,mmap
0,47889582900,47889583000,00000000100,a08,lseek
0,47889592500,47889592800,00000000300,a09,mmap
0,47889592900,47889593000,00000000100,a08,lseek
0,47889607400,47889607800,00000000400,a09,mmap
0,47889607000,47889607900,00000000900,a08,lseek
0,47889621500,47889621900,00000000400,a09,mmap
0,47889622000,47889622000,00000000000,a08,lseek
0,47889635500,47889635500,00000000000,a08,lseek
0,47889637900,47889638400,00000000500,a09,mmap
0,47889638400,47889638400,00000000000,a08,lseek
0,47889643400,47889643900,00000000500,a09,mmap
0,47889643900,47889644000,00000000100,a08,lseek
0,47889653700,47889654200,00000000500,a09,mmap
0,47889654300,47889654400,00000000100,a08,lseek
0,47889668800,47889669100,00000000300,a09,mmap
0,47889669200,47889669200,00000000000,a08,lseek
0,47889682900,47889683300,00000000400,a09,mmap
0,47889683400,47889683500,00000000100,a08,lseek
0,47889697100,47889697200,00000000100,a08,lseek
0,47889699400,47889699900,00000000500,a09,mmap
0,47889700000,47889700100,00000000100,a08,lseek
0,47889705000,47889705400,00000000400,a09,mmap
0,47889705500,47889705600,00000000100,a08,lseek
0,47889715000,47889715500,00000000500,a09,mmap
0,47889715500,47889715600,00000000100,a08,lseek
0,47889729700,47889730200,00000000500,a09,mmap
0,47889730200,47889730300,00000000100,a08,lseek
0,47889744100,47889744600,00000000500,a09,mmap
0,47889744600,47889744700,00000000100,a08,lseek
0,47889758300,47889758400,00000000100,a08,lseek
0,47889760600,47889761100,00000000500,a09,mmap
0,47889761200,47889761300,00000000100,a08,lseek
0,47889766200,47889766600,00000000400,a09,mmap
0,47889766700,47889766800,00000000100,a08,lseek
0,47889776600,47889777100,00000000500,a09,mmap
0,47889777100,47889777100,00000000000,a08,lseek
0,47889791400,47889791800,00000000400,a09,mmap
0,47889791900,47889792000,00000000100,a08,lseek
0,47889805600,47889806000,00000000400,a09,mmap
0,47889806100,47889806200,00000000100,a08,lseek
0,47889820100,47889820200,00000000100,a08,lseek
0,47889822500,47889822900,00000000400,a09,mmap
0,47889823000,47889823100,00000000100,a08,lseek
0,47889828000,47889828400,00000000400,a09,mmap
0,47889828500,47889828600,00000000100,a08,lseek
0,47889838100,47889838600,00000000500,a09,mmap
0,47889838700,47889838800,00000000100,a08,lseek
0,47889853100,47889853400,00000000300,a09,mmap
0,47889853500,47889853600,00000000100,a08,lseek
0,47889867500,47889867900,00000000400,a09,mmap
0,47889868000,47889868100,00000000100,a08,lseek
0,47889882100,47889882200,00000000100,a08,lseek
0,47889885100,47889885500,00000000400,a09,mmap
0,47889885600,47889885700,00000000100,a08,lseek
0,47889890800,47889891200,00000000400,a09,mmap
0,47889891300,47889891300,00000000000,a08,lseek
0,47889901200,47889901600,00000000400,a09,mmap
0,47889901700,47889901800,00000000100,a08,lseek
0,47889916000,47889916400,00000000400,a09,mmap
0,47889916500,47889916600,00000000100,a08,lseek
0,47889930300,47889930700,00000000400,a09,mmap
0,47889930800,47889930900,00000000100,a08,lseek
0,47889945000,47889945100,00000000100,a08,lseek
0,47889947500,47889948000,00000000500,a09,mmap
0,47889948100,47889948100,00000000000,a08,lseek
0,47889953200,47889953700,00000000500,a09,mmap
0,47889953700,47889953800,00000000100,a08,lseek
0,47889963300,47889963600,00000000300,a09,mmap
0,47889963700,47889963800,00000000100,a08,lseek
0,47889978100,47889978500,00000000400,a09,mmap
0,47889978500,47889978600,00000000100,a08,lseek
0,47889992600,47889993100,00000000500,a09,mmap
0,47889993100,47889993200,00000000100,a08,lseek
0,47890007500,47890007600,00000000100,a08,lseek
0,47890010000,47890010500,00000000500,a09,mmap
0,47890010500,47890010600,00000000100,a08,lseek
0,47890015400,47890015900,00000000500,a09,mmap
0,47890016000,47890016100,00000000100,a08,lseek
0,47890025500,47890025900,00000000400,a09,mmap
0,47890026000,47890026000,00000000000,a08,lseek
0,47890040300,47890040800,00000000500,a09,mmap
0,47890040800,47890040900,00000000100,a08,lseek
0,47890054500,47890055000,00000000500,a09,mmap
0,47890055000,47890055100,00000000100,a08,lseek
0,47890069700,47890069800,00000000100,a08,lseek
0,47890072000,47890072500,00000000500,a09,mmap
0,47890072600,47890072700,00000000100,a08,lseek
0,47890077500,47890078000,00000000500,a09,mmap
0,47890078000,47890078100,00000000100,a08,lseek
0,47890087400,47890087900,00000000500,a09,mmap
0,47890088000,47890088100,00000000100,a08,lseek
0,47890102300,47890102700,00000000400,a09,mmap
0,47890102700,47890102800,00000000100,a08,lseek
0,47890116600,47890117000,00000000400,a09,mmap
0,47890117100,47890117200,00000000100,a08,lseek
0,47890131800,47890131900,00000000100,a08,lseek
0,47890134300,47890134700,00000000400,a09,mmap
0,47890134800,47890134800,00000000000,a08,lseek
0,47890140300,47890140800,00000000500,a09,mmap
0,47890140800,47890140900,00000000100,a08,lseek
0,47890150400,47890150900,00000000500,a09,mmap
0,47890150900,47890151000,00000000100,a08,lseek
0,47890165300,47890165700,00000000400,a09,mmap
0,47890165800,47890165800,00000000000,a08,lseek
0,47890179700,47890180000,00000000300,a09,mmap
0,47890180100,47890180200,00000000100,a08,lseek
0,47890195100,47890195100,00000000000,a08,lseek
0,47890197500,47890198000,00000000500,a09,mmap
0,47890198100,47890198200,00000000100,a08,lseek
0,47890203000,47890203500,00000000500,a09,mmap
0,47890203600,47890203700,00000000100,a08,lseek
0,47890213100,47890213500,00000000400,a09,mmap
0,47890213600,47890213700,00000000100,a08,lseek
0,47890227800,47890228200,00000000400,a09,mmap
0,47890228300,47890228400,00000000100,a08,lseek
0,47890242100,47890242500,00000000400,a09,mmap
0,47890242600,47890242600,00000000000,a08,lseek
0,47890257800,47890257900,00000000100,a08,lseek
0,47890260100,47890260600,00000000500,a09,mmap
0,47890260600,47890260700,00000000100,a08,lseek
0,47890265600,47890266000,00000000400,a09,mmap
0,47890266100,47890266200,00000000100,a08,lseek
0,47890275600,47890276000,00000000400,a09,mmap
0,47890276100,47890276200,00000000100,a08,lseek
0,47890290500,47890290900,00000000400,a09,mmap
0,47890291000,47890291100,00000000100,a08,lseek
0,47890304800,47890305200,00000000400,a09,mmap
0,47890305300,47890305300,00000000000,a08,lseek
0,47890320600,47890320700,00000000100,a08,lseek
0,47890322900,47890323400,00000000500,a09,mmap
0,47890323500,47890323600,00000000100,a08,lseek
0,47890328400,47890328900,00000000500,a09,mmap
0,47890329000,47890329000,00000000000,a08,lseek
0,47890338700,47890339100,00000000400,a09,mmap
0,47890339200,47890339300,00000000100,a08,lseek
0,47890353900,47890354300,00000000400,a09,mmap
0,47890354400,47890354500,00000000100,a08,lseek
0,47890368200,47890368600,00000000400,a09,mmap
0,47890368700,47890368800,00000000100,a08,lseek
0,47890384200,47890384200,00000000000,a08,lseek
0,47890386500,47890387000,00000000500,a09,mmap
0,47890387000,47890387000,00000000000,a08,lseek
0,47890392500,47890392900,00000000400,a09,mmap
0,47890393000,47890393100,00000000100,a08,lseek
0,47890402700,47890403200,00000000500,a09,mmap
0,47890403300,47890403400,00000000100,a08,lseek
0,47890417700,47890418100,00000000400,a09,mmap
0,47890418200,47890418300,00000000100,a08,lseek
0,47890431900,47890432400,00000000500,a09,mmap
0,47890432400,47890432500,00000000100,a08,lseek
0,47890449600,47890449700,00000000100,a08,lseek
0,47890452400,47890452900,00000000500,a09,mmap
0,47890453000,47890453100,00000000100,a08,lseek
0,47890458200,47890458600,00000000400,a09,mmap
0,47890458700,47890458800,00000000100,a08,lseek
0,47890468500,47890468800,00000000300,a09,mmap
0,47890468900,47890469000,00000000100,a08,lseek
0,47890483800,47890484100,00000000300,a09,mmap
0,47890484200,47890484300,00000000100,a08,lseek
0,47890498000,47890498400,00000000400,a09,mmap
0,47890498500,47890498600,00000000100,a08,lseek
0,47890514300,47890514400,00000000100,a08,lseek
0,47890517000,47890517400,00000000400,a09,mmap
0,47890517500,47890517600,00000000100,a08,lseek
0,47890522500,47890523000,00000000500,a09,mmap
0,47890523000,47890523100,00000000100,a08,lseek
0,47890532500,47890533000,00000000500,a09,mmap
0,47890533100,47890533200,00000000100,a08,lseek
0,47890547200,47890547600,00000000400,a09,mmap
0,47890547600,47890547700,00000000100,a08,lseek
0,47890561300,47890561800,00000000500,a09,mmap
0,47890561800,47890561800,00000000000,a08,lseek
0,47890578000,47890578100,00000000100,a08,lseek
0,47890580300,47890580800,00000000500,a09,mmap
0,47890580800,47890580800,00000000000,a08,lseek
0,47890585800,47890586300,00000000500,a09,mmap
0,47890586300,47890586400,00000000100,a08,lseek
0,47890595800,47890596100,00000000300,a09,mmap
0,47890596200,47890596300,00000000100,a08,lseek
0,47890610400,47890610800,00000000400,a09,mmap
0,47890610900,47890611000,00000000100,a08,lseek
0,47890624500,47890625000,00000000500,a09,mmap
0,47890625000,47890625100,00000000100,a08,lseek
0,47890641400,47890641500,00000000100,a08,lseek
0,47890643900,47890646600,00000002700,a2a,connect
0,47890649600,47890650300,00000000700,a09,mmap
0,47890650300,47890650400,00000000100,a08,lseek
0,47890655800,47890656300,00000000500,a09,mmap
0,47890656400,47890656500,00000000100,a08,lseek
0,47890666300,47890666700,00000000400,a09,mmap
0,47890666800,47890666900,00000000100,a08,lseek
0,47890681400,47890681700,00000000300,a09,mmap
0,47890681800,47890681900,00000000100,a08,lseek
0,47890695500,47890696000,00000000500,a09,mmap
0,47890696000,47890696100,00000000100,a08,lseek
0,47890713000,47890713100,00000000100,a08,lseek
0,47890715500,47890715900,00000000400,a09,mmap
0,47890716000,47890716000,00000000000,a08,lseek
0,47890721300,47890721600,00000000300,a09,mmap
0,47890721700,47890721800,00000000100,a08,lseek
0,47890731300,47890731800,00000000500,a09,mmap
0,47890731800,47890731900,00000000100,a08,lseek
0,47890746000,47890746400,00000000400,a09,mmap
0,47890746400,47890746500,00000000100,a08,lseek
0,47890760100,47890760500,00000000400,a09,mmap
0,47890760600,47890760600,00000000000,a08,lseek
0,47890777200,47890777300,00000000100,a08,lseek
0,47890779500,47890780000,00000000500,a09,mmap
0,47890780000,47890780100,00000000100,a08,lseek
0,47890784900,47890785400,00000000500,a09,mmap
0,47890785500,47890785500,00000000000,a08,lseek
0,47890794900,47890795400,00000000500,a09,mmap
0,47890795400,47890795500,00000000100,a08,lseek
0,47890809400,47890809900,00000000500,a09,mmap
0,47890809900,47890810000,00000000100,a08,lseek
0,47890823500,47890823900,00000000400,a09,mmap
0,47890824000,47890824000,00000000000,a08,lseek
0,47890840700,47890840800,00000000100,a08,lseek
0,47890843100,47890843700,00000000600,a09,mmap
0,47890843700,47890843800,00000000100,a08,lseek
0,47890848700,47890849200,00000000500,a09,mmap
0,47890849300,47890849300,00000000000,a08,lseek
0,47890859200,47890859700,00000000500,a09,mmap
0,47890859800,47890859900,00000000100,a08,lseek
0,47890873900,47890874400,00000000500,a09,mmap
0,47890874400,47890874500,00000000100,a08,lseek
0,47890888000,47890888400,00000000400,a09,mmap
0,47890888500,47890888500,00000000000,a08,lseek
0,47890905600,47890905700,00000000100,a08,lseek
0,47890905900,47890906900,00000001000,a00,read
0,47890909300,47890909800,00000000500,a09,mmap
0,47890909800,47890909900,00000000100,a08,lseek
0,47890915100,47890915500,00000000400,a09,mmap
0,47890915600,47890915700,00000000100,a08,lseek
0,47890925200,47890925700,00000000500,a09,mmap
0,47890925800,47890925800,00000000000,a08,lseek
0,47890940000,47890940400,00000000400,a09,mmap
0,47890940500,47890940600,00000000100,a08,lseek
0,47890954200,47890954600,00000000400,a09,mmap
0,47890953800,47890954700,00000000900,a08,lseek
0,47890971700,47890971800,00000000100,a08,lseek
0,47890974300,47890974900,00000000600,a09,mmap
0,47890974900,47890975000,00000000100,a08,lseek
0,47890979900,47890980400,00000000500,a09,mmap
0,47890980400,47890980500,00000000100,a08,lseek
0,47890989900,47890990400,00000000500,a09,mmap
0,47890990400,47890990500,00000000100,a08,lseek
0,47891004500,47891004900,00000000400,a09,mmap
0,47891005000,47891005100,00000000100,a08,lseek
0,47891018600,47891019000,00000000400,a09,mmap
0,47891019100,47891019200,00000000100,a08,lseek
0,47891036300,47891036400,00000000100,a08,lseek
0,47891038700,47891039100,00000000400,a09,mmap
0,47891039200,47891039300,00000000100,a08,lseek
0,47891044400,47891044900,00000000500,a09,mmap
0,47891044900,47891045000,00000000100,a08,lseek
0,47891054500,47891055000,00000000500,a09,mmap
0,47891055000,47891055100,00000000100,a08,lseek
0,47891069100,47891069500,00000000400,a09,mmap
0,47891069500,47891069600,00000000100,a08,lseek
0,47891083100,47891083600,00000000500,a09,mmap
0,47891083600,47891083700,00000000100,a08,lseek
0,47891101200,47891101300,00000000100,a08,lseek
0,47891104100,47891104600,00000000500,a09,mmap
0,47891104700,47891104700,00000000000,a08,lseek
0,47891109900,47891110400,00000000500,a09,mmap
0,47891110500,47891110600,00000000100,a08,lseek
0,47891119900,47891120400,00000000500,a09,mmap
0,47891120400,47891120400,00000000000,a08,lseek
0,47891134600,47891135000,00000000400,a09,mmap
0,47891135000,47891135100,00000000100,a08,lseek
0,47891148900,47891149200,00000000300,a09,mmap
0,47891149300,47891149400,00000000100,a08,lseek
0,47891167200,47891167300,00000000100,a08,lseek
0,47891169600,47891170000,00000000400,a09,mmap
0,47891170100,47891170200,00000000100,a08,lseek
0,47891175100,47891175500,00000000400,a09,mmap
0,47891175500,47891175600,00000000100,a08,lseek
0,47891185000,47891185500,00000000500,a09,mmap
0,47891185500,47891185600,00000000100,a08,lseek
0,47891199800,47891200200,00000000400,a09,mmap
0,47891200200,47891200200,00000000000,a08,lseek
0,47891213700,47891214200,00000000500,a09,mmap
0,47891214200,47891214300,00000000100,a08,lseek
0,47891231900,47891232000,00000000100,a08,lseek
0,47891234200,47891234600,00000000400,a09,mmap
0,47891234700,47891234800,00000000100,a08,lseek
0,47891239700,47891240100,00000000400,a09,mmap
0,47891240100,47891240200,00000000100,a08,lseek
0,47891249600,47891250000,00000000400,a09,mmap
0,47891250000,47891250100,00000000100,a08,lseek
0,47891264300,47891264800,00000000500,a09,mmap
0,47891264800,47891264800,00000000000,a08,lseek
0,47891278600,47891279100,00000000500,a09,mmap
0,47891279100,47891279200,00000000100,a08,lseek
0,47891297200,47891297300,00000000100,a08,lseek
0,47891299700,47891300300,00000000600,a09,mmap
0,47891300300,47891300400,00000000100,a08,lseek
0,47891305500,47891306000,00000000500,a09,mmap
0,47891306000,47891306100,00000000100,a08,lseek
0,47891315700,47891316100,00000000400,a09,mmap
0,47891316100,47891316200,00000000100,a08,lseek
0,47891330400,47891330800,00000000400,a09,mmap
0,47891330900,47891331000,00000000100,a08,lseek
0,47891344600,47891345000,00000000400,a09,mmap
0,47891345000,47891345100,00000000100,a08,lseek
0,47891363400,47891363500,00000000100,a08,lseek
0,47891372000,47891373900,00000001900,a15,access
0,47891382200,47891389400,00000007200,a00,read
0,47891393800,47891394600,00000000800,a09,mmap
0,47891394700,47891394800,00000000100,a08,lseek
0,47891410400,47891410900,00000000500,a00,read
0,47891413300,47891413600,00000000300,a00,read
0,47891416200,47891416700,00000000500,a09,mmap
0,47891416800,47891416800,00000000000,a08,lseek
0,47891431100,47891431500,00000000400,a00,read
0,47891433300,47891433700,00000000400,a00,read
0,47891435900,47891436400,00000000500,a09,mmap
0,47891436500,47891436600,00000000100,a08,lseek
0,47891449600,47891450000,00000000400,a00,read
0,47891452900,47891453400,00000000500,a09,mmap
0,47891453500,47891453500,00000000000,a08,lseek
0,47891466100,47891466400,00000000300,a00,read
0,47891468100,47891468400,00000000300,a00,read
0,47891470800,47891471300,00000000500,a09,mmap
0,47891471400,47891471400,00000000000,a08,lseek
0,47891483500,47891483900,00000000400,a00,read
0,47891486400,47891486900,00000000500,a09,mmap
0,47891487000,47891487100,00000000100,a08,lseek
0,47891498700,47891499000,00000000300,a00,read
0,47891500900,47891501500,00000000600,a00,read
0,47891503100,47891503500,00000000400,a00,read
0,47891505900,47891506200,00000000300,a09,mmap
0,47891506300,47891506400,00000000100,a08,lseek
0,47891517900,47891518400,00000000500,a00,read
0,47891520600,47891521100,00000000500,a09,mmap
0,47891521100,47891521200,00000000100,a08,lseek
0,47891532400,47891532700,00000000300,a00,read
0,47891534600,47891534800,00000000200,a00,read
0,47891537100,47891537600,00000000500,a09,mmap
0,47891537600,47891537700,00000000100,a08,lseek
0,47891548800,47891549100,00000000300,a00,read
0,47891551600,47891551900,00000000300,a09,mmap
0,47891552000,47891552100,00000000100,a08,lseek
0,47891562900,47891563200,00000000300,a00,read
0,47891565000,47891565300,00000000300,a00,read
0,47891567600,47891568100,00000000500,a09,mmap
0,47891568100,47891568200,00000000100,a08,lseek
0,47891579500,47891579900,00000000400,a00,read
0,47891581600,47891581900,00000000300,a00,read
0,47891584100,47891584500,00000000400,a09,mmap
0,47891584600,47891584700,00000000100,a08,lseek
0,47891596700,47891597100,00000000400,a00,read
0,47891599400,47891599900,00000000500,a09,mmap
0,47891600000,47891600100,00000000100,a08,lseek
0,47891610900,47891611600,00000000700,a00,read
0,47891614300,47891614600,00000000300,a09,mmap
0,47891614700,47891614800,00000000100,a08,lseek
0,47891627900,47891628400,00000000500,a00,read
0,47891630800,47891631300,00000000500,a09,mmap
0,47891631300,47891631400,00000000100,a08,lseek
0,47891644800,47891645100,00000000300,a00,read
0,47891646800,47891647200,00000000400,a00,read
0,47891648900,47891649200,00000000300,a00,read
0,47891650900,47891651200,00000000300,a00,read
0,47891653600,47891654100,00000000500,a09,mmap
0,47891654100,47891654200,00000000100,a08,lseek
0,47891665100,47891665500,00000000400,a00,read
0,47891667200,47891667500,00000000300,a00,read
0,47891669600,47891670100,00000000500,a09,mmap
0,47891670200,47891670300,00000000100,a08,lseek
0,47891680800,47891681100,00000000300,a00,read
0,47891682800,47891683100,00000000300,a00,read
0,47891685400,47891685900,00000000500,a09,mmap
0,47891685900,47891686000,00000000100,a08,lseek
0,47891696100,47891696400,00000000300,a00,read
0,47891698100,47891698600,00000000500,a00,read
0,47891700800,47891701100,00000000300,a00,read
0,47891702800,47891703100,00000000300,a00,read
0,47891704800,47891705000,00000000200,a00,read
0,47891706700,47891707000,00000000300,a00,read
0,47891709500,47891710000,00000000500,a09,mmap
0,47891710100,47891710200,00000000100,a08,lseek
0,47891721300,47891721700,00000000400,a00,read
0,47891723400,47891723600,00000000200,a00,read
0,47891726000,47891726500,00000000500,a09,mmap
0,47891726500,47891726500,00000000000,a08,lseek
0,47891742200,47891742600,00000000400,a00,read
0,47891744300,47891744600,00000000300,a00,read
0,47891746900,47891747400,00000000500,a09,mmap
0,47891747400,47891747500,00000000100,a08,lseek
0,47891761600,47891761900,00000000300,a00,read
0,47891763600,47891764200,00000000600,a00,read
0,47891765800,47891766200,00000000400,a00,read
0,47891768900,47891769400,00000000500,a09,mmap
0,47891769400,47891769500,00000000100,a08,lseek
0,47891780600,47891781100,00000000500,a00,read
0,47891783400,47891783800,00000000400,a09,mmap
0,47891783800,47891783900,00000000100,a08,lseek
0,47891795000,47891795400,00000000400,a00,read
0,47891797100,47891797400,00000000300,a00,read
0,47891799700,47891800200,00000000500,a09,mmap
0,47891800300,47891800400,00000000100,a08,lseek
0,47891811200,47891811600,00000000400,a00,read
0,47891813300,47891813600,00000000300,a00,read
0,47891815300,47891815500,00000000200,a00,read
0,47891817900,47891818400,00000000500,a09,mmap
0,47891818400,47891818500,00000000100,a08,lseek
0,47891829500,47891829800,00000000300,a00,read
0,47891832200,47891832700,00000000500,a09,mmap
0,47891832700,47891832800,00000000100,a08,lseek
0,47891843800,47891844200,00000000400,a00,read
0,47891846500,47891847000,00000000500,a09,mmap
0,47891847000,47891847100,00000000100,a08,lseek
0,47891858000,47891858300,00000000300,a00,read
0,47891860800,47891861200,00000000400,a09,mmap
0,47891861300,47891861400,00000000100,a08,lseek
0,47891870800,47891871400,00000000600,a00,read
0,47891874000,47891874500,00000000500,a09,mmap
0,47891874600,47891874700,00000000100,a08,lseek
0,47891884000,47891884400,00000000400,a00,read
0,47891886700,47891887200,00000000500,a09,mmap
0,47891887200,47891887300,00000000100,a08,lseek
0,47891897500,47891898000,00000000500,a00,read
0,47891899800,47891900000,00000000200,a00,read
0,47891902300,47891902800,00000000500,a09,mmap
0,47891902800,47891902900,00000000100,a08,lseek
0,47891913100,47891913500,00000000400,a00,read
0,47891915700,47891916100,00000000400,a09,mmap
0,47891916200,47891916300,00000000100,a08,lseek
0,47891926400,47891926800,00000000400,a00,read
0,47891929200,47891929700,00000000500,a09,mmap
0,47891929700,47891929800,00000000100,a08,lseek
0,47266648500,47892037400,00625388900,a07,poll
0,47892040800,47892042700,00000001900,aca,futex
0,47892046300,47892047200,00000000900,aca,futex
0,47892049200,47892050100,00000000900,aca,futex
0,47892056400,47892062700,00000006300,a2e,sendmsg
0,47266712300,47892065500,00625353200,ae8,epoll_wait
0,47892078400,47892081200,00000002800,a2f,recvmsg
0,47892094900,47892095100,00000000200,a2f,recvmsg
0,47892352200,47892357400,00000005200,a2e,sendmsg
0,47892360000,47892362800,00000002800,a2e,sendmsg
0,47892363900,47892368700,00000004800,a2e,sendmsg
0,47892370000,47892372800,00000002800,a2e,sendmsg
0,47892374300,47892377200,00000002900,a2e,sendmsg
0,47892378200,47892380800,00000002600,a2e,sendmsg
0,47892382000,47892384500,00000002500,a2e,sendmsg
0,47892394600,47892395300,00000000700,a00,read
0,47892410500,47892412000,00000001500,a2f,recvmsg
0,47892508100,47892508700,00000000600,a00,read
0,47892523700,47892524800,00000001100,a2f,recvmsg
0,47892539300,47892582200,00000042900,a07,poll
0,47892584200,47892585400,00000001200,aca,futex
0,47892603100,47892604200,00000001100,aca,futex
0,47892692200,47892694600,00000002400,a2e,sendmsg
0,47892696600,47892696700,00000000100,a00,read
0,47892701200,47892705300,00000004100,a07,poll
0,47892707400,47892707900,00000000500,a00,read
0,47892722100,47892723500,00000001400,a2f,recvmsg
0,47892790500,47892793300,00000002800,a07,poll
0,47892841900,47892855800,00000013900,a38,clone
0,47892387700,47892869800,00000482100,ae8,epoll_wait
0,47892876800,47892878600,00000001800,a2f,recvmsg
0,47892889500,47892889800,00000000300,a2f,recvmsg
0,47892891700,47892892400,00000000700,a2f,recvmsg
0,47892897500,47892897700,00000000200,a2f,recvmsg
0,47892939400,47892941500,00000002100,a2e,sendmsg
0,47892969000,47892969600,00000000600,a2e,sendmsg
0,47892974300,47892975300,00000001000,a2f,recvmsg
0,47892980600,47892980800,00000000200,a2f,recvmsg
0,47893010200,47893010900,00000000700,a2e,sendmsg
0,47893013600,47893031100,00000017500,ae8,epoll_wait
0,47893033500,47893034600,00000001100,a2f,recvmsg
0,47893040400,47893040600,00000000200,a2f,recvmsg
0,47893066700,47893067700,00000001000,a2e,sendmsg
0,47893072900,47893073700,00000000800,a00,read
0,47893083300,47893084300,00000001000,a2f,recvmsg
0,47893070700,47893125000,00000054300,ae8,epoll_wait
0,47893128500,47893129800,00000001300,a2f,recvmsg
0,47893136700,47893136900,00000000200,a2f,recvmsg
0,47893165700,47893166800,00000001100,a2e,sendmsg
0,47893206500,47893207300,00000000800,a2f,recvmsg
0,47893209500,47893209700,00000000200,a00,read
0,47893170200,47893233000,00000062800,ae8,epoll_wait
0,47893236100,47893237100,00000001000,a2f,recvmsg
0,47893244600,47893244800,00000000200,a2f,recvmsg
0,47893295900,47893299800,00000003900,a2e,sendmsg
0,47893325900,47893326600,00000000700,a2f,recvmsg
0,47893360500,47893361000,00000000500,a2f,recvmsg
0,47893390000,47893390500,00000000500,a2f,recvmsg
0,47893302600,47893401000,00000098400,ae8,epoll_wait
0,47893404000,47893405000,00000001000,a2f,recvmsg
0,47893412100,47893412300,00000000200,a2f,recvmsg
0,47893449300,47893452300,00000003000,a2e,sendmsg
0,47893454900,47893545300,00000090400,ae8,epoll_wait
0,47893548600,47893550400,00000001800,a2f,recvmsg
0,47893557500,47893557700,00000000200,a2f,recvmsg
0,47893588200,47893591100,00000002900,a2e,sendmsg
0,47893493100,47893597100,00000104000,a07,poll
0,47893597600,47893598000,00000000400,a00,read
0,47893604700,47893605400,00000000700,a2f,recvmsg
0,47893649100,47893678100,00000029000,a07,poll
0,47893679700,47893681300,00000001600,aca,futex
0,47893683200,47893684100,00000000900,aca,futex
0,47893685500,47893686400,00000000900,aca,futex
0,47893689200,47893691300,00000002100,a2e,sendmsg
0,47893595100,47893692500,00000097400,ae8,epoll_wait
0,47893695800,47893696800,00000001000,a2f,recvmsg
0,47893703500,47893703700,00000000200,a2f,recvmsg
0,47893923100,47893926400,00000003300,a2e,sendmsg
0,47893928000,47893929600,00000001600,a2e,sendmsg
0,47893930600,47893931800,00000001200,a2e,sendmsg
0,47893932600,47893934200,00000001600,a2e,sendmsg
0,47893935100,47893936700,00000001600,a2e,sendmsg
0,47893937700,47893939600,00000001900,a2e,sendmsg
0,47893940700,47893942200,00000001500,a2e,sendmsg
0,47893649100,47893947800,00000298700,a07,poll
0,47893960100,47893960900,00000000800,a2f,recvmsg
0,47893972200,47894016200,00000044000,a07,poll
0,47894018000,47894019300,00000001300,aca,futex
0,47894029600,47894030600,00000001000,aca,futex
0,47894100800,47894102500,00000001700,a2e,sendmsg
0,47894104600,47894104800,00000000200,a00,read
0,47893944600,47894111000,00000166400,ae8,epoll_wait
0,47894114700,47894116200,00000001500,a2f,recvmsg
0,47894124300,47894124500,00000000200,a2f,recvmsg
0,47894125700,47894126200,00000000500,a2f,recvmsg
0,47894130500,47894130700,00000000200,a2f,recvmsg
0,47894162000,47894163100,00000001100,a2e,sendmsg
0,47894188100,47894188600,00000000500,a2e,sendmsg
0,47894201000,47894201400,00000000400,a00,read
0,47894207600,47894208300,00000000700,a2f,recvmsg
0,47894258800,47894259400,00000000600,a2f,recvmsg
0,47894261400,47894261500,00000000100,a00,read
0,47894191800,47894373400,00000181600,ae8,epoll_wait
0,47894377200,47894378800,00000001600,a2f,recvmsg
0,47894386600,47894386800,00000000200,a2f,recvmsg
0,47894293000,47894650500,00000357500,a07,poll
0,47894652900,47894654400,00000001500,aca,futex
0,47894656700,47894657700,00000001000,aca,futex
0,47894659400,47894660100,00000000700,aca,futex
0,47894663800,47894666200,00000002400,a2e,sendmsg
0,47894440200,47894668400,00000228200,ae8,epoll_wait
0,47894672600,47894673700,00000001100,a2f,recvmsg
0,47894680600,47894680900,00000000300,a2f,recvmsg
0,47894904400,47894907500,00000003100,a2e,sendmsg
0,47894909200,47894911000,00000001800,a2e,sendmsg
0,47894912000,47894913300,00000001300,a2e,sendmsg
0,47894914300,47894915700,00000001400,a2e,sendmsg
0,47894916700,47894918500,00000001800,a2e,sendmsg
0,47894919500,47894921200,00000001700,a2e,sendmsg
0,47894922300,47894923700,00000001400,a2e,sendmsg
0,47894927400,47894928300,00000000900,a2f,recvmsg
0,47894933900,47894934100,00000000200,a2f,recvmsg
0,47894293000,47894975900,00000682900,a07,poll
0,47894989000,47894990000,00000001000,a2f,recvmsg
0,47895002900,47895044000,00000041100,a07,poll
0,47895045800,47895047000,00000001200,aca,futex
0,47895059800,47895060800,00000001000,aca,futex
0,47895131300,47895133200,00000001900,a2e,sendmsg
0,47895135100,47895135200,00000000100,a00,read
0,47894972700,47895142000,00000169300,ae8,epoll_wait
0,47895146000,47895147400,00000001400,a2f,recvmsg
0,47895155500,47895155700,00000000200,a2f,recvmsg
0,47895156800,47895157300,00000000500,a2f,recvmsg
0,47895161700,47895161800,00000000100,a2f,recvmsg
0,47895194100,47895195400,00000001300,a2e,sendmsg
0,47895220600,47895221400,00000000800,a2e,sendmsg
0,47895235000,47895235500,00000000500,a00,read
0,47895242200,47895243100,00000000900,a2f,recvmsg
0,47895296000,47895296600,00000000600,a2f,recvmsg
0,47895298600,47895298700,00000000100,a00,read
0,47895225000,47895364000,00000139000,ae8,epoll_wait
0,47895367500,47895368900,00000001400,a2f,recvmsg
0,47895376400,47895376500,00000000100,a2f,recvmsg
0,47895406700,47895409500,00000002800,a2e,sendmsg
0,47895329700,47895415500,00000085800,a07,poll
0,47895416000,47895416300,00000000300,a00,read
0,47895423000,47895423600,00000000600,a2f,recvmsg
0,47895413400,47895433700,00000020300,ae8,epoll_wait
0,47895436100,47895437100,00000001000,a2f,recvmsg
0,47895443900,47895444100,00000000200,a2f,recvmsg
0,47895541500,47895574200,00000032700,a07,poll
0,47895575800,47895576900,00000001100,aca,futex
0,47895579000,47895579900,00000000900,aca,futex
0,47895581500,47895582200,00000000700,aca,futex
0,47895584900,47895587200,00000002300,a2e,sendmsg
0,47895495700,47895588300,00000092600,ae8,epoll_wait
0,47895591700,47895592700,00000001000,a2f,recvmsg
0,47895599200,47895599400,00000000200,a2f,recvmsg
0,47895814200,47895817200,00000003000,a2e,sendmsg
0,47895819000,47895820700,00000001700,a2e,sendmsg
0,47895821800,47895822900,00000001100,a2e,sendmsg
0,47895823800,47895824900,00000001100,a2e,sendmsg
0,47895826100,47895827500,00000001400,a2e,sendmsg
0,47895828500,47895829700,00000001200,a2e,sendmsg
0,47895830700,47895832000,00000001300,a2e,sendmsg
0,47895835800,47895836700,00000000900,a2f,recvmsg
0,47895842300,47895842400,00000000100,a2f,recvmsg
0,47895541500,47895883600,00000342100,a07,poll
0,47895895100,47895896000,00000000900,a2f,recvmsg
0,47895906200,47895943800,00000037600,a07,poll
0,47895945600,47895946700,00000001100,aca,futex
0,47895957500,47895958600,00000001100,aca,futex
0,47896026500,47896028300,00000001800,a2e,sendmsg
0,47896030300,47896030500,00000000200,a00,read
0,47895880400,47896036900,00000156500,ae8,epoll_wait
0,47896040600,47896042100,00000001500,a2f,recvmsg
0,47896049500,47896049700,00000000200,a2f,recvmsg
0,47896050700,47896051200,00000000500,a2f,recvmsg
0,47896055700,47896055800,00000000100,a2f,recvmsg
0,47896088600,47896089700,00000001100,a2e,sendmsg
0,47896115000,47896115700,00000000700,a2e,sendmsg
0,47896128900,47896129300,00000000400,a00,read
0,47896136000,47896136700,00000000700,a2f,recvmsg
0,47896188700,47896189400,00000000700,a2f,recvmsg
0,47896191400,47896191500,00000000100,a00,read
0,47896222300,47896282700,00000060400,a07,poll
0,47896284400,47896285700,00000001300,aca,futex
0,47896287500,47896288400,00000000900,aca,futex
0,47896289800,47896290600,00000000800,aca,futex
0,47896293400,47896295800,00000002400,a2e,sendmsg
0,47896119100,47896297300,00000178200,ae8,epoll_wait
0,47896301100,47896302100,00000001000,a2f,recvmsg
0,47896309300,47896309500,00000000200,a2f,recvmsg
0,47896523000,47896525200,00000002200,a2e,sendmsg
0,47896527100,47896528400,00000001300,a2e,sendmsg
0,47896529500,47896530200,00000000700,a2e,sendmsg
0,47896531300,47896532500,00000001200,a2e,sendmsg
0,47896533500,47896535000,00000001500,a2e,sendmsg
0,47896535900,47896537200,00000001300,a2e,sendmsg
0,47896538200,47896539400,00000001200,a2e,sendmsg
0,47896543700,47896545000,00000001300,a2f,recvmsg
0,47896555400,47896555600,00000000200,a2f,recvmsg
0,47896582000,47896582900,00000000900,a2e,sendmsg
0,47896222300,47896634400,00000412100,a07,poll
0,47896645600,47896646700,00000001100,a2f,recvmsg
0,47896656700,47896693900,00000037200,a07,poll
0,47896695700,47896696800,00000001100,aca,futex
0,47896707200,47896708200,00000001000,aca,futex
0,47896775900,47896777600,00000001700,a2e,sendmsg
0,47896779500,47896779600,00000000100,a00,read
0,47896810700,47896811900,00000001200,a2f,recvmsg
0,47896818600,47896818800,00000000200,a2f,recvmsg
0,47896819900,47896820400,00000000500,a2f,recvmsg
0,47896824900,47896825100,00000000200,a2f,recvmsg
0,47896893700,47896894600,00000000900,a2e,sendmsg
0,47896908800,47896909300,00000000500,a00,read
0,47896916300,47896917300,00000001000,a2f,recvmsg
0,47896970100,47896970800,00000000700,a2f,recvmsg
0,47896972800,47896973000,00000000200,a00,read
0,47897004400,47897073200,00000068800,a07,poll
0,47897075100,47897076200,00000001100,aca,futex
0,47897078100,47897079000,00000000900,aca,futex
0,47897080700,47897081600,00000000900,aca,futex
0,47897084400,47897087000,00000002600,a2e,sendmsg
0,47896897900,47897088600,00000190700,ae8,epoll_wait
0,47897092600,47897093800,00000001200,a2f,recvmsg
0,47897101100,47897101400,00000000300,a2f,recvmsg
0,47897320400,47897322900,00000002500,a2e,sendmsg
0,47897325000,47897326200,00000001200,a2e,sendmsg
0,47897327300,47897327800,00000000500,a2e,sendmsg
0,47897328700,47897329800,00000001100,a2e,sendmsg
0,47897330900,47897332900,00000002000,a2e,sendmsg
0,47897334000,47897335900,00000001900,a2e,sendmsg
0,47897337000,47897338400,00000001400,a2e,sendmsg
0,47897342700,47897343500,00000000800,a2f,recvmsg
0,47897349200,47897349400,00000000200,a2f,recvmsg
0,47897350100,47897350600,00000000500,a2f,recvmsg
0,47897355100,47897355300,00000000200,a2f,recvmsg
0,47897381800,47897382800,00000001000,a2e,sendmsg
0,47897421700,47897422500,00000000800,a2f,recvmsg
0,47897427500,47897427700,00000000200,a2f,recvmsg
0,47897004400,47897462900,00000458500,a07,poll
0,47897474500,47897475700,00000001200,a2f,recvmsg
0,47897486700,47897524800,00000038100,a07,poll
0,47897526900,47897528000,00000001100,aca,futex
0,47897539400,47897540400,00000001000,aca,futex
0,47897607300,47897609000,00000001700,a2e,sendmsg
0,47897610900,47897611000,00000000100,a00,read
0,47897459400,47897617400,00000158000,ae8,epoll_wait
0,47897621000,47897622100,00000001100,a2f,recvmsg
0,47897629500,47897629700,00000000200,a2f,recvmsg
0,47897630800,47897631400,00000000600,a2f,recvmsg
0,47897635600,47897635800,00000000200,a2f,recvmsg
0,47897665900,47897667000,00000001100,a2e,sendmsg
0,47897691500,47897692100,00000000600,a2e,sendmsg
0,47897695300,47897696000,00000000700,a2f,recvmsg
0,47897700600,47897701200,00000000600,a2f,recvmsg
0,47897705600,47897705800,00000000200,a2f,recvmsg
0,47897728700,47897729400,00000000700,a2e,sendmsg
0,47897786800,47897787200,00000000400,a00,read
0,47897794300,47897795100,00000000800,a2f,recvmsg
0,47897847900,47897848600,00000000700,a2f,recvmsg
0,47897850700,47897850800,00000000100,a00,read
0,47897878700,47897879200,00000000500,a2f,recvmsg
0,47897908600,47897909100,00000000500,a2f,recvmsg
0,47897938500,47897996000,00000057500,a07,poll
0,47897997800,47897999000,00000001200,aca,futex
0,47898001100,47898002000,00000000900,aca,futex
0,47898003400,47898004200,00000000800,aca,futex
0,47898007000,47898009400,00000002400,a2e,sendmsg
0,47897775900,47898011200,00000235300,ae8,epoll_wait
0,47898015000,47898016100,00000001100,a2f,recvmsg
0,47898023000,47898023200,00000000200,a2f,recvmsg
0,47898243500,47898246000,00000002500,a2e,sendmsg
0,47898248000,47898249300,00000001300,a2e,sendmsg
0,47898250300,47898251000,00000000700,a2e,sendmsg
0,47898251800,47898253200,00000001400,a2e,sendmsg
0,47897938500,47898255300,00000316800,a07,poll
0,47898266500,47898267400,00000000900,a2f,recvmsg
0,47898278500,47898310900,00000032400,a07,poll
0,47898312800,47898313800,00000001000,aca,futex
0,47898329000,47898330100,00000001100,aca,futex
0,47898398000,47898399500,00000001500,a2e,sendmsg
0,47898401600,47898401700,00000000100,a00,read
0,47898411800,47898414200,00000002400,a2e,sendmsg
0,47898415300,47898416500,00000001200,a2e,sendmsg
0,47898417600,47898419100,00000001500,a2e,sendmsg
0,47898425000,47898426400,00000001400,a2f,recvmsg
0,47898434200,47898434500,00000000300,a2f,recvmsg
0,47898435400,47898436000,00000000600,a2f,recvmsg
0,47898440700,47898441200,00000000500,a2f,recvmsg
0,47898445600,47898445800,00000000200,a2f,recvmsg
0,47898446500,47898447000,00000000500,a2f,recvmsg
0,47898451200,47898451400,00000000200,a2f,recvmsg
0,47898482700,47898483500,00000000800,a2e,sendmsg
0,47898586600,47898587300,00000000700,a2e,sendmsg
0,47898602900,47898603400,00000000500,a00,read
0,47898610600,47898611500,00000000900,a2f,recvmsg
0,47898667500,47898668200,00000000700,a2f,recvmsg
0,47898670500,47898670600,00000000100,a00,read
0,47898700900,47898758400,00000057500,a07,poll
0,47898760100,47898761300,00000001200,aca,futex
0,47898763400,47898764200,00000000800,aca,futex
0,47898765700,47898766600,00000000900,aca,futex
0,47898769500,47898771900,00000002400,a2e,sendmsg
0,47898590900,47898773500,00000182600,ae8,epoll_wait
0,47898777400,47898778500,00000001100,a2f,recvmsg
0,47898785700,47898786000,00000000300,a2f,recvmsg
0,47899000900,47899003200,00000002300,a2e,sendmsg
0,47899004900,47899006500,00000001600,a2e,sendmsg
0,47899007500,47899008100,00000000600,a2e,sendmsg
0,47899009000,47899010200,00000001200,a2e,sendmsg
0,47898700900,47899012200,00000311300,a07,poll
0,47899023200,47899024100,00000000900,a2f,recvmsg
0,47899033900,47899074200,00000040300,a07,poll
0,47899076000,47899077200,00000001200,aca,futex
0,47899084600,47899085400,00000000800,aca,futex
0,47899153700,47899155400,00000001700,a2e,sendmsg
0,47899157300,47899157400,00000000100,a00,read
0,47899181100,47899183900,00000002800,a2e,sendmsg
0,47899184900,47899186300,00000001400,a2e,sendmsg
0,47899187400,47899188500,00000001100,a2e,sendmsg
0,47899194300,47899195700,00000001400,a2f,recvmsg
0,47899203200,47899203500,00000000300,a2f,recvmsg
0,47899204400,47899205500,00000001100,a2f,recvmsg
0,47899214400,47899214500,00000000100,a2f,recvmsg
0,47899215500,47899215900,00000000400,a2f,recvmsg
0,47899220100,47899220200,00000000100,a2f,recvmsg
0,47899252100,47899252900,00000000800,a2e,sendmsg
0,47899277500,47899278000,00000000500,a2e,sendmsg
0,47899340200,47899341000,00000000800,a2e,sendmsg
0,47899344800,47899345600,00000000800,a2f,recvmsg
0,47899351000,47899351200,00000000200,a2f,recvmsg
0,47899405400,47899406100,00000000700,a00,read
0,47899413400,47899414200,00000000800,a2f,recvmsg
0,47899469000,47899469600,00000000600,a2f,recvmsg
0,47899471700,47899471900,00000000200,a00,read
0,47899498900,47899499400,00000000500,a2f,recvmsg
0,47899530700,47899594000,00000063300,a07,poll
0,47899595800,47899597000,00000001200,aca,futex
0,47899598900,47899599900,00000001000,aca,futex
0,47899601200,47899602000,00000000800,aca,futex
0,47899605200,47899607800,00000002600,a2e,sendmsg
0,47899610200,47899610500,00000000300,a00,read
0,47899613000,47899656100,00000043100,a07,poll
0,47899657100,47899658200,00000001100,aca,futex
0,47899659600,47899660400,00000000800,aca,futex
0,47899661600,47899662400,00000000800,aca,futex
0,47899664100,47899665300,00000001200,a2e,sendmsg
0,47899700100,47899708700,00000008600,a4e,getdents
0,47899722400,47899728700,00000006300,a09,mmap
0,47899728900,47899729000,00000000100,a08,lseek
0,47899758500,47899759400,00000000900,a09,mmap
0,47899759500,47899759600,00000000100,a08,lseek
0,47899773900,47899774400,00000000500,a09,mmap
0,47899774400,47899774500,00000000100,a08,lseek
0,47899792200,47899793900,00000001700,a02,open
0,47899797300,47899798200,00000000900,a02,open
0,47899800100,47899801000,00000000900,a02,open
0,47899802700,47899803500,00000000800,a02,open
0,47899805300,47899806100,00000000800,a02,open
0,47899807800,47899809000,00000001200,a02,open
0,47899810900,47899811800,00000000900,a02,open
0,47899813400,47899814300,00000000900,a02,open
0,47899815800,47899816700,00000000900,a02,open
0,47899818200,47899819300,00000001100,a02,open
0,47899820900,47899822100,00000001200,a02,open
0,47899823600,47899827400,00000003800,a02,open
0,47899828900,47899830000,00000001100,a02,open
0,47899831600,47899832600,00000001000,a02,open
0,47899834200,47899835200,00000001000,a02,open
0,47899836700,47899837600,00000000900,a02,open
0,47899839100,47899840100,00000001000,a02,open
0,47899841700,47899842500,00000000800,a02,open
0,47899843900,47899844800,00000000900,a02,open
0,47899846300,47899847300,00000001000,a02,open
0,47899848700,47899849500,00000000800,a02,open
0,47899851000,47899851900,00000000900,a02,open
0,47899853300,47899854200,00000000900,a02,open
0,47899855600,47899856600,00000001000,a02,open
0,47899858100,47899858900,00000000800,a02,open
0,47899860400,47899861100,00000000700,a02,open
0,47899862500,47899863400,00000000900,a02,open
0,47899864800,47899866100,00000001300,a02,open
0,47899867400,47899868300,00000000900,a02,open
0,47899869700,47899870600,00000000900,a02,open
0,47899872100,47899872900,00000000800,a02,open
0,47899876800,47899878100,00000001300,a00,read
0,47899928600,47899930200,00000001600,a02,open
0,47899931700,47899932600,00000000900,a02,open
0,47899936400,47899937100,00000000700,a00,read
0,47899968100,47899969200,00000001100,a02,open
0,47899970800,47899971700,00000000900,a02,open
0,47899973200,47899974100,00000000900,a02,open
0,47899975500,47899976300,00000000800,a02,open
0,47899977800,47899978500,00000000700,a02,open
0,47899980100,47899980900,00000000800,a02,open
0,47899982200,47899983100,00000000900,a02,open
0,47899984400,47899985300,00000000900,a02,open
0,47899986800,47899988500,00000001700,a02,open
0,47899990000,47899991000,00000001000,a02,open
0,47899393100,47900177700,00000784600,ae8,epoll_wait
0,47900184000,47900186600,00000002600,a2f,recvmsg
0,47900199900,47900200200,00000000300,a2f,recvmsg
0,47900201800,47900202800,00000001000,a2f,recvmsg
0,47900207600,47900207800,00000000200,a2f,recvmsg
0,47900208900,47900210000,00000001100,a2f,recvmsg
0,47900218600,47900218800,00000000200,a2f,recvmsg
0,47900450800,47900454900,00000004100,a2e,sendmsg
0,47900457000,47900458900,00000001900,a2e,sendmsg
0,47900460100,47900461300,00000001200,a2e,sendmsg
0,47900462200,47900464300,00000002100,a2e,sendmsg
0,47900047800,47900466900,00000419100,a07,poll
0,47900480100,47900481300,00000001200,a2f,recvmsg
0,47900493800,47900540200,00000046400,a07,poll
0,47900542700,47900544000,00000001300,aca,futex
0,47900553700,47900554600,00000000900,aca,futex
0,47900616700,47900628200,00000011500,a07,poll
0,47900638500,47900640200,00000001700,a2e,sendmsg
0,47900642200,47900642400,00000000200,a00,read
0,47900655100,47900658200,00000003100,a2e,sendmsg
0,47900659300,47900661200,00000001900,a2e,sendmsg
0,47900662500,47900664800,00000002300,a2e,sendmsg
0,47900869600,47900871400,00000001800,a2e,sendmsg
0,47900872500,47900873900,00000001400,a2e,sendmsg
0,47900874900,47900875600,00000000700,a2e,sendmsg
0,47900876400,47900877700,00000001300,a2e,sendmsg
0,47900646400,47900879900,00000233500,a07,poll
0,47900887100,47900888000,00000000900,a2f,recvmsg
0,47900896200,47900931000,00000034800,a07,poll
0,47900933000,47900934000,00000001000,aca,futex
0,47900940900,47900941700,00000000800,aca,futex
0,47901002400,47901004000,00000001600,a2e,sendmsg
0,47901005700,47901005900,00000000200,a00,read
0,47901015900,47901018300,00000002400,a2e,sendmsg
0,47901019300,47901020800,00000001500,a2e,sendmsg
0,47901021800,47901023100,00000001300,a2e,sendmsg
0,47901060100,47901061500,00000001400,a2e,sendmsg
0,47901086700,47901087400,00000000700,a2e,sendmsg
0,47901132700,47901134800,00000002100,a2f,recvmsg
0,47901146600,47901146700,00000000100,a2f,recvmsg
0,47901147800,47901148600,00000000800,a2f,recvmsg
0,47901156300,47901156500,00000000200,a2f,recvmsg
0,47901181400,47901182300,00000000900,a2e,sendmsg
0,47901205600,47901206200,00000000600,a2e,sendmsg
0,47901229100,47901229800,00000000700,a2e,sendmsg
0,47901252000,47901252800,00000000800,a2e,sendmsg
0,47901255800,47904627200,00003371400,ae8,epoll_wait
0,47904630200,47904631300,00000001100,a2f,recvmsg
0,47904636900,47904637000,00000000100,a2f,recvmsg
0,47904637800,47904639300,00000001500,a2f,recvmsg
0,47904651900,47904652100,00000000200,a2f,recvmsg
0,47904678900,47904679900,00000001000,a2e,sendmsg
0,47904722400,47904725200,00000002800,a2e,sendmsg
0,47904781000,47904782300,00000001300,a2e,sendmsg
0,47901010000,47904789100,00003779100,a07,poll
0,47904793500,47904795500,00000002000,aca,futex
0,47904809100,47904810300,00000001200,a2f,recvmsg
0,47904824600,47904826000,00000001400,aca,futex
0,47904828000,47904828900,00000000900,aca,futex
0,47904832100,47904833900,00000001800,a2e,sendmsg
0,47904886100,47904886300,00000000200,a00,read
0,47904887800,47904888500,00000000700,a2f,recvmsg
0,47904918100,47904918600,00000000500,a2f,recvmsg
0,47904949200,47904949800,00000000600,a2f,recvmsg
0,47904976400,47904977000,00000000600,a2f,recvmsg
0,47905002800,47905003400,00000000600,a2f,recvmsg
0,47905032000,47905032500,00000000500,a2f,recvmsg
0,47905058100,47905058700,00000000600,a2f,recvmsg
0,47905091200,47905236000,00000144800,a07,poll
0,47905237600,47905238900,00000001300,aca,futex
0,47905240900,47905241800,00000000900,aca,futex
0,47905243100,47905243900,00000000800,aca,futex
0,47905246100,47905248300,00000002200,a2e,sendmsg
0,47905250700,47905251000,00000000300,a00,read
0,47905253500,47905359300,00000105800,a07,poll
0,47905360600,47905361400,00000000800,aca,futex
0,47905363000,47905363800,00000000800,aca,futex
0,47905365000,47905365900,00000000900,aca,futex
0,47905367700,47905369300,00000001600,a2e,sendmsg
0,47904785800,47905476800,00000691000,ae8,epoll_wait
0,47905480600,47905482800,00000002200,a2f,recvmsg
0,47905495700,47905495800,00000000100,a2f,recvmsg
0,47905497200,47905498300,00000001100,a2f,recvmsg
0,47905528100,47905528500,00000000400,a2f,recvmsg
0,47905583200,47905586800,00000003600,a2e,sendmsg
0,47905641100,47905643000,00000001900,a2e,sendmsg
0,47905662100,47905663700,00000001600,a2e,sendmsg
0,47905373800,47905666200,00000292400,a07,poll
0,47905677700,47905678800,00000001100,a2f,recvmsg
0,47905689400,47905780800,00000091400,a07,poll
0,47905782800,47905784100,00000001300,aca,futex
0,47905897100,47905900400,00000003300,a2e,sendmsg
0,47905905900,47905907500,00000001600,a2f,recvmsg
0,47905919500,47905919700,00000000200,a2f,recvmsg
0,47905949000,47905950100,00000001100,a2e,sendmsg
0,47905974800,47905975800,00000001000,a2e,sendmsg
0,47905864900,47905981500,00000116600,a07,poll
0,47905984300,47905986100,00000001800,aca,futex
0,47905995500,47905996400,00000000900,a2f,recvmsg
0,47906007400,47906008700,00000001300,aca,futex
0,47906010300,47906011200,00000000900,aca,futex
0,47906013400,47906015200,00000001800,a2e,sendmsg
0,47906058200,47906058500,00000000300,a00,read
0,47906059800,47906060500,00000000700,a2f,recvmsg
0,47905979000,47906217300,00000238300,ae8,epoll_wait
0,47906221500,47906223000,00000001500,a2f,recvmsg
0,47906242400,47906242500,00000000100,a2f,recvmsg
0,47906269700,47906272900,00000003200,a2e,sendmsg
0,47906278000,47906279000,00000001000,a2f,recvmsg
0,47906285100,47906285300,00000000200,a2f,recvmsg
0,47906317800,47906318500,00000000700,a2e,sendmsg
0,47906093000,47906324600,00000231600,a07,poll
0,47906326900,47906328500,00000001600,aca,futex
0,47906336300,47906336900,00000000600,a2f,recvmsg
0,47906345400,47906346600,00000001200,aca,futex
0,47906348100,47906348900,00000000800,aca,futex
0,47906351100,47906352800,00000001700,a2e,sendmsg
0,47906322000,47906514100,00000192100,ae8,epoll_wait
0,47906517700,47906519500,00000001800,a2f,recvmsg
0,47906537000,47906537200,00000000200,a2f,recvmsg
0,47906564000,47906567600,00000003600,a2e,sendmsg
0,47906396100,47906573200,00000177100,a07,poll
0,47906575100,47906576400,00000001300,aca,futex
0,47906579000,47906580000,00000001000,aca,futex
0,47906581700,47906582500,00000000800,aca,futex
0,47906586300,47906587800,00000001500,a2e,sendmsg
0,47906570700,47906589000,00000018300,ae8,epoll_wait
0,47906591200,47906592100,00000000900,a2f,recvmsg
0,47906607000,47906607200,00000000200,a2f,recvmsg
0,47906627800,47906629900,00000002100,a2e,sendmsg
0,47906639100,47906639500,00000000400,a00,read
0,47906643600,47906765400,00000121800,a07,poll
0,47906766900,47906767900,00000001000,aca,futex
0,47906769400,47906770300,00000000900,aca,futex
0,47906771600,47906772400,00000000800,aca,futex
0,47906774800,47906777100,00000002300,a2e,sendmsg
0,47906632200,47906778700,00000146500,ae8,epoll_wait
0,47906782000,47906782900,00000000900,a2f,recvmsg
0,47906808600,47906808800,00000000200,a2f,recvmsg
0,47906833700,47906836900,00000003200,a2e,sendmsg
0,47906851900,47906971100,00000119200,a07,poll
0,47906972500,47906973600,00000001100,aca,futex
0,47906975400,47906976200,00000000800,aca,futex
0,47906977500,47906978300,00000000800,aca,futex
0,47906980800,47906983000,00000002200,a2e,sendmsg
0,47906839700,47906984200,00000144500,ae8,epoll_wait
0,47906987500,47906988800,00000001300,a2f,recvmsg
0,47907006000,47907006200,00000000200,a2f,recvmsg
0,47907030800,47907033500,00000002700,a2e,sendmsg
0,47906851900,47907035900,00000184000,a07,poll
0,47907037000,47907037800,00000000800,a00,read
0,47907050500,47907051600,00000001100,a2f,recvmsg
0,47907063200,47907156400,00000093200,a07,poll
0,47907158300,47907159300,00000001000,aca,futex
0,47907260600,47907260900,00000000300,a00,read
0,47907265200,47907414600,00000149400,a07,poll
0,47907416000,47907417100,00000001100,aca,futex
0,47907418700,47907419600,00000000900,aca,futex
0,47907420900,47907421700,00000000800,aca,futex
0,47907424600,47907427600,00000003000,a2e,sendmsg
0,47907252200,47907429300,00000177100,ae8,epoll_wait
0,47907432900,47907434100,00000001200,a2f,recvmsg
0,47907457700,47907458000,00000000300,a2f,recvmsg
0,47907484900,47907486300,00000001400,a2e,sendmsg
0,47907501100,47907631100,00000130000,a07,poll
0,47907632600,47907633600,00000001000,aca,futex
0,47907635500,47907636300,00000000800,aca,futex
0,47907637500,47907638300,00000000800,aca,futex
0,47907640800,47907643000,00000002200,a2e,sendmsg
0,47907489100,47907644500,00000155400,ae8,epoll_wait
0,47907647700,47907648700,00000001000,a2f,recvmsg
0,47907671000,47907671200,00000000200,a2f,recvmsg
0,47907694900,47907696700,00000001800,a2e,sendmsg
0,47907501100,47907698200,00000197100,a07,poll
0,47907699200,47907699500,00000000300,a00,read
0,47907707200,47907707900,00000000700,a2f,recvmsg
0,47907716700,47907838100,00000121400,a07,poll
0,47907839800,47907840800,00000001000,aca,futex
0,47907951000,47907951200,00000000200,a00,read
0,47907955600,47908081600,00000126000,a07,poll
0,47908083100,47908084100,00000001000,aca,futex
0,47908085700,47908086600,00000000900,aca,futex
0,47908087900,47908088900,00000001000,aca,futex
0,47908091500,47908093900,00000002400,a2e,sendmsg
0,47907943400,47908095300,00000151900,ae8,epoll_wait
0,47908098800,47908100100,00000001300,a2f,recvmsg
0,47908119100,47908119300,00000000200,a2f,recvmsg
0,47908146100,47908147800,00000001700,a2e,sendmsg
0,47908162000,47908278500,00000116500,a07,poll
0,47908279900,47908281100,00000001200,aca,futex
0,47908282900,47908283600,00000000700,aca,futex
0,47908285000,47908285700,00000000700,aca,futex
0,47908288300,47908290500,00000002200,a2e,sendmsg
0,47908150500,47908291800,00000141300,ae8,epoll_wait
0,47908294800,47908295900,00000001100,a2f,recvmsg
0,47908312500,47908312800,00000000300,a2f,recvmsg
0,47908335700,47908336900,00000001200,a2e,sendmsg
0,47908346600,47908347000,00000000400,a00,read
0,36016086100,47908405500,11892319400,a17,select
0,47908434100,47908434500,00000000400,a2f,recvmsg
0,47908582300,47908611300,00000029000,a10,ioctl
0,47908613300,47908849300,00000236000,a10,ioctl
0,47908851200,47908989000,00000137800,a10,ioctl
0,47908990200,47909132900,00000142700,a10,ioctl
0,47908339600,47909247300,00000907700,ae8,epoll_wait
0,47909254700,47909257200,00000002500,a2f,recvmsg
0,47909268000,47909268300,00000000300,a2f,recvmsg
0,47909322800,47909326700,00000003900,a2e,sendmsg
0,47908350700,47909337300,00000986600,a07,poll
0,47909350600,47909351800,00000001200,a2f,recvmsg
0,47909415000,47909475000,00000060000,a07,poll
0,47909476900,47909478300,00000001400,aca,futex
0,47909480600,47909481600,00000001000,aca,futex
0,47909483100,47909483900,00000000800,aca,futex
0,47909486800,47909489900,00000003100,a2e,sendmsg
0,47909333800,47909491600,00000157800,ae8,epoll_wait
0,47909496500,47909497800,00000001300,a2f,recvmsg
0,47909516800,47909517100,00000000300,a2f,recvmsg
0,47909549500,47909552900,00000003400,a2e,sendmsg
0,47909415000,47909556200,00000141200,a07,poll
0,47909557500,47909558300,00000000800,a00,read
0,47909571300,47909572200,00000000900,a2f,recvmsg
0,47909585600,47909676000,00000090400,a07,poll
0,47909677900,47909679100,00000001200,aca,futex
0,47909807100,47909807400,00000000300,a00,read
0,47909812500,47909991200,00000178700,a07,poll
0,47909992900,47909993900,00000001000,aca,futex
0,47909995800,47909996700,00000000900,aca,futex
0,47909998300,47909999000,00000000700,aca,futex
0,47910002700,47910006300,00000003600,a2e,sendmsg
0,47909796800,47910008200,00000211400,ae8,epoll_wait
0,47910013100,47910014500,00000001400,a2f,recvmsg
0,47910039800,47910040100,00000000300,a2f,recvmsg
0,47910076700,47910078600,00000001900,a2e,sendmsg
0,47910095400,47910226600,00000131200,a07,poll
0,47910228100,47910229000,00000000900,aca,futex
0,47910231100,47910232000,00000000900,aca,futex
0,47910233300,47910234100,00000000800,aca,futex
0,47910237100,47910240100,00000003000,a2e,sendmsg
0,47910081600,47910241600,00000160000,ae8,epoll_wait
0,47910245700,47910246800,00000001100,a2f,recvmsg
0,47910264300,47910264500,00000000200,a2f,recvmsg
0,47910293000,47910295500,00000002500,a2e,sendmsg
0,47910095400,47910297900,00000202500,a07,poll
0,47910299000,47910299300,00000000300,a00,read
0,47910309300,47910310200,00000000900,a2f,recvmsg
0,47910320300,47910401600,00000081300,a07,poll
0,47910403600,47910404700,00000001100,aca,futex
0,47910505100,47910505300,00000000200,a00,read
0,47910510000,47910640700,00000130700,a07,poll
0,47910642200,47910643200,00000001000,aca,futex
0,47910644900,47910645800,00000000900,aca,futex
0,47910647500,47910648400,00000000900,aca,futex
0,47910651400,47910654400,00000003000,a2e,sendmsg
0,47910494500,47910656000,00000161500,ae8,epoll_wait
0,47910659900,47910661000,00000001100,a2f,recvmsg
0,47910679500,47910679800,00000000300,a2f,recvmsg
0,47910709800,47910711400,00000001600,a2e,sendmsg
0,47910726900,47910848100,00000121200,a07,poll
0,47910849500,47910850500,00000001000,aca,futex
0,47910852300,47910853200,00000000900,aca,futex
0,47910854500,47910855300,00000000800,aca,futex
0,47910857800,47910860300,00000002500,a2e,sendmsg
0,47910714300,47910861600,00000147300,ae8,epoll_wait
0,47910864900,47910866000,00000001100,a2f,recvmsg
0,47910882900,47910883100,00000000200,a2f,recvmsg
0,47910909400,47910911700,00000002300,a2e,sendmsg
0,47910922200,47910922500,00000000300,a00,read
0,47910926500,47911046600,00000120100,a07,poll
0,47911048000,47911049000,00000001000,aca,futex
0,47911050500,47911051300,00000000800,aca,futex
0,47911052500,47911053300,00000000800,aca,futex
0,47911055800,47911058100,00000002300,a2e,sendmsg
0,47910914600,47911059400,00000144800,ae8,epoll_wait
0,47911062700,47911063700,00000001000,a2f,recvmsg
0,47911080800,47911081000,00000000200,a2f,recvmsg
0,47911106300,47911108400,00000002100,a2e,sendmsg
0,47910926500,47911110300,00000183800,a07,poll
0,47911111200,47911111600,00000000400,a00,read
0,47911120000,47911120900,00000000900,a2f,recvmsg
0,47911129600,47911208800,00000079200,a07,poll
0,47911210700,47911211600,00000000900,aca,futex
0,47911313600,47911441800,00000128200,a07,poll
0,47911443600,47911444700,00000001100,aca,futex
0,47911446700,47911447700,00000001000,aca,futex
0,47911448900,47911449800,00000000900,aca,futex
0,47911452700,47911455400,00000002700,a2e,sendmsg
0,47911299800,47911457000,00000157200,ae8,epoll_wait
0,47911460500,47911461700,00000001200,a2f,recvmsg
0,47911480000,47911480300,00000000300,a2f,recvmsg
0,47911508500,47911510000,00000001500,a2e,sendmsg
0,47911520700,47911521000,00000000300,a00,read
0,47911524800,47911645900,00000121100,a07,poll
0,47911647400,47911648400,00000001000,aca,futex
0,47911649900,47911650800,00000000900,aca,futex
0,47911652000,47911652800,00000000800,aca,futex
0,47911655400,47911657800,00000002400,a2e,sendmsg
0,47911513000,47911659200,00000146200,ae8,epoll_wait
0,47911662500,47911663600,00000001100,a2f,recvmsg
0,47911681200,47911681400,00000000200,a2f,recvmsg
0,47911708300,47911711200,00000002900,a2e,sendmsg
0,47911725500,47911839200,00000113700,a07,poll
0,47911840600,47911841600,00000001000,aca,futex
0,47911843400,47911844200,00000000800,aca,futex
0,47911845500,47911846300,00000000800,aca,futex
0,47911848800,47911851100,00000002300,a2e,sendmsg
0,47911714200,47911852400,00000138200,ae8,epoll_wait
0,47911855700,47911856800,00000001100,a2f,recvmsg
0,47911872900,47911873100,00000000200,a2f,recvmsg
0,47911897700,47911899800,00000002100,a2e,sendmsg
0,47911725500,47911901800,00000176300,a07,poll
0,47911902600,47911902900,00000000300,a00,read
0,47911911800,47911912600,00000000800,a2f,recvmsg
0,47911921700,47911995500,00000073800,a07,poll
0,47911997100,47911998100,00000001000,aca,futex
0,47912093400,47912093700,00000000300,a00,read
0,47912097800,47912220400,00000122600,a07,poll
0,47912221900,47912223000,00000001100,aca,futex
0,47912224600,47912225500,00000000900,aca,futex
0,47912226700,47912227500,00000000800,aca,futex
0,47912230400,47912232900,00000002500,a2e,sendmsg
0,47912084500,47912234100,00000149600,ae8,epoll_wait
0,47909137300,47912251700,00003114400,a17,select
0,47912270400,47912273600,00000003200,a14,writev
0,47912274300,47912274500,00000000200,a2f,recvmsg
0,47912305200,47912306100,00000000900,a2f,recvmsg
0,47912324100,47912324300,00000000200,a2f,recvmsg
0,47912292800,47912361200,00000068400,a17,select
0,47912370000,47912372900,00000002900,a14,writev
0,47912373400,47912373600,00000000200,a2f,recvmsg
0,47912383600,47912386000,00000002400,a2e,sendmsg
0,47912406500,47912549500,00000143000,a07,poll
0,47912551600,47912552800,00000001200,aca,futex
0,47912555000,47912555900,00000000900,aca,futex
0,47912557200,47912558000,00000000800,aca,futex
0,47912561200,47912563700,00000002500,a2e,sendmsg
0,47912390200,47912565100,00000174900,ae8,epoll_wait
0,47912569000,47912570300,00000001300,a2f,recvmsg
0,47912588500,47912588700,00000000200,a2f,recvmsg
0,47912632800,47912635700,00000002900,a2e,sendmsg
0,47912647600,47912648400,00000000800,a00,read
0,47913333700,47913333900,00000000200,a0c,brk
0,47913345500,47913348800,00000003300,a15,access
0,47913349600,47913350700,00000001100,a09,mmap
0,47913355300,47913356200,00000000900,a15,access
0,47913368000,47913368700,00000000700,a15,access
0,47913376300,47913377300,00000001000,a00,read
0,47913380100,47913381900,00000001800,a09,mmap
0,47913386300,47913388400,00000002100,a09,mmap
0,47913401300,47913402000,00000000700,a15,access
0,47913405400,47913406000,00000000600,a00,read
0,47913406900,47913407900,00000001000,a09,mmap
0,47913410700,47913412000,00000001300,a09,mmap
0,47913420600,47913421100,00000000500,a15,access
0,47913424200,47913424800,00000000600,a00,read
0,47913425500,47913426400,00000000900,a09,mmap
0,47913427800,47913429900,00000002100,a09,mmap
0,47913434900,47913438300,00000003400,a09,mmap
0,47913440300,47913441400,00000001100,a09,mmap
0,47913450900,47913451500,00000000600,a15,access
0,47913454500,47913455100,00000000600,a00,read
0,47913455900,47913457500,00000001600,a09,mmap
0,47913460600,47913462400,00000001800,a09,mmap
0,47913470800,47913471400,00000000600,a15,access
0,47913474400,47913475000,00000000600,a00,read
0,47913475800,47913477600,00000001800,a09,mmap
0,47913481600,47913483900,00000002300,a09,mmap
0,47913492600,47913493200,00000000600,a15,access
0,47913495500,47913496300,00000000800,a00,read
0,47913496800,47913497900,00000001100,a09,mmap
0,47913499100,47913500500,00000001400,a09,mmap
0,47913511900,47913512400,00000000500,a15,access
0,47913514800,47913515500,00000000700,a00,read
0,47913516000,47913517400,00000001400,a09,mmap
0,47913520300,47913522200,00000001900,a09,mmap
0,47913536900,47913537600,00000000700,a09,mmap
0,47913541300,47913541600,00000000300,a09,mmap
0,47913542600,47913542900,00000000300,a09,mmap
0,47913737400,47913737600,00000000200,a0c,brk
0,47913737700,47913738500,00000000800,a0c,brk
0,47913774700,47913782100,00000007400,a00,read
0,47913795000,47913796400,00000001400,a00,read
0,47913835000,47913836100,00000001100,a00,read
0,47913962700,47913963500,00000000800,a00,read
0,47914036600,47914037200,00000000600,a00,read
0,47914125400,47914126200,00000000800,a00,read
0,47914257500,47914258400,00000000900,a00,read
0,47914387200,47914388100,00000000900,a00,read
0,47914545900,47914546700,00000000800,a00,read
0,47914697300,47914698100,00000000800,a00,read
0,47914735100,47914736400,00000001300,a0c,brk
0,47914851900,47914852800,00000000900,a00,read
0,47915000200,47915001000,00000000800,a00,read
0,47915157100,47915157700,00000000600,a00,read
0,47915317600,47915318300,00000000700,a00,read
0,47915427000,47915427600,00000000600,a00,read
0,47915458200,47915458900,00000000700,a0c,brk
0,47915566900,47915567800,00000000900,a00,read
0,47915815800,47915816400,00000000600,a00,read
0,47915828300,47915828700,00000000400,a00,read
0,47915872600,47915873000,00000000400,a00,read
0,47915892600,47915893400,00000000800,a00,read
0,47916099800,47916100300,00000000500,a00,read
0,47916130000,47916130900,00000000900,a00,read
0,47916227700,47916228500,00000000800,a00,read
0,47916298200,47916298700,00000000500,a00,read
0,47916375000,47916375900,00000000900,a00,read
0,47916528900,47916529300,00000000400,a00,read
0,47916667100,47916667800,00000000700,a00,read
0,47916763800,47916764300,00000000500,a00,read
0,47916776200,47916776700,00000000500,a00,read
0,47916861600,47916861900,00000000300,a00,read
0,47916886400,47916886800,00000000400,a00,read
0,47916909400,47916910000,00000000600,a00,read
0,47917012100,47917013400,00000001300,a0c,brk
0,47917015200,47917016100,00000000900,a00,read
0,47917217300,47917217800,00000000500,a00,read
0,47917303300,47917303900,00000000600,a00,read
0,47917367500,47917368200,00000000700,a00,read
0,47917498300,47917498800,00000000500,a00,read
0,47917531200,47917531900,00000000700,a00,read
0,47917546600,47917547800,00000001200,a02,open
0,47917658900,47917659500,00000000600,a00,read
0,47917729900,47917730200,00000000300,a00,read
0,47917782400,47917783500,00000001100,a0c,brk
0,47917789500,47917790300,00000000800,a00,read
0,47917897000,47917897500,00000000500,a00,read
0,47918048500,47918049400,00000000900,a00,read
0,47918179000,47918179700,00000000700,a00,read
0,47918237400,47918238200,00000000800,a00,read
0,47918294300,47918295000,00000000700,a00,read
0,47918364800,47918365500,00000000700,a00,read
0,47918417900,47918418600,00000000700,a00,read
0,47918506800,47918507500,00000000700,a0c,brk
0,47918538600,47918542500,00000003900,a0c,brk
0,47918556400,47918557200,00000000800,a00,read
0,47918671200,47918672200,00000001000,a00,read
0,47918830100,47918831000,00000000900,a00,read
0,47918949000,47918949700,00000000700,a00,read
0,47919095100,47919095800,00000000700,a00,read
0,47919213000,47919213600,00000000600,a00,read
0,47919375100,47919375800,00000000700,a00,read
0,47919380700,47919381500,00000000800,a0c,brk
0,47919496500,47919497100,00000000600,a00,read
0,47919614900,47919615600,00000000700,a00,read
0,47919757400,47919758200,00000000800,a00,read
0,47919889000,47919889700,00000000700,a00,read
0,47919982400,47919983100,00000000700,a00,read
0,47920094700,47920095400,00000000700,a00,read
0,47920219400,47920220100,00000000700,a00,read
0,47920331100,47920331700,00000000600,a0c,brk
0,47920354400,47920355200,00000000800,a00,read
0,47920524000,47920524700,00000000700,a00,read
0,47920684500,47920685200,00000000700,a00,read
0,47920796000,47920796600,00000000600,a00,read
0,47920964200,47920965200,00000001000,a00,read
0,47921041800,47921042600,00000000800,a00,read
0,47921123700,47921124500,00000000800,a00,read
0,47921190900,47921191800,00000000900,a0c,brk
0,47921205300,47921206000,00000000700,a00,read
0,47921278300,47921279200,00000000900,a00,read
0,47921381000,47921381700,00000000700,a00,read
0,47921483800,47921484300,00000000500,a00,read
0,47921573400,47921574000,00000000600,a00,read
0,47921654200,47921654900,00000000700,a00,read
0,47921755600,47921756100,00000000500,a00,read
0,47921836600,47921836900,00000000300,a0c,brk
0,47921839400,47921840100,00000000700,a00,read
0,47921948000,47921948800,00000000800,a00,read
0,47922040800,47922041500,00000000700,a00,read
0,47922160200,47922160800,00000000600,a00,read
0,47922273800,47922274400,00000000600,a00,read
0,47922377200,47922377800,00000000600,a00,read
0,47922478000,47922478300,00000000300,a0c,brk
0,47922839300,47922842800,00000003500,a57,unlink
0,47922868600,47922869100,00000000500,a48,fcntl
0,47922914300,47922928400,00000014100,a01,write
0,47922946300,47922949000,00000002700,a01,write
0,47922965300,47922967700,00000002400,a01,write
0,47912652600,47923228500,00010575900,a07,poll
0,47923233000,47923234600,00000001600,aca,futex
0,47923238100,47923239000,00000000900,aca,futex
0,47923242000,47923243400,00000001400,aca,futex
0,47923252000,47923260500,00000008500,a2e,sendmsg
0,47912639000,47923264200,00010625200,ae8,epoll_wait
0,47923277300,47923280600,00000003300,a2f,recvmsg
0,47923305900,47923306400,00000000500,a2f,recvmsg
0,47923359800,47923363900,00000004100,a2e,sendmsg
0,47912652600,47923367800,00010715200,a07,poll
0,47923369500,47923370300,00000000800,a00,read
0,47923388200,47923389700,00000001500,a2f,recvmsg
0,47923405200,47923502100,00000096900,a07,poll
0,47923504100,47923505300,00000001200,aca,futex
0,47923674900,47923813700,00000138800,a07,poll
0,47923815500,47923816500,00000001000,aca,futex
0,47923818600,47923819600,00000001000,aca,futex
0,47923821300,47923822100,00000000800,aca,futex
0,47923826000,47923829200,00000003200,a2e,sendmsg
0,47923616100,47923831100,00000215000,ae8,epoll_wait
0,47923836900,47923838300,00000001400,a2f,recvmsg
0,47923857500,47923857700,00000000200,a2f,recvmsg
0,47923897300,47923902600,00000005300,a2e,sendmsg
0,47923915600,47923916000,00000000400,a00,read
0,47923920400,47924051700,00000131300,a07,poll
0,47924053200,47924054400,00000001200,aca,futex
0,47924056100,47924056900,00000000800,aca,futex
0,47924058300,47924059100,00000000800,aca,futex
0,47924062600,47924065300,00000002700,a2e,sendmsg
0,47923906200,47924066900,00000160700,ae8,epoll_wait
0,47924071100,47924072900,00000001800,a2f,recvmsg
0,47924091100,47924091200,00000000100,a2f,recvmsg
0,47924124800,47924128400,00000003600,a2e,sendmsg
0,47924144400,47924270700,00000126300,a07,poll
0,47924272100,47924273100,00000001000,aca,futex
0,47924274900,47924275800,00000000900,aca,futex
0,47924277100,47924277800,00000000700,aca,futex
0,47924281000,47924283700,00000002700,a2e,sendmsg
0,47924131400,47924285200,00000153800,ae8,epoll_wait
0,47924289600,47924290900,00000001300,a2f,recvmsg
0,47924309100,47924309300,00000000200,a2f,recvmsg
0,47924339700,47924342000,00000002300,a2e,sendmsg
0,47924354300,47924354700,00000000400,a00,read
0,47924358700,47924479900,00000121200,a07,poll
0,47924481200,47924482300,00000001100,aca,futex
0,47924483800,47924484600,00000000800,aca,futex
0,47924485900,47924486600,00000000700,aca,futex
0,47924489600,47924491900,00000002300,a2e,sendmsg
0,47924345000,47924493400,00000148400,ae8,epoll_wait
0,47924497000,47924498100,00000001100,a2f,recvmsg
0,47924515300,47924515500,00000000200,a2f,recvmsg
0,47924543000,47924544200,00000001200,a2e,sendmsg
0,47924558500,47924693700,00000135200,a07,poll
0,47924695300,47924696300,00000001000,aca,futex
0,47924698400,47924699200,00000000800,aca,futex
0,47924700500,47924701200,00000000700,aca,futex
0,47924704000,47924706600,00000002600,a2e,sendmsg
0,47924547000,47924707900,00000160900,ae8,epoll_wait
0,47924711700,47924712900,00000001200,a2f,recvmsg
0,47924729500,47924729600,00000000100,a2f,recvmsg
0,47924757100,47924759700,00000002600,a2e,sendmsg
0,47924558500,47924765300,00000206800,a07,poll
0,47924766400,47924766900,00000000500,a00,read
0,47924777300,47924778400,00000001100,a2f,recvmsg
0,47924788300,47924871900,00000083600,a07,poll
0,47924873700,47924874600,00000000900,aca,futex
0,47924964300,47924964500,00000000200,a00,read
0,47924968900,47925094100,00000125200,a07,poll
0,47925095600,47925096600,00000001000,aca,futex
0,47925098200,47925099200,00000001000,aca,futex
0,47925100400,47925101300,00000000900,aca,futex
0,47925104100,47925107200,00000003100,a2e,sendmsg
0,47924762600,47925108600,00000346000,ae8,epoll_wait
0,47925112600,47925113800,00000001200,a2f,recvmsg
0,47925132100,47925132300,00000000200,a2f,recvmsg
0,47925159500,47925161600,00000002100,a2e,sendmsg
0,47924968900,47925167000,00000198100,a07,poll
0,47925167800,47925168200,00000000400,a00,read
0,47925176000,47925176700,00000000700,a2f,recvmsg
0,47925185800,47925256900,00000071100,a07,poll
0,47925258600,47925259600,00000001000,aca,futex
0,47925344000,47925465600,00000121600,a07,poll
0,47925467000,47925468000,00000001000,aca,futex
0,47925470200,47925471000,00000000800,aca,futex
0,47925472300,47925473100,00000000800,aca,futex
0,47925476200,47925479200,00000003000,a2e,sendmsg
0,47925164700,47925480800,00000316100,ae8,epoll_wait
0,47925484500,47925485800,00000001300,a2f,recvmsg
0,47925503900,47925504100,00000000200,a2f,recvmsg
0,47925531100,47925535000,00000003900,a2e,sendmsg
0,47925545500,47925545800,00000000300,a00,read
0,47925549800,47925666400,00000116600,a07,poll
0,47925667800,47925668800,00000001000,aca,futex
0,47925670400,47925671200,00000000800,aca,futex
0,47925672400,47925673200,00000000800,aca,futex
0,47925675900,47925678100,00000002200,a2e,sendmsg
0,47925538100,47925679300,00000141200,ae8,epoll_wait
0,47925682500,47925683600,00000001100,a2f,recvmsg
0,47925700600,47925700800,00000000200,a2f,recvmsg
0,47925725900,47925728600,00000002700,a2e,sendmsg
0,47925744600,47925859400,00000114800,a07,poll
0,47925860900,47925861900,00000001000,aca,futex
0,47925863800,47925864600,00000000800,aca,futex
0,47925865800,47925866600,00000000800,aca,futex
0,47925869500,47925871800,00000002300,a2e,sendmsg
0,47925731400,47925873000,00000141600,ae8,epoll_wait
0,47925876200,47925877200,00000001000,a2f,recvmsg
0,47925894200,47925894300,00000000100,a2f,recvmsg
0,47925917600,47925918900,00000001300,a2e,sendmsg
0,47925928800,47925929200,00000000400,a00,read
0,47925932900,47926047700,00000114800,a07,poll
0,47926049000,47926050000,00000001000,aca,futex
0,47926051600,47926052400,00000000800,aca,futex
0,47926053700,47926054400,00000000700,aca,futex
0,47926057200,47926059500,00000002300,a2e,sendmsg
0,47925921400,47926060700,00000139300,ae8,epoll_wait
0,47926063900,47926065000,00000001100,a2f,recvmsg
0,47926081200,47926081500,00000000300,a2f,recvmsg
0,47926104400,47926105400,00000001000,a2e,sendmsg
0,47926119100,47926235700,00000116600,a07,poll
0,47926237100,47926238200,00000001100,aca,futex
0,47926240100,47926240900,00000000800,aca,futex
0,47926242000,47926242900,00000000900,aca,futex
0,47926245500,47926247400,00000001900,a2e,sendmsg
0,47926108100,47926248600,00000140500,ae8,epoll_wait
0,47926251900,47926253000,00000001100,a2f,recvmsg
0,47926270000,47926270200,00000000200,a2f,recvmsg
0,47926294900,47926298600,00000003700,a2e,sendmsg
0,47926309900,47926310200,00000000300,a00,read
0,47926313800,47926431000,00000117200,a07,poll
0,47926432300,47926433300,00000001000,aca,futex
0,47926435000,47926435700,00000000700,aca,futex
0,47926437000,47926437700,00000000700,aca,futex
0,47926440500,47926442500,00000002000,a2e,sendmsg
0,47926301500,47926443500,00000142000,ae8,epoll_wait
0,47926447100,47926448100,00000001000,a2f,recvmsg
0,47926465300,47926465500,00000000200,a2f,recvmsg
0,47926490200,47926493600,00000003400,a2e,sendmsg
0,47926496800,47926620600,00000123800,ae8,epoll_wait
0,47926623400,47926625000,00000001600,a2f,recvmsg
0,47926633200,47926633300,00000000100,a2f,recvmsg
0,47926671400,47926673700,00000002300,a2e,sendmsg
0,47926525200,47926679800,00000154600,a07,poll
0,47926680400,47926680700,00000000300,a00,read
0,47926688500,47926689500,00000001000,a2f,recvmsg
0,47926744900,47926746500,00000001600,a07,poll
0,47926744900,47926871900,00000127000,a07,poll
0,47926873600,47926874700,00000001100,aca,futex
0,47926876700,47926877600,00000000900,aca,futex
0,47926879000,47926879900,00000000900,aca,futex
0,47926882200,47926884900,00000002700,a2e,sendmsg
0,47926677900,47926886200,00000208300,ae8,epoll_wait
0,47926889900,47926891200,00000001300,a2f,recvmsg
0,47926914300,47926914500,00000000200,a2f,recvmsg
0,47926940400,47926942700,00000002300,a2e,sendmsg
0,47926953100,47926953500,00000000400,a00,read
0,47926945400,47927276400,00000331000,ae8,epoll_wait
0,47927279500,47927281200,00000001700,a2f,recvmsg
0,47927288800,47927289000,00000000200,a2f,recvmsg
0,47927322600,47927325100,00000002500,a2e,sendmsg
0,47926975000,47927330800,00000355800,a07,poll
0,47927338600,47927339200,00000000600,a2f,recvmsg
0,47927391100,47927392700,00000001600,a07,poll
0,47927391100,47927519400,00000128300,a07,poll
0,47927520900,47927522100,00000001200,aca,futex
0,47927524100,47927524900,00000000800,aca,futex
0,47927526300,47927527000,00000000700,aca,futex
0,47927529400,47927531800,00000002400,a2e,sendmsg
0,47927329000,47927533100,00000204100,ae8,epoll_wait
0,47927536400,47927537600,00000001200,a2f,recvmsg
0,47927560800,47927561100,00000000300,a2f,recvmsg
0,47927587300,47927588700,00000001400,a2e,sendmsg
0,47927599100,47927599500,00000000400,a00,read
0,47927591300,47927754400,00000163100,ae8,epoll_wait
0,47927757000,47927758400,00000001400,a2f,recvmsg
0,47927765700,47927765800,00000000100,a2f,recvmsg
0,47927801700,47927804000,00000002300,a2e,sendmsg
0,47927620200,47927809500,00000189300,a07,poll
0,47927817000,47927817600,00000000600,a2f,recvmsg
0,47927866000,47927867500,00000001500,a07,poll
0,47927866000,47927972300,00000106300,a07,poll
0,47927973800,47927974900,00000001100,aca,futex
0,47927976800,47927977700,00000000900,aca,futex
0,47927978900,47927979700,00000000800,aca,futex
0,47927982000,47927984300,00000002300,a2e,sendmsg
0,47927807600,47927985700,00000178100,ae8,epoll_wait
0,47927989100,47927990200,00000001100,a2f,recvmsg
0,47928007600,47928007900,00000000300,a2f,recvmsg
0,47928033300,47928035100,00000001800,a2e,sendmsg
0,47928045000,47928045300,00000000300,a00,read
0,47928037800,47928477400,00000439600,ae8,epoll_wait
0,47928480000,47928481700,00000001700,a2f,recvmsg
0,47928488900,47928489100,00000000200,a2f,recvmsg
0,47928520600,47928522800,00000002200,a2e,sendmsg
0,47928065400,47928528400,00000463000,a07,poll
0,47928536000,47928536600,00000000600,a2f,recvmsg
0,47928585000,47928586500,00000001500,a07,poll
0,47928585000,47928706200,00000121200,a07,poll
0,47928707700,47928708800,00000001100,aca,futex
0,47928710800,47928711800,00000001000,aca,futex
0,47928713100,47928713800,00000000700,aca,futex
0,47928716500,47928719200,00000002700,a2e,sendmsg
0,47928526600,47928720700,00000194100,ae8,epoll_wait
0,47928724100,47928725200,00000001100,a2f,recvmsg
0,47928742500,47928742700,00000000200,a2f,recvmsg
0,47928768700,47928769800,00000001100,a2e,sendmsg
0,47928780300,47928780600,00000000300,a00,read
0,47928772700,47928882100,00000109400,ae8,epoll_wait
0,47928884800,47928886300,00000001500,a2f,recvmsg
0,47928893500,47928893700,00000000200,a2f,recvmsg
0,47928929500,47928931800,00000002300,a2e,sendmsg
0,47928801300,47928937400,00000136100,a07,poll
0,47928944300,47928944900,00000000600,a2f,recvmsg
0,47928992300,47928993800,00000001500,a07,poll
0,47928992300,47929099100,00000106800,a07,poll
0,47929100600,47929101600,00000001000,aca,futex
0,47929103500,47929104400,00000000900,aca,futex
0,47929105700,47929106600,00000000900,aca,futex
0,47929109000,47929111400,00000002400,a2e,sendmsg
0,47928935500,47929112900,00000177400,ae8,epoll_wait
0,47929116400,47929117500,00000001100,a2f,recvmsg
0,47929135100,47929135200,00000000100,a2f,recvmsg
0,47929160900,47929162700,00000001800,a2e,sendmsg
0,47929172400,47929172700,00000000300,a00,read
0,47929165400,47929504300,00000338900,ae8,epoll_wait
0,47929506900,47929508400,00000001500,a2f,recvmsg
0,47929515600,47929515700,00000000100,a2f,recvmsg
0,47929546800,47929549000,00000002200,a2e,sendmsg
0,47929192400,47929554100,00000361700,a07,poll
0,47929561500,47929562100,00000000600,a2f,recvmsg
0,47929608800,47929610500,00000001700,a07,poll
0,47929608800,47929715700,00000106900,a07,poll
0,47929717200,47929718300,00000001100,aca,futex
0,47929720300,47929721200,00000000900,aca,futex
0,47929722500,47929723200,00000000700,aca,futex
0,47929725800,47929728200,00000002400,a2e,sendmsg
0,47929552400,47929729700,00000177300,ae8,epoll_wait
0,47929733400,47929734500,00000001100,a2f,recvmsg
0,47929752000,47929752300,00000000300,a2f,recvmsg
1,47886887100,47886887800,00000000700,a00,read
1,47887033100,47887033800,00000000700,a00,read
1,47887151200,47887151800,00000000600,a00,read
1,47887312800,47887313400,00000000600,a00,read
1,47887318400,47887319100,00000000700,a0c,brk
1,47887433600,47887434500,00000000900,a00,read
1,47887552200,47887552900,00000000700,a00,read
1,47887694100,47887695200,00000001100,a00,read
1,47887825800,47887826400,00000000600,a00,read
1,47887919500,47887920100,00000000600,a00,read
1,47888032800,47888033500,00000000700,a00,read
1,47888156700,47888157500,00000000800,a00,read
1,47888268900,47888269500,00000000600,a0c,brk
1,47888292300,47888293000,00000000700,a00,read
1,47888461400,47888462300,00000000900,a00,read
1,47888611900,47888612600,00000000700,a00,read
1,47888722800,47888723500,00000000700,a00,read
1,47888891200,47888892200,00000001000,a00,read
1,47888969000,47888969600,00000000600,a00,read
1,47889051100,47889051900,00000000800,a00,read
1,47889132600,47889133400,00000000800,a00,read
1,47889205500,47889206100,00000000600,a00,read
1,47889306500,47889307400,00000000900,a00,read
1,47889409200,47889410000,00000000800,a00,read
1,47889500500,47889501200,00000000700,a00,read
1,47889581400,47889582000,00000000600,a00,read
1,47889682300,47889682800,00000000500,a00,read
1,47889774500,47889775200,00000000700,a0c,brk
1,47889777700,47889778500,00000000800,a00,read
1,47889885300,47889886000,00000000700,a00,read
1,47889978000,47889978700,00000000700,a00,read
1,47890097900,47890098700,00000000800,a00,read
1,47890211400,47890212100,00000000700,a00,read
1,47890314700,47890315400,00000000700,a00,read
1,47890415500,47890415900,00000000400,a0c,brk
1,47890776000,47890779500,00000003500,a57,unlink
1,47890803500,47890804000,00000000500,a48,fcntl
1,47890850600,47890864500,00000013900,a01,write
1,47890882600,47890885400,00000002800,a01,write
1,47890902000,47890904600,00000002600,a01,write
1,47363537600,47891072700,00527535100,a3d,wait4
1,47891092800,47891094800,00000002000,a00,read
1,47891097100,47891097500,00000000400,a00,read
1,47891107500,47891116800,00000009300,a14,writev
1,47891119100,47893752900,00002633800,a07,poll
1,47893758700,47893759100,00000000400,a2f,recvmsg
1,47893759900,47893760100,00000000200,a2f,recvmsg
1,47893764600,47893766600,00000002000,a14,writev
1,47893767000,47893780300,00000013300,a07,poll
1,47893781800,47893782000,00000000200,a2f,recvmsg
1,47893782400,47893782600,00000000200,a2f,recvmsg
1,47893784100,47893786000,00000001900,a14,writev
1,47893786300,47893795400,00000009100,a07,poll
1,47893796800,47893797000,00000000200,a2f,recvmsg
1,47893797400,47893797500,00000000100,a2f,recvmsg
1,47893800000,47893802000,00000002000,a14,writev
1,47893802400,47893811000,00000008600,a07,poll
1,47893812300,47893812500,00000000200,a2f,recvmsg
1,47893812800,47893813000,00000000200,a2f,recvmsg
1,47893815500,47893817400,00000001900,a14,writev
1,47893817800,47893826600,00000008800,a07,poll
1,47893828000,47893828200,00000000200,a2f,recvmsg
1,47893828500,47893828600,00000000100,a2f,recvmsg
1,47893830000,47893831700,00000001700,a14,writev
1,47893832100,47893840100,00000008000,a07,poll
1,47893841700,47893841800,00000000100,a2f,recvmsg
1,47893842100,47893842300,00000000200,a2f,recvmsg
1,47893843100,47893843300,00000000200,a08,lseek
1,47893853600,47893853700,00000000100,a08,lseek
1,47893854900,47893856600,00000001700,a14,writev
1,47893857000,47893865500,00000008500,a07,poll
1,47893867200,47893867300,00000000100,a2f,recvmsg
1,47893867700,47893867900,00000000200,a2f,recvmsg
1,47893871600,47893873400,00000001800,a14,writev
1,47893873700,47893881700,00000008000,a07,poll
1,47893883000,47893883200,00000000200,a2f,recvmsg
1,47893883500,47893883600,00000000100,a2f,recvmsg
1,47893885400,47893887000,00000001600,a14,writev
1,47893887300,47893894900,00000007600,a07,poll
1,47893896300,47893896400,00000000100,a2f,recvmsg
1,47893896800,47893896900,00000000100,a2f,recvmsg
1,47893898900,47893900700,00000001800,a14,writev
1,47893901000,47893908500,00000007500,a07,poll
1,47893910100,47893910200,00000000100,a2f,recvmsg
1,47893910500,47893910700,00000000200,a2f,recvmsg
1,47893912800,47893914400,00000001600,a14,writev
1,47893914800,47893922500,00000007700,a07,poll
1,47893923800,47893924000,00000000200,a2f,recvmsg
1,47893924300,47893924500,00000000200,a2f,recvmsg
1,47893926500,47893928200,00000001700,a14,writev
1,47893928600,47893936000,00000007400,a07,poll
1,47893937300,47893937400,00000000100,a2f,recvmsg
1,47893937800,47893938000,00000000200,a2f,recvmsg
1,47893939700,47893941300,00000001600,a14,writev
1,47893941700,47893949500,00000007800,a07,poll
1,47893950700,47893950900,00000000200,a2f,recvmsg
1,47893951200,47893951400,00000000200,a2f,recvmsg
1,47893952800,47893954300,00000001500,a14,writev
1,47893954600,47893961900,00000007300,a07,poll
1,47893963400,47893963400,00000000000,a2f,recvmsg
1,47893963800,47893963900,00000000100,a2f,recvmsg
1,47893967100,47893968600,00000001500,a14,writev
1,47893969000,47893976900,00000007900,a07,poll
1,47893978400,47893978600,00000000200,a2f,recvmsg
1,47893978800,47893979000,00000000200,a2f,recvmsg
1,47893980900,47893982500,00000001600,a14,writev
1,47893982900,47893990200,00000007300,a07,poll
1,47893991700,47893991900,00000000200,a2f,recvmsg
1,47893992100,47893992300,00000000200,a2f,recvmsg
1,47893994100,47893995700,00000001600,a14,writev
1,47893996000,47894003500,00000007500,a07,poll
1,47894005800,47894005900,00000000100,a2f,recvmsg
1,47894006300,47894006400,00000000100,a2f,recvmsg
1,47894009000,47894010600,00000001600,a14,writev
1,47894010900,47894018500,00000007600,a07,poll
1,47894019800,47894020000,00000000200,a2f,recvmsg
1,47894020300,47894020400,00000000100,a2f,recvmsg
1,47894022200,47894023800,00000001600,a14,writev
1,47894025200,47894031500,00000006300,a07,poll
1,47894032700,47894032900,00000000200,a2f,recvmsg
1,47894033200,47894033400,00000000200,a2f,recvmsg
1,47894035200,47894036700,00000001500,a14,writev
1,47894037000,47894044500,00000007500,a07,poll
1,47894045800,47894046000,00000000200,a2f,recvmsg
1,47894046300,47894046500,00000000200,a2f,recvmsg
1,47894048100,47894049800,00000001700,a14,writev
1,47894050100,47894057600,00000007500,a07,poll
1,47894058900,47894059100,00000000200,a2f,recvmsg
1,47894059400,47894059600,00000000200,a2f,recvmsg
1,47894060800,47894062300,00000001500,a14,writev
1,47894062600,47894070000,00000007400,a07,poll
1,47894071400,47894071600,00000000200,a2f,recvmsg
1,47894071800,47894072000,00000000200,a2f,recvmsg
1,47894076200,47894077800,00000001600,a14,writev
1,47894078100,47894085700,00000007600,a07,poll
1,47894087000,47894087200,00000000200,a2f,recvmsg
1,47894087500,47894087700,00000000200,a2f,recvmsg
1,47894088800,47894090400,00000001600,a14,writev
1,47894090700,47894098200,00000007500,a07,poll
1,47894099500,47894099700,00000000200,a2f,recvmsg
1,47894100000,47894100200,00000000200,a2f,recvmsg
1,47894101300,47894102800,00000001500,a14,writev
1,47894103200,47894110600,00000007400,a07,poll
1,47894112000,47894112100,00000000100,a2f,recvmsg
1,47894112400,47894112600,00000000200,a2f,recvmsg
1,47894113800,47894115500,00000001700,a14,writev
1,47894115800,47894123300,00000007500,a07,poll
1,47894124600,47894124800,00000000200,a2f,recvmsg
1,47894125000,47894125200,00000000200,a2f,recvmsg
1,47894127800,47894129400,00000001600,a14,writev
1,47894129700,47894137200,00000007500,a07,poll
1,47894138500,47894138600,00000000100,a2f,recvmsg
1,47894138900,47894139100,00000000200,a2f,recvmsg
1,47894140400,47894142000,00000001600,a14,writev
1,47894142300,47894149600,00000007300,a07,poll
1,47894151000,47894151200,00000000200,a2f,recvmsg
1,47894151500,47894151600,00000000100,a2f,recvmsg
1,47894153400,47894155100,00000001700,a14,writev
1,47894155300,47894162800,00000007500,a07,poll
1,47894164100,47894164300,00000000200,a2f,recvmsg
1,47894164600,47894164800,00000000200,a2f,recvmsg
1,47894166600,47894168100,00000001500,a14,writev
1,47894168500,47894175900,00000007400,a07,poll
1,47894177100,47894177300,00000000200,a2f,recvmsg
1,47894177600,47894177800,00000000200,a2f,recvmsg
1,47894181100,47894182700,00000001600,a14,writev
1,47894183100,47894190700,00000007600,a07,poll
1,47894192100,47894192300,00000000200,a2f,recvmsg
1,47894192600,47894192800,00000000200,a2f,recvmsg
1,47894194800,47894196300,00000001500,a14,writev
1,47894196700,47894203900,00000007200,a07,poll
1,47894205200,47894205400,00000000200,a2f,recvmsg
1,47894205700,47894205900,00000000200,a2f,recvmsg
1,47894208000,47894209600,00000001600,a14,writev
1,47894209900,47894217700,00000007800,a07,poll
1,47894218900,47894219100,00000000200,a2f,recvmsg
1,47894219400,47894219600,00000000200,a2f,recvmsg
1,47894223500,47894225100,00000001600,a14,writev
1,47894225400,47894232900,00000007500,a07,poll
1,47894234300,47894234500,00000000200,a2f,recvmsg
1,47894234800,47894235000,00000000200,a2f,recvmsg
1,47894237100,47894238800,00000001700,a14,writev
1,47894239000,47894246500,00000007500,a07,poll
1,47894247800,47894248000,00000000200,a2f,recvmsg
1,47894248300,47894248400,00000000100,a2f,recvmsg
1,47894250000,47894251600,00000001600,a14,writev
1,47894251900,47894259400,00000007500,a07,poll
1,47894260600,47894260800,00000000200,a2f,recvmsg
1,47894261100,47894261300,00000000200,a2f,recvmsg
1,47894264700,47894266300,00000001600,a14,writev
1,47894266600,47894274100,00000007500,a07,poll
1,47894275400,47894275600,00000000200,a2f,recvmsg
1,47894275900,47894276100,00000000200,a2f,recvmsg
1,47894278700,47894280300,00000001600,a14,writev
1,47894280600,47894288100,00000007500,a07,poll
1,47894289400,47894289500,00000000100,a2f,recvmsg
1,47894289800,47894290000,00000000200,a2f,recvmsg
1,47894292200,47894293900,00000001700,a14,writev
1,47894294100,47894301700,00000007600,a07,poll
1,47894303100,47894303300,00000000200,a2f,recvmsg
1,47894303500,47894303700,00000000200,a2f,recvmsg
1,47894305600,47894307200,00000001600,a14,writev
1,47894307500,47894314900,00000007400,a07,poll
1,47894316400,47894316600,00000000200,a2f,recvmsg
1,47894316800,47894317000,00000000200,a2f,recvmsg
1,47894318600,47894320200,00000001600,a14,writev
1,47894320600,47894328100,00000007500,a07,poll
1,47894329300,47894329500,00000000200,a2f,recvmsg
1,47894329800,47894330000,00000000200,a2f,recvmsg
1,47894331300,47894332900,00000001600,a14,writev
1,47894333200,47894340500,00000007300,a07,poll
1,47894341700,47894341900,00000000200,a2f,recvmsg
1,47894342200,47894342400,00000000200,a2f,recvmsg
1,47894344200,47894345800,00000001600,a14,writev
1,47894346100,47894353600,00000007500,a07,poll
1,47894354900,47894355100,00000000200,a2f,recvmsg
1,47894355400,47894355600,00000000200,a2f,recvmsg
1,47894356700,47894356900,00000000200,a08,lseek
1,47894359600,47894362800,00000003200,a00,read
1,47894366500,47894366600,00000000100,a08,lseek
1,47894367900,47894369600,00000001700,a14,writev
1,47894370000,47894377300,00000007300,a07,poll
1,47894378700,47894378900,00000000200,a2f,recvmsg
1,47894379300,47894379500,00000000200,a2f,recvmsg
1,47894404900,47894406600,00000001700,a14,writev
1,47894407000,47894414800,00000007800,a07,poll
1,47894416400,47894416600,00000000200,a2f,recvmsg
1,47894417000,47894417200,00000000200,a2f,recvmsg
1,47894421000,47894422000,00000001000,a00,read
1,47894427500,47894427600,00000000100,a08,lseek
1,47894429100,47894430800,00000001700,a14,writev
1,47894431100,47894438400,00000007300,a07,poll
1,47894439900,47894440000,00000000100,a2f,recvmsg
1,47894440300,47894440500,00000000200,a2f,recvmsg
1,47894441800,47894443400,00000001600,a14,writev
1,47894443700,47894451000,00000007300,a07,poll
1,47894452300,47894452500,00000000200,a2f,recvmsg
1,47894452800,47894453000,00000000200,a2f,recvmsg
1,47894454100,47894455600,00000001500,a14,writev
1,47894455900,47894463200,00000007300,a07,poll
1,47894464600,47894464800,00000000200,a2f,recvmsg
1,47894465000,47894465200,00000000200,a2f,recvmsg
1,47894466400,47894467900,00000001500,a14,writev
1,47894468200,47894475600,00000007400,a07,poll
1,47894476900,47894477100,00000000200,a2f,recvmsg
1,47894477400,47894477600,00000000200,a2f,recvmsg
1,47894478700,47894480300,00000001600,a14,writev
1,47894480600,47894487900,00000007300,a07,poll
1,47894489300,47894489500,00000000200,a2f,recvmsg
1,47894489700,47894489900,00000000200,a2f,recvmsg
1,47894491000,47894492700,00000001700,a14,writev
1,47894493000,47894500400,00000007400,a07,poll
1,47894501600,47894501800,00000000200,a2f,recvmsg
1,47894502100,47894502300,00000000200,a2f,recvmsg
1,47894503400,47894505000,00000001600,a14,writev
1,47894505300,47894512600,00000007300,a07,poll
1,47894514000,47894514200,00000000200,a2f,recvmsg
1,47894514400,47894514600,00000000200,a2f,recvmsg
1,47894516200,47898247900,00003731700,a07,poll
1,47898249700,47898250600,00000000900,aca,futex
1,47898266600,47898267700,00000001100,aca,futex
1,47898302500,47898305000,00000002500,a2e,sendmsg
1,47898307100,47898307200,00000000100,a00,read
1,47898310900,47898691500,00000380600,a07,poll
1,47898703400,47898704400,00000001000,a2f,recvmsg
1,47898716000,47898762000,00000046000,a07,poll
1,47898763800,47898764700,00000000900,aca,futex
1,47898775800,47898776700,00000000900,aca,futex
1,47898852100,47898855900,00000003800,a2e,sendmsg
1,47898858100,47898858300,00000000200,a00,read
1,47898862400,47898865300,00000002900,a07,poll
1,47898876000,47898877000,00000001000,a2f,recvmsg
1,47898949000,47898951700,00000002700,a07,poll
1,47898959900,47898960600,00000000700,a2f,recvmsg
1,47898968700,47899004100,00000035400,a07,poll
1,47899006000,47899007000,00000001000,aca,futex
1,47899013800,47899014800,00000001000,aca,futex
1,47899044700,47899063400,00000018700,aca,futex
1,47899061800,47899068900,00000007100,a07,poll
1,47899070200,47899071000,00000000800,aca,futex
1,47899123700,47899125800,00000002100,a07,poll
1,47899129000,47899132500,00000003500,a2e,sendmsg
1,47899134800,47899134900,00000000100,a00,read
1,47899139200,47899145900,00000006700,a07,poll
1,47899158200,47899159400,00000001200,a2f,recvmsg
1,47899219600,47899223900,00000004300,a07,poll
1,47899225500,47899225900,00000000400,a00,read
1,47899236500,47899237800,00000001300,a2f,recvmsg
1,47899292600,47899296600,00000004000,a07,poll
1,47899311300,47899312300,00000001000,a2f,recvmsg
1,47899369800,47899372300,00000002500,a07,poll
1,47899389300,47899416500,00000027200,a07,poll
1,47899418100,47899419200,00000001100,aca,futex
1,47899435600,47899436900,00000001300,aca,futex
1,47899477300,47899479500,00000002200,a2e,sendmsg
1,47899481300,47899481400,00000000100,a00,read
1,47899485300,47899673100,00000187800,a07,poll
1,47899684300,47899685400,00000001100,a2f,recvmsg
1,47899695300,47899735000,00000039700,a07,poll
1,47899736800,47899737700,00000000900,aca,futex
1,47899751400,47899752400,00000001000,aca,futex
1,47899826600,47899829800,00000003200,a2e,sendmsg
1,47899831900,47899832100,00000000200,a00,read
1,47899836300,47899839500,00000003200,a07,poll
1,47899840500,47899841000,00000000500,a00,read
1,47899851800,47899852900,00000001100,a2f,recvmsg
1,47899924300,47899926800,00000002500,a07,poll
1,47899934900,47899935700,00000000800,a2f,recvmsg
1,47899943600,47899976400,00000032800,a07,poll
1,47899977800,47899978800,00000001000,aca,futex
1,47899987500,47899988400,00000000900,aca,futex
1,47900037300,47900037400,00000000100,a00,read
1,47900037000,47900060000,00000023000,a07,poll
1,47900061200,47900062300,00000001100,aca,futex
1,47900079700,47900081100,00000001400,aca,futex
1,47900119500,47900123300,00000003800,a2e,sendmsg
1,47900104100,47900132600,00000028500,aca,futex
1,47900130500,47900138400,00000007900,a07,poll
1,47900139400,47900140400,00000001000,aca,futex
1,47900186300,47900188500,00000002200,a07,poll
1,47900191300,47900193700,00000002400,a2e,sendmsg
1,47900195600,47900195800,00000000200,a00,read
1,47900199600,47900206600,00000007000,a07,poll
1,47900208000,47900208400,00000000400,a00,read
1,47900220100,47900221300,00000001200,a2f,recvmsg
1,47900280700,47900284100,00000003400,a07,poll
1,47900285500,47900285800,00000000300,a00,read
1,47900295000,47900296000,00000001000,a2f,recvmsg
1,47900351900,47900355100,00000003200,a07,poll
1,47900356400,47900356700,00000000300,a00,read
1,47900367600,47900368600,00000001000,a2f,recvmsg
1,47900423400,47900425700,00000002300,a07,poll
1,47900443700,47900470900,00000027200,a07,poll
1,47900472600,47900473700,00000001100,aca,futex
1,47900489800,47900491100,00000001300,aca,futex
1,47900529400,47900531400,00000002000,a2e,sendmsg
1,47900533100,47900533200,00000000100,a00,read
1,47900537100,47900582500,00000045400,a07,poll
1,47900592800,47900593900,00000001100,a2f,recvmsg
1,47900603400,47900642400,00000039000,a07,poll
1,47900644200,47900645300,00000001100,aca,futex
1,47900656900,47900657900,00000001000,aca,futex
1,47900730200,47900733900,00000003700,a2e,sendmsg
1,47900736200,47900736400,00000000200,a00,read
1,47900740600,47900743400,00000002800,a07,poll
1,47900744500,47900744900,00000000400,a00,read
1,47900754400,47900755400,00000001000,a2f,recvmsg
1,47900807300,47900810100,00000002800,a07,poll
1,47900810900,47900811200,00000000300,a00,read
1,47900821400,47900822300,00000000900,a2f,recvmsg
1,47900890600,47900893400,00000002800,a07,poll
1,47900894400,47900894600,00000000200,a00,read
1,47900903000,47900904200,00000001200,a2f,recvmsg
1,47900952300,47900954900,00000002600,a07,poll
1,47900955700,47900955900,00000000200,a00,read
1,47900965400,47900966400,00000001000,a2f,recvmsg
1,47901015900,47901018200,00000002300,a07,poll
1,47901026600,47901027400,00000000800,a2f,recvmsg
1,47901035500,47901069400,00000033900,a07,poll
1,47901071200,47901072200,00000001000,aca,futex
1,47901079900,47901080800,00000000900,aca,futex
1,47901128500,47901128600,00000000100,a00,read
1,47901128300,47901152700,00000024400,a07,poll
1,47901153900,47901154900,00000001000,aca,futex
1,47901173300,47901174500,00000001200,aca,futex
1,47901214600,47901217100,00000002500,a2e,sendmsg
1,47901198800,47901226600,00000027800,aca,futex
1,47901224100,47901232600,00000008500,a07,poll
1,47901233500,47901234500,00000001000,aca,futex
1,47901282200,47901284300,00000002100,a07,poll
1,47901287000,47901288400,00000001400,a2e,sendmsg
1,47901290300,47901290400,00000000100,a00,read
1,47901298100,47901298900,00000000800,a2f,recvmsg
1,47901304000,47901329300,00000025300,a07,poll
1,47901330600,47901331600,00000001000,aca,futex
1,47901336800,47901337700,00000000900,aca,futex
1,47901360700,47901375800,00000015100,a38,clone
1,47901402500,47901409500,00000007000,a07,poll
1,47901410500,47901411400,00000000900,aca,futex
1,47901459600,47901461700,00000002100,a07,poll
1,47901464500,47901466300,00000001800,a2e,sendmsg
1,47901468300,47901468400,00000000100,a00,read
1,47901472400,47901484300,00000011900,a07,poll
1,47901485900,47901486400,00000000500,a00,read
1,47901496700,47901497600,00000000900,a2f,recvmsg
1,47901552300,47901555500,00000003200,a07,poll
1,47901556100,47901556400,00000000300,a00,read
1,47901566400,47901567300,00000000900,a2f,recvmsg
1,47901634700,47901638000,00000003300,a07,poll
1,47901638900,47901639200,00000000300,a00,read
1,47901647900,47901648800,00000000900,a2f,recvmsg
1,47901711000,47901713800,00000002800,a07,poll
1,47901714900,47901715200,00000000300,a00,read
1,47901726000,47901727000,00000001000,a2f,recvmsg
1,47901778700,47901782000,00000003300,a07,poll
1,47901794100,47901795200,00000001100,a2f,recvmsg
1,47901804600,47901847900,00000043300,a07,poll
1,47901850200,47901851200,00000001000,aca,futex
1,47901863000,47901863900,00000000900,aca,futex
1,47901939100,47901941300,00000002200,a2e,sendmsg
1,47901943200,47901943400,00000000200,a00,read
1,47901947300,47901950100,00000002800,a07,poll
1,47901971500,47902002300,00000030800,a07,poll
1,47902004000,47902005000,00000001000,aca,futex
1,47902022100,47902023300,00000001200,aca,futex
1,47902063900,47902065700,00000001800,a2e,sendmsg
1,47902071400,47902071500,00000000100,a00,read
1,47902071100,47902096200,00000025100,a07,poll
1,47902097500,47902098800,00000001300,aca,futex
1,47902112100,47902113400,00000001300,aca,futex
1,47902147100,47902148600,00000001500,a2e,sendmsg
1,47902150800,47902151600,00000000800,a2f,recvmsg
1,47902153800,47902183700,00000029900,a07,poll
1,47902185000,47902186000,00000001000,aca,futex
1,47902193000,47902194000,00000001000,aca,futex
1,47902233700,47902233900,00000000200,a00,read
1,47902238500,47902258700,00000020200,a07,poll
1,47902259800,47902260800,00000001000,aca,futex
1,47902276600,47902277800,00000001200,aca,futex
1,47902311500,47902314500,00000003000,a2e,sendmsg
1,47902320500,47902343400,00000022900,a07,poll
1,47902344800,47902345700,00000000900,aca,futex
1,47902359600,47902360800,00000001200,aca,futex
1,47902394700,47902396200,00000001500,a2e,sendmsg
1,47902397900,47902398100,00000000200,a00,read
1,47902379900,47902403500,00000023600,aca,futex
1,47902401600,47902409100,00000007500,a07,poll
1,47902410100,47902411000,00000000900,aca,futex
1,47902455700,47902457800,00000002100,a07,poll
1,47902460200,47902461400,00000001200,a2e,sendmsg
1,47902468000,47902473800,00000005800,a07,poll
1,47902475300,47902475700,00000000400,a00,read
1,47902486800,47902488100,00000001300,a2f,recvmsg
1,47902544900,47902548400,00000003500,a07,poll
1,47902549300,47902549500,00000000200,a00,read
1,47902559800,47902560800,00000001000,a2f,recvmsg
1,47902629500,47902633100,00000003600,a07,poll
1,47902634300,47902634500,00000000200,a00,read
1,47902643600,47902644800,00000001200,a2f,recvmsg
1,47902695000,47902698100,00000003100,a07,poll
1,47902699400,47902699600,00000000200,a00,read
1,47902710400,47902711400,00000001000,a2f,recvmsg
1,47902764800,47902767800,00000003000,a07,poll
1,47902778200,47902779200,00000001000,a2f,recvmsg
1,47902788900,47902828400,00000039500,a07,poll
1,47902830200,47902831400,00000001200,aca,futex
1,47902844300,47902845400,00000001100,aca,futex
1,47902918000,47902920300,00000002300,a2e,sendmsg
1,47902922200,47902922300,00000000100,a00,read
1,47902926700,47902929500,00000002800,a07,poll
1,47902930400,47902930600,00000000200,a00,read
1,47902950600,47902980400,00000029800,a07,poll
1,47902981900,47902982900,00000001000,aca,futex
1,47902999900,47903001200,00000001300,aca,futex
1,47903041600,47903043000,00000001400,a2e,sendmsg
1,47903045400,47903046200,00000000800,a2f,recvmsg
1,47903048700,47903048900,00000000200,a00,read
1,47903048500,47903076600,00000028100,a07,poll
1,47903077800,47903078900,00000001100,aca,futex
1,47903088500,47903089400,00000000900,aca,futex
1,47903114600,47903133400,00000018800,aca,futex
1,47903131700,47903143800,00000012100,a07,poll
1,47903144700,47903145700,00000001000,aca,futex
1,47903195600,47903197800,00000002200,a07,poll
1,47903200700,47903202500,00000001800,a2e,sendmsg
1,47903204700,47903204800,00000000100,a00,read
1,47903208900,47903215000,00000006100,a07,poll
1,47903216200,47903216500,00000000300,a00,read
1,47903227100,47903228200,00000001100,a2f,recvmsg
1,47903284300,47903287300,00000003000,a07,poll
1,47903288000,47903288200,00000000200,a00,read
1,47903298100,47903299000,00000000900,a2f,recvmsg
1,47903365400,47903368600,00000003200,a07,poll
1,47903369700,47903370000,00000000300,a00,read
1,47903379000,47903379900,00000000900,a2f,recvmsg
1,47903429800,47903432700,00000002900,a07,poll
1,47903433500,47903433800,00000000300,a00,read
1,47903443900,47903444900,00000001000,a2f,recvmsg
1,47903496100,47903498900,00000002800,a07,poll
1,47903508600,47903509300,00000000700,a2f,recvmsg
1,47903517900,47903551200,00000033300,a07,poll
1,47903552900,47903554100,00000001200,aca,futex
1,47903569000,47903569900,00000000900,aca,futex
1,47903640900,47903642900,00000002000,a2e,sendmsg
1,47903644900,47903645100,00000000200,a00,read
1,47903648900,47903651500,00000002600,a07,poll
1,47903671400,47903700200,00000028800,a07,poll
1,47903701500,47903702600,00000001100,aca,futex
1,47903721600,47903723000,00000001400,aca,futex
1,47903763600,47903765300,00000001700,a2e,sendmsg
1,47903771000,47903771200,00000000200,a00,read
1,47903770700,47903794800,00000024100,a07,poll
1,47903796000,47903797000,00000001000,aca,futex
1,47903810700,47903811800,00000001100,aca,futex
1,47903845000,47903846500,00000001500,a2e,sendmsg
1,47903848900,47903849500,00000000600,a2f,recvmsg
1,47903851800,47903882200,00000030400,a07,poll
1,47903883400,47903884400,00000001000,aca,futex
1,47903889500,47903890400,00000000900,aca,futex
1,47903916000,47903934300,00000018300,aca,futex
1,47903932200,47903940100,00000007900,a07,poll
1,47903941000,47903941900,00000000900,aca,futex
1,47903990200,47903992400,00000002200,a07,poll
1,47903995400,47903997100,00000001700,a2e,sendmsg
1,47903999100,47903999200,00000000100,a00,read
1,47904003200,47904009100,00000005900,a07,poll
1,47904010400,47904010700,00000000300,a00,read
1,47904021600,47904022700,00000001100,a2f,recvmsg
1,47904078300,47904081400,00000003100,a07,poll
1,47904082200,47904082500,00000000300,a00,read
1,47904092500,47904093500,00000001000,a2f,recvmsg
1,47904165300,47904168600,00000003300,a07,poll
1,47904169700,47904170000,00000000300,a00,read
1,47904178600,47904179700,00000001100,a2f,recvmsg
1,47904240900,47904243800,00000002900,a07,poll
1,47904244800,47904245000,00000000200,a00,read
1,47904255300,47904256300,00000001000,a2f,recvmsg
1,47904310200,47904312800,00000002600,a07,poll
1,47904323200,47904324100,00000000900,a2f,recvmsg
1,47904333500,47904375400,00000041900,a07,poll
1,47904377300,47904378400,00000001100,aca,futex
1,47904386600,47904387500,00000000900,aca,futex
1,47904459200,47904461500,00000002300,a2e,sendmsg
1,47904463400,47904463600,00000000200,a00,read
1,47904501900,47904504700,00000002800,a07,poll
1,47904526000,47904555900,00000029900,a07,poll
1,47904557700,47904558800,00000001100,aca,futex
1,47904577400,47904578700,00000001300,aca,futex
1,47904619900,47904621600,00000001700,a2e,sendmsg
1,47904627400,47904627500,00000000100,a00,read
1,47904627100,47904652400,00000025300,a07,poll
1,47904653700,47904654600,00000000900,aca,futex
1,47904668000,47904669100,00000001100,aca,futex
1,47904704300,47904706000,00000001700,a2e,sendmsg
1,47904711500,47905219900,00000508400,a07,poll
1,47905228500,47905229700,00000001200,a2f,recvmsg
1,47905238700,47905277300,00000038600,a07,poll
1,47905279200,47905280100,00000000900,aca,futex
1,47905291100,47905292100,00000001000,aca,futex
1,47905409200,47905411100,00000001900,a2e,sendmsg
1,47905413500,47905413700,00000000200,a00,read
1,47905415200,47905415800,00000000600,a2e,sendmsg
1,47905423800,47905427400,00000003600,a07,poll
1,47905428800,47905429100,00000000300,a00,read
1,47905441100,47905442100,00000001000,a2f,recvmsg
1,47905515800,47905519600,00000003800,a07,poll
1,47905521300,47905521700,00000000400,a00,read
1,47905533100,47905534200,00000001100,a2f,recvmsg
1,47905596300,47905599600,00000003300,a07,poll
1,47905600900,47905601200,00000000300,a00,read
1,47905610600,47905611700,00000001100,a2f,recvmsg
1,47905664000,47905667100,00000003100,a07,poll
1,47905668500,47905668800,00000000300,a00,read
1,47905680600,47905681600,00000001000,a2f,recvmsg
1,47905738100,47905740300,00000002200,a07,poll
1,47905741000,47905741100,00000000100,a00,read
1,47905748800,47905749400,00000000600,a2f,recvmsg
1,47905806200,47905808700,00000002500,a07,poll
1,47905809500,47905809700,00000000200,a00,read
1,47905816600,47905817400,00000000800,a2f,recvmsg
1,47905862200,47905864300,00000002100,a07,poll
1,47905864900,47905865000,00000000100,a00,read
1,47905871600,47905872400,00000000800,a2f,recvmsg
1,47905913100,47905915200,00000002100,a07,poll
1,47905915700,47905915800,00000000100,a00,read
1,47905922300,47905923100,00000000800,a2f,recvmsg
1,47905968400,47905970800,00000002400,a07,poll
1,47905980200,47905980900,00000000700,a2f,recvmsg
1,47905989900,47906028800,00000038900,a07,poll
1,47906030600,47906032000,00000001400,aca,futex
1,47906039700,47906040500,00000000800,aca,futex
1,47906106500,47906110200,00000003700,a2e,sendmsg
1,47906112300,47906112400,00000000100,a00,read
1,47906116400,47906119500,00000003100,a07,poll
1,47906120500,47906120900,00000000400,a00,read
1,47906132100,47906133300,00000001200,a2f,recvmsg
1,47906144400,47906184000,00000039600,a07,poll
1,47906185700,47906186800,00000001100,aca,futex
1,47906194000,47906194900,00000000900,aca,futex
1,47906243400,47906244300,00000000900,a2f,recvmsg
1,47906246600,47906246800,00000000200,a00,read
1,47906246300,47906273200,00000026900,a07,poll
1,47906274400,47906275400,00000001000,aca,futex
1,47906279500,47906280500,00000001000,aca,futex
1,47906298200,47906304400,00000006200,aca,futex
1,47906302300,47906311100,00000008800,a07,poll
1,47906312000,47906312900,00000000900,aca,futex
1,47906367700,47906375400,00000007700,a07,poll
1,47906376400,47906377400,00000001000,aca,futex
1,47906431200,47906433100,00000001900,a2e,sendmsg
1,47906441400,47906442200,00000000800,a2e,sendmsg
1,47906439100,47906467300,00000028200,a07,poll
1,47906468500,47906469500,00000001000,aca,futex
1,47906486100,47906487300,00000001200,aca,futex
1,47906522300,47906524300,00000002000,a2e,sendmsg
1,47906529200,47906529400,00000000200,a00,read
1,47906506000,47906534500,00000028500,aca,futex
1,47906532400,47909489100,00002956700,a07,poll
1,47909500700,47909523000,00000022300,a07,poll
1,47909524300,47909525200,00000000900,aca,futex
1,47909538700,47909539800,00000001100,aca,futex
1,47909573800,47909576700,00000002900,a2e,sendmsg
1,47909582200,47909582300,00000000100,a00,read
1,47909581900,47909605100,00000023200,a07,poll
1,47909606200,47909607200,00000001000,aca,futex
1,47909619100,47909620200,00000001100,aca,futex
1,47909653500,47909657600,00000004100,a2e,sendmsg
1,47909663100,47910350600,00000687500,a07,poll
1,47910351000,47910351200,00000000200,a00,read
1,47910361600,47910382800,00000021200,a07,poll
1,47910384000,47910385000,00000001000,aca,futex
1,47910399100,47910400300,00000001200,aca,futex
1,47910432800,47910434100,00000001300,a2e,sendmsg
1,47910439100,47910439200,00000000100,a00,read
1,47910438800,47910461500,00000022700,a07,poll
1,47910462800,47910463700,00000000900,aca,futex
1,47910476200,47910477300,00000001100,aca,futex
1,47910508700,47910510100,00000001400,a2e,sendmsg
1,47910516200,47910518600,00000002400,a07,poll
1,47910527800,47910529000,00000001200,a2f,recvmsg
1,47910537800,47910626100,00000088300,a07,poll
1,47910627700,47910628600,00000000900,aca,futex
1,47910708100,47910711000,00000002900,a07,poll
1,47910712100,47910712400,00000000300,a00,read
1,47910722200,47910723500,00000001300,a2f,recvmsg
1,47910733100,47910820200,00000087100,a07,poll
1,47910822000,47910823000,00000001000,aca,futex
1,47910932300,47910933900,00000001600,aca,futex
1,47910991000,47910993300,00000002300,a2e,sendmsg
1,47910995300,47910995400,00000000100,a00,read
1,47910997700,47911038000,00000040300,a07,poll
1,47911039100,47911039600,00000000500,a00,read
1,47911050600,47911051700,00000001100,a2f,recvmsg
1,47911162500,47911165200,00000002700,a07,poll
1,47911564600,47911569200,00000004600,a09,mmap
1,47911615000,47911616300,00000001300,aca,futex
1,47911659900,47911664100,00000004200,a07,poll
1,47911668800,47911673700,00000004900,a2e,sendmsg
1,47911676300,47911676500,00000000200,a00,read
1,47911777900,47911783500,00000005600,a02,open
1,47911799600,47911802100,00000002500,a00,read
1,47911859600,47911860500,00000000900,a00,read
1,47911914100,47911914900,00000000800,a00,read
1,47911970500,47911971500,00000001000,a00,read
1,47912027000,47912027700,00000000700,a00,read
1,47912080900,47912081600,00000000700,a00,read
1,47912132500,47912133300,00000000800,a00,read
1,47912185900,47912186600,00000000700,a00,read
1,47912241600,47912242400,00000000800,a00,read
1,47912296500,47912297300,00000000800,a00,read
1,47912348000,47912348700,00000000700,a00,read
1,47912377800,47912380000,00000002200,a02,open
1,47912383200,47912384200,00000001000,a00,read
1,47912440900,47912441700,00000000800,a00,read
1,47912528700,47912529600,00000000900,a00,read
1,47912603900,47912604700,00000000800,a00,read
1,47912684100,47912684900,00000000800,a00,read
1,47912765400,47912766100,00000000700,a00,read
1,47912846400,47912847200,00000000800,a00,read
1,47912934100,47912935000,00000000900,a00,read
1,47913001500,47913002200,00000000700,a00,read
1,47913060700,47913061500,00000000800,a00,read
1,47913143900,47913150700,00000006800,a14,writev
1,47913152600,47913158900,00000006300,a07,poll
1,47913160900,47913161600,00000000700,a00,read
1,47913179400,47913181700,00000002300,a2f,recvmsg
1,47913316400,47913320000,00000003600,a07,poll
1,47913586700,47913590900,00000004200,a09,mmap
1,47913596400,47913597800,00000001400,a09,mmap
1,47913619300,47913621000,00000001700,aca,futex
1,47913669100,47913674000,00000004900,a07,poll
1,47913680300,47913684400,00000004100,a2e,sendmsg
1,47913687600,47913687800,00000000200,a00,read
1,47913693300,47913715500,00000022200,a07,poll
1,47913717000,47913718100,00000001100,aca,futex
1,47913748500,47913750900,00000002400,a07,poll
1,47913753600,47913755600,00000002000,a2e,sendmsg
1,47913762100,47913780500,00000018400,a07,poll
1,47913781900,47913782900,00000001000,aca,futex
1,47913810600,47913812600,00000002000,a07,poll
1,47913815100,47913816600,00000001500,a2e,sendmsg
1,47913819600,47913819700,00000000100,a00,read
1,47913823800,47913837900,00000014100,a07,poll
1,47913839100,47913840000,00000000900,aca,futex
1,47913865300,47913867100,00000001800,a07,poll
1,47913869400,47913871600,00000002200,a2e,sendmsg
1,47913938500,47913940200,00000001700,a2f,recvmsg
1,47913946500,47913989700,00000043200,a07,poll
1,47913991400,47913992500,00000001100,aca,futex
1,47913994600,47913995400,00000000800,aca,futex
1,47913997900,47913998900,00000001000,aca,futex
1,47914001400,47914006000,00000004600,a2e,sendmsg
1,47914008500,47914008700,00000000200,a00,read
1,47325811700,47914019100,00588207400,ae8,epoll_wait
1,47914028000,47914030500,00000002500,a2f,recvmsg
1,47914042000,47914042400,00000000400,a2f,recvmsg
1,47914044500,47914047200,00000002700,a2f,recvmsg
1,47914067700,47914067900,00000000200,a2f,recvmsg
1,47914086500,47914091100,00000004600,a2e,sendmsg
1,47914113000,47914114400,00000001400,a2f,recvmsg
1,47914442800,47914469200,00000026400,a02,open
1,47914483400,47914492800,00000009400,a01,write
1,47914193000,47914539200,00000346200,a07,poll
1,47914541100,47914541800,00000000700,a00,read
1,47914558700,47914560500,00000001800,a2f,recvmsg
1,47914576500,47914700700,00000124200,a07,poll
1,47914703400,47914704900,00000001500,aca,futex
1,47914796100,47914797900,00000001800,aca,futex
1,47914840900,47914841500,00000000600,a00,read
1,47914870200,47914871600,00000001400,a2f,recvmsg
1,47914874000,47914874200,00000000200,a00,read
1,47914873800,47914950200,00000076400,a07,poll
1,47914951500,47914952500,00000001000,aca,futex
1,47915014500,47915015900,00000001400,aca,futex
1,47915069600,47915070700,00000001100,a2f,recvmsg
1,47915072800,47915183100,00000110300,a07,poll
1,47915184500,47915185300,00000000800,aca,futex
1,47915242000,47915243500,00000001500,aca,futex
1,47915295400,47915295600,00000000200,a00,read
1,47915318500,47915323200,00000004700,a07,poll
1,47915324700,47915325100,00000000400,a00,read
1,47915339000,47915340400,00000001400,a2f,recvmsg
1,47915355700,47915463600,00000107900,a07,poll
1,47915465700,47915466700,00000001000,aca,futex
1,47915566100,47915567400,00000001300,a2f,recvmsg
1,47915569800,47915569900,00000000100,a00,read
1,47915569400,47915677100,00000107700,a07,poll
1,47915678600,47915679700,00000001100,aca,futex
1,47915773500,47915774500,00000001000,a2f,recvmsg
1,47915776700,47915833000,00000056300,a07,poll
1,47915834300,47915835200,00000000900,aca,futex
1,47915899800,47915900600,00000000800,a2f,recvmsg
1,47915902600,47915957000,00000054400,a07,poll
1,47915958200,47915959200,00000001000,aca,futex
1,47916024600,47916053300,00000028700,a07,poll
1,47916195600,47916195800,00000000200,a00,read
1,47916259900,47916262800,00000002900,a07,poll
1,47916286800,47916327600,00000040800,a07,poll
1,47916328600,47916329100,00000000500,a00,read
1,47916340800,47916341800,00000001000,a2f,recvmsg
1,47916352100,47916434000,00000081900,a07,poll
1,47916436000,47916437100,00000001100,aca,futex
1,47916508900,47916510700,00000001800,aca,futex
1,47916570500,47916571500,00000001000,a2f,recvmsg
1,47916573900,47916574000,00000000100,a00,read
1,47916573500,47916636600,00000063100,a07,poll
1,47916638000,47916638900,00000000900,aca,futex
1,47916698100,47916699400,00000001300,aca,futex
1,47916745400,47916745700,00000000300,a00,read
1,47916769300,47916788500,00000019200,a07,poll
1,47916789500,47916789800,00000000300,a00,read
1,47916800400,47916801600,00000001200,a2f,recvmsg
1,47916811900,47916889800,00000077900,a07,poll
1,47916891600,47916892600,00000001000,aca,futex
1,47916975500,47916979000,00000003500,a07,poll
1,47916987100,47916987500,00000000400,a2f,recvmsg
1,47916988400,47916988500,00000000100,a2f,recvmsg
1,47916992300,47916997900,00000005600,a14,writev
1,47916998900,47917037600,00000038700,a07,poll
1,47917041000,47917041200,00000000200,a2f,recvmsg
1,47917041800,47917042000,00000000200,a2f,recvmsg
1,47917054400,47917061500,00000007100,a06,lstat
1,47917062600,47917064000,00000001400,a06,lstat
1,47917093900,47917106600,00000012700,a01,write
1,47917112400,47917115800,00000003400,a14,writev
1,47917116800,47917136400,00000019600,a07,poll
1,47917139900,47917140100,00000000200,a2f,recvmsg
1,47917140600,47917140800,00000000200,a2f,recvmsg
1,47917143200,47917503000,00000359800,a38,clone
1,47917116800,47917536900,00000420100,a07,poll
1,47917538100,47917538500,00000000400,a00,read
1,47917551900,47917553100,00000001200,a2f,recvmsg
1,47917563100,47917643900,00000080800,a07,poll
1,47917646000,47917647200,00000001200,aca,futex
1,47917739900,47917743900,00000004000,a07,poll
1,47917745700,47917746000,00000000300,a00,read
1,47917762400,47917764200,00000001800,a2f,recvmsg
1,47917778000,47917885900,00000107900,a07,poll
1,47917888200,47917889500,00000001300,aca,futex
1,47917983200,47917985200,00000002000,aca,futex
1,47918059700,47928669100,00010609400,a07,poll
1,47928670600,47928671100,00000000500,a00,read
1,47928685200,47928686400,00000001200,a2f,recvmsg
1,47928700500,47928794000,00000093500,a07,poll
1,47928796000,47928797100,00000001100,aca,futex
1,47928891400,47928895400,00000004000,a07,poll
1,47928896800,47928897200,00000000400,a00,read
1,47928910000,47928911200,00000001200,a2f,recvmsg
1,47928922700,47929013200,00000090500,a07,poll
1,47929015100,47929016300,00000001200,aca,futex
1,47929104400,47929106100,00000001700,aca,futex
1,47929140700,47929141000,00000000300,a00,read
1,47929168400,47929171100,00000002700,a07,poll
1,47929172200,47929172300,00000000100,a00,read
1,47929181400,47929182700,00000001300,a2f,recvmsg
1,47929191300,47929268500,00000077200,a07,poll
1,47929270400,47929271300,00000000900,aca,futex
1,47929353400,47929354400,00000001000,a2f,recvmsg
1,47929356600,47929356700,00000000100,a00,read
1,47929356400,47929436400,00000080000,a07,poll
1,47929437800,47929438800,00000001000,aca,futex
1,47929507300,47930299100,00000791800,a07,poll
1,47930299700,47930299800,00000000100,a00,read
1,47930305300,47930306300,00000001000,a2f,recvmsg
1,47930311700,47930371900,00000060200,a07,poll
1,47930373300,47930374500,00000001200,aca,futex
1,47930442800,47930493300,00000050500,a07,poll
1,47930494400,47930494600,00000000200,a00,read
1,47930504200,47930505200,00000001000,a2f,recvmsg
1,47930514000,47930592800,00000078800,a07,poll
1,47930594500,47930595500,00000001000,aca,futex
1,47930664400,47930665700,00000001300,aca,futex
1,47930721900,47930722900,00000001000,a2f,recvmsg
1,47930725300,47930725500,00000000200,a00,read
1,47930725000,47930789900,00000064900,a07,poll
1,47930791300,47930792200,00000000900,aca,futex
1,47930848800,47930850000,00000001200,aca,futex
1,47930879600,47930879900,00000000300,a00,read
1,47930898700,47930899500,00000000800,a2f,recvmsg
1,47930901500,47930961000,00000059500,a07,poll
1,47930962200,47930963300,00000001100,aca,futex
1,47931017300,47931018500,00000001200,aca,futex
1,47931066800,47931070700,00000003900,a07,poll
1,47931086300,47931087900,00000001600,a2f,recvmsg
1,47931100100,47931200800,00000100700,a07,poll
1,47931202800,47931203800,00000001000,aca,futex
1,47931311100,47931312800,00000001700,aca,futex
1,47931375400,47931380600,00000005200,a2e,sendmsg
1,47931383000,47931383100,00000000100,a00,read
1,47931385400,47931389700,00000004300,a07,poll
1,47931391500,47931391900,00000000400,a00,read
1,47931406300,47931407800,00000001500,a2f,recvmsg
1,47931544600,47931547000,00000002400,a07,poll
1,47931544600,47931707600,00000163000,a07,poll
1,47931709400,47931710600,00000001200,aca,futex
1,47931751700,47931754700,00000003000,a07,poll
1,47931759700,47931764000,00000004300,a2e,sendmsg
1,47931766600,47931766900,00000000300,a00,read
1,47931771700,47931790400,00000018700,a07,poll
1,47931791600,47931792600,00000001000,aca,futex
1,47931822300,47931824600,00000002300,a07,poll
1,47931826800,47931828700,00000001900,a2e,sendmsg
1,47931835000,47931853200,00000018200,a07,poll
1,47931854400,47931855200,00000000800,aca,futex
1,47931881500,47931883400,00000001900,a07,poll
1,47931885800,47931887400,00000001600,a2e,sendmsg
1,47931889300,47931889400,00000000100,a00,read
1,47931893100,47931906800,00000013700,a07,poll
1,47931907900,47931908700,00000000800,aca,futex
1,47931932900,47931934600,00000001700,a07,poll
1,47931936500,47931937700,00000001200,a2e,sendmsg
1,47931943400,47932022000,00000078600,a07,poll
1,47932023400,47932024400,00000001000,aca,futex
1,47932026300,47932027200,00000000900,aca,futex
1,47932029800,47932030600,00000000800,aca,futex
1,47932032600,47932035800,00000003200,a2e,sendmsg
1,47932038100,47932038200,00000000100,a00,read
1,47914303200,47932047500,00017744300,ae8,epoll_wait
1,47932055700,47932059000,00000003300,a2f,recvmsg
1,47932083100,47932083400,00000000300,a2f,recvmsg
1,47932043900,47932187900,00000144000,a07,poll
1,47932199300,47932200700,00000001400,a2f,recvmsg
1,47932210500,47932330600,00000120100,a07,poll
1,47932332700,47932333900,00000001200,aca,futex
1,47932451100,47932452500,00000001400,aca,futex
1,47932510500,47932514400,00000003900,a2e,sendmsg
1,47932516600,47932516800,00000000200,a00,read
1,47932519000,47932521600,00000002600,a07,poll
1,47932543500,47932544500,00000001000,a2f,recvmsg
1,47932699100,47932699300,00000000200,a00,read
1,47932758400,47932760600,00000002200,a07,poll
1,47932782100,47932783400,00000001300,a07,poll
1,47932782100,47932938200,00000156100,a07,poll
1,47932940000,47932941000,00000001000,aca,futex
1,47932974200,47932976600,00000002400,a07,poll
1,47932980000,47932982700,00000002700,a2e,sendmsg
1,47932985600,47932985700,00000000100,a00,read
1,47932990300,47933006400,00000016100,a07,poll
1,47933007500,47933008400,00000000900,aca,futex
1,47933035000,47933036900,00000001900,a07,poll
1,47933038800,47933040200,00000001400,a2e,sendmsg
1,47933046000,47933062300,00000016300,a07,poll
1,47933063400,47933064300,00000000900,aca,futex
1,47933091900,47933093600,00000001700,a07,poll
1,47933095900,47933097200,00000001300,a2e,sendmsg
1,47933098900,47933099000,00000000100,a00,read
1,47933102800,47933116000,00000013200,a07,poll
1,47933117100,47933118000,00000000900,aca,futex
1,47933142300,47933143900,00000001600,a07,poll
1,47933145700,47933147100,00000001400,a2e,sendmsg
1,47933152600,47933223600,00000071000,a07,poll
1,47933225000,47933226000,00000001000,aca,futex
1,47933228000,47933228800,00000000800,aca,futex
1,47933231500,47933232300,00000000800,aca,futex
1,47933234200,47933237400,00000003200,a2e,sendmsg
1,47933239500,47933239700,00000000200,a00,read
1,47932184000,47933247900,00001063900,ae8,epoll_wait
1,47933253900,47933257000,00000003100,a2f,recvmsg
1,47933279500,47933279900,00000000400,a2f,recvmsg
1,47933245200,47933385800,00000140600,a07,poll
1,47933396300,47933397600,00000001300,a2f,recvmsg
1,47933407200,47933482500,00000075300,a07,poll
1,47933484600,47933485600,00000001000,aca,futex
1,47933580100,47933581500,00000001400,aca,futex
1,47933638500,47933642500,00000004000,a2e,sendmsg
1,47933644700,47933644900,00000000200,a00,read
1,47933647000,47933649200,00000002200,a07,poll
1,47933658300,47933659400,00000001100,a2f,recvmsg
1,47933777400,47933777600,00000000200,a00,read
1,47933830300,47933832400,00000002100,a07,poll
1,47933853600,47933854800,00000001200,a07,poll
1,47933853600,47933976800,00000123200,a07,poll
1,47933978400,47933979400,00000001000,aca,futex
1,47934011700,47934014200,00000002500,a07,poll
1,47934017600,47934020700,00000003100,a2e,sendmsg
1,47934023000,47934023300,00000000300,a00,read
1,47934027700,47934043200,00000015500,a07,poll
1,47934044300,47934045300,00000001000,aca,futex
1,47934071200,47934073000,00000001800,a07,poll
1,47934075000,47934076600,00000001600,a2e,sendmsg
1,47934082500,47934098500,00000016000,a07,poll
1,47934099500,47934100500,00000001000,aca,futex
1,47934125700,47934127500,00000001800,a07,poll
1,47934129600,47934130900,00000001300,a2e,sendmsg
1,47934133400,47934133500,00000000100,a00,read
1,47934137200,47934150300,00000013100,a07,poll
1,47934151200,47934152100,00000000900,aca,futex
1,47934175500,47934177100,00000001600,a07,poll
1,47934178900,47934180100,00000001200,a2e,sendmsg
1,47934185400,47934250900,00000065500,a07,poll
1,47934252300,47934253200,00000000900,aca,futex
1,47934255100,47934256000,00000000900,aca,futex
1,47934258500,47934259300,00000000800,aca,futex
1,47934261100,47934264100,00000003000,a2e,sendmsg
1,47934266200,47934266200,00000000000,a00,read
1,47933379600,47934275200,00000895600,ae8,epoll_wait
1,47934280300,47934283300,00000003000,a2f,recvmsg
1,47934306200,47934306600,00000000400,a2f,recvmsg
1,47934272000,47934400700,00000128700,a07,poll
1,47934410900,47934412100,00000001200,a2f,recvmsg
1,47934421300,47934494200,00000072900,a07,poll
1,47934496100,47934497100,00000001000,aca,futex
1,47934588100,47934589500,00000001400,aca,futex
1,47934645100,47934649300,00000004200,a2e,sendmsg
1,47934651400,47934651600,00000000200,a00,read
1,47934653800,47934656200,00000002400,a07,poll
1,47934664800,47934665900,00000001100,a2f,recvmsg
1,47934780100,47934780300,00000000200,a00,read
1,47934833100,47934835200,00000002100,a07,poll
1,47934854700,47934856000,00000001300,a07,poll
1,47934854700,47934975700,00000121000,a07,poll
1,47934977500,47934978600,00000001100,aca,futex
1,47935010600,47935013200,00000002600,a07,poll
1,47935016400,47935019500,00000003100,a2e,sendmsg
1,47935021800,47935022000,00000000200,a00,read
1,47935026400,47935042500,00000016100,a07,poll
1,47934397100,47935045900,00000648800,ae8,epoll_wait
1,47935050700,47935052100,00000001400,a2f,recvmsg
1,47935061500,47935061800,00000000300,a2f,recvmsg
1,47935043600,47935098100,00000054500,aca,futex
1,47935134300,47935137100,00000002800,a07,poll
1,47935150000,47935152300,00000002300,a2e,sendmsg
1,47935095600,47935154100,00000058500,ae8,epoll_wait
1,47935157200,47935157900,00000000700,a2f,recvmsg
1,47935165400,47935165600,00000000200,a2f,recvmsg
1,47935141300,47935195200,00000053900,a07,poll
1,47935204200,47935205300,00000001100,a2f,recvmsg
1,47935214000,47935287700,00000073700,a07,poll
1,47935289800,47935290900,00000001100,aca,futex
1,47935381200,47935382600,00000001400,aca,futex
1,47935436100,47935439400,00000003300,a2e,sendmsg
1,47935441500,47935441600,00000000100,a00,read
1,47935482100,47935482200,00000000100,a00,read
1,47935506700,47935508700,00000002000,a07,poll
1,47935520600,47935541200,00000020600,a07,poll
1,47935542600,47935543600,00000001000,aca,futex
1,47935573400,47935575600,00000002200,a07,poll
1,47935578900,47935581400,00000002500,a2e,sendmsg
1,47935192700,47935583400,00000390700,ae8,epoll_wait
1,47935587500,47935588600,00000001100,a2f,recvmsg
1,47935597400,47935597700,00000000300,a2f,recvmsg
1,47935636000,47935636300,00000000300,a00,read
1,47935676900,47935678800,00000001900,a07,poll
1,47935685800,47935702800,00000017000,a07,poll
1,47935704200,47935705200,00000001000,aca,futex
1,47935732600,47935734700,00000002100,a07,poll
1,47935737500,47935740000,00000002500,a2e,sendmsg
1,47935627900,47935741700,00000113800,ae8,epoll_wait
1,47935745000,47935746000,00000001000,a2f,recvmsg
1,47935754000,47935754300,00000000300,a2f,recvmsg
1,47935732600,47935786500,00000053900,a07,poll
1,47935796500,47935797700,00000001200,a2f,recvmsg
1,47935805900,47935876900,00000071000,a07,poll
1,47935878900,47935880000,00000001100,aca,futex
1,47935969600,47935970900,00000001300,aca,futex
1,47936025400,47936028700,00000003300,a2e,sendmsg
1,47936030700,47936030900,00000000200,a00,read
1,47936040500,47936040600,00000000100,a00,read
1,47936085900,47936087900,00000002000,a07,poll
1,47936095600,47936173000,00000077400,a07,poll
1,47936174700,47936175700,00000001000,aca,futex
1,47936177800,47936178700,00000000900,aca,futex
1,47936181600,47936182500,00000000900,aca,futex
1,47936185100,47936188000,00000002900,a2e,sendmsg
1,47936190500,47936190700,00000000200,a00,read
1,47936196800,47936461700,00000264900,a07,poll
1,47936469900,47936470900,00000001000,a2f,recvmsg
1,47936478200,47936545800,00000067600,a07,poll
1,47936547400,47936548300,00000000900,aca,futex
1,47936635300,47936636500,00000001200,aca,futex
1,47936687400,47936690600,00000003200,a2e,sendmsg
1,47936692500,47936692700,00000000200,a00,read
1,47936694800,47936697000,00000002200,a07,poll
1,47936704800,47936705800,00000001000,a2f,recvmsg
1,47936798300,47936799900,00000001600,a07,poll
1,47936798300,47936927300,00000129000,a07,poll
1,47936929000,47936930000,00000001000,aca,futex
1,47936964100,47936966700,00000002600,a07,poll
1,47936970200,47936973600,00000003400,a2e,sendmsg
1,47935783500,47936975900,00001192400,ae8,epoll_wait
1,47936981000,47936982300,00000001300,a2f,recvmsg
1,47936991600,47936991900,00000000300,a2f,recvmsg
1,47936964100,47937029600,00000065500,a07,poll
1,47937038500,47937039900,00000001400,a2f,recvmsg
1,47937048100,47937121100,00000073000,a07,poll
1,47937123000,47937124100,00000001100,aca,futex
1,47937216600,47937218100,00000001500,aca,futex
1,47937271100,47937274200,00000003100,a2e,sendmsg
1,47937276200,47937276400,00000000200,a00,read
1,47937287000,47937287200,00000000200,a00,read
1,47937333300,47937335500,00000002200,a07,poll
1,47937344200,47937363200,00000019000,a07,poll
1,47937364500,47937365500,00000001000,aca,futex
1,47937409200,47937411500,00000002300,a07,poll
1,47937415000,47937417400,00000002400,a2e,sendmsg
1,47937026400,47937419300,00000392900,ae8,epoll_wait
1,47937424000,47937425300,00000001300,a2f,recvmsg
1,47937434400,47937434700,00000000300,a2f,recvmsg
1,47937476500,47937477000,00000000500,a00,read
1,47937518900,47937520900,00000002000,a07,poll
1,47937528100,47937550000,00000021900,a07,poll
1,47937551400,47937552500,00000001100,aca,futex
1,47937581900,47937584300,00000002400,a07,poll
1,47937587000,47937589300,00000002300,a2e,sendmsg
1,47937468700,47937591000,00000122300,ae8,epoll_wait
1,47937594600,47937595900,00000001300,a2f,recvmsg
1,47937604200,47937604500,00000000300,a2f,recvmsg
1,47937581900,47937635900,00000054000,a07,poll
1,47937644600,47937646100,00000001500,a2f,recvmsg
1,47937654500,47937725000,00000070500,a07,poll
1,47937726800,47937728000,00000001200,aca,futex
1,47937840200,47937840400,00000000200,a00,read
1,47937884800,47937887200,00000002400,a07,poll
1,47937895100,47937913000,00000017900,a07,poll
1,47937914200,47937915500,00000001300,aca,futex
1,47937944900,47937947000,00000002100,a07,poll
1,47937950100,47937952700,00000002600,a2e,sendmsg
1,47937633000,47937954600,00000321600,ae8,epoll_wait
1,47937958300,47937959600,00000001300,a2f,recvmsg
1,47937968100,47937968300,00000000200,a2f,recvmsg
1,47938006500,47938007000,00000000500,a00,read
1,47938047500,47938049300,00000001800,a07,poll
1,47938056400,47938131200,00000074800,a07,poll
1,47938132700,47938133800,00000001100,aca,futex
1,47938135700,47938136600,00000000900,aca,futex
1,47938139200,47938140200,00000001000,aca,futex
1,47938142200,47938146000,00000003800,a2e,sendmsg
1,47938148200,47938148500,00000000300,a00,read
1,47938154400,47938442900,00000288500,a07,poll
1,47938447700,47938448700,00000001000,a2f,recvmsg
1,47938527900,47938529600,00000001700,a07,poll
1,47938527900,47938655300,00000127400,a07,poll
1,47938656900,47938657800,00000000900,aca,futex
1,47938691100,47938693600,00000002500,a07,poll
1,47938696900,47938699800,00000002900,a2e,sendmsg
1,47937999300,47938702000,00000702700,ae8,epoll_wait
1,47938706500,47938707900,00000001400,a2f,recvmsg
1,47938717000,47938717300,00000000300,a2f,recvmsg
1,47938756700,47938757200,00000000500,a00,read
1,47938799500,47938801200,00000001700,a07,poll
1,47938809100,47938825500,00000016400,a07,poll
1,47938826800,47938827900,00000001100,aca,futex
1,47938855900,47938857900,00000002000,a07,poll
1,47938860500,47938863000,00000002500,a2e,sendmsg
1,47938749000,47938864500,00000115500,ae8,epoll_wait
1,47938868000,47938869100,00000001100,a2f,recvmsg
1,47938877400,47938877500,00000000100,a2f,recvmsg
1,47938913400,47938913700,00000000300,a00,read
1,47938953100,47938954900,00000001800,a07,poll
1,47938961700,47938981100,00000019400,a07,poll
1,47938982400,47938983400,00000001000,aca,futex
1,47939010300,47939012300,00000002000,a07,poll
1,47939014800,47939017100,00000002300,a2e,sendmsg
1,47938906300,47939018400,00000112100,ae8,epoll_wait
1,47939021800,47939022700,00000000900,a2f,recvmsg
1,47939030400,47939030500,00000000100,a2f,recvmsg
1,47939063600,47939064000,00000000400,a00,read
1,47939102100,47939103900,00000001800,a07,poll
1,47939110900,47939125800,00000014900,a07,poll
1,47939127000,47939128100,00000001100,aca,futex
1,47939154200,47939156000,00000001800,a07,poll
1,47939158600,47939160700,00000002100,a2e,sendmsg
1,47939057200,47939162100,00000104900,ae8,epoll_wait
1,47939165400,47939166300,00000000900,a2f,recvmsg
1,47939173900,47939174100,00000000200,a2f,recvmsg
1,47939207400,47939207900,00000000500,a00,read
1,47939247700,47939249500,00000001800,a07,poll
1,47939328300,47939331400,00000003100,a01,write
1,47939347800,47939348000,00000000200,a2f,recvmsg
1,47939351600,47939351800,00000000200,a2f,recvmsg
1,47939352100,47939352300,00000000200,a2f,recvmsg
1,47939355500,47939355700,00000000200,a2f,recvmsg
1,47939355900,47939356100,00000000200,a2f,recvmsg
1,47939356600,47939358900,00000002300,a07,poll
1,47939360800,47939362200,00000001400,aca,futex
1,47939364700,47939365700,00000001000,aca,futex
1,47939369300,47939370200,00000000900,aca,futex
1,47939372900,47939375900,00000003000,a2e,sendmsg
1,47939378400,47939378600,00000000200,a00,read
1,47939384900,47939416300,00000031400,a07,poll
1,47939420300,47939420400,00000000100,a2f,recvmsg
1,47939421300,47939421500,00000000200,a2f,recvmsg
1,47939421600,47939421800,00000000200,a2f,recvmsg
1,47939422800,47939423000,00000000200,a2f,recvmsg
1,47939423200,47939423300,00000000100,a2f,recvmsg
1,47939423700,47939479500,00000055800,a07,poll
1,47939481600,47939481700,00000000100,a2f,recvmsg
1,47939482300,47939482500,00000000200,a2f,recvmsg
1,47939482800,47939482900,00000000100,a2f,recvmsg
1,47939483600,47939483800,00000000200,a2f,recvmsg
1,47939484000,47939484100,00000000100,a2f,recvmsg
1,47939484300,47939541400,00000057100,a07,poll
1,47939543400,47939543600,00000000200,a2f,recvmsg
1,47939544300,47939544400,00000000100,a2f,recvmsg
1,47939544600,47939544700,00000000100,a2f,recvmsg
1,47939545400,47939545600,00000000200,a2f,recvmsg
1,47939545800,47939546000,00000000200,a2f,recvmsg
1,47939546200,47939601400,00000055200,a07,poll
1,47939603300,47939603400,00000000100,a2f,recvmsg
1,47939603900,47939604100,00000000200,a2f,recvmsg
1,47939604300,47939604500,00000000200,a2f,recvmsg
1,47939605200,47939605200,00000000000,a2f,recvmsg
1,47939605400,47939605600,00000000200,a2f,recvmsg
1,47939605800,47939663200,00000057400,a07,poll
1,47939665100,47939665200,00000000100,a2f,recvmsg
1,47939665900,47939666000,00000000100,a2f,recvmsg
1,47939666400,47939666600,00000000200,a2f,recvmsg
1,47939667300,47939667400,00000000100,a2f,recvmsg
1,47939667700,47939667900,00000000200,a2f,recvmsg
1,47939668000,47940884800,00001216800,a07,poll
1,47940890400,47940891500,00000001100,a2f,recvmsg
1,47940983200,47940985200,00000002000,a07,poll
1,47940990100,47940991300,00000001200,a03,close
1,47940983200,47940993400,00000010200,a07,poll
1,47940999100,47940999300,00000000200,a2f,recvmsg
1,47941000300,47941000500,00000000200,a2f,recvmsg
1,47941000700,47941000900,00000000200,a2f,recvmsg
1,47941002700,47941002900,00000000200,a2f,recvmsg
1,47941003100,47941003300,00000000200,a2f,recvmsg
1,47941003700,47941133900,00000130200,a07,poll
1,47941135400,47941136600,00000001200,aca,futex
1,47941172000,47941174800,00000002800,a07,poll
1,47941178500,47941181800,00000003300,a2e,sendmsg
1,47941184100,47941184300,00000000200,a00,read
1,47941188900,47941205700,00000016800,a07,poll
1,47941206900,47941208000,00000001100,aca,futex
1,47941233800,47941235700,00000001900,a07,poll
1,47941237600,47941239200,00000001600,a2e,sendmsg
1,47941244700,47941261000,00000016300,a07,poll
1,47941262400,47941263300,00000000900,aca,futex
1,47941288400,47941290100,00000001700,a07,poll
1,47941292400,47941293700,00000001300,a2e,sendmsg
1,47941295300,47941295500,00000000200,a00,read
1,47941299400,47941312100,00000012700,a07,poll
1,47941313300,47941314200,00000000900,aca,futex
1,47941337500,47941339100,00000001600,a07,poll
1,47941341000,47941342400,00000001400,a2e,sendmsg
1,47941348100,47941467000,00000118900,a07,poll
1,47941468500,47941469400,00000000900,aca,futex
1,47941471600,47941472600,00000001000,aca,futex
1,47941475000,47941476300,00000001300,aca,futex
1,47941478300,47941482200,00000003900,a2e,sendmsg
1,47941484800,47941484900,00000000100,a00,read
1,47939201000,47941494200,00002293200,ae8,epoll_wait
1,47941500800,47941504000,00000003200,a2f,recvmsg
1,47941527100,47941527400,00000000300,a2f,recvmsg
1,47941490700,47941630900,00000140200,a07,poll
1,47941676900,47941677100,00000000200,a00,read
1,47941733100,47941735100,00000002000,a07,poll
1,47941755200,47941828700,00000073500,a07,poll
1,47941829200,47941829300,00000000100,a00,read
1,47941833800,47941834800,00000001000,a2f,recvmsg
1,47941913700,47941915600,00000001900,a07,poll
1,47941913700,47942044800,00000131100,a07,poll
1,47942046500,47942047600,00000001100,aca,futex
1,47942080600,47942083400,00000002800,a07,poll
1,47942086600,47942089300,00000002700,a2e,sendmsg
1,47942091500,47942091600,00000000100,a00,read
1,47942096100,47942113200,00000017100,a07,poll
1,47942114300,47942115300,00000001000,aca,futex
1,47942141600,47942143500,00000001900,a07,poll
1,47942145500,47942147000,00000001500,a2e,sendmsg
1,47942153000,47942170000,00000017000,a07,poll
1,47942171100,47942172000,00000000900,aca,futex
1,47942198300,47942200000,00000001700,a07,poll
1,47942202100,47942203400,00000001300,a2e,sendmsg
1,47942205200,47942205300,00000000100,a00,read
1,47942209400,47942222900,00000013500,a07,poll
1,47942224000,47942224900,00000000900,aca,futex
1,47942249300,47942250900,00000001600,a07,poll
1,47942252800,47942253800,00000001000,a2e,sendmsg
1,47942259400,47942353500,00000094100,a07,poll
1,47942354900,47942355900,00000001000,aca,futex
1,47942358000,47942358800,00000000800,aca,futex
1,47942361400,47942362300,00000000900,aca,futex
1,47942364400,47942367800,00000003400,a2e,sendmsg
1,47942370200,47942370300,00000000100,a00,read
1,47941620900,47942379400,00000758500,ae8,epoll_wait
1,47942385800,47942388900,00000003100,a2f,recvmsg
1,47942411900,47942412200,00000000300,a2f,recvmsg
1,47942376100,47942508200,00000132100,a07,poll
1,47942554000,47942554000,00000000000,a00,read
1,47942610100,47942612300,00000002200,a07,poll
1,47942632000,47942714300,00000082300,a07,poll
1,47942714800,47942715000,00000000200,a00,read
1,47942719500,47942720800,00000001300,a2f,recvmsg
1,47942795900,47942797700,00000001800,a07,poll
1,47942795900,47942923200,00000127300,a07,poll
1,47942924900,47942926000,00000001100,aca,futex
1,47942957200,47942960200,00000003000,a07,poll
1,47942963400,47942966300,00000002900,a2e,sendmsg
1,47942968400,47942968500,00000000100,a00,read
1,47942972700,47942988800,00000016100,a07,poll
1,47942989800,47942990900,00000001100,aca,futex
1,47943016400,47943018100,00000001700,a07,poll
1,47943020200,47943021500,00000001300,a2e,sendmsg
1,47943027100,47943042600,00000015500,a07,poll
1,47943043800,47943044600,00000000800,aca,futex
1,47943069000,47943071000,00000002000,a07,poll
1,47943073400,47943074700,00000001300,a2e,sendmsg
1,47943076300,47943076500,00000000200,a00,read
1,47943080300,47943093000,00000012700,a07,poll
1,47943094000,47943094900,00000000900,aca,futex
1,47943118300,47943120000,00000001700,a07,poll
1,47943121700,47943122900,00000001200,a2e,sendmsg
1,47943165900,47943178900,00000013000,a2f,recvmsg
1,47943187800,47943188100,00000000300,a2f,recvmsg
1,47943193700,47943194100,00000000400,a00,read
1,47943217500,47943222200,00000004700,a14,writev
1,47943223400,47943229200,00000005800,a07,poll
1,47942505400,47943304800,00000799400,ae8,epoll_wait
1,47943311200,47943314000,00000002800,a2f,recvmsg
1,47943336300,47943336600,00000000300,a2f,recvmsg
1,47943338700,47943340600,00000001900,a2f,recvmsg
1,47943356300,47943356500,00000000200,a2f,recvmsg
1,47943456000,47943456700,00000000700,a2e,sendmsg
1,47943463900,47943464700,00000000800,a2e,sendmsg
1,47943299600,47943470300,00000170700,a07,poll
1,47943471100,47943471600,00000000500,a00,read
1,47943519200,47943519200,00000000000,a00,read
1,47943570500,47943571000,00000000500,a2f,recvmsg
1,47943607800,47943608400,00000000600,a2f,recvmsg
1,47943650500,47943652900,00000002400,a07,poll
1,47943673900,47943675400,00000001500,a07,poll
1,47943676200,47943678100,00000001900,a2f,recvmsg
1,47943690100,47943691700,00000001600,a2d,recvfrom
1,47943693300,47943693500,00000000200,a2f,recvmsg
1,47943694100,47943694300,00000000200,a2f,recvmsg
1,47943753900,47943754200,00000000300,a2f,recvmsg
1,47943755700,47943755900,00000000200,a2f,recvmsg
1,47944211400,47944212800,00000001400,a2f,recvmsg
1,47948473600,47948488400,00000014800,a14,writev
1,47948489800,47949393100,00000903300,a07,poll
1,47943467200,47949919200,00006452000,ae8,epoll_wait
1,47949937900,47949940700,00000002800,a2f,recvmsg
1,47949962100,47949962500,00000000400,a2f,recvmsg
1,47950000400,47950007600,00000007200,a2e,sendmsg
1,47949410600,47950012000,00000601400,a07,poll
1,47950014600,47950016000,00000001400,a00,read
1,47950042800,47950044500,00000001700,a2f,recvmsg
1,47950149100,47950171700,00000022600,a07,poll
1,47950181900,47950182200,00000000300,a2f,recvmsg
1,47950201900,47950202700,00000000800,a00,read
1,47950220100,47950220400,00000000300,a00,read
1,47950236400,47950237200,00000000800,a2f,recvmsg
1,47950238800,47950239000,00000000200,a2f,recvmsg
1,47950456100,47950457600,00000001500,a2f,recvmsg
1,47950461000,47961513800,00011052800,a07,poll
1,47962428500,47962441400,00000012900,a14,writev
1,47962443300,47963093100,00000649800,a07,poll
1,47963102200,47963102400,00000000200,a2f,recvmsg
1,47963104100,47963104300,00000000200,a2f,recvmsg
1,47963123400,47963124400,00000001000,a2f,recvmsg
1,47914498300,47969677200,00055178900,a4a,fsync
1,47969687000,47969714700,00000027700,a52,rename
1,47969748300,47969753600,00000005300,a09,mmap
1,47963133400,47969838100,00006704700,a07,poll
1,47969842300,47969844000,00000001700,aca,futex
1,47969848300,47969849400,00000001100,aca,futex
1,47969852200,47969853100,00000000900,aca,futex
1,47969871900,47969872200,00000000300,a00,read
1,47969877200,47969929500,00000052300,a07,poll
1,47969931100,47969932100,00000001000,aca,futex
1,47969933800,47969934800,00000001000,aca,futex
1,47969936500,47969937200,00000000700,aca,futex
1,47969939700,47969941600,00000001900,a2e,sendmsg
1,47970119800,47970129900,00000010100,a01,write
1,47950168500,47970170500,00020002000,ae8,epoll_wait
1,47970183100,47970187500,00000004400,a2f,recvmsg
1,47970208500,47970208800,00000000300,a2f,recvmsg
1,47970232100,47970238700,00000006600,a2e,sendmsg
1,47970279000,47970280000,00000001000,a2e,sendmsg
1,47969964600,47970394900,00000430300,a07,poll
1,47970441100,47970482200,00000041100,a07,poll
1,47970503600,47972563400,00002059800,a07,poll
1,47970503600,47972566800,00002063200,a07,poll
1,47972579400,47972579600,00000000200,a2f,recvmsg
1,47972583500,47972583600,00000000100,a2f,recvmsg
1,47972583900,47972584100,00000000200,a2f,recvmsg
1,47972588100,47972588300,00000000200,a2f,recvmsg
1,47972588500,47972588700,00000000200,a2f,recvmsg
1,47972603100,47972603400,00000000300,a2f,recvmsg
1,47972633400,47972645600,00000012200,a07,poll
1,47972633400,47972648000,00000014600,a07,poll
1,47972652400,47972652600,00000000200,a2f,recvmsg
1,47972653800,47972654000,00000000200,a2f,recvmsg
1,47972654200,47972654400,00000000200,a2f,recvmsg
1,47972655700,47972655800,00000000100,a2f,recvmsg
1,47972656000,47972656200,00000000200,a2f,recvmsg
1,47972659700,47972707800,00000048100,a07,poll
1,47972659700,47972709700,00000050000,a07,poll
1,47972711800,47972712000,00000000200,a2f,recvmsg
1,47972712700,47972712800,00000000100,a2f,recvmsg
1,47972713000,47972713200,00000000200,a2f,recvmsg
1,47972713900,47972714100,00000000200,a2f,recvmsg
1,47972714200,47972714400,00000000200,a2f,recvmsg
1,47972717400,47972766200,00000048800,a07,poll
1,47972766600,47972767700,00000001100,a2f,recvmsg
1,47972717400,47972769000,00000051600,a07,poll
1,47972771000,47972771200,00000000200,a2f,recvmsg
1,47972771800,47972772000,00000000200,a2f,recvmsg
1,47972772100,47972772300,00000000200,a2f,recvmsg
1,47972773000,47972773200,00000000200,a2f,recvmsg
1,47972773400,47972773500,00000000100,a2f,recvmsg
1,47972775600,47972825800,00000050200,a07,poll
1,47972775600,47972828100,00000052500,a07,poll
1,47972830100,47972830300,00000000200,a2f,recvmsg
1,47972830800,47972831000,00000000200,a2f,recvmsg
1,47972831200,47972831400,00000000200,a2f,recvmsg
1,47972832000,47972832200,00000000200,a2f,recvmsg
1,47972832400,47972832400,00000000000,a2f,recvmsg
1,47972832400,47972834400,00000002000,a2f,recvmsg
1,47972835300,47972884600,00000049300,a07,poll
1,47972884900,47972885900,00000001000,a2f,recvmsg
1,47972835300,47972887200,00000051900,a07,poll
1,47972888800,47972889000,00000000200,a2f,recvmsg
1,47972889500,47972889700,00000000200,a2f,recvmsg
1,47972889900,47972890000,00000000100,a2f,recvmsg
1,47972890900,47972891000,00000000100,a2f,recvmsg
1,47972891200,47972891400,00000000200,a2f,recvmsg
1,47972893800,47972942200,00000048400,a07,poll
1,47972945700,47972987900,00000042200,a07,poll
1,47972989100,47973032100,00000043000,a07,poll
1,47973037400,47973076300,00000038900,a07,poll
1,47973077500,47973121600,00000044100,a07,poll
1,47973122900,47973165200,00000042300,a07,poll
1,47973167400,47973220300,00000052900,a07,poll
1,47973221800,47973238900,00000017100,a07,poll
1,47973240300,47973255300,00000015000,a07,poll
1,47973256700,47973271300,00000014600,a07,poll
1,47973272700,47973286100,00000013400,a07,poll
1,47973287400,47973301700,00000014300,a07,poll
1,47973303000,47973328500,00000025500,a07,poll
1,47973328800,47973330500,00000001700,a2f,recvmsg
1,47973335000,47973336300,00000001300,a2d,recvfrom
1,47973341700,47973341900,00000000200,a2f,recvmsg
1,47973342600,47973342700,00000000100,a2f,recvmsg
1,47973415700,47973416000,00000000300,a2f,recvmsg
1,47973418900,47973419100,00000000200,a2f,recvmsg
1,47973422500,47973619000,00000196500,a07,poll
1,47973623300,47973623600,00000000300,a2f,recvmsg
1,47973624700,47973624800,00000000100,a2f,recvmsg
1,47973625000,47973625200,00000000200,a2f,recvmsg
1,47973626300,47973626400,00000000100,a2f,recvmsg
1,47973626600,47973626700,00000000100,a2f,recvmsg
1,47973627100,47974450900,00000823800,a07,poll
1,47970284700,47975880000,00005595300,ae8,epoll_wait
1,47975891300,47975893300,00000002000,a2f,recvmsg
1,47975907200,47975907500,00000000300,a2f,recvmsg
1,47975930600,47975934600,00000004000,a2e,sendmsg
1,47974525200,47975937700,00001412500,a07,poll
1,47975939500,47975940100,00000000600,a00,read
1,47975955000,47975956200,00000001200,a2f,recvmsg
1,47976894000,47976894200,00000000200,a0c,brk
1,47976904600,47976907300,00000002700,a15,access
1,47976908000,47976909100,00000001100,a09,mmap
1,47976913100,47976915500,00000002400,a15,access
1,47976922300,47976923300,00000001000,a09,mmap
1,47976927000,47976927600,00000000600,a15,access
1,47976935200,47976936200,00000001000,a00,read
1,47976937700,47976939300,00000001600,a09,mmap
1,47976943400,47976945700,00000002300,a09,mmap
1,47976957400,47976958100,00000000700,a15,access
1,47976961400,47976962200,00000000800,a00,read
1,47976966400,47976967800,00000001400,a09,mmap
1,47976976500,47976977100,00000000600,a15,access
1,47976980400,47976981100,00000000700,a00,read
1,47976981800,47976982500,00000000700,a09,mmap
1,47976984000,47976986100,00000002100,a09,mmap
1,47976990800,47976994200,00000003400,a09,mmap
1,47976996400,47976997500,00000001100,a09,mmap
1,47977007000,47977007800,00000000800,a15,access
1,47977010500,47977011700,00000001200,a00,read
1,47977012400,47977014100,00000001700,a09,mmap
1,47977017100,47977018900,00000001800,a09,mmap
1,47977027300,47977027900,00000000600,a15,access
1,47977031000,47977031600,00000000600,a00,read
1,47977032300,47977033800,00000001500,a09,mmap
1,47977037400,47977039800,00000002400,a09,mmap
1,47977048500,47977049200,00000000700,a15,access
1,47977051800,47977052300,00000000500,a00,read
1,47977052700,47977053800,00000001100,a09,mmap
1,47977055100,47977056400,00000001300,a09,mmap
1,47977059400,47977060700,00000001300,a09,mmap
1,47977066900,47977067500,00000000600,a15,access
1,47977069900,47977070500,00000000600,a00,read
1,47977071200,47977072600,00000001400,a09,mmap
1,47977074900,47977076600,00000001700,a09,mmap
1,47977091300,47977092000,00000000700,a09,mmap
1,47977095800,47977096000,00000000200,a09,mmap
1,47977097200,47977097500,00000000300,a09,mmap
1,47977290900,47977291000,00000000100,a0c,brk
1,47977291100,47977291900,00000000800,a0c,brk
1,47977327300,47977328200,00000000900,a00,read
1,47977340100,47977341600,00000001500,a00,read
1,47977402000,47977403100,00000001100,a00,read
1,47977527300,47977528100,00000000800,a00,read
1,47977600900,47977601400,00000000500,a00,read
1,47977688300,47977689000,00000000700,a00,read
1,47977820000,47977820900,00000000900,a00,read
1,47977951400,47977952100,00000000700,a00,read
1,47978109600,47978110300,00000000700,a00,read
1,47978264100,47978264800,00000000700,a00,read
1,47978302300,47978303600,00000001300,a0c,brk
1,47978421100,47978421900,00000000800,a00,read
1,47978572300,47978573000,00000000700,a00,read
1,47978729400,47978730100,00000000700,a00,read
1,47978892000,47978892800,00000000800,a00,read
1,47979002900,47979003600,00000000700,a00,read
1,47979034900,47979035800,00000000900,a0c,brk
1,47979145100,47979145900,00000000800,a00,read
1,47979392700,47979393200,00000000500,a00,read
1,47979405500,47979405900,00000000400,a00,read
1,47979449900,47979450200,00000000300,a00,read
1,47979469900,47979470600,00000000700,a00,read
1,47979678200,47979678600,00000000400,a00,read
1,47979707600,47979708500,00000000900,a00,read
1,47979805600,47979806400,00000000800,a00,read
1,47979830200,47979831500,00000001300,a0c,brk
1,47979876300,47979876800,00000000500,a00,read
1,47979952600,47979953500,00000000900,a00,read
1,47980105600,47980106200,00000000600,a00,read
1,47980218400,47980219000,00000000600,a00,read
1,47980312700,47980313000,00000000300,a00,read
1,47980326000,47980326500,00000000500,a00,read
1,47980406200,47980406600,00000000400,a00,read
1,47980430500,47980430800,00000000300,a00,read
1,47980452600,47980453200,00000000600,a00,read
1,47980554300,47980555400,00000001100,a0c,brk
1,47980556400,47980557400,00000001000,a00,read
1,47980757300,47980757900,00000000600,a00,read
1,47980841000,47980841600,00000000600,a00,read
1,47980904900,47980905500,00000000600,a00,read
1,47981035000,47981035400,00000000400,a00,read
1,47981067200,47981067800,00000000600,a00,read
1,47981087100,47981088800,00000001700,a02,open
1,47981199100,47981199700,00000000600,a00,read
1,47981269600,47981270100,00000000500,a00,read
1,47981322000,47981323100,00000001100,a0c,brk
1,47981329200,47981329900,00000000700,a00,read
1,47985448000,47985448600,00000000600,a00,read
1,47985599500,47985600700,00000001200,a00,read
1,47985730200,47985730900,00000000700,a00,read
1,47985788700,47985789400,00000000700,a00,read
1,47985846400,47985847200,00000000800,a00,read
1,47985916600,47985917400,00000000800,a00,read
1,47985970000,47985970600,00000000600,a00,read
1,47986058700,47986059600,00000000900,a0c,brk
1,47986090600,47986094000,00000003400,a0c,brk
1,47986108400,47986109100,00000000700,a00,read
1,47986224600,47986225500,00000000900,a00,read
1,47986384100,47986384800,00000000700,a00,read
0,47912375200,47927433400,00015058200,a17,select
0,47927453200,47927453400,00000000200,a2f,recvmsg
0,47927456200,47930076200,00002620000,a17,select
0,47930081000,47930083100,00000002100,a14,writev
0,47930083300,47930083500,00000000200,a2f,recvmsg
0,47930084500,47930093300,00000008800,a17,select
0,47930096400,47930098400,00000002000,a14,writev
0,47930098700,47930098800,00000000100,a2f,recvmsg
0,47930099600,47930108700,00000009100,a17,select
0,47930112100,47930114000,00000001900,a14,writev
0,47930114300,47930114400,00000000100,a2f,recvmsg
0,47930115100,47930124200,00000009100,a17,select
0,47930127800,47930129700,00000001900,a14,writev
0,47930130000,47930130200,00000000200,a2f,recvmsg
0,47930130700,47930138400,00000007700,a17,select
0,47930141300,47930143000,00000001700,a14,writev
0,47930143300,47930143500,00000000200,a2f,recvmsg
0,47930144100,47930163500,00000019400,a17,select
0,47930166500,47930168400,00000001900,a14,writev
0,47930168600,47930168800,00000000200,a2f,recvmsg
0,47930169400,47930180000,00000010600,a17,select
0,47930182800,47930184400,00000001600,a14,writev
0,47930184700,47930184900,00000000200,a2f,recvmsg
0,47930185600,47930193500,00000007900,a17,select
0,47930196000,47930197700,00000001700,a14,writev
0,47930198000,47930198200,00000000200,a2f,recvmsg
0,47930198800,47930207300,00000008500,a17,select
0,47930209800,47930211400,00000001600,a14,writev
0,47930211700,47930211800,00000000100,a2f,recvmsg
0,47930212300,47930221200,00000008900,a17,select
0,47930223700,47930225400,00000001700,a14,writev
0,47930225600,47930225800,00000000200,a2f,recvmsg
0,47930226300,47930234900,00000008600,a17,select
0,47930237200,47930238900,00000001700,a14,writev
0,47930239000,47930239200,00000000200,a2f,recvmsg
0,47930239700,47930248100,00000008400,a17,select
0,47930250700,47930252300,00000001600,a14,writev
0,47930252500,47930252700,00000000200,a2f,recvmsg
0,47930253200,47930261000,00000007800,a17,select
0,47930263300,47930264800,00000001500,a14,writev
0,47930265100,47930265200,00000000100,a2f,recvmsg
0,47930265700,47930275300,00000009600,a17,select
0,47930278200,47930279800,00000001600,a14,writev
0,47930280000,47930280200,00000000200,a2f,recvmsg
0,47930280700,47930289300,00000008600,a17,select
0,47930291700,47930293300,00000001600,a14,writev
0,47930293500,47930293700,00000000200,a2f,recvmsg
0,47930294100,47930302500,00000008400,a17,select
0,47930304900,47930306400,00000001500,a14,writev
0,47930306700,47930306800,00000000100,a2f,recvmsg
0,47930307300,47930317200,00000009900,a17,select
0,47930319800,47930321200,00000001400,a14,writev
0,47930321500,47930321700,00000000200,a2f,recvmsg
0,47930322200,47930330400,00000008200,a17,select
0,47930332700,47930334200,00000001500,a14,writev
0,47930334500,47930334600,00000000100,a2f,recvmsg
0,47930335200,47930343400,00000008200,a17,select
0,47930345800,47930347200,00000001400,a14,writev
0,47930347500,47930347700,00000000200,a2f,recvmsg
0,47930348200,47930356400,00000008200,a17,select
0,47930358800,47930360500,00000001700,a14,writev
0,47930360600,47930360800,00000000200,a2f,recvmsg
0,47930361300,47930369000,00000007700,a17,select
0,47930371500,47930372900,00000001400,a14,writev
0,47930373200,47930373400,00000000200,a2f,recvmsg
0,47930373800,47930384500,00000010700,a17,select
0,47930386900,47930388500,00000001600,a14,writev
0,47930388800,47930389000,00000000200,a2f,recvmsg
0,47930389400,47930397100,00000007700,a17,select
0,47930399500,47930400900,00000001400,a14,writev
0,47930401200,47930401400,00000000200,a2f,recvmsg
0,47930401900,47930409600,00000007700,a17,select
0,47930411800,47930413400,00000001600,a14,writev
0,47930413700,47930413800,00000000100,a2f,recvmsg
0,47930414300,47930422200,00000007900,a17,select
0,47930424700,47930426100,00000001400,a14,writev
0,47930426400,47930426500,00000000100,a2f,recvmsg
0,47930427000,47930436100,00000009100,a17,select
0,47930438400,47930440000,00000001600,a14,writev
0,47930440300,47930440300,00000000000,a2f,recvmsg
0,47930440900,47930448700,00000007800,a17,select
0,47930451000,47930452400,00000001400,a14,writev
0,47930452700,47930452900,00000000200,a2f,recvmsg
0,47930453400,47930461800,00000008400,a17,select
0,47930464100,47930465600,00000001500,a14,writev
0,47930465800,47930466000,00000000200,a2f,recvmsg
0,47930466600,47930474800,00000008200,a17,select
0,47930477200,47930478600,00000001400,a14,writev
0,47930478900,47930479100,00000000200,a2f,recvmsg
0,47930479600,47930489400,00000009800,a17,select
0,47930491900,47930493500,00000001600,a14,writev
0,47930493700,47930493900,00000000200,a2f,recvmsg
0,47930494400,47930503000,00000008600,a17,select
0,47930505300,47930506800,00000001500,a14,writev
0,47930506900,47930507100,00000000200,a2f,recvmsg
0,47930507700,47930516300,00000008600,a17,select
0,47930518700,47930520400,00000001700,a14,writev
0,47930520700,47930520800,00000000100,a2f,recvmsg
0,47930521400,47930531700,00000010300,a17,select
0,47930534200,47930535600,00000001400,a14,writev
0,47930535900,47930536100,00000000200,a2f,recvmsg
0,47930536600,47930545400,00000008800,a17,select
0,47930547800,47930549300,00000001500,a14,writev
0,47930549600,47930549700,00000000100,a2f,recvmsg
0,47930550300,47930558200,00000007900,a17,select
0,47930560700,47930562100,00000001400,a14,writev
0,47930562400,47930562600,00000000200,a2f,recvmsg
0,47930563100,47930573000,00000009900,a17,select
0,47930575300,47930576900,00000001600,a14,writev
0,47930577100,47930577300,00000000200,a2f,recvmsg
0,47930577800,47930586900,00000009100,a17,select
0,47930589400,47930590800,00000001400,a14,writev
0,47930591100,47930591300,00000000200,a2f,recvmsg
0,47930591800,47930600500,00000008700,a17,select
0,47930603000,47930604600,00000001600,a14,writev
0,47930604800,47930605000,00000000200,a2f,recvmsg
0,47930605500,47930613800,00000008300,a17,select
0,47930616300,47930617800,00000001500,a14,writev
0,47930618000,47930618200,00000000200,a2f,recvmsg
0,47930618800,47930626800,00000008000,a17,select
0,47930629300,47930630800,00000001500,a14,writev
0,47930631100,47930631200,00000000100,a2f,recvmsg
0,47930631800,47930639600,00000007800,a17,select
0,47930641800,47930643300,00000001500,a14,writev
0,47930643600,47930643600,00000000000,a2f,recvmsg
0,47930644200,47930652500,00000008300,a17,select
0,47930654900,47930656400,00000001500,a14,writev
0,47930656700,47930656800,00000000100,a2f,recvmsg
0,47930657300,47930676300,00000019000,a17,select
0,47930678600,47930680000,00000001400,a14,writev
0,47930680300,47930680400,00000000100,a2f,recvmsg
0,47930681000,47930713500,00000032500,a17,select
0,47930716100,47930717600,00000001500,a14,writev
0,47930717800,47930718000,00000000200,a2f,recvmsg
0,47930718500,47930737400,00000018900,a17,select
0,47930739800,47930741200,00000001400,a14,writev
0,47930741500,47930741700,00000000200,a2f,recvmsg
0,47930742200,47930750000,00000007800,a17,select
0,47930752300,47930753800,00000001500,a14,writev
0,47930754100,47930754200,00000000100,a2f,recvmsg
0,47930754800,47930762300,00000007500,a17,select
0,47930764600,47930766100,00000001500,a14,writev
0,47930766300,47930766500,00000000200,a2f,recvmsg
0,47930767000,47930774600,00000007600,a17,select
0,47930776900,47930778500,00000001600,a14,writev
0,47930778600,47930778800,00000000200,a2f,recvmsg
0,47930779300,47930787000,00000007700,a17,select
0,47930789400,47930790800,00000001400,a14,writev
0,47930791000,47930791200,00000000200,a2f,recvmsg
0,47930791700,47930799400,00000007700,a17,select
0,47930801700,47930803200,00000001500,a14,writev
0,47930803400,47930803600,00000000200,a2f,recvmsg
0,47930804100,47930811700,00000007600,a17,select
0,47930814100,47930815500,00000001400,a14,writev
0,47930815700,47930815900,00000000200,a2f,recvmsg
0,47930816400,47930824800,00000008400,a17,select
0,47930827300,47930828800,00000001500,a14,writev
0,47930829100,47930829300,00000000200,a2f,recvmsg
0,47930829800,47930837500,00000007700,a17,select
0,47930839900,47930841300,00000001400,a14,writev
0,47930841600,47930841700,00000000100,a2f,recvmsg
0,47930842300,47930852600,00000010300,a17,select
0,47930854900,47930856500,00000001600,a14,writev
0,47930856700,47930856900,00000000200,a2f,recvmsg
0,47930857400,47930867800,00000010400,a17,select
0,47930870500,47930871800,00000001300,a14,writev
0,47930872100,47930872300,00000000200,a2f,recvmsg
0,47930872800,47930881100,00000008300,a17,select
0,47930883400,47930884900,00000001500,a14,writev
0,47930885100,47930885300,00000000200,a2f,recvmsg
0,47930885800,47930893800,00000008000,a17,select
0,47930896100,47930897600,00000001500,a14,writev
0,47930897800,47930898000,00000000200,a2f,recvmsg
0,47930898400,47930906400,00000008000,a17,select
0,47930908600,47930910100,00000001500,a14,writev
0,47930910400,47930910600,00000000200,a2f,recvmsg
0,47930911100,47930919000,00000007900,a17,select
0,47930921300,47930922800,00000001500,a14,writev
0,47930922900,47930923100,00000000200,a2f,recvmsg
0,47930923600,47930932300,00000008700,a17,select
0,47930934600,47930936200,00000001600,a14,writev
0,47930936400,47930936500,00000000100,a2f,recvmsg
0,47930937100,47930945300,00000008200,a17,select
0,47930947600,47930949100,00000001500,a14,writev
0,47930949300,47930949500,00000000200,a2f,recvmsg
0,47930949900,47930957900,00000008000,a17,select
0,47930960300,47930961800,00000001500,a14,writev
0,47930962100,47930962300,00000000200,a2f,recvmsg
0,47930962800,47930970600,00000007800,a17,select
0,47930973000,47930974400,00000001400,a14,writev
0,47930974700,47930974800,00000000100,a2f,recvmsg
0,47930975400,47930983200,00000007800,a17,select
0,47930985500,47930987000,00000001500,a14,writev
0,47930987300,47930987500,00000000200,a2f,recvmsg
0,47930987900,47930995900,00000008000,a17,select
0,47930998300,47930999700,00000001400,a14,writev
0,47931000000,47931000100,00000000100,a2f,recvmsg
0,47931000700,47931009000,00000008300,a17,select
0,47931011400,47931013000,00000001600,a14,writev
0,47931013300,47931013400,00000000100,a2f,recvmsg
0,47931014000,47931021800,00000007800,a17,select
0,47931024200,47931025600,00000001400,a14,writev
0,47931025900,47931026100,00000000200,a2f,recvmsg
0,47931026600,47931034500,00000007900,a17,select
0,47931036800,47931038400,00000001600,a14,writev
0,47931038600,47931038800,00000000200,a2f,recvmsg
0,47931039300,47931047100,00000007800,a17,select
0,47931049500,47931050900,00000001400,a14,writev
0,47931051200,47931051400,00000000200,a2f,recvmsg
0,47931051900,47931066000,00000014100,a17,select
0,47931068400,47931070000,00000001600,a14,writev
0,47931070200,47931070400,00000000200,a2f,recvmsg
0,47931070900,47931079100,00000008200,a17,select
0,47931081400,47931082800,00000001400,a14,writev
0,47931083000,47931083200,00000000200,a2f,recvmsg
0,47931083700,47931091600,00000007900,a17,select
0,47931093900,47931095400,00000001500,a14,writev
0,47931095700,47931095800,00000000100,a2f,recvmsg
0,47931096300,47931104400,00000008100,a17,select
0,47931106700,47931108200,00000001500,a14,writev
0,47931108400,47931108600,00000000200,a2f,recvmsg
0,47931109100,47931117200,00000008100,a17,select
0,47931119500,47931121000,00000001500,a14,writev
0,47931121300,47931121500,00000000200,a2f,recvmsg
0,47931122000,47931179000,00000057000,a17,select
0,47931180400,47931181700,00000001300,a2f,recvmsg
0,47931267200,47931270300,00000003100,a14,writev
0,47931270600,47931273500,00000002900,a14,writev
0,47931355500,47931357200,00000001700,a14,writev
0,47931416900,47931418600,00000001700,a14,writev
0,47931418800,47931420300,00000001500,a14,writev
0,47931475400,47931477100,00000001700,a14,writev
0,47931477300,47931478800,00000001500,a14,writev
0,47931534900,47931536600,00000001700,a14,writev
0,47931536800,47931538400,00000001600,a14,writev
0,47931594000,47931595800,00000001800,a14,writev
0,47931596100,47931597500,00000001400,a14,writev
0,47931602400,47931603200,00000000800,a2f,recvmsg
0,47931653100,47931655300,00000002200,a14,writev
0,47931697900,47931699400,00000001500,a14,writev
0,47931742600,47931744300,00000001700,a14,writev
0,47931786600,47931788100,00000001500,a14,writev
0,47931830500,47931832300,00000001800,a14,writev
0,47931874800,47931876300,00000001500,a14,writev
0,47931902600,47931905100,00000002500,a2f,recvmsg
0,47931929900,47931931500,00000001600,a14,writev
0,47931949100,47931951100,00000002000,a14,writev
0,47931966400,47931967900,00000001500,a14,writev
0,47931981600,47931983400,00000001800,a14,writev
0,47931997200,47931999000,00000001800,a14,writev
0,47932012800,47932014300,00000001500,a14,writev
0,47932018200,47932020100,00000001900,a14,writev
0,47932020400,47932020600,00000000200,a2f,recvmsg
0,47932021300,47932021800,00000000500,a14,writev
0,47932042400,47932043800,00000001400,a14,writev
0,47932044200,47932044400,00000000200,a2f,recvmsg
0,47932056600,47932058300,00000001700,a14,writev
0,47932060800,47932060900,00000000100,a2f,recvmsg
0,47929608800,47932068300,00002459500,a07,poll
0,47932073200,47932081200,00000008000,a2f,recvmsg
0,47932094500,47932094700,00000000200,a2f,recvmsg
0,47932123100,47932127800,00000004700,a07,poll
0,47932133500,47932142000,00000008500,a2f,recvmsg
0,47932156100,47932156400,00000000300,a2f,recvmsg
0,47932181400,47932186500,00000005100,a07,poll
0,47932192500,47932201800,00000009300,a2f,recvmsg
0,47932215800,47932216000,00000000200,a2f,recvmsg
0,47932061400,47932247300,00000185900,a17,select
0,47932264300,47932266000,00000001700,a14,writev
0,47932266400,47932266600,00000000200,a2f,recvmsg
0,47932280400,47932281400,00000001000,a14,writev
0,47932281800,47932282100,00000000300,a2f,recvmsg
0,47932294300,47932295500,00000001200,a14,writev
0,47932295800,47932295900,00000000100,a2f,recvmsg
0,47932241900,47932301000,00000059100,a07,poll
0,47932302600,47932303800,00000001200,a2f,recvmsg
0,47932313400,47932314400,00000001000,a2d,recvfrom
0,47932315800,47932315900,00000000100,a2f,recvmsg
0,47932316600,47932316800,00000000200,a2f,recvmsg
0,47932366200,47932366600,00000000400,a2f,recvmsg
0,47932369400,47932369600,00000000200,a2f,recvmsg
0,47932372300,47932376400,00000004100,a07,poll
0,47932377500,47932378900,00000001400,a2f,recvmsg
0,47932391400,47932392400,00000001000,a2d,recvfrom
0,47932393600,47932393800,00000000200,a2f,recvmsg
0,47932394900,47932395100,00000000200,a2f,recvmsg
0,47932435600,47932436000,00000000400,a2f,recvmsg
0,47932439300,47932439400,00000000100,a2f,recvmsg
0,47932444000,47932448600,00000004600,a07,poll
0,47932450300,47932452800,00000002500,a2f,recvmsg
0,47932467000,47932467700,00000000700,a2d,recvfrom
0,47932469500,47932469600,00000000100,a2f,recvmsg
0,47932470400,47932470600,00000000200,a2f,recvmsg
0,47932510400,47932510600,00000000200,a2f,recvmsg
0,47932513200,47932513300,00000000100,a2f,recvmsg
0,47929552400,47932940500,00003388100,ae8,epoll_wait
0,47932953500,47932955100,00000001600,a2f,recvmsg
0,47932968900,47932969200,00000000300,a2f,recvmsg
0,47933036100,47933041200,00000005100,a2e,sendmsg
0,47932518300,47933054400,00000536100,a07,poll
0,47933074700,47933075900,00000001200,a2f,recvmsg
0,47933156800,47933159300,00000002500,a07,poll
0,47933156800,47933310300,00000153500,a07,poll
0,47933312500,47933313700,00000001200,aca,futex
0,47933315900,47933316900,00000001000,aca,futex
0,47933318600,47933319300,00000000700,aca,futex
0,47933323000,47933326300,00000003300,a2e,sendmsg
0,47933329000,47933329300,00000000300,a00,read
0,47933050200,47933353300,00000303100,ae8,epoll_wait
0,47933360000,47933361800,00000001800,a2f,recvmsg
0,47933381600,47933381900,00000000300,a2f,recvmsg
0,47933420400,47933424500,00000004100,a2e,sendmsg
0,47932296400,47933436700,00001140300,a17,select
0,47933456900,47933459000,00000002100,a14,writev
0,47933459800,47933460100,00000000300,a2f,recvmsg
0,47933462200,47933651600,00000189400,a17,select
0,47933660900,47933662500,00000001600,a14,writev
0,47933662700,47933664100,00000001400,a14,writev
0,47933664500,47933664600,00000000100,a2f,recvmsg
0,47933665400,47933697700,00000032300,a17,select
0,47933704900,47933706400,00000001500,a14,writev
0,47933706600,47933707800,00000001200,a14,writev
0,47933708200,47933708300,00000000100,a2f,recvmsg
0,47933428200,47933805600,00000377400,ae8,epoll_wait
0,47933810100,47933811200,00000001100,a2f,recvmsg
0,47933819200,47933819500,00000000300,a2f,recvmsg
0,47933858800,47933860800,00000002000,a2e,sendmsg
0,47933351100,47933867400,00000516300,a07,poll
0,47933877300,47933878000,00000000700,a2f,recvmsg
0,47933933900,47933935800,00000001900,a07,poll
0,47933933900,47934073800,00000139900,a07,poll
0,47934075500,47934076800,00000001300,aca,futex
0,47934078900,47934079900,00000001000,aca,futex
0,47934081400,47934082200,00000000800,aca,futex
0,47934085400,47934088100,00000002700,a2e,sendmsg
0,47934090700,47934090900,00000000200,a00,read
0,47933865400,47934111200,00000245800,ae8,epoll_wait
0,47934115300,47934116800,00000001500,a2f,recvmsg
0,47934136600,47934136800,00000000200,a2f,recvmsg
0,47934165800,47934169100,00000003300,a2e,sendmsg
0,47933708900,47936050700,00002341800,a17,select
0,47936064600,47936064900,00000000300,a2f,recvmsg
0,47936066900,47938060300,00001993400,a17,select
0,47938064600,47938066400,00000001800,a14,writev
0,47938066800,47938066900,00000000100,a2f,recvmsg
0,47938067700,47938131100,00000063400,a17,select
0,47938134300,47938135800,00000001500,a14,writev
0,47938136100,47938136200,00000000100,a2f,recvmsg
0,47938136900,47954432800,00016295900,a17,select
0,47954447500,47954450500,00000003000,a14,writev
0,47954451400,47954451700,00000000300,a2f,recvmsg
0,47954454300,47954468100,00000013800,a17,select
0,47954472500,47954474400,00000001900,a14,writev
0,47954474700,47954475000,00000000300,a2f,recvmsg
0,47954475600,47954485600,00000010000,a17,select
0,47954489100,47954490900,00000001800,a14,writev
0,47954491100,47954491400,00000000300,a2f,recvmsg
0,47954492000,47954501500,00000009500,a17,select
0,47954504900,47954506500,00000001600,a14,writev
0,47954506800,47954506900,00000000100,a2f,recvmsg
0,47954507500,47954517500,00000010000,a17,select
0,47954521000,47954522700,00000001700,a14,writev
0,47954522800,47954523000,00000000200,a2f,recvmsg
0,47954523600,47954531800,00000008200,a17,select
0,47954534700,47954536200,00000001500,a14,writev
0,47954536400,47954536600,00000000200,a2f,recvmsg
0,47954537100,47954556600,00000019500,a17,select
0,47954559500,47954561000,00000001500,a14,writev
0,47954561300,47954561400,00000000100,a2f,recvmsg
0,47954561900,47954573500,00000011600,a17,select
0,47954576100,47954577800,00000001700,a14,writev
0,47954577900,47954578100,00000000200,a2f,recvmsg
0,47954578700,47954586900,00000008200,a17,select
0,47954589500,47954591100,00000001600,a14,writev
0,47954591200,47954591400,00000000200,a2f,recvmsg
0,47954591900,47954601400,00000009500,a17,select
0,47954603800,47954605300,00000001500,a14,writev
0,47954605600,47954605700,00000000100,a2f,recvmsg
0,47954606300,47954615600,00000009300,a17,select
0,47954618200,47954619800,00000001600,a14,writev
0,47954620000,47954620200,00000000200,a2f,recvmsg
0,47954620700,47954629900,00000009200,a17,select
0,47954632400,47954633900,00000001500,a14,writev
0,47954634200,47954634400,00000000200,a2f,recvmsg
0,47954634900,47954643100,00000008200,a17,select
0,47954645900,47954647400,00000001500,a14,writev
0,47954647600,47954647800,00000000200,a2f,recvmsg
0,47954648200,47954656800,00000008600,a17,select
0,47954659400,47954661000,00000001600,a14,writev
0,47954661200,47954661400,00000000200,a2f,recvmsg
0,47954661800,47954671600,00000009800,a17,select
0,47954674400,47954675900,00000001500,a14,writev
0,47954676200,47954676300,00000000100,a2f,recvmsg
0,47954676800,47954685100,00000008300,a17,select
0,47954687700,47954689100,00000001400,a14,writev
0,47954689400,47954689500,00000000100,a2f,recvmsg
0,47954690000,47954698300,00000008300,a17,select
0,47954700800,47954702200,00000001400,a14,writev
0,47954702500,47954702700,00000000200,a2f,recvmsg
0,47954703200,47954711300,00000008100,a17,select
0,47954713800,47954715300,00000001500,a14,writev
0,47954715500,47954715700,00000000200,a2f,recvmsg
0,47954716200,47954725200,00000009000,a17,select
0,47954727500,47954729000,00000001500,a14,writev
0,47954729200,47954729400,00000000200,a2f,recvmsg
0,47954729900,47954738300,00000008400,a17,select
0,47954740800,47954742200,00000001400,a14,writev
0,47954742500,47954742700,00000000200,a2f,recvmsg
0,47954743200,47954751200,00000008000,a17,select
0,47954753700,47954755300,00000001600,a14,writev
0,47954755500,47954755700,00000000200,a2f,recvmsg
0,47954756200,47954764100,00000007900,a17,select
0,47954766500,47954767900,00000001400,a14,writev
0,47954768200,47954768400,00000000200,a2f,recvmsg
0,47954768900,47954778900,00000010000,a17,select
0,47954781300,47954782800,00000001500,a14,writev
0,47954783000,47954783100,00000000100,a2f,recvmsg
0,47954783600,47954791200,00000007600,a17,select
0,47954793800,47954795400,00000001600,a14,writev
0,47954795600,47954795800,00000000200,a2f,recvmsg
0,47954796300,47954803900,00000007600,a17,select
0,47954806300,47954807800,00000001500,a14,writev
0,47954808000,47954808100,00000000100,a2f,recvmsg
0,47954808700,47954816400,00000007700,a17,select
0,47954819100,47954820500,00000001400,a14,writev
0,47954820800,47954820900,00000000100,a2f,recvmsg
0,47954821400,47954829600,00000008200,a17,select
0,47954832000,47954833500,00000001500,a14,writev
0,47954833700,47954833900,00000000200,a2f,recvmsg
0,47954834400,47954842200,00000007800,a17,select
0,47954844700,47954846100,00000001400,a14,writev
0,47954846400,47954846600,00000000200,a2f,recvmsg
0,47954847100,47954855700,00000008600,a17,select
0,47954858300,47954859700,00000001400,a14,writev
0,47954859900,47954860100,00000000200,a2f,recvmsg
0,47954860600,47954868900,00000008300,a17,select
0,47954871400,47954872800,00000001400,a14,writev
0,47954873100,47954873300,00000000200,a2f,recvmsg
0,47954873800,47954882600,00000008800,a17,select
0,47954885200,47954886700,00000001500,a14,writev
0,47954886900,47954887100,00000000200,a2f,recvmsg
0,47954887600,47954897000,00000009400,a17,select
0,47954899300,47954900800,00000001500,a14,writev
0,47954901000,47954901100,00000000100,a2f,recvmsg
0,47934165800,47970844400,00036678600,a2e,sendmsg
0,47970854800,47970855200,00000000400,a00,read
0,47970847600,47970955200,00000107600,ae8,epoll_wait
0,47970957800,47970959500,00000001700,a2f,recvmsg
0,47970966500,47970966700,00000000200,a2f,recvmsg
0,47971001700,47971003800,00000002100,a2e,sendmsg
0,47970875300,47971009100,00000133800,a07,poll
0,47971016100,47971016700,00000000600,a2f,recvmsg
0,47971062800,47971064300,00000001500,a07,poll
0,47971062800,47971169800,00000107000,a07,poll
0,47971171200,47971172400,00000001200,aca,futex
0,47971174300,47971175000,00000000700,aca,futex
0,47971176300,47971177100,00000000800,aca,futex
0,47971179400,47971182000,00000002600,a2e,sendmsg
0,47971007300,47971183600,00000176300,ae8,epoll_wait
0,47971187100,47971188300,00000001200,a2f,recvmsg
0,47971206300,47971206500,00000000200,a2f,recvmsg
0,47971231700,47971233700,00000002000,a2e,sendmsg
0,47971243500,47971243900,00000000400,a00,read
0,47971236400,47971745600,00000509200,ae8,epoll_wait
0,47971748200,47971749600,00000001400,a2f,recvmsg
0,47971756500,47971756700,00000000200,a2f,recvmsg
0,47971792800,47971794900,00000002100,a2e,sendmsg
0,47971264200,47971800300,00000536100,a07,poll
0,47971807600,47971808200,00000000600,a2f,recvmsg
0,47971856100,47971857600,00000001500,a07,poll
0,47971856100,47971962900,00000106800,a07,poll
0,47971964500,47971965500,00000001000,aca,futex
0,47971967500,47971968400,00000000900,aca,futex
0,47971969700,47971970500,00000000800,aca,futex
0,47971972900,47971975400,00000002500,a2e,sendmsg
0,47971798500,47971976700,00000178200,ae8,epoll_wait
0,47971980200,47971981300,00000001100,a2f,recvmsg
0,47971998100,47971998300,00000000200,a2f,recvmsg
0,47972024100,47972026000,00000001900,a2e,sendmsg
0,47972036500,47972036900,00000000400,a00,read
0,47295175100,47972068300,00676893200,a3d,wait4
0,47972096600,47972102900,00000006300,a00,read
0,47972105400,47972105900,00000000500,a00,read
0,47954887600,47972135200,00017247600,a17,select
0,47972155200,47972155400,00000000200,a2f,recvmsg
0,47972174800,47972175100,00000000300,a2f,recvmsg
0,47972175800,47972176100,00000000300,a2f,recvmsg
0,47972159300,47972187100,00000027800,a17,select
0,47972192900,47972193100,00000000200,a2f,recvmsg
0,47972028900,47972334900,00000306000,ae8,epoll_wait
0,47972338800,47972339800,00000001000,a2f,recvmsg
0,47972348600,47972348700,00000000100,a2f,recvmsg
0,47972389300,47972391500,00000002200,a2e,sendmsg
0,47972180200,47972397900,00000217700,a07,poll
0,47972407100,47972407800,00000000700,a2f,recvmsg
0,47972461400,47972463100,00000001700,a07,poll
0,47972395600,47972494500,00000098900,ae8,epoll_wait
0,47972498100,47972499600,00000001500,a2f,recvmsg
0,47972507400,47972507600,00000000200,a2f,recvmsg
0,47972540000,47972542800,00000002800,a2e,sendmsg
0,47972461400,47972548600,00000087200,a07,poll
0,47972549300,47972549600,00000000300,a00,read
0,47972556300,47972556900,00000000600,a2f,recvmsg
0,47972560900,47972562500,00000001600,aca,futex
0,47972607300,47972697000,00000089700,a07,poll
0,47972698500,47972699600,00000001100,aca,futex
0,47972701600,47972702500,00000000900,aca,futex
0,47972703900,47972704700,00000000800,aca,futex
0,47972707200,47972710100,00000002900,a2e,sendmsg
0,47972546500,47972711700,00000165200,ae8,epoll_wait
0,47972715200,47972716300,00000001100,a2f,recvmsg
0,47972734400,47972734600,00000000200,a2f,recvmsg
0,47972760300,47972763100,00000002800,a2e,sendmsg
0,47972773400,47972773700,00000000300,a00,read
0,47972794600,47972900200,00000105600,a07,poll
0,47972901600,47972902700,00000001100,aca,futex
0,47972904200,47972905100,00000000900,aca,futex
0,47972906300,47972907100,00000000800,aca,futex
0,47972909500,47972911900,00000002400,a2e,sendmsg
0,47972765900,47972913400,00000147500,ae8,epoll_wait
0,47972916500,47972917500,00000001000,a2f,recvmsg
0,47972934900,47972935100,00000000200,a2f,recvmsg
0,47972958800,47972960900,00000002100,a2e,sendmsg
0,47972963800,47972996600,00000032800,ae8,epoll_wait
0,47972999200,47973000700,00000001500,a2f,recvmsg
0,47973007600,47973007800,00000000200,a2f,recvmsg
0,47973042600,47973044700,00000002100,a2e,sendmsg
0,47972991200,47973049800,00000058600,a07,poll
0,47973050500,47973050800,00000000300,a00,read
0,47973057300,47973057800,00000000500,a2f,recvmsg
0,47973104800,47973106200,00000001400,a07,poll
0,47973104800,47973208600,00000103800,a07,poll
0,47973210100,47973211200,00000001100,aca,futex
0,47973213200,47973214000,00000000800,aca,futex
0,47973215400,47973216200,00000000800,aca,futex
0,47973218700,47973221100,00000002400,a2e,sendmsg
0,47973048300,47973222400,00000174100,ae8,epoll_wait
0,47973225900,47973226900,00000001000,a2f,recvmsg
0,47973244600,47973244800,00000000200,a2f,recvmsg
0,47973270000,47973271800,00000001800,a2e,sendmsg
0,47973281800,47973282100,00000000300,a00,read
0,47973310500,47973310800,00000000300,a2f,recvmsg
0,47973311500,47973311700,00000000200,a2f,recvmsg
0,47972194300,47973329200,00001134900,a17,select
0,47973340900,47973341100,00000000200,a2f,recvmsg
0,47973353100,47973353300,00000000200,a2f,recvmsg
0,47973353800,47973354000,00000000200,a2f,recvmsg
0,47973343600,47973361300,00000017700,a17,select
0,47973366100,47973366200,00000000100,a2f,recvmsg
0,47973373000,47973373200,00000000200,a2f,recvmsg
0,47973373600,47973373800,00000000200,a2f,recvmsg
0,47973367100,47973381800,00000014700,a17,select
0,47973386200,47973386400,00000000200,a2f,recvmsg
0,47973392700,47973392900,00000000200,a2f,recvmsg
0,47973393400,47973393600,00000000200,a2f,recvmsg
0,47973387100,47973398800,00000011700,a17,select
0,47973402300,47973402500,00000000200,a2f,recvmsg
0,47973408800,47973408900,00000000100,a2f,recvmsg
0,47973409300,47973409500,00000000200,a2f,recvmsg
0,47973410700,47973411300,00000000600,a08,lseek
0,47973422900,47973423100,00000000200,a08,lseek
0,47973403100,47973428200,00000025100,a17,select
0,47973432500,47973432600,00000000100,a2f,recvmsg
0,47973439100,47973439200,00000000100,a2f,recvmsg
0,47973439600,47973439700,00000000100,a2f,recvmsg
0,47973433300,47973448100,00000014800,a17,select
0,47973451500,47973451700,00000000200,a2f,recvmsg
0,47973457800,47973457900,00000000100,a2f,recvmsg
0,47973458200,47973458400,00000000200,a2f,recvmsg
0,47973452300,47973464000,00000011700,a17,select
0,47973467400,47973467600,00000000200,a2f,recvmsg
0,47973473600,47973473800,00000000200,a2f,recvmsg
0,47973474200,47973474400,00000000200,a2f,recvmsg
0,47973468100,47973480200,00000012100,a17,select
0,47973483500,47973483700,00000000200,a2f,recvmsg
0,47973489800,47973490000,00000000200,a2f,recvmsg
0,47973490400,47973490500,00000000100,a2f,recvmsg
0,47973484400,47973497100,00000012700,a17,select
0,47973500600,47973500800,00000000200,a2f,recvmsg
0,47973506700,47973506800,00000000100,a2f,recvmsg
0,47973507200,47973507400,00000000200,a2f,recvmsg
0,47973501400,47973513200,00000011800,a17,select
0,47973516400,47973516600,00000000200,a2f,recvmsg
0,47973522600,47973522700,00000000100,a2f,recvmsg
0,47973523000,47973523200,00000000200,a2f,recvmsg
0,47973517200,47973529700,00000012500,a17,select
0,47973533200,47973533400,00000000200,a2f,recvmsg
0,47973539300,47973539500,00000000200,a2f,recvmsg
0,47973539800,47973539900,00000000100,a2f,recvmsg
0,47973534100,47973545600,00000011500,a17,select
0,47973548900,47973549100,00000000200,a2f,recvmsg
0,47973554600,47973554800,00000000200,a2f,recvmsg
0,47973555100,47973555200,00000000100,a2f,recvmsg
0,47973549700,47973561600,00000011900,a17,select
0,47973565700,47973565800,00000000100,a2f,recvmsg
0,47973571700,47973571900,00000000200,a2f,recvmsg
0,47973572200,47973572400,00000000200,a2f,recvmsg
0,47973566500,47973577800,00000011300,a17,select
0,47973581300,47973581400,00000000100,a2f,recvmsg
0,47973274500,47973586000,00000311500,ae8,epoll_wait
0,47973589300,47973590600,00000001300,a2f,recvmsg
0,47973598800,47973598900,00000000100,a2f,recvmsg
0,47973637300,47973639300,00000002000,a2e,sendmsg
0,47973574000,47973645300,00000071300,a07,poll
0,47973654400,47973655000,00000000600,a2f,recvmsg
0,47973722900,47973724500,00000001600,a07,poll
0,47973722900,47973838600,00000115700,a07,poll
0,47973840300,47973841500,00000001200,aca,futex
0,47973843700,47973844600,00000000900,aca,futex
0,47973846100,47973846900,00000000800,aca,futex
0,47973849500,47973852600,00000003100,a2e,sendmsg
0,47973643500,47973854300,00000210800,ae8,epoll_wait
0,47973857900,47973859100,00000001200,a2f,recvmsg
0,47973877700,47973877900,00000000200,a2f,recvmsg
0,47973905200,47973907400,00000002200,a2e,sendmsg
0,47973918000,47973918300,00000000300,a00,read
0,47973946500,47973946600,00000000100,a2f,recvmsg
0,47973947200,47973947400,00000000200,a2f,recvmsg
0,47973582000,47973958700,00000376700,a17,select
0,47973966400,47973966600,00000000200,a2f,recvmsg
0,47973975100,47973975200,00000000100,a2f,recvmsg
0,47973975600,47973975800,00000000200,a2f,recvmsg
0,47973968200,47973981600,00000013400,a17,select
0,47973985400,47973985600,00000000200,a2f,recvmsg
0,47973991200,47973991300,00000000100,a2f,recvmsg
0,47973991700,47973991900,00000000200,a2f,recvmsg
0,47973986300,47973997100,00000010800,a17,select
0,47974001000,47974001100,00000000100,a2f,recvmsg
0,47974006600,47974006800,00000000200,a2f,recvmsg
0,47974007200,47974007300,00000000100,a2f,recvmsg
0,47974001700,47974012900,00000011200,a17,select
0,47974016200,47974016400,00000000200,a2f,recvmsg
0,47974021700,47974021900,00000000200,a2f,recvmsg
0,47974022300,47974022500,00000000200,a2f,recvmsg
0,47974016900,47974027700,00000010800,a17,select
0,47974031200,47974031300,00000000100,a2f,recvmsg
0,47974037100,47974037300,00000000200,a2f,recvmsg
0,47974037700,47974037800,00000000100,a2f,recvmsg
0,47974032100,47974042500,00000010400,a17,select
0,47974045700,47974045900,00000000200,a2f,recvmsg
0,47974051100,47974051200,00000000100,a2f,recvmsg
0,47974051600,47974051800,00000000200,a2f,recvmsg
0,47974046500,47974058600,00000012100,a17,select
0,47974062200,47974062300,00000000100,a2f,recvmsg
0,47974067800,47974068000,00000000200,a2f,recvmsg
0,47974068300,47974068500,00000000200,a2f,recvmsg
0,47974062800,47974073100,00000010300,a17,select
0,47974076200,47974076300,00000000100,a2f,recvmsg
0,47974081400,47974081500,00000000100,a2f,recvmsg
0,47974081900,47974082000,00000000100,a2f,recvmsg
0,47974076900,47974086800,00000009900,a17,select
0,47974089900,47974090000,00000000100,a2f,recvmsg
0,47974095100,47974095300,00000000200,a2f,recvmsg
0,47974095600,47974095800,00000000200,a2f,recvmsg
0,47974090600,47974100400,00000009800,a17,select
0,47974103600,47974103800,00000000200,a2f,recvmsg
0,47974108900,47974109100,00000000200,a2f,recvmsg
0,47974109400,47974109600,00000000200,a2f,recvmsg
0,47974104300,47974114500,00000010200,a17,select
0,47974118000,47974118100,00000000100,a2f,recvmsg
0,47974123500,47974123600,00000000100,a2f,recvmsg
0,47974124000,47974124200,00000000200,a2f,recvmsg
0,47974118800,47974128900,00000010100,a17,select
0,47974132100,47974132200,00000000100,a2f,recvmsg
0,47974137300,47974137500,00000000200,a2f,recvmsg
0,47974137800,47974138000,00000000200,a2f,recvmsg
0,47974132700,47974145200,00000012500,a17,select
0,47974148500,47974148700,00000000200,a2f,recvmsg
0,47974153900,47974154000,00000000100,a2f,recvmsg
0,47974154400,47974154600,00000000200,a2f,recvmsg
0,47974149200,47974159800,00000010600,a17,select
0,47974163100,47974163200,00000000100,a2f,recvmsg
0,47974168400,47974168600,00000000200,a2f,recvmsg
0,47974168900,47974169000,00000000100,a2f,recvmsg
0,47974163800,47974174900,00000011100,a17,select
0,47974178500,47974178700,00000000200,a2f,recvmsg
0,47974184100,47974184300,00000000200,a2f,recvmsg
0,47974184700,47974184900,00000000200,a2f,recvmsg
0,47974179200,47974190400,00000011200,a17,select
0,47974193500,47974193600,00000000100,a2f,recvmsg
0,47974198900,47974199000,00000000100,a2f,recvmsg
0,47974199300,47974199500,00000000200,a2f,recvmsg
0,47974194200,47974204900,00000010700,a17,select
0,47974208200,47974208400,00000000200,a2f,recvmsg
0,47973910400,47974452200,00000541800,ae8,epoll_wait
0,47974455700,47974456900,00000001200,a2f,recvmsg
0,47974465200,47974465300,00000000100,a2f,recvmsg
0,47974499500,47974501600,00000002100,a2e,sendmsg
0,47974201200,47974507400,00000306200,a07,poll
0,47974516400,47974517200,00000000800,a2f,recvmsg
0,47974568000,47974569700,00000001700,a07,poll
0,47974568000,47974678800,00000110800,a07,poll
0,47974680400,47974681700,00000001300,aca,futex
0,47974683700,47974684600,00000000900,aca,futex
0,47974686000,47974686800,00000000800,aca,futex
0,47974689300,47974692000,00000002700,a2e,sendmsg
0,47974505600,47974693500,00000187900,ae8,epoll_wait
0,47974697000,47974698000,00000001000,a2f,recvmsg
0,47974715600,47974715800,00000000200,a2f,recvmsg
0,47974742100,47974745100,00000003000,a2e,sendmsg
0,47974755900,47974756100,00000000200,a00,read
0,47974783100,47974783400,00000000300,a2f,recvmsg
0,47974784000,47974784200,00000000200,a2f,recvmsg
0,47974208900,47974797500,00000588600,a17,select
0,47974804600,47974804800,00000000200,a2f,recvmsg
0,47974813000,47974813200,00000000200,a2f,recvmsg
0,47974813600,47974813800,00000000200,a2f,recvmsg
0,47974806400,47974821400,00000015000,a17,select
0,47974825500,47974825700,00000000200,a2f,recvmsg
0,47974831300,47974831500,00000000200,a2f,recvmsg
0,47974831900,47974832000,00000000100,a2f,recvmsg
0,47974826300,47974837400,00000011100,a17,select
0,47974841000,47974841200,00000000200,a2f,recvmsg
0,47974846800,47974847000,00000000200,a2f,recvmsg
0,47974847400,47974847600,00000000200,a2f,recvmsg
0,47974841700,47974854000,00000012300,a17,select
0,47974857600,47974857800,00000000200,a2f,recvmsg
0,47974863100,47974863300,00000000200,a2f,recvmsg
0,47974863700,47974863900,00000000200,a2f,recvmsg
0,47974858400,47974869400,00000011000,a17,select
0,47974872700,47974872900,00000000200,a2f,recvmsg
0,47974878200,47974878400,00000000200,a2f,recvmsg
0,47974878800,47974879000,00000000200,a2f,recvmsg
0,47974873500,47974884800,00000011300,a17,select
0,47974888100,47974888200,00000000100,a2f,recvmsg
0,47974893500,47974893700,00000000200,a2f,recvmsg
0,47974894100,47974894300,00000000200,a2f,recvmsg
0,47974888800,47974900500,00000011700,a17,select
0,47974903900,47974904000,00000000100,a2f,recvmsg
0,47974909300,47974909400,00000000100,a2f,recvmsg
0,47974909800,47974910000,00000000200,a2f,recvmsg
0,47974904500,47974915000,00000010500,a17,select
0,47974918100,47974918300,00000000200,a2f,recvmsg
0,47974923700,47974923800,00000000100,a2f,recvmsg
0,47974924200,47974924400,00000000200,a2f,recvmsg
0,47974918900,47974929400,00000010500,a17,select
0,47974932800,47974933000,00000000200,a2f,recvmsg
0,47974938300,47974938500,00000000200,a2f,recvmsg
0,47974938900,47974939100,00000000200,a2f,recvmsg
0,47974933600,47974944800,00000011200,a17,select
0,47974948000,47974948200,00000000200,a2f,recvmsg
0,47974953500,47974953700,00000000200,a2f,recvmsg
0,47974954000,47974954200,00000000200,a2f,recvmsg
0,47974956300,47974957000,00000000700,a08,lseek
0,47974960300,47974962700,00000002400,a00,read
0,47974966500,47974966600,00000000100,a08,lseek
0,47974948800,47974971800,00000023000,a17,select
0,47974975300,47974975500,00000000200,a2f,recvmsg
0,47974981400,47974981500,00000000100,a2f,recvmsg
0,47974981900,47974982000,00000000100,a2f,recvmsg
0,47974976100,47975012600,00000036500,a17,select
0,47975016200,47975016300,00000000100,a2f,recvmsg
0,47975022000,47975022200,00000000200,a2f,recvmsg
0,47975022600,47975022800,00000000200,a2f,recvmsg
0,47975026900,47975028100,00000001200,a00,read
0,47975033700,47975033900,00000000200,a08,lseek
0,47975017000,47975039300,00000022300,a17,select
0,47975042700,47975042800,00000000100,a2f,recvmsg
0,47975048700,47975048800,00000000100,a2f,recvmsg
0,47975049200,47975049400,00000000200,a2f,recvmsg
0,47975043500,47975054000,00000010500,a17,select
0,47975057200,47975057300,00000000100,a2f,recvmsg
0,47975062400,47975062600,00000000200,a2f,recvmsg
0,47975063000,47975063100,00000000100,a2f,recvmsg
0,47975058000,47975067700,00000009700,a17,select
0,47975070600,47975070800,00000000200,a2f,recvmsg
0,47975075900,47975076100,00000000200,a2f,recvmsg
0,47975076400,47975076600,00000000200,a2f,recvmsg
0,47975071300,47975081000,00000009700,a17,select
0,47975084000,47975084200,00000000200,a2f,recvmsg
0,47975089200,47975089400,00000000200,a2f,recvmsg
0,47975089800,47975090000,00000000200,a2f,recvmsg
0,47975084600,47975094300,00000009700,a17,select
0,47975097600,47975097800,00000000200,a2f,recvmsg
0,47975102800,47975103000,00000000200,a2f,recvmsg
0,47975103400,47975103600,00000000200,a2f,recvmsg
0,47975098200,47975107800,00000009600,a17,select
0,47975110900,47975111100,00000000200,a2f,recvmsg
0,47975116300,47975116500,00000000200,a2f,recvmsg
0,47975116900,47975117100,00000000200,a2f,recvmsg
0,47975111600,47975121600,00000010000,a17,select
0,47975124600,47975124700,00000000100,a2f,recvmsg
0,47975130000,47975130200,00000000200,a2f,recvmsg
0,47975130400,47975130600,00000000200,a2f,recvmsg
0,47975125300,47975135700,00000010400,a17,select
0,47975138800,47975138900,00000000100,a2f,recvmsg
0,47975144200,47975144400,00000000200,a2f,recvmsg
0,47975144800,47975145000,00000000200,a2f,recvmsg
0,47975139500,47975149300,00000009800,a17,select
0,47975152500,47975152700,00000000200,a2f,recvmsg
0,47975157700,47975157900,00000000200,a2f,recvmsg
0,47975158300,47975158500,00000000200,a2f,recvmsg
0,47975159000,47975159100,00000000100,a08,lseek
0,47975153200,47975165400,00000012200,a17,select
0,47975168600,47975168800,00000000200,a2f,recvmsg
0,47975174200,47975174400,00000000200,a2f,recvmsg
0,47975174800,47975175000,00000000200,a2f,recvmsg
0,47975169400,47975181900,00000012500,a17,select
0,47975185100,47975185300,00000000200,a2f,recvmsg
0,47975190900,47975191000,00000000100,a2f,recvmsg
0,47975191400,47975191600,00000000200,a2f,recvmsg
0,47975185800,47975196700,00000010900,a17,select
0,47975199600,47975199800,00000000200,a2f,recvmsg
0,47975205200,47975205300,00000000100,a2f,recvmsg
0,47975205700,47975205900,00000000200,a2f,recvmsg
0,47975200400,47975210700,00000010300,a17,select
0,47975213700,47975213800,00000000100,a2f,recvmsg
0,47975219100,47975219300,00000000200,a2f,recvmsg
0,47975219600,47975219700,00000000100,a2f,recvmsg
0,47975214500,47975224600,00000010100,a17,select
0,47975227500,47975227700,00000000200,a2f,recvmsg
0,47975233000,47975233200,00000000200,a2f,recvmsg
0,47975233500,47975233700,00000000200,a2f,recvmsg
0,47975228300,47975238400,00000010100,a17,select
0,47975241400,47975241600,00000000200,a2f,recvmsg
0,47975246700,47975246800,00000000100,a2f,recvmsg
0,47975247200,47975247400,00000000200,a2f,recvmsg
0,47975242200,47975252500,00000010300,a17,select
0,47975255600,47975255800,00000000200,a2f,recvmsg
0,47975261000,47975261200,00000000200,a2f,recvmsg
0,47975261400,47975261600,00000000200,a2f,recvmsg
0,47975256400,47975266400,00000010000,a17,select
0,47975269600,47975269700,00000000100,a2f,recvmsg
0,47975274900,47975275100,00000000200,a2f,recvmsg
0,47975275400,47975275600,00000000200,a2f,recvmsg
0,47975270300,47975280500,00000010200,a17,select
0,47975283500,47975283700,00000000200,a2f,recvmsg
0,47975288800,47975289000,00000000200,a2f,recvmsg
0,47975289300,47975289500,00000000200,a2f,recvmsg
0,47975284200,47975294200,00000010000,a17,select
0,47975297300,47975297400,00000000100,a2f,recvmsg
0,47975302500,47975302700,00000000200,a2f,recvmsg
0,47975303100,47975303200,00000000100,a2f,recvmsg
0,47975298000,47975307800,00000009800,a17,select
0,47975310700,47975310900,00000000200,a2f,recvmsg
0,47975316000,47975316200,00000000200,a2f,recvmsg
0,47975316500,47975316700,00000000200,a2f,recvmsg
0,47975311500,47975321300,00000009800,a17,select
0,47975324200,47975324400,00000000200,a2f,recvmsg
0,47975329700,47975329800,00000000100,a2f,recvmsg
0,47975330100,47975330300,00000000200,a2f,recvmsg
0,47975325000,47975335600,00000010600,a17,select
0,47975338700,47975338900,00000000200,a2f,recvmsg
0,47975344000,47975344200,00000000200,a2f,recvmsg
0,47975344600,47975344800,00000000200,a2f,recvmsg
0,47975339400,47975349400,00000010000,a17,select
0,47975352500,47975352500,00000000000,a2f,recvmsg
0,47975357700,47975357900,00000000200,a2f,recvmsg
0,47975358200,47975358400,00000000200,a2f,recvmsg
0,47975353100,47975363000,00000009900,a17,select
0,47975365900,47975366100,00000000200,a2f,recvmsg
0,47975371200,47975371400,00000000200,a2f,recvmsg
0,47975371600,47975371800,00000000200,a2f,recvmsg
0,47975366700,47975376500,00000009800,a17,select
0,47975379700,47975379900,00000000200,a2f,recvmsg
0,47975385300,47975385500,00000000200,a2f,recvmsg
0,47975385900,47975386100,00000000200,a2f,recvmsg
0,47975380400,47975396200,00000015800,a17,select
0,47975399400,47975399600,00000000200,a2f,recvmsg
0,47975405100,47975405200,00000000100,a2f,recvmsg
0,47975405600,47975405700,00000000100,a2f,recvmsg
0,47975400300,47975410700,00000010400,a17,select
0,47975413600,47975413800,00000000200,a2f,recvmsg
0,47975418900,47975419000,00000000100,a2f,recvmsg
0,47975419300,47975419500,00000000200,a2f,recvmsg
0,47975414300,47975424200,00000009900,a17,select
0,47975427100,47975427300,00000000200,a2f,recvmsg
0,47975432300,47975432500,00000000200,a2f,recvmsg
0,47975432900,47975433100,00000000200,a2f,recvmsg
0,47975427900,47975438000,00000010100,a17,select
0,47975440800,47975441000,00000000200,a2f,recvmsg
0,47975446100,47975446200,00000000100,a2f,recvmsg
0,47975446600,47975446800,00000000200,a2f,recvmsg
0,47975441600,47975451600,00000010000,a17,select
0,47975454800,47975454900,00000000100,a2f,recvmsg
0,47975460000,47975460100,00000000100,a2f,recvmsg
0,47975460500,47975460700,00000000200,a2f,recvmsg
0,47975483600,47975517300,00000033700,a57,unlink
0,47975518900,47975524300,00000005400,a14,writev
0,47975455400,47975528400,00000073000,a17,select
0,47975531100,47975532600,00000001500,a2f,recvmsg
0,47975630600,47975633800,00000003200,a14,writev
0,47975716300,47975718200,00000001900,a14,writev
0,47975780300,47975781900,00000001600,a14,writev
0,47975842100,47975843900,00000001800,a14,writev
0,47975902300,47975903900,00000001600,a14,writev
0,47975964000,47975965600,00000001600,a14,writev
0,47975970700,47975971900,00000001200,a2f,recvmsg
0,47976267400,47976269800,00000002400,a2f,recvmsg
0,47976377600,47976377900,00000000300,a2f,recvmsg
0,47976378500,47976378900,00000000400,a14,writev
0,47975518300,47976389700,00000871400,a07,poll
0,47976391600,47976392500,00000000900,a00,read
0,47976395900,47976404000,00000008100,a2f,recvmsg
0,47976415500,47976415700,00000000200,a2f,recvmsg
0,47976459100,47976467200,00000008100,a2f,recvmsg
0,47976479800,47976480000,00000000200,a2f,recvmsg
0,47976502800,47976507500,00000004700,a07,poll
0,47976509400,47976510400,00000001000,a00,read
0,47976514900,47976523500,00000008600,a2f,recvmsg
0,47976536400,47976536700,00000000300,a2f,recvmsg
0,47974747900,47976562400,00001814500,ae8,epoll_wait
0,47976568800,47976570100,00000001300,a2f,recvmsg
0,47976580300,47976580500,00000000200,a2f,recvmsg
0,47976624900,47976629300,00000004400,a2e,sendmsg
0,47976381000,47976640700,00000259700,a17,select
0,47976663300,47976664800,00000001500,a14,writev
0,47976665400,47976665600,00000000200,a2f,recvmsg
0,47976681300,47976682300,00000001000,a14,writev
0,47976682500,47976682700,00000000200,a2f,recvmsg
0,47976695500,47976696400,00000000900,a14,writev
0,47976696700,47976696800,00000000100,a2f,recvmsg
0,47976559400,47976701600,00000142200,a07,poll
0,47976702900,47976703900,00000001000,a2f,recvmsg
0,47976713300,47976714400,00000001100,a2d,recvfrom
0,47976715700,47976715900,00000000200,a2f,recvmsg
0,47976716700,47976716800,00000000100,a2f,recvmsg
0,47976763000,47976763200,00000000200,a2f,recvmsg
0,47976766000,47976766100,00000000100,a2f,recvmsg
0,47976768900,47976771800,00000002900,a07,poll
0,47976772800,47976774100,00000001300,a2f,recvmsg
0,47976783300,47976784100,00000000800,a2d,recvfrom
0,47976785200,47976785500,00000000300,a2f,recvmsg
0,47976786300,47976786500,00000000200,a2f,recvmsg
0,47976822200,47976822500,00000000300,a2f,recvmsg
0,47976825000,47976825100,00000000100,a2f,recvmsg
0,47976828800,47976832300,00000003500,a07,poll
0,47976833500,47976834800,00000001300,a2f,recvmsg
0,47976844000,47976844600,00000000600,a2d,recvfrom
0,47976845900,47976845900,00000000000,a2f,recvmsg
0,47976847000,47976847200,00000000200,a2f,recvmsg
0,47976881000,47976881300,00000000300,a2f,recvmsg
0,47976884000,47976884200,00000000200,a2f,recvmsg
0,47976888000,47976893600,00000005600,a07,poll
0,47976906800,47976908300,00000001500,a2f,recvmsg
0,47976972800,47976975300,00000002500,a07,poll
0,47976972800,47977106300,00000133500,a07,poll
0,47977108300,47977109600,00000001300,aca,futex
0,47977111900,47977112800,00000000900,aca,futex
0,47977114400,47977115300,00000000900,aca,futex
0,47977118600,47977122200,00000003600,a2e,sendmsg
0,47976634800,47977124200,00000489400,ae8,epoll_wait
0,47977129200,47977130600,00000001400,a2f,recvmsg
0,47977150100,47977150400,00000000300,a2f,recvmsg
0,47977183500,47977187200,00000003700,a2e,sendmsg
0,47977199600,47977200000,00000000400,a00,read
0,47977233900,47977234100,00000000200,a2f,recvmsg
0,47977235000,47977235200,00000000200,a2f,recvmsg
0,47977236200,47977263700,00000027500,a57,unlink
0,47976697400,47977278200,00000580800,a17,select
0,47977291800,47977294300,00000002500,a14,writev
0,47977296400,47977296600,00000000200,a2f,recvmsg
0,47977699000,47977699300,00000000300,a2f,recvmsg
0,47977700000,47977700200,00000000200,a2f,recvmsg
0,47977190700,47977788700,00000598000,ae8,epoll_wait
0,47977794000,47977795400,00000001400,a2f,recvmsg
0,47977804800,47977805000,00000000200,a2f,recvmsg
0,47977847700,47977851000,00000003300,a2e,sendmsg
0,47977696000,47977858600,00000162600,a07,poll
0,47977869000,47977869900,00000000900,a2f,recvmsg
0,47977929700,47977932000,00000002300,a07,poll
0,47977929700,47978057500,00000127800,a07,poll
0,47978059700,47978060900,00000001200,aca,futex
0,47978063100,47978064100,00000001000,aca,futex
0,47978065700,47978066400,00000000700,aca,futex
0,47978069500,47978072400,00000002900,a2e,sendmsg
0,47977856200,47978074200,00000218000,ae8,epoll_wait
0,47978078500,47978079700,00000001200,a2f,recvmsg
0,47978098400,47978098600,00000000200,a2f,recvmsg
0,47978127800,47978130500,00000002700,a2e,sendmsg
0,47978141800,47978142200,00000000400,a00,read
0,47978133600,47978675800,00000542200,ae8,epoll_wait
0,47978680800,47978682800,00000002000,a2f,recvmsg
0,47978692000,47978692200,00000000200,a2f,recvmsg
0,47978732700,47978736400,00000003700,a2e,sendmsg
0,47978165100,47978744000,00000578900,a07,poll
0,47978754000,47978754900,00000000900,a2f,recvmsg
0,47978813000,47978815000,00000002000,a07,poll
0,47978813000,47978942900,00000129900,a07,poll
0,47978944600,47978946000,00000001400,aca,futex
0,47978948200,47978949200,00000001000,aca,futex
0,47978950900,47978951700,00000000800,aca,futex
0,47978954800,47978957700,00000002900,a2e,sendmsg
0,47978741300,47978959500,00000218200,ae8,epoll_wait
0,47978963800,47978965200,00000001400,a2f,recvmsg
0,47978984500,47978984700,00000000200,a2f,recvmsg
0,47979013300,47979016100,00000002800,a2e,sendmsg
0,47979027900,47979028200,00000000300,a00,read
0,47978671600,47979054400,00000382800,60e,page_fault
0,47979163900,47979169500,00000005600,a04,stat
0,47979169600,47979171200,00000001600,a04,stat
0,47979174400,47979175200,00000000800,a04,stat
0,47979175300,47979177200,00000001900,a04,stat
0,47979177400,47979178900,00000001500,a04,stat
0,47979179100,47979179800,00000000700,a04,stat
0,47979180000,47979180500,00000000500,a04,stat
0,47979181700,47979182200,00000000500,a04,stat
0,47979182300,47979182700,00000000400,a04,stat
0,47979183100,47979183700,00000000600,a04,stat
0,47979183900,47979184800,00000000900,a04,stat
0,47979184900,47979185400,00000000500,a04,stat
0,47979186600,47979187000,00000000400,a04,stat
0,47979187300,47979187800,00000000500,a04,stat
0,47979188200,47979188600,00000000400,a04,stat
0,47979188900,47979189300,00000000400,a04,stat
0,47979189600,47979190000,00000000400,a04,stat
0,47979190200,47979190700,00000000500,a04,stat
0,47979192300,47979192800,00000000500,a04,stat
0,47979193000,47979194100,00000001100,a04,stat
0,47979194300,47979194800,00000000500,a04,stat
0,47979194900,47979195200,00000000300,a04,stat
0,47979195500,47979196100,00000000600,a04,stat
0,47979197200,47979197600,00000000400,a04,stat
0,47979197800,47979198400,00000000600,a04,stat
0,47979198700,47979199400,00000000700,a04,stat
0,47979199500,47979200000,00000000500,a04,stat
0,47979200100,47979200600,00000000500,a04,stat
0,47979201900,47979202200,00000000300,a04,stat
0,47979202500,47979203400,00000000900,a04,stat
0,47979203700,47979204300,00000000600,a04,stat
0,47979204500,47979204900,00000000400,a04,stat
0,47979205100,47979205600,00000000500,a04,stat
0,47979206600,47979207100,00000000500,a04,stat
0,47979051800,47979345000,00000293200,a07,poll
0,47979349200,47979351100,00000001900,aca,futex
0,47979357200,47979358300,00000001100,aca,futex
0,47979361300,47979362300,00000001000,aca,futex
0,47979368100,47979371200,00000003100,a2e,sendmsg
0,47979380400,47979455200,00000074800,a07,poll
0,47979456700,47979458000,00000001300,aca,futex
0,47979460300,47979461400,00000001100,aca,futex
0,47979462600,47979463700,00000001100,aca,futex
0,47979466700,47979468300,00000001600,a2e,sendmsg
0,47979471100,47979471300,00000000200,a00,read
0,47977298200,47979539300,00002241100,a17,select
0,47979569900,47979572700,00000002800,a14,writev
0,47979573800,47979574100,00000000300,a2f,recvmsg
0,47979577200,47984803100,00005225900,a17,select
0,47984811800,47984813900,00000002100,a2f,recvmsg
0,47984893900,47985320700,00000426800,a10,ioctl
0,47985422100,47985783000,00000360900,a10,ioctl
0,47985817200,47985818400,00000001200,aca,futex
0,47985844000,47985846100,00000002100,a2f,recvmsg
0,47985850600,47985852500,00000001900,aca,futex
0,47985853500,47985854400,00000000900,aca,futex
0,47985890900,47985892600,00000001700,a2f,recvmsg
0,47986001300,47986004600,00000003300,aca,futex
0,47986005900,47986006900,00000001000,aca,futex
0,47986017100,47986018200,00000001100,aca,futex
0,47986019000,47986019800,00000000800,aca,futex
0,47986090600,47986097400,00000006800,a2f,recvmsg
0,47986162000,47986162500,00000000500,a2f,recvmsg
0,47979473900,47986187300,00006713400,a07,poll
0,47986210700,47986216400,00000005700,a2e,sendmsg
0,47986337400,47986351200,00000013800,a02,open
0,47986379300,47986383800,00000004500,a00,read
0,47986455600,47986457800,00000002200,a00,read
0,47986521100,47986522900,00000001800,a00,read
0,47986585600,47986587900,00000002300,a00,read
0,47986650000,47986653300,00000003300,a00,read
0,47986716300,47986717500,00000001200,a00,read
0,47986773100,47986774500,00000001400,a00,read
0,47986831700,47986832500,00000000800,a00,read
0,47986889900,47986891000,00000001100,a00,read
0,47986946900,47986948500,00000001600,a00,read
0,47987001900,47987002700,00000000800,a00,read
0,47987035000,47987039000,00000004000,a02,open
0,47987043600,47987044800,00000001200,a00,read
0,47987103000,47987104500,00000001500,a00,read
0,47987195000,47987196000,00000001000,a00,read
0,47987272800,47987274000,00000001200,a00,read
0,47987354600,47987355500,00000000900,a00,read
0,47987438300,47987439600,00000001300,a00,read
0,47987520400,47987521200,00000000800,a00,read
0,47987609500,47987610500,00000001000,a00,read
0,47987678200,47987679000,00000000800,a00,read
0,47987737400,47987738300,00000000900,a00,read
0,47986168300,47987847700,00001679400,a17,select
0,47987865300,47987865600,00000000300,a2f,recvmsg
0,47987889100,47987889400,00000000300,a2f,recvmsg
0,47987890000,47987890300,00000000300,a2f,recvmsg
0,47987874600,47987897800,00000023200,a17,select
0,47987904700,47987904800,00000000100,a2f,recvmsg
0,47987914400,47987914600,00000000200,a2f,recvmsg
0,47987915000,47987915300,00000000300,a2f,recvmsg
0,47987922800,47987930500,00000007700,a06,lstat
0,47987931300,47987932300,00000001000,a06,lstat
0,47987959800,47987977600,00000017800,a01,write
0,47987906900,47987989700,00000082800,a17,select
0,47987998100,47987998300,00000000200,a2f,recvmsg
0,47988009800,47988010000,00000000200,a2f,recvmsg
0,47988010400,47988010600,00000000200,a2f,recvmsg
0,47988012700,47988396600,00000383900,a38,clone
0,47989031000,47989031100,00000000100,a0c,brk
0,47989042200,47989046000,00000003800,a15,access
0,47989047000,47989048100,00000001100,a09,mmap
0,47989052700,47989053700,00000001000,a15,access
0,47989061500,47989062500,00000001000,a09,mmap
0,47989067100,47989067800,00000000700,a15,access
0,47989075900,47989077100,00000001200,a00,read
0,47989079000,47989080900,00000001900,a09,mmap
0,47989085600,47989088100,00000002500,a09,mmap
0,47989100400,47989101100,00000000700,a15,access
0,47989104900,47989105600,00000000700,a00,read
0,47989106400,47989107400,00000001000,a09,mmap
0,47989110200,47989111600,00000001400,a09,mmap
0,47989120400,47989121300,00000000900,a15,access
0,47989124600,47989125500,00000000900,a00,read
0,47989126400,47989127300,00000000900,a09,mmap
0,47989128900,47989131200,00000002300,a09,mmap
0,47989136300,47989139900,00000003600,a09,mmap
0,47989142400,47989143500,00000001100,a09,mmap
0,47989154600,47989155600,00000001000,a15,access
0,47989158700,47989159600,00000000900,a00,read
0,47989160200,47989162000,00000001800,a09,mmap
0,47989165500,47989167400,00000001900,a09,mmap
0,47989176100,47989176900,00000000800,a15,access
0,47989179900,47989180700,00000000800,a00,read
0,47989181300,47989182900,00000001600,a09,mmap
0,47989187300,47989189900,00000002600,a09,mmap
0,47989198900,47989199600,00000000700,a15,access
0,47989202100,47989202700,00000000600,a00,read
0,47989210500,47989211900,00000001400,a09,mmap
0,47989219100,47989219800,00000000700,a15,access
0,47989222300,47989222800,00000000500,a00,read
0,47989223400,47989224900,00000001500,a09,mmap
0,47989227700,47989229500,00000001800,a09,mmap
0,47989246200,47989246700,00000000500,a09,mmap
0,47989250600,47989250900,00000000300,a09,mmap
0,47989252000,47989252300,00000000300,a09,mmap
0,47989464000,47989464100,00000000100,a0c,brk
0,47989464200,47989465300,00000001100,a0c,brk
0,47989502200,47989503600,00000001400,a00,read
0,47989516300,47989517700,00000001400,a00,read
0,47989558900,47989560100,00000001200,a00,read
0,47989707100,47989708200,00000001100,a00,read
0,47989779700,47989780200,00000000500,a00,read
0,47989871100,47989871800,00000000700,a00,read
0,47990003200,47990004000,00000000800,a00,read
0,47990133500,47990134300,00000000800,a00,read
0,47990290200,47990290900,00000000700,a00,read
0,47990441200,47990441900,00000000700,a00,read
0,47990478400,47990480000,00000001600,a0c,brk
0,47990595500,47990596200,00000000700,a00,read
0,47990744700,47990745400,00000000700,a00,read
0,47990900800,47990901600,00000000800,a00,read
0,47991061400,47991062100,00000000700,a00,read
0,47991170600,47991171400,00000000800,a00,read
0,47991201900,47991202500,00000000600,a0c,brk
0,47991310500,47991311300,00000000800,a00,read
0,47991554800,47991555500,00000000700,a00,read
0,47991567200,47991567600,00000000400,a00,read
0,47991611500,47991611900,00000000400,a00,read
0,47991631700,47991632400,00000000700,a00,read
0,47991840900,47991841400,00000000500,a00,read
0,47991871600,47991872500,00000000900,a00,read
0,47991969600,47991970200,00000000600,a00,read
0,47991994000,47991995000,00000001000,a0c,brk
0,47992040000,47992040400,00000000400,a00,read
0,47992118500,47992119300,00000000800,a00,read
0,47992272300,47992272800,00000000500,a00,read
0,47992384800,47992385500,00000000700,a00,read
0,47992479500,47992480000,00000000500,a00,read
0,47992492200,47992492600,00000000400,a00,read
0,47992574000,47992574400,00000000400,a00,read
0,47992598300,47992598700,00000000400,a00,read
0,47992621200,47992621700,00000000500,a00,read
0,47992723700,47992724700,00000001000,a0c,brk
0,47992726500,47992727500,00000001000,a00,read
0,47992928900,47992929400,00000000500,a00,read
0,47993013300,47993014000,00000000700,a00,read
0,47993078000,47993078700,00000000700,a00,read
0,47993206600,47993207000,00000000400,a00,read
0,47993239400,47993240000,00000000600,a00,read
0,47993257800,47993259200,00000001400,a02,open
0,47993370900,47993371500,00000000600,a00,read
0,47993442900,47993443500,00000000600,a00,read
0,47993503800,47993504500,00000000700,a00,read
0,47993616800,47993617400,00000000600,a00,read
0,47993781100,47993782100,00000001000,a00,read
0,47993912100,47993912800,00000000700,a00,read
0,47993970600,47993971200,00000000600,a00,read
0,47994027200,47994027800,00000000600,a00,read
0,47994097800,47994098500,00000000700,a00,read
0,47994151000,47994151700,00000000700,a00,read
0,47994239700,47994240600,00000000900,a0c,brk
0,47994274500,47994278200,00000003700,a0c,brk
0,47994293300,47994294100,00000000800,a00,read
0,47994410300,47994411100,00000000800,a00,read
0,47994573900,47994574600,00000000700,a00,read
0,47994695900,47994696800,00000000900,a00,read
0,47994846200,47994846900,00000000700,a00,read
0,47994967600,47994968300,00000000700,a00,read
0,47995133300,47995133900,00000000600,a00,read
0,47995139000,47995139900,00000000900,a0c,brk
0,47995259200,47995259900,00000000700,a00,read
0,47995382100,47995382900,00000000800,a00,read
0,47995528100,47995528800,00000000700,a00,read
0,47995663500,47995664200,00000000700,a00,read
0,47995761100,47995761800,00000000700,a00,read
0,47995877200,47995878000,00000000800,a00,read
0,47996005100,47996005700,00000000600,a00,read
0,47996120200,47996120800,00000000600,a0c,brk
0,47996144000,47996144800,00000000800,a00,read
0,47996318700,47996319500,00000000800,a00,read
0,47996473200,47996474100,00000000900,a00,read
0,47996587900,47996588700,00000000800,a00,read
0,47996758900,47996759900,00000001000,a00,read
0,47996840100,47996840800,00000000700,a00,read
0,47996925500,47996926400,00000000900,a00,read
0,47996995900,47996996500,00000000600,a0c,brk
0,47997011300,47997012000,00000000700,a00,read
0,47997087800,47997088600,00000000800,a00,read
0,47997193000,47997193700,00000000700,a00,read
0,47997299300,47997300000,00000000700,a00,read
0,47997392500,47997393400,00000000900,a00,read
0,47997477000,47997477700,00000000700,a00,read
0,47997581900,47997582500,00000000600,a00,read
0,47988001000,47998761900,00010760900,a17,select
0,47998774200,47998780600,00000006400,a2f,recvmsg
0,47998843600,47999229000,00000385400,a10,ioctl
0,47999306500,47999314600,00000008100,aca,futex
0,47999317500,47999318900,00000001400,aca,futex
0,47999334800,47999336300,00000001500,aca,futex
0,47999337200,47999338200,00000001000,aca,futex
0,47999384400,47999392100,00000007700,a14,writev
0,47999392900,47999394300,00000001400,a2f,recvmsg
0,47999418000,47999474200,00000056200,a10,ioctl
0,48005713400,48005716500,00000003100,a00,read
0,48005835600,48005836500,00000000900,a00,read
0,48005936000,48005937100,00000001100,a00,read
0,48006071800,48006073100,00000001300,a00,read
0,48006197300,48006198200,00000000900,a00,read
0,48006310400,48006311300,00000000900,a00,read
0,48006437700,48006439000,00000001300,a0c,brk
0,47988006900,48006549900,00018543000,a07,poll
0,48006556500,48006557300,00000000800,a00,read
0,48006690100,48006693000,00000002900,a01,write
0,48006705400,48006706300,00000000900,a2f,recvmsg
0,48006708700,48006708900,00000000200,a00,read
0,48007067600,48007071600,00000004000,a57,unlink
0,48007072600,48007130000,00000057400,a02,open
0,48007132300,48007132900,00000000600,a48,fcntl
0,48007190900,48007203000,00000012100,a01,write
0,48007221200,48007223800,00000002600,a01,write
0,48007241800,48007243900,00000002100,a01,write
0,47988436700,48007416600,00018979900,a3d,wait4
0,48007433500,48007435400,00000001900,a00,read
0,48007437600,48007438000,00000000400,a00,read
0,47999476900,48007464200,00007987300,a17,select
0,48007483800,48007484100,00000000300,a2f,recvmsg
0,48007452800,48007518600,00000065800,a07,poll
0,48007523000,48007523300,00000000300,a2f,recvmsg
0,48007524000,48007524200,00000000200,a2f,recvmsg
0,48007511100,48007535200,00000024100,a17,select
0,48007542300,48007542400,00000000100,a2f,recvmsg
0,48007530900,48007547700,00000016800,a07,poll
0,48007549300,48007549500,00000000200,a2f,recvmsg
0,48007549900,48007550100,00000000200,a2f,recvmsg
0,48007543500,48007557100,00000013600,a17,select
0,48007561400,48007561600,00000000200,a2f,recvmsg
0,48007553500,48007566000,00000012500,a07,poll
0,48007567800,48007567900,00000000100,a2f,recvmsg
0,48007568300,48007568500,00000000200,a2f,recvmsg
0,48007562300,48007575600,00000013300,a17,select
0,48007580100,48007580300,00000000200,a2f,recvmsg
0,48007572600,48007584400,00000011800,a07,poll
0,48007585800,48007586000,00000000200,a2f,recvmsg
0,48007586300,48007586500,00000000200,a2f,recvmsg
0,48007580900,48007593500,00000012600,a17,select
0,48007598200,48007598300,00000000100,a2f,recvmsg
0,48007590500,48007602400,00000011900,a07,poll
0,48007603700,48007603900,00000000200,a2f,recvmsg
0,48007604300,48007604500,00000000200,a2f,recvmsg
0,48007598900,48007610100,00000011200,a17,select
0,48007613800,48007613900,00000000100,a2f,recvmsg
0,48007607100,48007617800,00000010700,a07,poll
0,48007619300,48007619500,00000000200,a2f,recvmsg
0,48007619900,48007620100,00000000200,a2f,recvmsg
0,48007621100,48007621400,00000000300,a08,lseek
0,48007631400,48007631500,00000000100,a08,lseek
0,48007614500,48007637200,00000022700,a17,select
0,48007641600,48007641800,00000000200,a2f,recvmsg
0,48007634000,48007645700,00000011700,a07,poll
0,48007647100,48007647300,00000000200,a2f,recvmsg
0,48007647700,48007647900,00000000200,a2f,recvmsg
0,48007642400,48007656200,00000013800,a17,select
0,48007660000,48007660100,00000000100,a2f,recvmsg
0,48007653000,48007664000,00000011000,a07,poll
0,48007665500,48007665600,00000000100,a2f,recvmsg
0,48007665900,48007666100,00000000200,a2f,recvmsg
0,48007660700,48007672100,00000011400,a17,select
0,48007675600,48007675700,00000000100,a2f,recvmsg
0,48007669300,48007679500,00000010200,a07,poll
0,48007680900,48007681000,00000000100,a2f,recvmsg
0,48007681300,48007681500,00000000200,a2f,recvmsg
0,48007676300,48007687800,00000011500,a17,select
0,48007691300,48007691500,00000000200,a2f,recvmsg
0,48007684900,48007695100,00000010200,a07,poll
0,48007696500,48007696700,00000000200,a2f,recvmsg
0,48007697000,48007697200,00000000200,a2f,recvmsg
0,48007692100,48007703500,00000011400,a17,select
0,48007707200,48007707300,00000000100,a2f,recvmsg
0,48007700700,48007711100,00000010400,a07,poll
0,48007712400,48007712600,00000000200,a2f,recvmsg
0,48007713000,48007713200,00000000200,a2f,recvmsg
0,48007707800,48007719500,00000011700,a17,select
0,48007723000,48007723200,00000000200,a2f,recvmsg
0,48007716800,48007726900,00000010100,a07,poll
0,48007729100,48007729300,00000000200,a2f,recvmsg
0,48007729700,48007729900,00000000200,a2f,recvmsg
0,48007723800,48007735900,00000012100,a17,select
0,48007739600,48007739800,00000000200,a2f,recvmsg
0,48007733100,48007743500,00000010400,a07,poll
0,48007745000,48007745200,00000000200,a2f,recvmsg
0,48007745500,48007745600,00000000100,a2f,recvmsg
0,48007740300,48007751900,00000011600,a17,select
0,48007755400,48007755600,00000000200,a2f,recvmsg
0,48007749200,48007759200,00000010000,a07,poll
0,48007760500,48007760700,00000000200,a2f,recvmsg
0,48007761000,48007761200,00000000200,a2f,recvmsg
0,48007756200,48007768200,00000012000,a17,select
0,48007771900,48007772100,00000000200,a2f,recvmsg
0,48007765400,48007775700,00000010300,a07,poll
0,48007777000,48007777200,00000000200,a2f,recvmsg
0,48007777600,48007777700,00000000100,a2f,recvmsg
0,48007772600,48007783600,00000011000,a17,select
0,48007787300,48007787400,00000000100,a2f,recvmsg
0,48007780900,48007791100,00000010200,a07,poll
0,48007792400,48007792600,00000000200,a2f,recvmsg
0,48007792900,48007793100,00000000200,a2f,recvmsg
0,48007788000,48007798900,00000010900,a17,select
0,48007802600,48007802600,00000000000,a2f,recvmsg
0,48007796300,48007806300,00000010000,a07,poll
0,48007807600,48007807800,00000000200,a2f,recvmsg
0,48007808200,48007808300,00000000100,a2f,recvmsg
0,48007803200,48007815200,00000012000,a17,select
0,48007818700,48007818900,00000000200,a2f,recvmsg
0,48007812400,48007822500,00000010100,a07,poll
0,48007823800,48007823900,00000000100,a2f,recvmsg
0,48007824300,48007824500,00000000200,a2f,recvmsg
0,48007819500,48007830200,00000010700,a17,select
0,48007833600,48007833800,00000000200,a2f,recvmsg
0,48007827500,48007837300,00000009800,a07,poll
0,48007838600,48007838700,00000000100,a2f,recvmsg
0,48007839100,48007839300,00000000200,a2f,recvmsg
0,48007834400,48007845000,00000010600,a17,select
0,48007848600,48007848800,00000000200,a2f,recvmsg
0,48007842500,48007852300,00000009800,a07,poll
0,48007853600,48007853800,00000000200,a2f,recvmsg
0,48007854200,48007854400,00000000200,a2f,recvmsg
0,48007849400,48007859900,00000010500,a17,select
0,48007863400,48007863600,00000000200,a2f,recvmsg
0,48007857500,48007867200,00000009700,a07,poll
0,48007868400,48007868600,00000000200,a2f,recvmsg
0,48007869000,48007869100,00000000100,a2f,recvmsg
0,48007864200,48007874300,00000010100,a17,select
0,48007878000,48007878100,00000000100,a2f,recvmsg
0,48007871600,48007881700,00000010100,a07,poll
0,48007882900,48007883000,00000000100,a2f,recvmsg
0,48007883400,48007883600,00000000200,a2f,recvmsg
0,48007878600,48007890900,00000012300,a17,select
0,48007894500,48007894700,00000000200,a2f,recvmsg
0,48007888300,48007898200,00000009900,a07,poll
0,48007899500,48007899600,00000000100,a2f,recvmsg
0,48007899900,48007900100,00000000200,a2f,recvmsg
0,48007895300,48007905100,00000009800,a17,select
0,48007908600,48007908800,00000000200,a2f,recvmsg
0,48007902600,48007912300,00000009700,a07,poll
0,48007913400,48007913600,00000000200,a2f,recvmsg
0,48007914000,48007914200,00000000200,a2f,recvmsg
0,48007909300,48007919100,00000009800,a17,select
0,48007922500,48007922700,00000000200,a2f,recvmsg
0,48007916600,48007926200,00000009600,a07,poll
0,48007927500,48007927600,00000000100,a2f,recvmsg
0,48007928000,48007928100,00000000100,a2f,recvmsg
0,48007923300,48007933100,00000009800,a17,select
0,48007936500,48007936700,00000000200,a2f,recvmsg
0,48007930600,48007940200,00000009600,a07,poll
0,48007941500,48007941600,00000000100,a2f,recvmsg
0,48007942000,48007942200,00000000200,a2f,recvmsg
0,48007937300,48007947700,00000010400,a17,select
0,48007951100,48007951300,00000000200,a2f,recvmsg
0,48007945100,48007954800,00000009700,a07,poll
0,48007956200,48007956300,00000000100,a2f,recvmsg
0,48007956600,48007956800,00000000200,a2f,recvmsg
0,48007951900,48007962000,00000010100,a17,select
0,48007965300,48007965500,00000000200,a2f,recvmsg
0,48007959400,48007969000,00000009600,a07,poll
0,48007970300,48007970400,00000000100,a2f,recvmsg
0,48007970800,48007971000,00000000200,a2f,recvmsg
0,48007966000,48007976700,00000010700,a17,select
0,48007980200,48007980400,00000000200,a2f,recvmsg
0,48007974000,48007983800,00000009800,a07,poll
0,48007985000,48007985200,00000000200,a2f,recvmsg
0,48007985600,48007985800,00000000200,a2f,recvmsg
0,48007981000,48007991400,00000010400,a17,select
0,48007994800,48007995000,00000000200,a2f,recvmsg
0,48007988800,48007998400,00000009600,a07,poll
0,48007999700,48007999900,00000000200,a2f,recvmsg
0,48008000200,48008000300,00000000100,a2f,recvmsg
0,48007995600,48008008300,00000012700,a17,select
0,48008012100,48008012300,00000000200,a2f,recvmsg
0,48008005800,48008015900,00000010100,a07,poll
0,48008017100,48008017300,00000000200,a2f,recvmsg
0,48008017600,48008017800,00000000200,a2f,recvmsg
0,48008012900,48008023700,00000010800,a17,select
0,48008027100,48008027200,00000000100,a2f,recvmsg
0,48008021100,48008030700,00000009600,a07,poll
0,48008032000,48008032100,00000000100,a2f,recvmsg
0,48008032500,48008032600,00000000100,a2f,recvmsg
0,48008027800,48008038500,00000010700,a17,select
0,48008042100,48008042300,00000000200,a2f,recvmsg
0,48008036000,48008045800,00000009800,a07,poll
0,48008047000,48008047200,00000000200,a2f,recvmsg
0,48008047600,48008047700,00000000100,a2f,recvmsg
0,48008042800,48008055800,00000013000,a17,select
0,48008059400,48008059600,00000000200,a2f,recvmsg
0,48008053300,48008063100,00000009800,a07,poll
0,48008064400,48008064600,00000000200,a2f,recvmsg
0,48008064900,48008065000,00000000100,a2f,recvmsg
0,48008060200,48008070500,00000010300,a17,select
0,48008074000,48008074100,00000000100,a2f,recvmsg
0,48008067900,48008077600,00000009700,a07,poll
0,48008078900,48008079100,00000000200,a2f,recvmsg
0,48008079400,48008079600,00000000200,a2f,recvmsg
0,48008074600,48008086200,00000011600,a17,select
0,48008089800,48008090000,00000000200,a2f,recvmsg
0,48008083700,48008093500,00000009800,a07,poll
0,48008094800,48008095000,00000000200,a2f,recvmsg
0,48008095200,48008095400,00000000200,a2f,recvmsg
0,48008090600,48008101700,00000011100,a17,select
0,48008105300,48008105400,00000000100,a2f,recvmsg
0,48008099100,48008108900,00000009800,a07,poll
0,48008110300,48008110400,00000000100,a2f,recvmsg
0,48008110800,48008110900,00000000100,a2f,recvmsg
0,48008106000,48008116800,00000010800,a17,select
0,48008120400,48008120500,00000000100,a2f,recvmsg
0,48008114200,48008124000,00000009800,a07,poll
0,48008125400,48008125600,00000000200,a2f,recvmsg
0,48008125800,48008126000,00000000200,a2f,recvmsg
0,48008121100,48008132300,00000011200,a17,select
0,48008135900,48008136100,00000000200,a2f,recvmsg
0,48008129600,48008139600,00000010000,a07,poll
0,48008140900,48008141100,00000000200,a2f,recvmsg
0,48008141400,48008141600,00000000200,a2f,recvmsg
0,48008136700,48008147300,00000010600,a17,select
0,48008150800,48008151000,00000000200,a2f,recvmsg
0,48008144700,48008154500,00000009800,a07,poll
0,48008155800,48008155900,00000000100,a2f,recvmsg
0,48008156200,48008156400,00000000200,a2f,recvmsg
0,48008151600,48008161900,00000010300,a17,select
0,48008165500,48008165600,00000000100,a2f,recvmsg
0,48008159400,48008169200,00000009800,a07,poll
0,48008170400,48008170600,00000000200,a2f,recvmsg
0,48008170900,48008171100,00000000200,a2f,recvmsg
0,48008166200,48008176500,00000010300,a17,select
0,48008179900,48008180100,00000000200,a2f,recvmsg
0,48008173800,48008183600,00000009800,a07,poll
0,48008184800,48008185000,00000000200,a2f,recvmsg
0,48008185400,48008185600,00000000200,a2f,recvmsg
0,48008180700,48008191300,00000010600,a17,select
0,48008194900,48008195100,00000000200,a2f,recvmsg
0,48008188700,48008198600,00000009900,a07,poll
0,48008199800,48008200000,00000000200,a2f,recvmsg
0,48008200300,48008200500,00000000200,a2f,recvmsg
0,48008201800,48008201900,00000000100,a08,lseek
0,48008204500,48008205800,00000001300,a00,read
0,48008209500,48008209600,00000000100,a08,lseek
0,48008195700,48008215000,00000019300,a17,select
0,48008218800,48008219000,00000000200,a2f,recvmsg
0,48008212200,48008222600,00000010400,a07,poll
0,48008224000,48008224200,00000000200,a2f,recvmsg
0,48008224500,48008224700,00000000200,a2f,recvmsg
0,48008219600,48008254500,00000034900,a17,select
0,48008258600,48008258700,00000000100,a2f,recvmsg
0,48008251600,48008262400,00000010800,a07,poll
0,48008263900,48008264000,00000000100,a2f,recvmsg
0,48008264300,48008264500,00000000200,a2f,recvmsg
0,48008268900,48008270000,00000001100,a00,read
0,48008275700,48008275800,00000000100,a08,lseek
0,48008259300,48008281600,00000022300,a17,select
0,48008285400,48008285500,00000000100,a2f,recvmsg
0,48008279000,48008289300,00000010300,a07,poll
0,48008290700,48008290900,00000000200,a2f,recvmsg
0,48008291200,48008291400,00000000200,a2f,recvmsg
0,48008286200,48008296600,00000010400,a17,select
0,48008299900,48008300100,00000000200,a2f,recvmsg
0,48008294100,48008303600,00000009500,a07,poll
0,48008304700,48008304900,00000000200,a2f,recvmsg
0,48008305300,48008305500,00000000200,a2f,recvmsg
0,48008300600,48008310200,00000009600,a17,select
0,48008313700,48008313700,00000000000,a2f,recvmsg
0,48008307900,48008317300,00000009400,a07,poll
0,48008318500,48008318600,00000000100,a2f,recvmsg
0,48008319000,48008319200,00000000200,a2f,recvmsg
0,48008314300,48008324100,00000009800,a17,select
0,48008327500,48008327700,00000000200,a2f,recvmsg
0,48008321600,48008331200,00000009600,a07,poll
0,48008332500,48008332700,00000000200,a2f,recvmsg
0,48008332900,48008333100,00000000200,a2f,recvmsg
0,48008328300,48008338200,00000009900,a17,select
0,48008341500,48008341700,00000000200,a2f,recvmsg
0,48008335700,48008345200,00000009500,a07,poll
0,48008346300,48008346500,00000000200,a2f,recvmsg
0,48008346900,48008347000,00000000100,a2f,recvmsg
0,48008342200,48008351900,00000009700,a17,select
0,48008355300,48008355500,00000000200,a2f,recvmsg
0,48008349500,48008358900,00000009400,a07,poll
0,48008360100,48008360300,00000000200,a2f,recvmsg
0,48008360700,48008360800,00000000100,a2f,recvmsg
0,48008356000,48008365600,00000009600,a17,select
0,48008368900,48008369100,00000000200,a2f,recvmsg
0,48008363200,48008372600,00000009400,a07,poll
0,48008373800,48008374000,00000000200,a2f,recvmsg
0,48008374300,48008374500,00000000200,a2f,recvmsg
0,48008369700,48008380000,00000010300,a17,select
0,48008383500,48008383700,00000000200,a2f,recvmsg
0,48008377600,48008387100,00000009500,a07,poll
0,48008388300,48008388500,00000000200,a2f,recvmsg
0,48008388800,48008389000,00000000200,a2f,recvmsg
0,48008384200,48008393900,00000009700,a17,select
0,48008397300,48008397400,00000000100,a2f,recvmsg
0,48008391500,48008401000,00000009500,a07,poll
0,48008402100,48008402300,00000000200,a2f,recvmsg
0,48008402700,48008402900,00000000200,a2f,recvmsg
0,48008403400,48008403500,00000000100,a08,lseek
0,48008397900,48008410000,00000012100,a17,select
0,48008413400,48008413600,00000000200,a2f,recvmsg
0,48008407300,48008417100,00000009800,a07,poll
0,48008418300,48008418500,00000000200,a2f,recvmsg
0,48008418800,48008419000,00000000200,a2f,recvmsg
0,48008414200,48008426500,00000012300,a17,select
0,48008430200,48008430400,00000000200,a2f,recvmsg
0,48008423900,48008433900,00000010000,a07,poll
0,48008435200,48008435300,00000000100,a2f,recvmsg
0,48008435700,48008435900,00000000200,a2f,recvmsg
0,48008431000,48008441600,00000010600,a17,select
0,48008445100,48008445200,00000000100,a2f,recvmsg
0,48008439100,48008448700,00000009600,a07,poll
0,48008450100,48008450300,00000000200,a2f,recvmsg
0,48008450500,48008450700,00000000200,a2f,recvmsg
0,48008445800,48008456200,00000010400,a17,select
0,48008459500,48008459700,00000000200,a2f,recvmsg
0,48008453700,48008463300,00000009600,a07,poll
0,48008464600,48008464800,00000000200,a2f,recvmsg
0,48008465200,48008465300,00000000100,a2f,recvmsg
0,48008460200,48008470700,00000010500,a17,select
0,48008473900,48008474100,00000000200,a2f,recvmsg
0,48008468100,48008477600,00000009500,a07,poll
0,48008479200,48008479400,00000000200,a2f,recvmsg
0,48008479700,48008479900,00000000200,a2f,recvmsg
0,48008474700,48008485200,00000010500,a17,select
0,48008488600,48008488800,00000000200,a2f,recvmsg
0,48008482800,48008492300,00000009500,a07,poll
0,48008493600,48008493700,00000000100,a2f,recvmsg
0,48008494100,48008494200,00000000100,a2f,recvmsg
0,48008489400,48008499900,00000010500,a17,select
0,48008503400,48008503600,00000000200,a2f,recvmsg
0,48008497500,48008507000,00000009500,a07,poll
0,48008508200,48008508400,00000000200,a2f,recvmsg
0,48008508800,48008509000,00000000200,a2f,recvmsg
0,48008504100,48008514200,00000010100,a17,select
0,48008517500,48008517700,00000000200,a2f,recvmsg
0,48008511700,48008521200,00000009500,a07,poll
0,48008522500,48008522700,00000000200,a2f,recvmsg
0,48008522900,48008523100,00000000200,a2f,recvmsg
0,48008518300,48008528300,00000010000,a17,select
0,48008531600,48008531800,00000000200,a2f,recvmsg
0,48008525800,48008535200,00000009400,a07,poll
0,48008536400,48008536600,00000000200,a2f,recvmsg
0,48008537000,48008537200,00000000200,a2f,recvmsg
0,48008532300,48008542400,00000010100,a17,select
0,48008545700,48008545900,00000000200,a2f,recvmsg
0,48008539900,48008549300,00000009400,a07,poll
0,48008550600,48008550800,00000000200,a2f,recvmsg
0,48008551200,48008551300,00000000100,a2f,recvmsg
0,48008546400,48008556600,00000010200,a17,select
0,48008559900,48008560100,00000000200,a2f,recvmsg
0,48008554100,48008563500,00000009400,a07,poll
0,48008564700,48008564900,00000000200,a2f,recvmsg
0,48008565300,48008565400,00000000100,a2f,recvmsg
0,48008560700,48008570600,00000009900,a17,select
0,48008574000,48008574000,00000000000,a2f,recvmsg
0,48008568200,48008577600,00000009400,a07,poll
0,48008578800,48008579000,00000000200,a2f,recvmsg
0,48008579300,48008579500,00000000200,a2f,recvmsg
0,48008574600,48008585300,00000010700,a17,select
0,48008588700,48008588800,00000000100,a2f,recvmsg
0,48008582800,48008592300,00000009500,a07,poll
0,48008593500,48008593700,00000000200,a2f,recvmsg
0,48008594000,48008594200,00000000200,a2f,recvmsg
0,48008589300,48008599400,00000010100,a17,select
0,48008602700,48008602900,00000000200,a2f,recvmsg
0,48008596900,48008606300,00000009400,a07,poll
0,48008607600,48008607800,00000000200,a2f,recvmsg
0,48008608200,48008608200,00000000000,a2f,recvmsg
0,48008603500,48008613500,00000010000,a17,select
0,48008616700,48008616900,00000000200,a2f,recvmsg
0,48008611000,48008620300,00000009300,a07,poll
0,48008621500,48008621700,00000000200,a2f,recvmsg
0,48008622000,48008622200,00000000200,a2f,recvmsg
0,48008617500,48008627500,00000010000,a17,select
0,48008631000,48008631100,00000000100,a2f,recvmsg
0,48008625100,48008634700,00000009600,a07,poll
0,48008636100,48008636300,00000000200,a2f,recvmsg
0,48008636600,48008636700,00000000100,a2f,recvmsg
0,48008631700,48008647500,00000015800,a17,select
0,48008651000,48008651200,00000000200,a2f,recvmsg
0,48008645000,48008654700,00000009700,a07,poll
0,48008656000,48008656200,00000000200,a2f,recvmsg
0,48008656500,48008656700,00000000200,a2f,recvmsg
0,48008651900,48008662100,00000010200,a17,select
0,48008665500,48008665700,00000000200,a2f,recvmsg
0,48008659600,48008669200,00000009600,a07,poll
0,48008670600,48008670700,00000000100,a2f,recvmsg
0,48008671000,48008671200,00000000200,a2f,recvmsg
0,48008666300,48008676400,00000010100,a17,select
0,48008679900,48008680000,00000000100,a2f,recvmsg
0,48008674000,48008683500,00000009500,a07,poll
0,48008684600,48008684800,00000000200,a2f,recvmsg
0,48008685200,48008685500,00000000300,a2f,recvmsg
0,48008680500,48008690800,00000010300,a17,select
0,48008694100,48008694300,00000000200,a2f,recvmsg
0,48008688400,48008697700,00000009300,a07,poll
0,48008699000,48008699200,00000000200,a2f,recvmsg
0,48008699400,48008699600,00000000200,a2f,recvmsg
0,48008694900,48008705000,00000010100,a17,select
0,48008708300,48008708500,00000000200,a2f,recvmsg
0,48008702500,48008711900,00000009400,a07,poll
0,48008713200,48008713400,00000000200,a2f,recvmsg
0,48008713700,48008713900,00000000200,a2f,recvmsg
0,48008735000,48008760200,00000025200,a57,unlink
0,48008761400,48008765300,00000003900,a14,writev
0,48008709000,48008770100,00000061100,a17,select
0,48008772600,48008773800,00000001200,a2f,recvmsg
0,48008858800,48008862500,00000003700,a14,writev
0,48008862900,48008866600,00000003700,a14,writev
0,48008946200,48008948100,00000001900,a14,writev
0,48008948400,48008950000,00000001600,a14,writev
0,48009008000,48009010500,00000002500,a14,writev
0,48009010800,48009012300,00000001500,a14,writev
0,48009067300,48009069200,00000001900,a14,writev
0,48009069400,48009071000,00000001600,a14,writev
0,48009126800,48009128600,00000001800,a14,writev
0,48009128800,48009130400,00000001600,a14,writev
0,48009185600,48009187400,00000001800,a14,writev
0,48009187600,48009189200,00000001600,a14,writev
0,48009193400,48009194600,00000001200,a2f,recvmsg
0,48009243200,48009244900,00000001700,a14,writev
0,48009289100,48009290600,00000001500,a14,writev
0,48009333200,48009334900,00000001700,a14,writev
0,48009377600,48009379100,00000001500,a14,writev
0,48009422700,48009424200,00000001500,a14,writev
0,48009466500,48009468100,00000001600,a14,writev
0,48009494500,48009496400,00000001900,a2f,recvmsg
0,48009521000,48009523000,00000002000,a14,writev
0,48009539800,48009541600,00000001800,a14,writev
0,48009556300,48009558200,00000001900,a14,writev
0,48009572500,48009574000,00000001500,a14,writev
0,48009587400,48009588900,00000001500,a14,writev
0,48009602500,48009604500,00000002000,a14,writev
0,48009610400,48009610600,00000000200,a2f,recvmsg
0,48009611300,48009611600,00000000300,a14,writev
0,48009629700,48009631500,00000001800,a14,writev
0,48009631700,48009633200,00000001500,a14,writev
0,48009633700,48009634000,00000000300,a2f,recvmsg
0,48008765900,48009644600,00000878700,a07,poll
0,48009649100,48009657000,00000007900,a2f,recvmsg
0,48009681400,48009681700,00000000300,a2f,recvmsg
0,48009710300,48009715600,00000005300,a07,poll
0,48009721100,48009729500,00000008400,a2f,recvmsg
0,48009742300,48009742500,00000000200,a2f,recvmsg
0,48009765900,48009770900,00000005000,a07,poll
0,48009776700,48009784300,00000007600,a2f,recvmsg
0,48009797000,48009797300,00000000300,a2f,recvmsg
0,48009821700,48009823800,00000002100,a07,poll
0,48009826800,48009827000,00000000200,a2f,recvmsg
0,48009827700,48009827900,00000000200,a2f,recvmsg
0,48009634700,48009860400,00000225700,a17,select
0,48009876700,48009878300,00000001600,a14,writev
0,48009878900,48009879100,00000000200,a2f,recvmsg
0,48009893500,48009894500,00000001000,a14,writev
0,48009894800,48009895000,00000000200,a2f,recvmsg
0,48009907300,48009908100,00000000800,a14,writev
0,48009908400,48009908600,00000000200,a2f,recvmsg
0,48009919000,48009921100,00000002100,a14,writev
0,48009923200,48009923400,00000000200,a2f,recvmsg
0,48009853600,48009928400,00000074800,a07,poll
0,48009929500,48009930600,00000001100,a2f,recvmsg
0,48009937800,48009938800,00000001000,a2d,recvfrom
0,48009940300,48009940400,00000000100,a2f,recvmsg
0,48009941200,48009941400,00000000200,a2f,recvmsg
0,48009986800,48009987200,00000000400,a2f,recvmsg
0,48009989400,48009989500,00000000100,a2f,recvmsg
0,48009992500,48009995500,00000003000,a07,poll
0,48009996600,48009997800,00000001200,a2f,recvmsg
0,48010006600,48010007300,00000000700,a2d,recvfrom
0,48010008400,48010008500,00000000100,a2f,recvmsg
0,48010009400,48010009500,00000000100,a2f,recvmsg
0,48010044200,48010044400,00000000200,a2f,recvmsg
0,48010047100,48010047300,00000000200,a2f,recvmsg
0,48010050600,48010054000,00000003400,a07,poll
0,48010055200,48010056300,00000001100,a2f,recvmsg
0,48010065200,48010065800,00000000600,a2d,recvfrom
0,48010067000,48010067200,00000000200,a2f,recvmsg
0,48010068200,48010068300,00000000100,a2f,recvmsg
0,48010102400,48010102600,00000000200,a2f,recvmsg
0,48010105000,48010105200,00000000200,a2f,recvmsg
0,48010108900,48010113000,00000004100,a07,poll
0,48010115700,48010115900,00000000200,a2f,recvmsg
0,48010116600,48010116800,00000000200,a2f,recvmsg
0,48010625100,48010629700,00000004600,a09,mmap
0,48010748400,48010751900,00000003500,a01,write
0,48010807000,48010808400,00000001400,aca,futex
0,48010855500,48010861100,00000005600,a02,open
0,48010869300,48010871200,00000001900,a00,read
0,48010928900,48010929900,00000001000,a00,read
0,48010981600,48010982400,00000000800,a00,read
0,48011032300,48011032900,00000000600,a00,read
0,48011084600,48011085300,00000000700,a00,read
0,48011134800,48011135400,00000000600,a00,read
0,48011182900,48011183700,00000000800,a00,read
0,48011233700,48011234400,00000000700,a00,read
0,48011286800,48011287500,00000000700,a00,read
0,48011338500,48011339200,00000000700,a00,read
0,48011388600,48011389300,00000000700,a00,read
0,48011416300,48011418700,00000002400,a02,open
0,48011422100,48011423100,00000001000,a00,read
0,48011477200,48011478000,00000000800,a00,read
0,48011562700,48011563600,00000000900,a00,read
0,48011634400,48011635000,00000000600,a00,read
0,48011712500,48011713200,00000000700,a00,read
0,48011791900,48011792600,00000000700,a00,read
0,48011869300,48011870000,00000000700,a00,read
0,48011953900,48011954500,00000000600,a00,read
0,48012019600,48012020300,00000000700,a00,read
0,48012077600,48012078400,00000000800,a00,read
0,48012159600,48012164100,00000004500,a07,poll
0,48012175500,48012180000,00000004500,a2e,sendmsg
0,48012185700,48012185900,00000000200,a00,read
0,48009924000,48012209500,00002285500,a17,select
0,48012224200,48012224500,00000000300,a2f,recvmsg
0,48012199100,48012233200,00000034100,a07,poll
0,48012235900,48012236200,00000000300,a2f,recvmsg
0,48012237100,48012237200,00000000100,a2f,recvmsg
0,48012226800,48012244300,00000017500,a17,select
0,48012249900,48012250100,00000000200,a2f,recvmsg
0,48012240400,48012255300,00000014900,a07,poll
0,48012256600,48012256800,00000000200,a2f,recvmsg
0,48012257200,48012257400,00000000200,a2f,recvmsg
0,48012263300,48012268600,00000005300,a06,lstat
0,48012269500,48012270500,00000001000,a06,lstat
0,48012291300,48012305100,00000013800,a01,write
0,48012250800,48012316300,00000065500,a17,select
0,48012323300,48012323600,00000000300,a2f,recvmsg
0,48012311100,48012329200,00000018100,a07,poll
0,48012331200,48012331400,00000000200,a2f,recvmsg
0,48012332000,48012332100,00000000100,a2f,recvmsg
0,48012334000,48012661000,00000327000,a38,clone
1,47972630500,47990434200,00017803700,a14,writev
1,47990434500,47990442000,00000007500,a07,poll
1,47990443300,47990443500,00000000200,a2f,recvmsg
1,47990443700,47990443900,00000000200,a2f,recvmsg
1,47990445300,47990446900,00000001600,a14,writev
1,47990447200,47990454600,00000007400,a07,poll
1,47990455900,47990456000,00000000100,a2f,recvmsg
1,47990456400,47990456500,00000000100,a2f,recvmsg
1,47990457000,47990457100,00000000100,a08,lseek
1,47990460300,47990461900,00000001600,a14,writev
1,47990462200,47990469800,00000007600,a07,poll
1,47990471100,47990471300,00000000200,a2f,recvmsg
1,47990471600,47990471800,00000000200,a2f,recvmsg
1,47990475400,47990477100,00000001700,a14,writev
1,47990477400,47990485200,00000007800,a07,poll
1,47990486400,47990486600,00000000200,a2f,recvmsg
1,47990487000,47990487100,00000000100,a2f,recvmsg
1,47990489000,47990490500,00000001500,a14,writev
1,47990490900,47990498200,00000007300,a07,poll
1,47990499400,47990499600,00000000200,a2f,recvmsg
1,47990499900,47990500100,00000000200,a2f,recvmsg
1,47990501600,47990503100,00000001500,a14,writev
1,47990503500,47990510800,00000007300,a07,poll
1,47990512100,47990512300,00000000200,a2f,recvmsg
1,47990512600,47990512800,00000000200,a2f,recvmsg
1,47990514200,47990515800,00000001600,a14,writev
1,47990516100,47990523400,00000007300,a07,poll
1,47990524700,47990524900,00000000200,a2f,recvmsg
1,47990525200,47990525400,00000000200,a2f,recvmsg
1,47990526800,47990528300,00000001500,a14,writev
1,47990528600,47990536000,00000007400,a07,poll
1,47990537200,47990537400,00000000200,a2f,recvmsg
1,47990537800,47990537900,00000000100,a2f,recvmsg
1,47990539900,47990541500,00000001600,a14,writev
1,47990541900,47990549400,00000007500,a07,poll
1,47990550800,47990550900,00000000100,a2f,recvmsg
1,47990551200,47990551400,00000000200,a2f,recvmsg
1,47990553000,47990554500,00000001500,a14,writev
1,47990554900,47990562300,00000007400,a07,poll
1,47990563600,47990563800,00000000200,a2f,recvmsg
1,47990564100,47990564300,00000000200,a2f,recvmsg
1,47990565700,47990567200,00000001500,a14,writev
1,47990567500,47990575000,00000007500,a07,poll
1,47990576400,47990576600,00000000200,a2f,recvmsg
1,47990576800,47990577000,00000000200,a2f,recvmsg
1,47990578500,47990580000,00000001500,a14,writev
1,47990580400,47990587700,00000007300,a07,poll
1,47990589000,47990589100,00000000100,a2f,recvmsg
1,47990589400,47990589600,00000000200,a2f,recvmsg
1,47990591000,47990592500,00000001500,a14,writev
1,47990592800,47990600200,00000007400,a07,poll
1,47990601500,47990601700,00000000200,a2f,recvmsg
1,47990602000,47990602200,00000000200,a2f,recvmsg
1,47990603600,47990605200,00000001600,a14,writev
1,47990605800,47990612900,00000007100,a07,poll
1,47990614300,47990614500,00000000200,a2f,recvmsg
1,47990614700,47990614900,00000000200,a2f,recvmsg
1,47990616800,47990618400,00000001600,a14,writev
1,47990618600,47990626200,00000007600,a07,poll
1,47990627500,47990627700,00000000200,a2f,recvmsg
1,47990628000,47990628100,00000000100,a2f,recvmsg
1,47990629600,47990631200,00000001600,a14,writev
1,47990631500,47990638900,00000007400,a07,poll
1,47990640200,47990640400,00000000200,a2f,recvmsg
1,47990640700,47990640900,00000000200,a2f,recvmsg
1,47990642300,47990643800,00000001500,a14,writev
1,47990644200,47990651600,00000007400,a07,poll
1,47990652800,47990653000,00000000200,a2f,recvmsg
1,47990653300,47990653500,00000000200,a2f,recvmsg
1,47990654800,47990656500,00000001700,a14,writev
1,47990657000,47990664100,00000007100,a07,poll
1,47990665500,47990665700,00000000200,a2f,recvmsg
1,47990666000,47990666100,00000000100,a2f,recvmsg
1,47990673700,47990675400,00000001700,a14,writev
1,47990675700,47990683100,00000007400,a07,poll
1,47990684700,47990684800,00000000100,a2f,recvmsg
1,47990685100,47990685200,00000000100,a2f,recvmsg
1,47990686900,47990688500,00000001600,a14,writev
1,47990688800,47990696000,00000007200,a07,poll
1,47990697300,47990697400,00000000100,a2f,recvmsg
1,47990697700,47990697900,00000000200,a2f,recvmsg
1,47990699400,47990700900,00000001500,a14,writev
1,47990701300,47990708600,00000007300,a07,poll
1,47990709900,47990710100,00000000200,a2f,recvmsg
1,47990710400,47990710600,00000000200,a2f,recvmsg
1,47990712100,47990713700,00000001600,a14,writev
1,47990714000,47990721300,00000007300,a07,poll
1,47990722700,47990722900,00000000200,a2f,recvmsg
1,47990723100,47990723300,00000000200,a2f,recvmsg
1,47990724900,47990726500,00000001600,a14,writev
1,47990726800,47990734300,00000007500,a07,poll
1,47990735600,47990735800,00000000200,a2f,recvmsg
1,47990736100,47990736300,00000000200,a2f,recvmsg
1,47990783000,47990788000,00000005000,a14,writev
1,47990788600,47990887600,00000099000,a07,poll
1,47990788600,47990891300,00000102700,a07,poll
1,47990903600,47990903700,00000000100,a2f,recvmsg
1,47990908700,47990908900,00000000200,a2f,recvmsg
1,47990909200,47990909300,00000000100,a2f,recvmsg
1,47990914100,47990914400,00000000300,a2f,recvmsg
1,47990914600,47990914700,00000000100,a2f,recvmsg
1,47990930100,47990930200,00000000100,a2f,recvmsg
1,47990968600,47990970000,00000001400,a2f,recvmsg
1,47990967700,47990972000,00000004300,a07,poll
1,47990977000,47990977200,00000000200,a2f,recvmsg
1,47990978400,47990978500,00000000100,a2f,recvmsg
1,47990978800,47990978900,00000000100,a2f,recvmsg
1,47990980100,47990980300,00000000200,a2f,recvmsg
1,47990980500,47990980700,00000000200,a2f,recvmsg
1,47990987100,47991031800,00000044700,a07,poll
1,47990987100,47991034200,00000047100,a07,poll
1,47991036300,47991036500,00000000200,a2f,recvmsg
1,47991037200,47991037400,00000000200,a2f,recvmsg
1,47991037700,47991037800,00000000100,a2f,recvmsg
1,47991038400,47991038600,00000000200,a2f,recvmsg
1,47991038800,47991039000,00000000200,a2f,recvmsg
1,47991038800,47991041300,00000002500,a2f,recvmsg
1,47991042200,47991090300,00000048100,a07,poll
1,47991042200,47991092500,00000050300,a07,poll
1,47991094300,47991094500,00000000200,a2f,recvmsg
1,47991095300,47991095400,00000000100,a2f,recvmsg
1,47991095600,47991095700,00000000100,a2f,recvmsg
1,47991096300,47991096400,00000000100,a2f,recvmsg
1,47991096600,47991096800,00000000200,a2f,recvmsg
1,47991096600,47991098600,00000002000,a2f,recvmsg
1,47991099200,47991150000,00000050800,a07,poll
1,47991099200,47991151800,00000052600,a07,poll
1,47991153600,47991153800,00000000200,a2f,recvmsg
1,47991154300,47991154500,00000000200,a2f,recvmsg
1,47991154700,47991154900,00000000200,a2f,recvmsg
1,47991155400,47991155600,00000000200,a2f,recvmsg
1,47991155800,47991155900,00000000100,a2f,recvmsg
1,47991158600,47991209100,00000050500,a07,poll
1,47991158600,47991211100,00000052500,a07,poll
1,47991212800,47991213000,00000000200,a2f,recvmsg
1,47991213500,47991213600,00000000100,a2f,recvmsg
1,47991213800,47991214000,00000000200,a2f,recvmsg
1,47991214500,47991214700,00000000200,a2f,recvmsg
1,47991214900,47991215100,00000000200,a2f,recvmsg
1,47991214900,47991217000,00000002100,a2f,recvmsg
1,47991217900,47991268400,00000050500,a07,poll
1,47991270100,47991299900,00000029800,a07,poll
1,47991270100,47991303300,00000033200,a07,poll
1,47991270100,47991312800,00000042700,a07,poll
1,47991316300,47991316500,00000000200,a2f,recvmsg
1,47991321300,47991321500,00000000200,a2f,recvmsg
1,47991321600,47991321800,00000000200,a2f,recvmsg
1,47991326500,47991326700,00000000200,a2f,recvmsg
1,47991326900,47991327100,00000000200,a2f,recvmsg
1,47991340500,47991340600,00000000100,a2f,recvmsg
1,47991327600,47991357600,00000030000,a07,poll
1,47991379400,47991380600,00000001200,a2f,recvmsg
1,47991378900,47991382500,00000003600,a07,poll
1,47991385200,47991385400,00000000200,a2f,recvmsg
1,47991386200,47991386400,00000000200,a2f,recvmsg
1,47991386600,47991386800,00000000200,a2f,recvmsg
1,47991387700,47991387800,00000000100,a2f,recvmsg
1,47991388000,47991388100,00000000100,a2f,recvmsg
1,47991390400,47991401300,00000010900,a07,poll
1,47991402600,47991438300,00000035700,a07,poll
1,47991438500,47991439600,00000001100,a2f,recvmsg
1,47991402600,47991440800,00000038200,a07,poll
1,47991442500,47991442700,00000000200,a2f,recvmsg
1,47991443100,47991443300,00000000200,a2f,recvmsg
1,47991443500,47991443700,00000000200,a2f,recvmsg
1,47991444200,47991444400,00000000200,a2f,recvmsg
1,47991444500,47991444700,00000000200,a2f,recvmsg
1,47991444900,47991445500,00000000600,a07,poll
1,47991446900,47991489500,00000042600,a07,poll
1,47991490700,47991496600,00000005900,a07,poll
1,47991496800,47991498100,00000001300,a2f,recvmsg
1,47991490700,47991499100,00000008400,a07,poll
1,47991500700,47991500900,00000000200,a2f,recvmsg
1,47991501400,47991501600,00000000200,a2f,recvmsg
1,47991501800,47991502000,00000000200,a2f,recvmsg
1,47991502400,47991502600,00000000200,a2f,recvmsg
1,47991502800,47991502900,00000000100,a2f,recvmsg
1,47991504600,47991544700,00000040100,a07,poll
1,47991547500,47991554300,00000006800,a07,poll
1,47991554500,47991555600,00000001100,a2f,recvmsg
1,47991547500,47991556800,00000009300,a07,poll
1,47991559700,47991559900,00000000200,a2f,recvmsg
1,47991560400,47991560600,00000000200,a2f,recvmsg
1,47991560800,47991560900,00000000100,a2f,recvmsg
1,47991561400,47991561600,00000000200,a2f,recvmsg
1,47991561800,47991561900,00000000100,a2f,recvmsg
1,47991563600,47991564600,00000001000,a07,poll
1,47991565900,47991581100,00000015200,a07,poll
1,47991582400,47991596700,00000014300,a07,poll
1,47991598100,47991612200,00000014100,a07,poll
1,47991598100,47991612300,00000014200,a07,poll
1,47991612500,47991613700,00000001200,a2f,recvmsg
1,47991613700,47991614700,00000001000,a07,poll
1,47991616400,47991616500,00000000100,a2f,recvmsg
1,47991617100,47991617300,00000000200,a2f,recvmsg
1,47991617400,47991617600,00000000200,a2f,recvmsg
1,47991618100,47991618200,00000000100,a2f,recvmsg
1,47991618400,47991618600,00000000200,a2f,recvmsg
1,47991620300,47991627400,00000007100,a07,poll
1,47991628700,47991633400,00000004700,a07,poll
1,47991636000,47991636200,00000000200,a2f,recvmsg
1,47991636700,47991636900,00000000200,a2f,recvmsg
1,47991660300,47991662000,00000001700,a07,poll
1,47991662600,47991664000,00000001400,a2f,recvmsg
1,47991667100,47991668500,00000001400,a2d,recvfrom
1,47991660300,47991668900,00000008600,a07,poll
1,47991670100,47991672500,00000002400,a07,poll
1,47991675600,47991675700,00000000100,a2f,recvmsg
1,47991676800,47991676900,00000000100,a2f,recvmsg
1,47991677100,47991677300,00000000200,a2f,recvmsg
1,47991678700,47991678800,00000000100,a2f,recvmsg
1,47991679000,47991679200,00000000200,a2f,recvmsg
1,47991685400,47991685700,00000000300,a2f,recvmsg
1,47991686300,47991686400,00000000100,a2f,recvmsg
1,47991679500,47991713900,00000034400,a07,poll
1,47991756900,47991757200,00000000300,a2f,recvmsg
1,47991715200,47991757800,00000042600,a07,poll
1,47991760800,47991761000,00000000200,a2f,recvmsg
1,47991764500,47991769000,00000004500,a07,poll
1,47991771500,47991771700,00000000200,a2f,recvmsg
1,47991772200,47991772300,00000000100,a2f,recvmsg
1,47991764500,47991802500,00000038000,a07,poll
1,47991803800,47991847400,00000043600,a07,poll
1,47991848500,47991891600,00000043100,a07,poll
1,47991894200,47991945500,00000051300,a07,poll
1,47991946600,47991963800,00000017200,a07,poll
1,47991965100,47991980500,00000015400,a07,poll
1,47991982200,47991995700,00000013500,a07,poll
1,47991996800,47992011000,00000014200,a07,poll
1,47992012200,47992025200,00000013000,a07,poll
1,47992026400,47992052200,00000025800,a07,poll
1,47992052400,47992054000,00000001600,a2f,recvmsg
1,47992055700,47992057300,00000001600,a2d,recvfrom
1,47992061100,47992061300,00000000200,a2f,recvmsg
1,47992061900,47992062000,00000000100,a2f,recvmsg
1,47992118500,47992118900,00000000400,a2f,recvmsg
1,47992121100,47992121300,00000000200,a2f,recvmsg
1,47992123800,47992468700,00000344900,a07,poll
1,47992471600,47992471800,00000000200,a2f,recvmsg
1,47992472600,47992472800,00000000200,a2f,recvmsg
1,47992472900,47992473000,00000000100,a2f,recvmsg
1,47992473900,47992474100,00000000200,a2f,recvmsg
1,47992474300,47992474500,00000000200,a2f,recvmsg
1,47992474700,47992509000,00000034300,a07,poll
1,47992514200,47992516200,00000002000,aca,futex
1,47992522300,47992523000,00000000700,aca,futex
1,47992535200,47992536400,00000001200,aca,futex
1,47992542400,47992548300,00000005900,a2e,sendmsg
1,47992586100,47992624600,00000038500,a2f,recvmsg
1,47992650000,47992650200,00000000200,a2f,recvmsg
1,47992689500,47993038900,00000349400,a07,poll
1,47993039500,47993039800,00000000300,a00,read
1,47993051200,47993052500,00000001300,a2f,recvmsg
1,47993204200,47993206700,00000002500,a07,poll
1,47993207100,47993209100,00000002000,a2f,recvmsg
1,47993219300,47993220400,00000001100,a2d,recvfrom
1,47993221700,47993221900,00000000200,a2f,recvmsg
1,47993222700,47993222900,00000000200,a2f,recvmsg
1,47993256600,47993260100,00000003500,a14,writev
1,47993260800,47993276000,00000015200,a07,poll
1,47993276300,47993278200,00000001900,a2f,recvmsg
1,47993279700,47993279800,00000000100,a2f,recvmsg
1,47993280200,47993280400,00000000200,a2f,recvmsg
1,47993304800,47993306800,00000002000,a14,writev
1,47993307100,47993319800,00000012700,a07,poll
1,47993320100,47993321500,00000001400,a2f,recvmsg
1,47993322500,47993322700,00000000200,a2f,recvmsg
1,47993323100,47993323300,00000000200,a2f,recvmsg
1,47993344300,47993344500,00000000200,a2f,recvmsg
1,47993307100,47993399400,00000092300,a07,poll
1,47993401300,47993402600,00000001300,aca,futex
1,47993405100,47993406000,00000000900,aca,futex
1,47993409000,47993409900,00000000900,aca,futex
1,47993412900,47993415900,00000003000,a2e,sendmsg
1,47993418800,47993419000,00000000200,a00,read
1,47993425800,47993782600,00000356800,a07,poll
1,47993788600,47993789700,00000001100,a2f,recvmsg
1,47993915200,47993917400,00000002200,a07,poll
1,47994263200,47994271200,00000008000,a02,open
1,47994290900,47994293900,00000003000,a00,read
1,47994346300,47994347200,00000000900,a00,read
1,47994402300,47994403100,00000000800,a00,read
1,47994456900,47994457700,00000000800,a00,read
1,47994510700,47994511400,00000000700,a00,read
1,47994563400,47994564300,00000000900,a00,read
1,47976057500,47994589800,00018532300,ae8,epoll_wait
1,47994600000,47994601800,00000001800,a2f,recvmsg
1,47994614100,47994614700,00000000600,a00,read
1,47994624300,47994624500,00000000200,a2f,recvmsg
1,47994647300,47994651400,00000004100,a2e,sendmsg
1,47994658600,47994659800,00000001200,a2e,sendmsg
1,47993915200,47994666700,00000751500,a07,poll
1,47994667200,47994667900,00000000700,a00,read
1,47994668600,47994669300,00000000700,a00,read
1,47994686200,47994687400,00000001200,a2f,recvmsg
1,47994751500,47994752600,00000001100,a00,read
1,47994769000,47994769800,00000000800,a2f,recvmsg
1,47994772000,47994772200,00000000200,a00,read
1,47994805400,47994806100,00000000700,a00,read
1,47994823100,47994827500,00000004400,a07,poll
1,47994864800,47994865600,00000000800,a00,read
1,47994894400,47994897300,00000002900,a02,open
1,47994900900,47994901800,00000000900,a00,read
1,47994956700,47994957600,00000000900,a00,read
1,47995042400,47995043300,00000000900,a00,read
1,47995116900,47995117700,00000000800,a00,read
1,47995196600,47995197400,00000000800,a00,read
1,47995277400,47995278200,00000000800,a00,read
1,47995309700,47995312000,00000002300,a2f,recvmsg
1,47995321000,47995321100,00000000100,a2f,recvmsg
1,47995356500,47995357200,00000000700,a00,read
1,47995442800,47995443500,00000000700,a00,read
1,47995509700,47995510400,00000000700,a00,read
1,47995568500,47995569500,00000001000,a00,read
1,47995648700,47995654500,00000005800,a14,writev
1,47995655600,47997660300,00002004700,a07,poll
1,47997663900,47997664200,00000000300,a2f,recvmsg
1,47997664900,47997665100,00000000200,a2f,recvmsg
1,47997666300,47997668400,00000002100,a14,writev
1,47997668700,47997679600,00000010900,a07,poll
1,47997681000,47997681100,00000000100,a2f,recvmsg
1,47997681500,47997681700,00000000200,a2f,recvmsg
1,47997687200,47997693300,00000006100,a06,lstat
1,47997694000,47997695700,00000001700,a06,lstat
1,47997719400,47997733600,00000014200,a01,write
1,47997736500,47997739600,00000003100,a14,writev
1,47997740400,47997749200,00000008800,a07,poll
1,47997751500,47997751700,00000000200,a2f,recvmsg
1,47997752200,47997752400,00000000200,a2f,recvmsg
1,47997753800,47998086900,00000333100,a38,clone
1,47998628300,47998628500,00000000200,a0c,brk
1,47998639600,47998642100,00000002500,a15,access
1,47998642700,47998643600,00000000900,a09,mmap
1,47998647600,47998648400,00000000800,a15,access
1,47998655500,47998656400,00000000900,a09,mmap
1,47998660000,47998660500,00000000500,a15,access
1,47998668100,47998669200,00000001100,a00,read
1,47998670700,47998672500,00000001800,a09,mmap
1,47998691000,47998691700,00000000700,a15,access
1,47998695200,47998695800,00000000600,a00,read
1,47998696600,47998697400,00000000800,a09,mmap
1,47998700200,47998701600,00000001400,a09,mmap
1,47998709700,47998710400,00000000700,a15,access
1,47998713800,47998714400,00000000600,a00,read
1,47998715100,47998715900,00000000800,a09,mmap
1,47998717500,47998719700,00000002200,a09,mmap
1,47998724900,47998728200,00000003300,a09,mmap
1,47998730200,47998731400,00000001200,a09,mmap
1,47998741500,47998742100,00000000600,a15,access
1,47998744900,47998745600,00000000700,a00,read
1,47998746300,47998747700,00000001400,a09,mmap
1,47998751100,47998752600,00000001500,a09,mmap
1,47998760900,47998761500,00000000600,a15,access
1,47998765000,47998765700,00000000700,a00,read
1,47998766300,47998767800,00000001500,a09,mmap
1,47998771800,47998774200,00000002400,a09,mmap
1,47998782800,47998783300,00000000500,a15,access
1,47998786100,47998786600,00000000500,a00,read
1,47998787100,47998788300,00000001200,a09,mmap
1,47998789500,47998790800,00000001300,a09,mmap
1,47998794200,47998795600,00000001400,a09,mmap
1,47998801900,47998802500,00000000600,a15,access
1,47998805100,47998805700,00000000600,a00,read
1,47998806400,47998807500,00000001100,a09,mmap
1,47998826400,47998826900,00000000500,a09,mmap
1,47998832200,47998832500,00000000300,a09,mmap
1,47999027600,47999027600,00000000000,a0c,brk
1,47999062500,47999063500,00000001000,a00,read
1,47999075700,47999077200,00000001500,a00,read
1,47999118600,47999119400,00000000800,a00,read
1,47999244000,47999244900,00000000900,a00,read
1,47999316700,47999317100,00000000400,a00,read
1,47999404100,47999404700,00000000600,a00,read
1,47999535400,47999536300,00000000900,a00,read
1,47999664400,47999665300,00000000900,a00,read
1,47999820400,47999821300,00000000900,a00,read
1,47999971200,47999972100,00000000900,a00,read
1,48000008700,48000010100,00000001400,a0c,brk
1,48000125500,48000126300,00000000800,a00,read
1,48000274300,48000275000,00000000700,a00,read
1,48000429800,48000430400,00000000600,a00,read
1,48000589000,48000589700,00000000700,a00,read
1,48000698100,48000698900,00000000800,a00,read
1,48000729300,48000730000,00000000700,a0c,brk
1,48000837800,48000838700,00000000900,a00,read
1,48001083300,48001083800,00000000500,a00,read
1,48001095300,48001095700,00000000400,a00,read
1,48001140600,48001140900,00000000300,a00,read
1,48001160600,48001161400,00000000800,a00,read
1,48001368200,48001368700,00000000500,a00,read
1,48001397900,48001398800,00000000900,a00,read
1,48001496100,48001497000,00000000900,a00,read
1,48001520700,48001521900,00000001200,a0c,brk
1,48001567000,48001567500,00000000500,a00,read
1,48001644100,48001644900,00000000800,a00,read
1,48001812900,48001813500,00000000600,a00,read
1,48001927600,48001928300,00000000700,a00,read
1,48002022600,48002023100,00000000500,a00,read
1,48002035100,48002035600,00000000500,a00,read
1,48002120500,48002120900,00000000400,a00,read
1,48002144700,48002145100,00000000400,a00,read
1,48002167000,48002167500,00000000500,a00,read
1,48002269100,48002270200,00000001100,a0c,brk
1,48002271300,48002272400,00000001100,a00,read
1,48002475400,48002476200,00000000800,a00,read
1,48002559500,48002560000,00000000500,a00,read
1,48002623900,48002624600,00000000700,a00,read
1,48002753600,48002754000,00000000400,a00,read
1,48002786100,48002786600,00000000500,a00,read
1,48002804100,48002805600,00000001500,a02,open
1,48002920900,48002921300,00000000400,a00,read
1,48002992700,48002993100,00000000400,a00,read
1,48003045300,48003046500,00000001200,a0c,brk
1,48003053100,48003053800,00000000700,a00,read
1,48003162500,48003163100,00000000600,a00,read
1,48003313500,48003314300,00000000800,a00,read
1,48003445400,48003446000,00000000600,a00,read
1,48003503500,48003504100,00000000600,a00,read
1,48003560400,48003561100,00000000700,a00,read
1,48003631100,48003631800,00000000700,a00,read
1,48003684400,48003685100,00000000700,a00,read
1,48003773500,48003774200,00000000700,a0c,brk
1,48003806500,48003810200,00000003700,a0c,brk
1,48003824700,48003825400,00000000700,a00,read
1,48003941300,48003942100,00000000800,a00,read
1,48004099900,48004100600,00000000700,a00,read
1,48004217500,48004218200,00000000700,a00,read
1,48004363100,48004363800,00000000700,a00,read
1,48004480300,48004480900,00000000600,a00,read
1,47970135600,48004631400,00034495800,a4a,fsync
1,48004692400,48004696400,00000004000,a09,mmap
1,47997740400,48004775200,00007034800,a07,poll
1,48004779100,48004781100,00000002000,aca,futex
1,48004786100,48004786900,00000000800,aca,futex
1,48004789500,48004790500,00000001000,aca,futex
1,48004810400,48004810700,00000000300,a00,read
1,48004816200,48004867300,00000051100,a07,poll
1,48004868800,48004870100,00000001300,aca,futex
1,48004871800,48004872600,00000000800,aca,futex
1,48004874100,48004874900,00000000800,aca,futex
1,48004877200,48004879300,00000002100,a2e,sendmsg
1,48005046700,48005054800,00000008100,a01,write
1,47994661800,48005089800,00010428000,ae8,epoll_wait
1,48005101700,48005106500,00000004800,a2f,recvmsg
1,48005126600,48005126800,00000000200,a2f,recvmsg
1,48005173900,48005174800,00000000900,a2e,sendmsg
1,48004900400,48009655800,00004755400,a07,poll
1,48009659900,48009660600,00000000700,a00,read
1,48009790800,48009791700,00000000900,a2f,recvmsg
1,48009794100,48009794600,00000000500,a00,read
1,48009847000,48009851400,00000004400,a07,poll
1,48009912000,48009912200,00000000200,a00,read
1,48009948500,48009952000,00000003500,a07,poll
1,48009956100,48009959800,00000003700,a2e,sendmsg
1,48005178100,48009962300,00004784200,ae8,epoll_wait
1,48009968400,48009969700,00000001300,a2f,recvmsg
1,48009979300,48009979500,00000000200,a2f,recvmsg
1,48009994100,48009996700,00000002600,a2e,sendmsg
1,48009948500,48009998800,00000050300,a07,poll
1,48009999900,48010000300,00000000400,a00,read
1,48010010500,48010011200,00000000700,a2f,recvmsg
1,48010092800,48010093100,00000000300,a00,read
1,48010174600,48010176500,00000001900,a00,read
1,48010182100,48010184400,00000002300,a0c,brk
1,48010304400,48010305100,00000000700,a00,read
1,48010424500,48010425300,00000000800,a00,read
1,48010571600,48010572300,00000000700,a00,read
1,48010704700,48010705400,00000000700,a00,read
1,48010798200,48010798900,00000000700,a00,read
1,48010912100,48010912600,00000000500,a00,read
1,48011037100,48011037800,00000000700,a00,read
1,48011150200,48011151200,00000001000,a0c,brk
1,48011173400,48011174300,00000000900,a00,read
1,48011344800,48011345600,00000000800,a00,read
1,48010101100,48011399400,00001298300,a07,poll
1,48010101100,48011402700,00001301600,a07,poll
1,48011416100,48011416300,00000000200,a2f,recvmsg
1,48011421100,48011421300,00000000200,a2f,recvmsg
1,48011421600,48011421700,00000000100,a2f,recvmsg
1,48011426700,48011426800,00000000100,a2f,recvmsg
1,48011427000,48011427200,00000000200,a2f,recvmsg
1,48011431900,48011432800,00000000900,a00,read
1,48011441300,48011441500,00000000200,a2f,recvmsg
1,48011474100,48011478800,00000004700,a07,poll
1,48011474100,48011481300,00000007200,a07,poll
1,48011484000,48011484200,00000000200,a2f,recvmsg
1,48011484900,48011485000,00000000100,a2f,recvmsg
1,48011485300,48011485400,00000000100,a2f,recvmsg
1,48011486200,48011486400,00000000200,a2f,recvmsg
1,48011486600,48011486800,00000000200,a2f,recvmsg
1,48011486600,48011488600,00000002000,a2f,recvmsg
1,48011496200,48011497000,00000000800,a00,read
1,48011489300,48011537500,00000048200,a07,poll
1,48011537700,48011538800,00000001100,a2f,recvmsg
1,48011489300,48011539900,00000050600,a07,poll
1,48011541500,48011541700,00000000200,a2f,recvmsg
1,48011542300,48011542500,00000000200,a2f,recvmsg
1,48011542600,48011542800,00000000200,a2f,recvmsg
1,48011543300,48011543400,00000000100,a2f,recvmsg
1,48011543600,48011543800,00000000200,a2f,recvmsg
1,48011545600,48011594500,00000048900,a07,poll
1,48011594600,48011595700,00000001100,a2f,recvmsg
1,48011545600,48011596700,00000051100,a07,poll
1,48011598400,48011598600,00000000200,a2f,recvmsg
1,48011599100,48011599300,00000000200,a2f,recvmsg
1,48011599500,48011599600,00000000100,a2f,recvmsg
1,48011600200,48011600200,00000000000,a2f,recvmsg
1,48011600400,48011600600,00000000200,a2f,recvmsg
1,48011606800,48011607600,00000000800,a00,read
1,48011602400,48011650800,00000048400,a07,poll
1,48011651000,48011652100,00000001100,a2f,recvmsg
1,48011602400,48011653200,00000050800,a07,poll
1,48011654800,48011655000,00000000200,a2f,recvmsg
1,48011655400,48011655600,00000000200,a2f,recvmsg
1,48011655800,48011655900,00000000100,a2f,recvmsg
1,48011656500,48011656600,00000000100,a2f,recvmsg
1,48011656800,48011657000,00000000200,a2f,recvmsg
1,48011658700,48011708200,00000049500,a07,poll
1,48011708400,48011709500,00000001100,a2f,recvmsg
1,48011658700,48011710500,00000051800,a07,poll
1,48011712200,48011712300,00000000100,a2f,recvmsg
1,48011712800,48011712900,00000000100,a2f,recvmsg
1,48011713100,48011713300,00000000200,a2f,recvmsg
1,48011713800,48011714000,00000000200,a2f,recvmsg
1,48011714200,48011714300,00000000100,a2f,recvmsg
1,48011716100,48011763600,00000047500,a07,poll
1,48011793700,48011794600,00000000900,a00,read
1,48011764900,48011807000,00000042100,a07,poll
1,48011808800,48011851200,00000042400,a07,poll
1,48011871300,48011872000,00000000700,a00,read
1,48011852900,48011894400,00000041500,a07,poll
1,48011895500,48011938100,00000042600,a07,poll
1,48011953400,48011954100,00000000700,a00,read
1,48011939300,48011981300,00000042000,a07,poll
1,48012020700,48012021700,00000001000,a0c,brk
1,48011982500,48012035700,00000053200,a07,poll
1,48012035800,48012036500,00000000700,a00,read
1,48012037100,48012055000,00000017900,a07,poll
1,48012058100,48012073000,00000014900,a07,poll
1,48012074100,48012088700,00000014600,a07,poll
1,48012090000,48012104900,00000014900,a07,poll
1,48012109600,48012110400,00000000800,a00,read
1,48012106100,48012119000,00000012900,a07,poll
1,48012120600,48012144200,00000023600,a07,poll
1,48012144400,48012145800,00000001400,a2f,recvmsg
1,48012149200,48012150900,00000001700,a2d,recvfrom
1,48012154900,48012155000,00000000100,a2f,recvmsg
1,48012155500,48012155700,00000000200,a2f,recvmsg
1,48012209700,48012210100,00000000400,a2f,recvmsg
1,48012210500,48012211300,00000000800,a00,read
1,48012211900,48012212000,00000000100,a2f,recvmsg
1,48012313300,48012314100,00000000800,a00,read
1,48012404000,48012404700,00000000700,a00,read
1,48012484300,48012485000,00000000700,a00,read
1,48012214300,48012561800,00000347500,a07,poll
1,48012564700,48012564900,00000000200,a2f,recvmsg
1,48012565700,48012565900,00000000200,a2f,recvmsg
1,48012566100,48012566300,00000000200,a2f,recvmsg
1,48012567100,48012567200,00000000100,a2f,recvmsg
1,48012567300,48012567500,00000000200,a2f,recvmsg
1,48012586500,48012587400,00000000900,a00,read
1,48012669800,48012670200,00000000400,a0c,brk
1,48012672900,48012673600,00000000700,a00,read
1,48012779400,48012780100,00000000700,a00,read
1,48012872100,48012872800,00000000700,a00,read
1,48012991800,48012992600,00000000800,a00,read
1,48013104500,48013105200,00000000700,a00,read
1,48013208300,48013208900,00000000600,a00,read
1,48013310800,48013311200,00000000400,a0c,brk
1,48013697100,48013700300,00000003200,a57,unlink
1,48013720000,48013720600,00000000600,a48,fcntl
1,48013772600,48013783500,00000010900,a01,write
1,48013802900,48013805500,00000002600,a01,write
1,48013822100,48013824500,00000002400,a01,write
1,47998110300,48013997000,00015886700,a3d,wait4
1,48014014300,48014015900,00000001600,a00,read
1,48014018100,48014018600,00000000500,a00,read
1,48014027300,48014033900,00000006600,a14,writev
1,48014035900,48014064400,00000028500,a07,poll
1,48014069300,48014069600,00000000300,a2f,recvmsg
1,48014070400,48014070500,00000000100,a2f,recvmsg
1,48014074100,48014076100,00000002000,a14,writev
1,48014076500,48014087400,00000010900,a07,poll
1,48014089100,48014089200,00000000100,a2f,recvmsg
1,48014089600,48014089800,00000000200,a2f,recvmsg
1,48014092400,48014094500,00000002100,a14,writev
1,48014095000,48014103800,00000008800,a07,poll
1,48014105100,48014105200,00000000100,a2f,recvmsg
1,48014105800,48014106000,00000000200,a2f,recvmsg
1,48014108200,48014109800,00000001600,a14,writev
1,48014110200,48014119700,00000009500,a07,poll
1,48014121100,48014121300,00000000200,a2f,recvmsg
1,48014121500,48014121700,00000000200,a2f,recvmsg
1,48014124500,48014126300,00000001800,a14,writev
1,48014126600,48014135700,00000009100,a07,poll
1,48014137000,48014137200,00000000200,a2f,recvmsg
1,48014137600,48014137800,00000000200,a2f,recvmsg
1,48014139100,48014140700,00000001600,a14,writev
1,48014141000,48014149400,00000008400,a07,poll
1,48014150600,48014150800,00000000200,a2f,recvmsg
1,48014151100,48014151300,00000000200,a2f,recvmsg
1,48014152000,48014152200,00000000200,a08,lseek
1,48014162400,48014162500,00000000100,a08,lseek
1,48014163600,48014165300,00000001700,a14,writev
1,48014165800,48014174200,00000008400,a07,poll
1,48014175500,48014175700,00000000200,a2f,recvmsg
1,48014176100,48014176200,00000000100,a2f,recvmsg
1,48014180700,48014182400,00000001700,a14,writev
1,48014182700,48014190800,00000008100,a07,poll
1,48014192200,48014192300,00000000100,a2f,recvmsg
1,48014192700,48014192900,00000000200,a2f,recvmsg
1,48014194300,48014195800,00000001500,a14,writev
1,48014196100,48014204200,00000008100,a07,poll
1,48014205500,48014205700,00000000200,a2f,recvmsg
1,48014206000,48014206200,00000000200,a2f,recvmsg
1,48014208900,48014210500,00000001600,a14,writev
1,48014210800,48014218400,00000007600,a07,poll
1,48014219900,48014220200,00000000300,a2f,recvmsg
1,48014220400,48014220600,00000000200,a2f,recvmsg
1,48014223200,48014224800,00000001600,a14,writev
1,48014225200,48014233000,00000007800,a07,poll
1,48014234300,48014234400,00000000100,a2f,recvmsg
1,48014234700,48014234900,00000000200,a2f,recvmsg
1,48014237500,48014239200,00000001700,a14,writev
1,48014239600,48014247000,00000007400,a07,poll
1,48014248500,48014248700,00000000200,a2f,recvmsg
1,48014248900,48014249100,00000000200,a2f,recvmsg
1,48014250800,48014252400,00000001600,a14,writev
1,48014252700,48014260500,00000007800,a07,poll
1,48014261900,48014262100,00000000200,a2f,recvmsg
1,48014262300,48014262500,00000000200,a2f,recvmsg
1,48014264600,48014266100,00000001500,a14,writev
1,48014266400,48014274100,00000007700,a07,poll
1,48014275400,48014275500,00000000100,a2f,recvmsg
1,48014275900,48014276100,00000000200,a2f,recvmsg
1,48014279000,48014280800,00000001800,a14,writev
1,48014281100,48014289000,00000007900,a07,poll
1,48014290400,48014290600,00000000200,a2f,recvmsg
1,48014290800,48014291000,00000000200,a2f,recvmsg
1,48014292800,48014294400,00000001600,a14,writev
1,48014294900,48014302200,00000007300,a07,poll
1,48014303600,48014303800,00000000200,a2f,recvmsg
1,48014304000,48014304200,00000000200,a2f,recvmsg
1,48014306000,48014307700,00000001700,a14,writev
1,48014307900,48014315300,00000007400,a07,poll
1,48014316800,48014317000,00000000200,a2f,recvmsg
1,48014317200,48014317400,00000000200,a2f,recvmsg
1,48014319100,48014320700,00000001600,a14,writev
1,48014321000,48014328500,00000007500,a07,poll
1,48014330600,48014330800,00000000200,a2f,recvmsg
1,48014331100,48014331300,00000000200,a2f,recvmsg
1,48014333000,48014334500,00000001500,a14,writev
1,48014334800,48014342100,00000007300,a07,poll
1,48014343600,48014343800,00000000200,a2f,recvmsg
1,48014344000,48014344200,00000000200,a2f,recvmsg
1,48014346100,48014347600,00000001500,a14,writev
1,48014348000,48014355300,00000007300,a07,poll
1,48014356700,48014356900,00000000200,a2f,recvmsg
1,48014357100,48014357300,00000000200,a2f,recvmsg
1,48014359000,48014360500,00000001500,a14,writev
1,48014360900,48014368500,00000007600,a07,poll
1,48014369900,48014370100,00000000200,a2f,recvmsg
1,48014370400,48014370500,00000000100,a2f,recvmsg
1,48014371700,48014373300,00000001600,a14,writev
1,48014373700,48014381200,00000007500,a07,poll
1,48014382500,48014382700,00000000200,a2f,recvmsg
1,48014383000,48014383200,00000000200,a2f,recvmsg
1,48014386600,48014388200,00000001600,a14,writev
1,48014388600,48014395900,00000007300,a07,poll
1,48014397300,48014397500,00000000200,a2f,recvmsg
1,48014397800,48014398000,00000000200,a2f,recvmsg
1,48014399000,48014400600,00000001600,a14,writev
1,48014400900,48014408500,00000007600,a07,poll
1,48014409800,48014410000,00000000200,a2f,recvmsg
1,48014410300,48014410400,00000000100,a2f,recvmsg
1,48014411700,48014413200,00000001500,a14,writev
1,48014413500,48014420900,00000007400,a07,poll
1,48014422300,48014422500,00000000200,a2f,recvmsg
1,48014422800,48014423000,00000000200,a2f,recvmsg
1,48014424200,48014425700,00000001500,a14,writev
1,48014426100,48014433700,00000007600,a07,poll
1,48014435000,48014435300,00000000300,a2f,recvmsg
1,48014435600,48014435800,00000000200,a2f,recvmsg
1,48014437300,48014438800,00000001500,a14,writev
1,48014439100,48014446600,00000007500,a07,poll
1,48014448100,48014448300,00000000200,a2f,recvmsg
1,48014448500,48014448700,00000000200,a2f,recvmsg
1,48014450100,48014451600,00000001500,a14,writev
1,48014452000,48014459300,00000007300,a07,poll
1,48014460700,48014461000,00000000300,a2f,recvmsg
1,48014461300,48014461500,00000000200,a2f,recvmsg
1,48014463500,48014465100,00000001600,a14,writev
1,48014465400,48014472900,00000007500,a07,poll
1,48014474300,48014474500,00000000200,a2f,recvmsg
1,48014474800,48014474900,00000000100,a2f,recvmsg
1,48014476800,48014478300,00000001500,a14,writev
1,48014478700,48014486100,00000007400,a07,poll
1,48014487400,48014487600,00000000200,a2f,recvmsg
1,48014487900,48014488100,00000000200,a2f,recvmsg
1,48014490200,48014492000,00000001800,a14,writev
1,48014492200,48014499800,00000007600,a07,poll
1,48014501200,48014501400,00000000200,a2f,recvmsg
1,48014501700,48014501800,00000000100,a2f,recvmsg
1,48014504800,48014506300,00000001500,a14,writev
1,48014506600,48014514000,00000007400,a07,poll
1,48014515300,48014515500,00000000200,a2f,recvmsg
1,48014515800,48014516000,00000000200,a2f,recvmsg
1,48014517900,48014519500,00000001600,a14,writev
1,48014519800,48014527400,00000007600,a07,poll
1,48014528700,48014528900,00000000200,a2f,recvmsg
1,48014529200,48014529400,00000000200,a2f,recvmsg
1,48014533700,48014535200,00000001500,a14,writev
1,48014535600,48014543100,00000007500,a07,poll
1,48014544400,48014544600,00000000200,a2f,recvmsg
1,48014544900,48014545100,00000000200,a2f,recvmsg
1,48014546600,48014548200,00000001600,a14,writev
1,48014548500,48014556300,00000007800,a07,poll
1,48014557600,48014557700,00000000100,a2f,recvmsg
1,48014558100,48014558300,00000000200,a2f,recvmsg
1,48014559700,48014561300,00000001600,a14,writev
1,48014561700,48014569100,00000007400,a07,poll
1,48014570300,48014570500,00000000200,a2f,recvmsg
1,48014570800,48014571000,00000000200,a2f,recvmsg
1,48014573300,48014574800,00000001500,a14,writev
1,48014575200,48014582500,00000007300,a07,poll
1,48014583800,48014584000,00000000200,a2f,recvmsg
1,48014584300,48014584500,00000000200,a2f,recvmsg
1,48014586500,48014588000,00000001500,a14,writev
1,48014588400,48014595800,00000007400,a07,poll
1,48014597200,48014597300,00000000100,a2f,recvmsg
1,48014597700,48014597900,00000000200,a2f,recvmsg
1,48014600100,48014601700,00000001600,a14,writev
1,48014602100,48014609600,00000007500,a07,poll
1,48014610900,48014611100,00000000200,a2f,recvmsg
1,48014611400,48014611600,00000000200,a2f,recvmsg
1,48014613400,48014614800,00000001400,a14,writev
1,48014615200,48014622600,00000007400,a07,poll
1,48014623900,48014624000,00000000100,a2f,recvmsg
1,48014624300,48014624500,00000000200,a2f,recvmsg
1,48014626300,48014627800,00000001500,a14,writev
1,48014628200,48014635700,00000007500,a07,poll
1,48014637000,48014637100,00000000100,a2f,recvmsg
1,48014637400,48014637600,00000000200,a2f,recvmsg
1,48014639000,48014640500,00000001500,a14,writev
1,48014640800,48014648100,00000007300,a07,poll
1,48014649700,48014649900,00000000200,a2f,recvmsg
1,48014650200,48014650400,00000000200,a2f,recvmsg
1,48014652500,48014654100,00000001600,a14,writev
1,48014654400,48014661900,00000007500,a07,poll
1,48014663100,48014663300,00000000200,a2f,recvmsg
1,48014663600,48014663800,00000000200,a2f,recvmsg
1,48014664900,48014665000,00000000100,a08,lseek
1,48014667600,48014668700,00000001100,a00,read
1,48014672400,48014672500,00000000100,a08,lseek
1,48014673500,48014675100,00000001600,a14,writev
1,48014675500,48014683100,00000007600,a07,poll
1,48014684400,48014684600,00000000200,a2f,recvmsg
1,48014684900,48014685100,00000000200,a2f,recvmsg
1,48014709300,48014710900,00000001600,a14,writev
1,48014711300,48014718700,00000007400,a07,poll
1,48014720300,48014720800,00000000500,a2f,recvmsg
1,48014721100,48014721300,00000000200,a2f,recvmsg
1,48014725100,48014726100,00000001000,a00,read
1,48014731600,48014731700,00000000100,a08,lseek
1,48014733300,48014734900,00000001600,a14,writev
1,48014735200,48014742600,00000007400,a07,poll
1,48014744000,48014744200,00000000200,a2f,recvmsg
1,48014744500,48014744700,00000000200,a2f,recvmsg
1,48014745900,48014747500,00000001600,a14,writev
1,48014747900,48014755200,00000007300,a07,poll
1,48014756500,48014756700,00000000200,a2f,recvmsg
1,48014757000,48014757200,00000000200,a2f,recvmsg
1,48014758200,48014759900,00000001700,a14,writev
1,48014760100,48014767500,00000007400,a07,poll
1,48014768700,48014768900,00000000200,a2f,recvmsg
1,48014769200,48014769400,00000000200,a2f,recvmsg
1,48014770600,48014772100,00000001500,a14,writev
1,48014772400,48014779600,00000007200,a07,poll
1,48014781000,48014781100,00000000100,a2f,recvmsg
1,48014781400,48014781600,00000000200,a2f,recvmsg
1,48014782800,48014784600,00000001800,a14,writev
1,48014784800,48014792200,00000007400,a07,poll
1,48014793400,48014793600,00000000200,a2f,recvmsg
1,48014793900,48014794100,00000000200,a2f,recvmsg
1,48014795200,48014796700,00000001500,a14,writev
1,48014797100,48014804500,00000007400,a07,poll
1,48014805700,48014805900,00000000200,a2f,recvmsg
1,48014806200,48014806400,00000000200,a2f,recvmsg
1,48014807500,48014809100,00000001600,a14,writev
1,48014809300,48014816700,00000007400,a07,poll
1,48014818000,48014818200,00000000200,a2f,recvmsg
1,48014818500,48014818700,00000000200,a2f,recvmsg
1,48014820400,48014821900,00000001500,a14,writev
1,48014822300,48014829700,00000007400,a07,poll
1,48014830900,48014831100,00000000200,a2f,recvmsg
1,48014831400,48014831600,00000000200,a2f,recvmsg
1,48014832800,48014834300,00000001500,a14,writev
1,48014834700,48014842100,00000007400,a07,poll
1,48014843500,48014843500,00000000000,a2f,recvmsg
1,48014843800,48014844000,00000000200,a2f,recvmsg
1,48014844600,48014844700,00000000100,a08,lseek
1,48014847300,48014849100,00000001800,a14,writev
1,48014849400,48014856800,00000007400,a07,poll
1,48014858200,48014858300,00000000100,a2f,recvmsg
1,48014858700,48014858800,00000000100,a2f,recvmsg
1,48014862300,48014863900,00000001600,a14,writev
1,48014864200,48014871800,00000007600,a07,poll
1,48014873100,48014873300,00000000200,a2f,recvmsg
1,48014873600,48014873800,00000000200,a2f,recvmsg
1,48014875600,48014877200,00000001600,a14,writev
1,48014877600,48014884800,00000007200,a07,poll
1,48014886100,48014886200,00000000100,a2f,recvmsg
1,48014886600,48014886800,00000000200,a2f,recvmsg
1,48014888200,48014889700,00000001500,a14,writev
1,48014890000,48014897400,00000007400,a07,poll
1,48014898700,48014898800,00000000100,a2f,recvmsg
1,48014899200,48014899400,00000000200,a2f,recvmsg
1,48014900700,48014902300,00000001600,a14,writev
1,48014902600,48014910000,00000007400,a07,poll
1,48014911300,48014911500,00000000200,a2f,recvmsg
1,48014911800,48014911900,00000000100,a2f,recvmsg
1,48014913400,48014914900,00000001500,a14,writev
1,48014915300,48014922600,00000007300,a07,poll
1,48014923800,48014924000,00000000200,a2f,recvmsg
1,48014924300,48014924500,00000000200,a2f,recvmsg
1,48014926500,48014928100,00000001600,a14,writev
1,48014928400,48014935700,00000007300,a07,poll
1,48014937000,48014937200,00000000200,a2f,recvmsg
1,48014937500,48014937700,00000000200,a2f,recvmsg
1,48014939200,48014940800,00000001600,a14,writev
1,48014941100,48014948400,00000007300,a07,poll
1,48014949700,48014949900,00000000200,a2f,recvmsg
1,48014950100,48014950300,00000000200,a2f,recvmsg
1,48014951800,48014953500,00000001700,a14,writev
1,48014953700,48014961100,00000007400,a07,poll
1,48014962500,48014962600,00000000100,a2f,recvmsg
1,48014963000,48014963100,00000000100,a2f,recvmsg
1,48014964700,48014966300,00000001600,a14,writev
1,48014966700,48014974100,00000007400,a07,poll
1,48014975400,48014975600,00000000200,a2f,recvmsg
1,48014975900,48014976100,00000000200,a2f,recvmsg
1,48014977600,48014979100,00000001500,a14,writev
1,48014979500,48014986800,00000007300,a07,poll
1,48014988000,48014988200,00000000200,a2f,recvmsg
1,48014988600,48014988800,00000000200,a2f,recvmsg
1,48014990300,48014991800,00000001500,a14,writev
1,48014992300,48014999500,00000007200,a07,poll
1,48015000900,48015001100,00000000200,a2f,recvmsg
1,48015001300,48015001500,00000000200,a2f,recvmsg
1,48015003900,48015005400,00000001500,a14,writev
1,48015006200,48015013300,00000007100,a07,poll
1,48015014700,48015014800,00000000100,a2f,recvmsg
1,48015015200,48015015400,00000000200,a2f,recvmsg
1,48015016900,48015018500,00000001600,a14,writev
1,48015018900,48015026200,00000007300,a07,poll
1,48015027600,48015027800,00000000200,a2f,recvmsg
1,48015028000,48015028200,00000000200,a2f,recvmsg
1,48015029700,48015031300,00000001600,a14,writev
1,48015031600,48015039100,00000007500,a07,poll
1,48015040700,48015040800,00000000100,a2f,recvmsg
1,48015041100,48015041200,00000000100,a2f,recvmsg
1,48015042800,48015044400,00000001600,a14,writev
1,48015044700,48015052100,00000007400,a07,poll
1,48015053400,48015053500,00000000100,a2f,recvmsg
1,48015053900,48015054100,00000000200,a2f,recvmsg
1,48015060800,48015062500,00000001700,a14,writev
1,48015062900,48015070400,00000007500,a07,poll
1,48015071700,48015071900,00000000200,a2f,recvmsg
1,48015072200,48015072400,00000000200,a2f,recvmsg
1,48015074000,48015075500,00000001500,a14,writev
1,48015075800,48015083600,00000007800,a07,poll
1,48015084900,48015085000,00000000100,a2f,recvmsg
1,48015085300,48015085500,00000000200,a2f,recvmsg
1,48015087000,48015088600,00000001600,a14,writev
1,48015088800,48015096200,00000007400,a07,poll
1,48015097600,48015097800,00000000200,a2f,recvmsg
1,48015098100,48015098200,00000000100,a2f,recvmsg
1,48015099900,48015101400,00000001500,a14,writev
1,48015101800,48015109100,00000007300,a07,poll
1,48015110400,48015110600,00000000200,a2f,recvmsg
1,48015110900,48015111100,00000000200,a2f,recvmsg
1,48015112700,48015114200,00000001500,a14,writev
1,48015114600,48015121900,00000007300,a07,poll
1,48015123200,48015123400,00000000200,a2f,recvmsg
1,48015123700,48015123900,00000000200,a2f,recvmsg
1,48015170300,48015175100,00000004800,a14,writev
1,48015175700,48015273700,00000098000,a07,poll
1,48015175700,48015277200,00000101500,a07,poll
1,48015289200,48015289400,00000000200,a2f,recvmsg
1,48015293700,48015293800,00000000100,a2f,recvmsg
1,48015294100,48015294300,00000000200,a2f,recvmsg
1,48015298000,48015298300,00000000300,a2f,recvmsg
1,48015298500,48015298700,00000000200,a2f,recvmsg
1,48015313100,48015313300,00000000200,a2f,recvmsg
1,48015344700,48015351000,00000006300,a07,poll
1,48015344700,48015353900,00000009200,a07,poll
1,48015358300,48015358400,00000000100,a2f,recvmsg
1,48015359700,48015359800,00000000100,a2f,recvmsg
1,48015360000,48015360200,00000000200,a2f,recvmsg
1,48015361300,48015361500,00000000200,a2f,recvmsg
1,48015361700,48015361900,00000000200,a2f,recvmsg
1,48015365300,48015414200,00000048900,a07,poll
1,48015414400,48015415400,00000001000,a2f,recvmsg
1,48015365300,48015416800,00000051500,a07,poll
1,48015418800,48015419000,00000000200,a2f,recvmsg
1,48015419600,48015419800,00000000200,a2f,recvmsg
1,48015420000,48015420100,00000000100,a2f,recvmsg
1,48015421100,48015421200,00000000100,a2f,recvmsg
1,48015421400,48015421500,00000000100,a2f,recvmsg
1,48015423500,48015473000,00000049500,a07,poll
1,48015423500,48015474900,00000051400,a07,poll
1,48015477100,48015477300,00000000200,a2f,recvmsg
1,48015478000,48015478100,00000000100,a2f,recvmsg
1,48015478200,48015478400,00000000200,a2f,recvmsg
1,48015479100,48015479300,00000000200,a2f,recvmsg
1,48015479400,48015479600,00000000200,a2f,recvmsg
1,48015479400,48015481400,00000002000,a2f,recvmsg
1,48015482100,48015531200,00000049100,a07,poll
1,48015482100,48015532800,00000050700,a07,poll
1,48015536000,48015536200,00000000200,a2f,recvmsg
1,48015536900,48015537000,00000000100,a2f,recvmsg
1,48015537100,48015537300,00000000200,a2f,recvmsg
1,48015538000,48015538200,00000000200,a2f,recvmsg
1,48015538400,48015538500,00000000100,a2f,recvmsg
1,48015541300,48015588300,00000047000,a07,poll
1,48015588500,48015589700,00000001200,a2f,recvmsg
1,48015541300,48015590700,00000049400,a07,poll
1,48015592400,48015592600,00000000200,a2f,recvmsg
1,48015593100,48015593300,00000000200,a2f,recvmsg
1,48015593500,48015593700,00000000200,a2f,recvmsg
1,48015594300,48015594500,00000000200,a2f,recvmsg
1,48015594800,48015595000,00000000200,a2f,recvmsg
1,48015596900,48015646800,00000049900,a07,poll
1,48015648000,48015691200,00000043200,a07,poll
1,48015693000,48015734800,00000041800,a07,poll
1,48015736200,48015779600,00000043400,a07,poll
1,48015781100,48015824000,00000042900,a07,poll
1,48015825400,48015867000,00000041600,a07,poll
1,48015868500,48015921400,00000052900,a07,poll
1,48015922700,48015940900,00000018200,a07,poll
1,48015942200,48015958300,00000016100,a07,poll
1,48015959500,48015974700,00000015200,a07,poll
1,48015976000,48015990200,00000014200,a07,poll
1,48015991400,48016006100,00000014700,a07,poll
1,48016007600,48016011700,00000004100,a07,poll
1,48016014000,48016014200,00000000200,a2f,recvmsg
1,48016014800,48016015000,00000000200,a2f,recvmsg
1,48016037200,48016038900,00000001700,a07,poll
1,48016039400,48016040800,00000001400,a2f,recvmsg
1,48016042400,48016043600,00000001200,a2d,recvfrom
1,48016037200,48016049800,00000012600,a07,poll
1,48016053400,48016053600,00000000200,a2f,recvmsg
1,48016054600,48016054800,00000000200,a2f,recvmsg
1,48016055000,48016055100,00000000100,a2f,recvmsg
1,48016056200,48016056400,00000000200,a2f,recvmsg
1,48016056600,48016056700,00000000100,a2f,recvmsg
1,48016060800,48016061100,00000000300,a2f,recvmsg
1,48016061600,48016061800,00000000200,a2f,recvmsg
1,48016128000,48016128300,00000000300,a2f,recvmsg
1,48016131400,48016131600,00000000200,a2f,recvmsg
1,48016135800,48016140200,00000004400,a07,poll
1,48016142600,48016142800,00000000200,a2f,recvmsg
1,48016143200,48016143400,00000000200,a2f,recvmsg
1,48005059100,48016442700,00011383600,a4a,fsync
1,48016499600,48016505500,00000005900,a09,mmap
1,48016135800,48016580300,00000444500,a07,poll
1,48016699900,48016704000,00000004100,a09,mmap
1,48017120800,48017125800,00000005000,a02,open
1,48017134000,48017136200,00000002200,a00,read
1,48017194400,48017195400,00000001000,a00,read
1,48017248000,48017248900,00000000900,a00,read
1,48017300300,48017301000,00000000700,a00,read
1,48017352900,48017353500,00000000600,a00,read
1,48017404200,48017404900,00000000700,a00,read
1,48017452700,48017453400,00000000700,a00,read
1,48017504100,48017504700,00000000600,a00,read
1,48017557500,48017558200,00000000700,a00,read
1,48017609100,48017609900,00000000800,a00,read
1,48016135800,48017659700,00001523900,a07,poll
1,48017670700,48017676000,00000005300,a2e,sendmsg
1,48010084600,48017679200,00007594600,ae8,epoll_wait
1,48017689700,48017691800,00000002100,a2f,recvmsg
1,48017706300,48017706500,00000000200,a2f,recvmsg
1,48017729300,48017732600,00000003300,a2e,sendmsg
1,48016135800,48017740900,00001605100,a07,poll
1,48017742400,48017743200,00000000800,a00,read
1,48017759400,48017760400,00000001000,a2f,recvmsg
1,48017841200,48017845000,00000003800,a07,poll
1,48018000600,48018001400,00000000800,a2f,recvmsg
1,48018007900,48018008200,00000000300,a2f,recvmsg
1,48018029300,48018033400,00000004100,a2e,sendmsg
1,48017736100,48018035500,00000299400,ae8,epoll_wait
1,48018041700,48018042900,00000001200,a2f,recvmsg
1,48018057200,48018057500,00000000300,a2f,recvmsg
1,48018072400,48018074400,00000002000,a2e,sendmsg
1,48018021200,48018080300,00000059100,a07,poll
1,48018081100,48018081600,00000000500,a00,read
1,48018090500,48018091300,00000000800,a2f,recvmsg
1,48018159800,48018162700,00000002900,a07,poll
1,48018492400,48018493500,00000001100,a2f,recvmsg
1,48018518500,48018519100,00000000600,a00,read
1,48018549900,48018551500,00000001600,a00,read
1,48018582900,48018587400,00000004500,a02,open
1,48018592200,48018593200,00000001000,a00,read
1,48018649100,48018649800,00000000700,a00,read
1,48018736100,48018736900,00000000800,a00,read
1,48018810400,48018811000,00000000600,a00,read
1,48018889500,48018890200,00000000700,a00,read
1,48018971800,48018972600,00000000800,a00,read
1,48019050700,48019051400,00000000700,a00,read
1,48019137200,48019137800,00000000600,a00,read
1,48019204300,48019205000,00000000700,a00,read
1,48019262700,48019263500,00000000800,a00,read
1,48019343500,48019350000,00000006500,a14,writev
1,48019351300,48019377200,00000025900,a07,poll
1,48019381500,48019381900,00000000400,a2f,recvmsg
1,48019382400,48019382600,00000000200,a2f,recvmsg
1,48019383800,48019386400,00000002600,a14,writev
1,48019386800,48019397600,00000010800,a07,poll
1,48019399200,48019399300,00000000100,a2f,recvmsg
1,48019399700,48019399700,00000000000,a2f,recvmsg
1,48019405400,48019411500,00000006100,a06,lstat
1,48019412400,48019413600,00000001200,a06,lstat
1,48019434600,48019448400,00000013800,a01,write
1,48019451000,48019454300,00000003300,a14,writev
1,48019454900,48019464500,00000009600,a07,poll
1,48019467400,48019467700,00000000300,a2f,recvmsg
1,48019468100,48019468300,00000000200,a2f,recvmsg
1,48019470000,48019799200,00000329200,a38,clone
1,48020335900,48020336000,00000000100,a0c,brk
1,48020347500,48020350100,00000002600,a15,access
1,48020350800,48020351800,00000001000,a09,mmap
1,48020357000,48020357700,00000000700,a15,access
1,48020363500,48020364600,00000001100,a09,mmap
1,48020368300,48020368800,00000000500,a15,access
1,48020376200,48020377000,00000000800,a00,read
1,48020378600,48020380100,00000001500,a09,mmap
1,48020384200,48020386300,00000002100,a09,mmap
1,48020397000,48020397600,00000000600,a15,access
1,48020401000,48020401700,00000000700,a00,read
1,48020402400,48020403300,00000000900,a09,mmap
1,48020405800,48020407200,00000001400,a09,mmap
1,48020415500,48020416200,00000000700,a15,access
1,48020419100,48020419800,00000000700,a00,read
1,48020420300,48020421100,00000000800,a09,mmap
1,48020429300,48020432600,00000003300,a09,mmap
1,48020434700,48020435700,00000001000,a09,mmap
1,48020445700,48020446500,00000000800,a15,access
1,48020448900,48020449600,00000000700,a00,read
1,48020450300,48020451800,00000001500,a09,mmap
1,48020454400,48020456100,00000001700,a09,mmap
1,48020464500,48020465200,00000000700,a15,access
1,48020468600,48020469300,00000000700,a00,read
1,48020469900,48020471300,00000001400,a09,mmap
1,48020474800,48020477000,00000002200,a09,mmap
1,48020485300,48020485800,00000000500,a15,access
1,48020488400,48020488900,00000000500,a00,read
1,48020489400,48020490400,00000001000,a09,mmap
1,48020491800,48020493100,00000001300,a09,mmap
1,48020495900,48020497200,00000001300,a09,mmap
1,48020503400,48020503800,00000000400,a15,access
1,48020506100,48020506600,00000000500,a00,read
1,48020511000,48020512700,00000001700,a09,mmap
1,48020529700,48020530200,00000000500,a09,mmap
1,48020534100,48020534500,00000000400,a09,mmap
1,48020535700,48020535900,00000000200,a09,mmap
1,48020712500,48020712600,00000000100,a0c,brk
1,48020712600,48020713500,00000000900,a0c,brk
1,48020740000,48020741000,00000001000,a00,read
1,48020751700,48020753100,00000001400,a00,read
1,48020789300,48020790300,00000001000,a00,read
1,48020911700,48020912400,00000000700,a00,read
1,48020983100,48020983600,00000000500,a00,read
1,48021068400,48021069100,00000000700,a00,read
1,48021200500,48021201400,00000000900,a00,read
1,48021329500,48021330100,00000000600,a00,read
1,48021485900,48021486600,00000000700,a00,read
1,48021636200,48021636900,00000000700,a00,read
1,48021698400,48021699600,00000001200,a0c,brk
1,48021814800,48021815700,00000000900,a00,read
1,48021964600,48021965100,00000000500,a00,read
1,48022119900,48022120500,00000000600,a00,read
1,48022280100,48022280700,00000000600,a00,read
1,48022388900,48022389900,00000001000,a00,read
1,48022529500,48022530300,00000000800,a00,read
1,48022772000,48022772500,00000000500,a00,read
1,48022784200,48022784600,00000000400,a00,read
1,48022828700,48022829100,00000000400,a00,read
1,48022848500,48022849200,00000000700,a00,read
1,48023054800,48023055300,00000000500,a00,read
1,48023083900,48023084800,00000000900,a00,read
1,48023181600,48023182500,00000000900,a00,read
1,48023206300,48023207500,00000001200,a0c,brk
1,48023252600,48023252900,00000000300,a00,read
1,48023328100,48023328900,00000000800,a00,read
1,48023481200,48023481700,00000000500,a00,read
1,48023593500,48023594300,00000000800,a00,read
1,48023687400,48023688000,00000000600,a00,read
1,48023699400,48023699900,00000000500,a00,read
1,48023782700,48023783000,00000000300,a00,read
1,48023806300,48023806700,00000000400,a00,read
1,48023828600,48023829100,00000000500,a00,read
1,48023930100,48023931100,00000001000,a0c,brk
1,48023932900,48023933800,00000000900,a00,read
1,48024134000,48024134500,00000000500,a00,read
1,48024216900,48024217500,00000000600,a00,read
1,48024282200,48024282800,00000000600,a00,read
1,48024409300,48024409800,00000000500,a00,read
1,48024442100,48024442600,00000000500,a00,read
1,48024458600,48024459800,00000001200,a02,open
1,48024573900,48024574400,00000000500,a00,read
1,48024645100,48024645500,00000000400,a00,read
1,48024697400,48024698500,00000001100,a0c,brk
1,48024704900,48024705600,00000000700,a00,read
1,48024813000,48024813600,00000000600,a00,read
1,48024964400,48024965200,00000000800,a00,read
1,48025096000,48025096700,00000000700,a00,read
1,48025153900,48025154600,00000000700,a00,read
1,48025210300,48025211100,00000000800,a00,read
1,48025280700,48025281400,00000000700,a00,read
1,48025334000,48025334700,00000000700,a00,read
1,48025422500,48025423100,00000000600,a0c,brk
1,48025453700,48025457100,00000003400,a0c,brk
1,48025470900,48025471700,00000000800,a00,read
1,48025585900,48025586700,00000000800,a00,read
1,48029766000,48029766900,00000000900,a00,read
1,48029885100,48029885800,00000000700,a00,read
1,48030032100,48030032800,00000000700,a00,read
1,48030149900,48030150600,00000000700,a00,read
1,48030312400,48030313200,00000000800,a00,read
1,48030318200,48030319100,00000000900,a0c,brk
1,48030434300,48030435000,00000000700,a00,read
1,48030553500,48030554200,00000000700,a00,read
1,48030695700,48030696400,00000000700,a00,read
1,48030866400,48030867500,00000001100,a00,read
1,48030961400,48030962200,00000000800,a00,read
1,48031074300,48031075000,00000000700,a00,read
1,48031198600,48031199200,00000000600,a00,read
1,48031310400,48031311200,00000000800,a0c,brk
1,48031333800,48031334500,00000000700,a00,read
1,48031502900,48031503600,00000000700,a00,read
1,48031655000,48031655600,00000000600,a00,read
1,48031766000,48031766700,00000000700,a00,read
1,48031938300,48031939300,00000001000,a00,read
1,48032016400,48032017100,00000000700,a00,read
1,48032098300,48032099100,00000000800,a00,read
1,48032165800,48032166400,00000000600,a0c,brk
1,48032179900,48032180500,00000000600,a00,read
1,48032253200,48032253900,00000000700,a00,read
1,48032356300,48032357000,00000000700,a00,read
1,48032459400,48032460100,00000000700,a00,read
1,48032550200,48032550900,00000000700,a00,read
1,48032631800,48032632500,00000000700,a00,read
1,48032734000,48032734700,00000000700,a00,read
1,48032815700,48032816200,00000000500,a0c,brk
1,48032818700,48032819400,00000000700,a00,read
1,48032926600,48032927300,00000000700,a00,read
1,48033021200,48033021900,00000000700,a00,read
1,48033140700,48033141400,00000000700,a00,read
1,48033255100,48033255800,00000000700,a00,read
1,48033359000,48033359500,00000000500,a00,read
1,48033459500,48033459800,00000000300,a0c,brk
1,48033831100,48033834200,00000003100,a57,unlink
1,48033858300,48033859000,00000000700,a48,fcntl
1,48033905600,48033920500,00000014900,a01,write
1,48033938300,48033940700,00000002400,a01,write
1,48033956900,48033959000,00000002100,a01,write
1,48019822800,48034124600,00014301800,a3d,wait4
1,48034144800,48034146500,00000001700,a00,read
1,48034148700,48034149100,00000000400,a00,read
1,48034158900,48034168200,00000009300,a14,writev
1,48034170300,48037664800,00003494500,a07,poll
1,48037670100,48037670300,00000000200,a2f,recvmsg
1,48037671100,48037671300,00000000200,a2f,recvmsg
1,48037673800,48037675900,00000002100,a14,writev
1,48037676300,48037689400,00000013100,a07,poll
1,48037691000,48037691100,00000000100,a2f,recvmsg
1,48037691400,48037691600,00000000200,a2f,recvmsg
1,48037693600,48037695300,00000001700,a14,writev
1,48037695600,48037704800,00000009200,a07,poll
1,48037706200,48037706300,00000000100,a2f,recvmsg
1,48037706600,48037706800,00000000200,a2f,recvmsg
1,48037708500,48037710000,00000001500,a14,writev
1,48037710300,48037719300,00000009000,a07,poll
1,48037720500,48037720700,00000000200,a2f,recvmsg
1,48037721000,48037721200,00000000200,a2f,recvmsg
1,48037722800,48037724400,00000001600,a14,writev
1,48037724800,48037733600,00000008800,a07,poll
1,48037734800,48037735000,00000000200,a2f,recvmsg
1,48037735300,48037735500,00000000200,a2f,recvmsg
1,48037737300,48037738900,00000001600,a14,writev
1,48037739200,48037747400,00000008200,a07,poll
1,48037748700,48037748900,00000000200,a2f,recvmsg
1,48037749200,48037749400,00000000200,a2f,recvmsg
1,48037750100,48037750400,00000000300,a08,lseek
1,48037762400,48037762500,00000000100,a08,lseek
1,48037763300,48037765100,00000001800,a14,writev
1,48037765500,48037773900,00000008400,a07,poll
1,48037775300,48037775500,00000000200,a2f,recvmsg
1,48037775900,48037776100,00000000200,a2f,recvmsg
1,48037779300,48037781000,00000001700,a14,writev
1,48037781400,48037789100,00000007700,a07,poll
1,48037790400,48037790600,00000000200,a2f,recvmsg
1,48037791000,48037791100,00000000100,a2f,recvmsg
1,48037792500,48037794100,00000001600,a14,writev
1,48037794400,48037802000,00000007600,a07,poll
1,48037803300,48037803400,00000000100,a2f,recvmsg
1,48037803800,48037804000,00000000200,a2f,recvmsg
1,48037805900,48037807600,00000001700,a14,writev
1,48037808000,48037815300,00000007300,a07,poll
1,48037816600,48037816800,00000000200,a2f,recvmsg
1,48037817100,48037817300,00000000200,a2f,recvmsg
1,48037819100,48037820700,00000001600,a14,writev
1,48037821100,48037828700,00000007600,a07,poll
1,48037830000,48037830100,00000000100,a2f,recvmsg
1,48037830500,48037830600,00000000100,a2f,recvmsg
1,48037832600,48037834200,00000001600,a14,writev
1,48037834600,48037842400,00000007800,a07,poll
1,48037843700,48037843900,00000000200,a2f,recvmsg
1,48037844200,48037844400,00000000200,a2f,recvmsg
1,48037846000,48037847600,00000001600,a14,writev
1,48037848000,48037855800,00000007800,a07,poll
1,48037858000,48037858200,00000000200,a2f,recvmsg
1,48037858400,48037858600,00000000200,a2f,recvmsg
1,48037860000,48037861600,00000001600,a14,writev
1,48037861900,48037869600,00000007700,a07,poll
1,48037870800,48037871000,00000000200,a2f,recvmsg
1,48037871300,48037871500,00000000200,a2f,recvmsg
1,48037874300,48037875900,00000001600,a14,writev
1,48037876300,48037884200,00000007900,a07,poll
1,48037885400,48037885600,00000000200,a2f,recvmsg
1,48037885900,48037886100,00000000200,a2f,recvmsg
1,48037887900,48037889500,00000001600,a14,writev
1,48037889800,48037897300,00000007500,a07,poll
1,48037898500,48037898700,00000000200,a2f,recvmsg
1,48037899000,48037899200,00000000200,a2f,recvmsg
1,48037900800,48037902400,00000001600,a14,writev
1,48037902800,48037910000,00000007200,a07,poll
1,48037911400,48037911500,00000000100,a2f,recvmsg
1,48037911800,48037912000,00000000200,a2f,recvmsg
1,48037913600,48037915200,00000001600,a14,writev
1,48037915600,48037923000,00000007400,a07,poll
1,48037925300,48037925500,00000000200,a2f,recvmsg
1,48037925800,48037926000,00000000200,a2f,recvmsg
1,48037927500,48037929200,00000001700,a14,writev
1,48037929500,48037936800,00000007300,a07,poll
1,48037938000,48037938200,00000000200,a2f,recvmsg
1,48037938500,48037938700,00000000200,a2f,recvmsg
1,48037940400,48037942000,00000001600,a14,writev
1,48037942300,48037949700,00000007400,a07,poll
1,48037951100,48037951200,00000000100,a2f,recvmsg
1,48037951400,48037951600,00000000200,a2f,recvmsg
1,48037953200,48037955000,00000001800,a14,writev
1,48037955200,48037962700,00000007500,a07,poll
1,48037964000,48037964200,00000000200,a2f,recvmsg
1,48037964500,48037964600,00000000100,a2f,recvmsg
1,48037965700,48037967300,00000001600,a14,writev
1,48037967600,48037975100,00000007500,a07,poll
1,48037976400,48037976500,00000000100,a2f,recvmsg
1,48037976900,48037977100,00000000200,a2f,recvmsg
1,48037980400,48037982100,00000001700,a14,writev
1,48037982400,48037989700,00000007300,a07,poll
1,48037991200,48037991300,00000000100,a2f,recvmsg
1,48037991600,48037991800,00000000200,a2f,recvmsg
1,48037992900,48037994500,00000001600,a14,writev
1,48037994900,48038002500,00000007600,a07,poll
1,48038003700,48038003900,00000000200,a2f,recvmsg
1,48038004200,48038004400,00000000200,a2f,recvmsg
1,48038005500,48038007100,00000001600,a14,writev
1,48038007500,48038014900,00000007400,a07,poll
1,48038016200,48038016400,00000000200,a2f,recvmsg
1,48038016700,48038016900,00000000200,a2f,recvmsg
1,48038018000,48038019700,00000001700,a14,writev
1,48038020000,48038027300,00000007300,a07,poll
1,48038028600,48038028800,00000000200,a2f,recvmsg
1,48038029100,48038029200,00000000100,a2f,recvmsg
1,48038030800,48038032400,00000001600,a14,writev
1,48038032700,48038040200,00000007500,a07,poll
1,48038041700,48038041800,00000000100,a2f,recvmsg
1,48038042100,48038042300,00000000200,a2f,recvmsg
1,48038043600,48038045200,00000001600,a14,writev
1,48038045500,48038052900,00000007400,a07,poll
1,48038054200,48038054300,00000000100,a2f,recvmsg
1,48038054700,48038054900,00000000200,a2f,recvmsg
1,48038056600,48038058200,00000001600,a14,writev
1,48038058500,48038065800,00000007300,a07,poll
1,48038067200,48038067200,00000000000,a2f,recvmsg
1,48038067500,48038067700,00000000200,a2f,recvmsg
1,48038069500,48038071100,00000001600,a14,writev
1,48038071400,48038079000,00000007600,a07,poll
1,48038080400,48038080500,00000000100,a2f,recvmsg
1,48038080800,48038081000,00000000200,a2f,recvmsg
1,48038084200,48038085800,00000001600,a14,writev
1,48038086200,48038093800,00000007600,a07,poll
1,48038095100,48038095200,00000000100,a2f,recvmsg
1,48038095600,48038095700,00000000100,a2f,recvmsg
1,48038097700,48038099400,00000001700,a14,writev
1,48038099600,48038107100,00000007500,a07,poll
1,48038108300,48038108500,00000000200,a2f,recvmsg
1,48038108800,48038109000,00000000200,a2f,recvmsg
1,48038111700,48038113300,00000001600,a14,writev
1,48038113700,48038121200,00000007500,a07,poll
1,48038122500,48038122600,00000000100,a2f,recvmsg
1,48038123000,48038123200,00000000200,a2f,recvmsg
1,48038127000,48038128700,00000001700,a14,writev
1,48038129000,48038136500,00000007500,a07,poll
1,48038137800,48038138000,00000000200,a2f,recvmsg
1,48038138300,48038138500,00000000200,a2f,recvmsg
1,48038140200,48038141800,00000001600,a14,writev
1,48038142100,48038149400,00000007300,a07,poll
1,48038150800,48038150800,00000000000,a2f,recvmsg
1,48038151200,48038151400,00000000200,a2f,recvmsg
1,48038152800,48038154500,00000001700,a14,writev
1,48038154800,48038162200,00000007400,a07,poll
1,48038163400,48038163600,00000000200,a2f,recvmsg
1,48038163900,48038164100,00000000200,a2f,recvmsg
1,48038166300,48038167900,00000001600,a14,writev
1,48038168200,48038175600,00000007400,a07,poll
1,48038177000,48038177200,00000000200,a2f,recvmsg
1,48038177400,48038177600,00000000200,a2f,recvmsg
1,48038179500,48038181200,00000001700,a14,writev
1,48038181500,48038188900,00000007400,a07,poll
1,48038190400,48038190500,00000000100,a2f,recvmsg
1,48038190800,48038191000,00000000200,a2f,recvmsg
1,48038193100,48038194800,00000001700,a14,writev
1,48038195100,48038202800,00000007700,a07,poll
1,48038204100,48038204200,00000000100,a2f,recvmsg
1,48038204600,48038204800,00000000200,a2f,recvmsg
1,48038207700,48038209200,00000001500,a14,writev
1,48038209600,48038216900,00000007300,a07,poll
1,48038218200,48038218400,00000000200,a2f,recvmsg
1,48038218700,48038218900,00000000200,a2f,recvmsg
1,48038220400,48038222000,00000001600,a14,writev
1,48038222400,48038229800,00000007400,a07,poll
1,48038231000,48038231200,00000000200,a2f,recvmsg
1,48038231500,48038231700,00000000200,a2f,recvmsg
1,48038233100,48038234700,00000001600,a14,writev
1,48038235000,48038242300,00000007300,a07,poll
1,48038243700,48038243900,00000000200,a2f,recvmsg
1,48038244100,48038244300,00000000200,a2f,recvmsg
1,48038246000,48038247700,00000001700,a14,writev
1,48038247900,48038255500,00000007600,a07,poll
1,48038256900,48038257000,00000000100,a2f,recvmsg
1,48038257200,48038257400,00000000200,a2f,recvmsg
1,48038258600,48038258700,00000000100,a08,lseek
1,48038261400,48038264100,00000002700,a00,read
1,48038267900,48038268000,00000000100,a08,lseek
1,48038269100,48038270800,00000001700,a14,writev
1,48038271300,48038278700,00000007400,a07,poll
1,48038280200,48038280400,00000000200,a2f,recvmsg
1,48038280700,48038280900,00000000200,a2f,recvmsg
1,48038305600,48038307200,00000001600,a14,writev
1,48038307600,48038315300,00000007700,a07,poll
1,48038316700,48038316900,00000000200,a2f,recvmsg
1,48038317200,48038317400,00000000200,a2f,recvmsg
1,48038321400,48038322200,00000000800,a00,read
1,48038327700,48038327800,00000000100,a08,lseek
1,48038329400,48038331000,00000001600,a14,writev
1,48038331300,48038338600,00000007300,a07,poll
1,48038340000,48038340200,00000000200,a2f,recvmsg
1,48038340500,48038340700,00000000200,a2f,recvmsg
1,48038341900,48038343500,00000001600,a14,writev
1,48038343800,48038351200,00000007400,a07,poll
1,48038352500,48038352700,00000000200,a2f,recvmsg
1,48038353000,48038353200,00000000200,a2f,recvmsg
1,48038354300,48038355900,00000001600,a14,writev
1,48038356200,48038363500,00000007300,a07,poll
1,48038364800,48038364900,00000000100,a2f,recvmsg
1,48038365300,48038365500,00000000200,a2f,recvmsg
1,48038366600,48038368200,00000001600,a14,writev
1,48038368500,48038375800,00000007300,a07,poll
1,48038377100,48038377300,00000000200,a2f,recvmsg
1,48038377600,48038377800,00000000200,a2f,recvmsg
1,48038378900,48038380600,00000001700,a14,writev
1,48038380800,48038388300,00000007500,a07,poll
1,48038389600,48038389800,00000000200,a2f,recvmsg
1,48038390100,48038390200,00000000100,a2f,recvmsg
1,48038391400,48038392900,00000001500,a14,writev
1,48038393300,48038400600,00000007300,a07,poll
1,48038401900,48038402000,00000000100,a2f,recvmsg
1,48038402400,48038402600,00000000200,a2f,recvmsg
1,48038403600,48038405300,00000001700,a14,writev
1,48038405500,48038413000,00000007500,a07,poll
1,48038414300,48038414500,00000000200,a2f,recvmsg
1,48038414800,48038414900,00000000100,a2f,recvmsg
1,48038416800,48038418400,00000001600,a14,writev
1,48038418700,48038426200,00000007500,a07,poll
1,48038427400,48038427600,00000000200,a2f,recvmsg
1,48038427900,48038428100,00000000200,a2f,recvmsg
1,48038429300,48038430900,00000001600,a14,writev
1,48038431300,48038438600,00000007300,a07,poll
1,48038439900,48038440000,00000000100,a2f,recvmsg
1,48038440400,48038440600,00000000200,a2f,recvmsg
1,48038441100,48038441200,00000000100,a08,lseek
1,48038443600,48038445300,00000001700,a14,writev
1,48038445700,48038452900,00000007200,a07,poll
1,48038454400,48038454600,00000000200,a2f,recvmsg
1,48038454900,48038455000,00000000100,a2f,recvmsg
1,48038458500,48038460200,00000001700,a14,writev
1,48038460500,48038468100,00000007600,a07,poll
1,48038469400,48038469600,00000000200,a2f,recvmsg
1,48038469900,48038470000,00000000100,a2f,recvmsg
1,48038471900,48038473500,00000001600,a14,writev
1,48038473800,48038481100,00000007300,a07,poll
1,48038482400,48038482600,00000000200,a2f,recvmsg
1,48038482900,48038483100,00000000200,a2f,recvmsg
1,48038484600,48038486200,00000001600,a14,writev
1,48038487700,48038493900,00000006200,a07,poll
1,48038495100,48038495300,00000000200,a2f,recvmsg
1,48038495600,48038495800,00000000200,a2f,recvmsg
1,48038497300,48038498900,00000001600,a14,writev
1,48038499200,48038506500,00000007300,a07,poll
1,48038507800,48038508000,00000000200,a2f,recvmsg
1,48038508200,48038508400,00000000200,a2f,recvmsg
1,48038509900,48038511600,00000001700,a14,writev
1,48038511800,48038519100,00000007300,a07,poll
1,48038520400,48038520500,00000000100,a2f,recvmsg
1,48038520900,48038521000,00000000100,a2f,recvmsg
1,48038522900,48038524500,00000001600,a14,writev
1,48038524900,48038532200,00000007300,a07,poll
1,48038533500,48038533600,00000000100,a2f,recvmsg
1,48038534000,48038534200,00000000200,a2f,recvmsg
1,48038535600,48038537200,00000001600,a14,writev
1,48038537600,48038544800,00000007200,a07,poll
1,48038546100,48038546200,00000000100,a2f,recvmsg
1,48038546600,48038546800,00000000200,a2f,recvmsg
1,48038548300,48038549900,00000001600,a14,writev
1,48038550300,48038557700,00000007400,a07,poll
1,48038559100,48038559200,00000000100,a2f,recvmsg
1,48038559500,48038559700,00000000200,a2f,recvmsg
1,48038561200,48038562800,00000001600,a14,writev
1,48038563100,48038570300,00000007200,a07,poll
1,48038571600,48038571700,00000000100,a2f,recvmsg
1,48038572100,48038572300,00000000200,a2f,recvmsg
1,48038573600,48038575200,00000001600,a14,writev
1,48038575600,48038582900,00000007300,a07,poll
1,48038584200,48038584300,00000000100,a2f,recvmsg
1,48038584700,48038584900,00000000200,a2f,recvmsg
1,48038586300,48038587900,00000001600,a14,writev
1,48038588200,48038595400,00000007200,a07,poll
1,48038596800,48038597000,00000000200,a2f,recvmsg
1,48038597300,48038597400,00000000100,a2f,recvmsg
1,48038599400,48038601100,00000001700,a14,writev
1,48038601400,48038608700,00000007300,a07,poll
1,48038610200,48038610400,00000000200,a2f,recvmsg
1,48038610600,48038610800,00000000200,a2f,recvmsg
1,48038612300,48038613900,00000001600,a14,writev
1,48038614200,48038621500,00000007300,a07,poll
1,48038622700,48038622900,00000000200,a2f,recvmsg
1,48038623200,48038623400,00000000200,a2f,recvmsg
1,48038624800,48038626400,00000001600,a14,writev
1,48038626700,48038634100,00000007400,a07,poll
1,48038635300,48038635500,00000000200,a2f,recvmsg
1,48038635800,48038636000,00000000200,a2f,recvmsg
1,48038637500,48038639100,00000001600,a14,writev
1,48038639400,48038646700,00000007300,a07,poll
1,48038648100,48038648300,00000000200,a2f,recvmsg
1,48038648600,48038648700,00000000100,a2f,recvmsg
1,48038655800,48038657400,00000001600,a14,writev
1,48038657800,48038665200,00000007400,a07,poll
1,48038666500,48038666700,00000000200,a2f,recvmsg
1,48038667000,48038667200,00000000200,a2f,recvmsg
1,48038668800,48038670400,00000001600,a14,writev
1,48038670800,48038678000,00000007200,a07,poll
1,48038679200,48038679400,00000000200,a2f,recvmsg
1,48038679700,48038679900,00000000200,a2f,recvmsg
1,48038681300,48038683000,00000001700,a14,writev
1,48038683300,48038690600,00000007300,a07,poll
1,48038692000,48038692200,00000000200,a2f,recvmsg
1,48038692400,48038692600,00000000200,a2f,recvmsg
1,48038694300,48038695900,00000001600,a14,writev
1,48038696200,48038703700,00000007500,a07,poll
1,48038704900,48038705100,00000000200,a2f,recvmsg
1,48038705400,48038705600,00000000200,a2f,recvmsg
1,48038707100,48038708700,00000001600,a14,writev
1,48038709100,48038716400,00000007300,a07,poll
1,48038717700,48038717900,00000000200,a2f,recvmsg
1,48038718200,48038718400,00000000200,a2f,recvmsg
1,48038761600,48038766100,00000004500,a14,writev
1,48038766600,48038863900,00000097300,a07,poll
1,48038766600,48038867900,00000101300,a07,poll
1,48038880400,48038880400,00000000000,a2f,recvmsg
1,48038885400,48038885600,00000000200,a2f,recvmsg
1,48038885900,48038886100,00000000200,a2f,recvmsg
1,48038890900,48038891100,00000000200,a2f,recvmsg
1,48038891300,48038891400,00000000100,a2f,recvmsg
1,48038895900,48038896800,00000000900,a00,read
1,48038907700,48038907900,00000000200,a2f,recvmsg
1,48038892000,48038943100,00000051100,a07,poll
1,48038945900,48038946100,00000000200,a2f,recvmsg
1,48038946900,48038947000,00000000100,a2f,recvmsg
1,48038947300,48038947400,00000000100,a2f,recvmsg
1,48038948300,48038948500,00000000200,a2f,recvmsg
1,48038948700,48038948800,00000000100,a2f,recvmsg
1,48038958200,48039002400,00000044200,a07,poll
1,48039002700,48039003800,00000001100,a2f,recvmsg
1,48038958200,48039005000,00000046800,a07,poll
1,48039006900,48039007100,00000000200,a2f,recvmsg
1,48039007700,48039007800,00000000100,a2f,recvmsg
1,48039008000,48039008100,00000000100,a2f,recvmsg
1,48039008700,48039008900,00000000200,a2f,recvmsg
1,48039009100,48039009200,00000000100,a2f,recvmsg
1,48039011100,48039061400,00000050300,a07,poll
1,48039061600,48039062800,00000001200,a2f,recvmsg
1,48039011100,48039063900,00000052800,a07,poll
1,48039065700,48039065800,00000000100,a2f,recvmsg
1,48039066400,48039066500,00000000100,a2f,recvmsg
1,48039066600,48039066800,00000000200,a2f,recvmsg
1,48039067300,48039067500,00000000200,a2f,recvmsg
1,48039067700,48039067900,00000000200,a2f,recvmsg
1,48039069500,48039119300,00000049800,a07,poll
1,48039119600,48039120700,00000001100,a2f,recvmsg
1,48039069500,48039121700,00000052200,a07,poll
1,48039123400,48039123500,00000000100,a2f,recvmsg
1,48039124000,48039124100,00000000100,a2f,recvmsg
1,48039124300,48039124500,00000000200,a2f,recvmsg
1,48039125000,48039125200,00000000200,a2f,recvmsg
1,48039125400,48039125500,00000000100,a2f,recvmsg
1,48039127300,48039175800,00000048500,a07,poll
1,48039176100,48039177100,00000001000,a2f,recvmsg
1,48039127300,48039178200,00000050900,a07,poll
1,48039179900,48039180100,00000000200,a2f,recvmsg
1,48039180600,48039180700,00000000100,a2f,recvmsg
1,48039180900,48039181100,00000000200,a2f,recvmsg
1,48039181600,48039181800,00000000200,a2f,recvmsg
1,48039182000,48039182100,00000000100,a2f,recvmsg
1,48039183800,48039232100,00000048300,a07,poll
1,48039233400,48039275400,00000042000,a07,poll
1,48039276500,48039319300,00000042800,a07,poll
1,48039320800,48039364000,00000043200,a07,poll
1,48039365200,48039407900,00000042700,a07,poll
1,48039409100,48039450400,00000041300,a07,poll
1,48039452500,48039504700,00000052200,a07,poll
1,48039505800,48039524800,00000019000,a07,poll
1,48039526100,48039541400,00000015300,a07,poll
1,48039542700,48039558500,00000015800,a07,poll
1,48039559700,48039574200,00000014500,a07,poll
1,48039575500,48039590200,00000014700,a07,poll
1,48039591400,48039595300,00000003900,a07,poll
1,48039597400,48039597500,00000000100,a2f,recvmsg
1,48039598100,48039598300,00000000200,a2f,recvmsg
1,48039618800,48039620400,00000001600,a07,poll
1,48039620800,48039622500,00000001700,a2f,recvmsg
1,48039626300,48039627600,00000001300,a2d,recvfrom
1,48039618800,48039633500,00000014700,a07,poll
1,48039636500,48039636600,00000000100,a2f,recvmsg
1,48039637800,48039637900,00000000100,a2f,recvmsg
1,48039638100,48039638300,00000000200,a2f,recvmsg
1,48039639200,48039639400,00000000200,a2f,recvmsg
1,48039639600,48039639800,00000000200,a2f,recvmsg
1,48039642300,48039642400,00000000100,a2f,recvmsg
1,48039643000,48039643100,00000000100,a2f,recvmsg
1,48039702000,48039702300,00000000300,a2f,recvmsg
1,48039704500,48039704800,00000000300,a2f,recvmsg
1,48039707600,48039711000,00000003400,a07,poll
1,48039713200,48039713400,00000000200,a2f,recvmsg
1,48039713900,48039714000,00000000100,a2f,recvmsg
1,48040287200,48040293900,00000006700,a02,open
1,48040303200,48040306000,00000002800,a00,read
1,48040357600,48040358500,00000000900,a00,read
1,48040407200,48040408000,00000000800,a00,read
1,48040454000,48040454700,00000000700,a00,read
1,48040501900,48040502600,00000000700,a00,read
1,48040548300,48040549000,00000000700,a00,read
1,48040592700,48040593600,00000000900,a00,read
1,48040638400,48040639100,00000000700,a00,read
1,48040686300,48040687200,00000000900,a00,read
1,48040735900,48040736700,00000000800,a00,read
1,48040783900,48040784500,00000000600,a00,read
1,48040811900,48040813700,00000001800,a02,open
1,48040816800,48040817800,00000001000,a00,read
1,48040871500,48040872200,00000000700,a00,read
1,48040954900,48040955800,00000000900,a00,read
1,48041026300,48041027100,00000000800,a00,read
1,48041103400,48041104000,00000000600,a00,read
1,48041180500,48041181300,00000000800,a00,read
1,48041256700,48041257300,00000000600,a00,read
1,48041340600,48041341300,00000000700,a00,read
1,48041406200,48041406900,00000000700,a00,read
1,48041463300,48041464000,00000000700,a00,read
1,48041531600,48041538100,00000006500,a14,writev
1,48041539300,48041559700,00000020400,a07,poll
1,48041563700,48041563900,00000000200,a2f,recvmsg
1,48041564500,48041564700,00000000200,a2f,recvmsg
1,48041565600,48041567600,00000002000,a14,writev
1,48041568000,48041577700,00000009700,a07,poll
1,48041578900,48041579100,00000000200,a2f,recvmsg
1,48041579400,48041579600,00000000200,a2f,recvmsg
1,48041584600,48041590900,00000006300,a06,lstat
1,48041591700,48041593000,00000001300,a06,lstat
1,48041612000,48041624800,00000012800,a01,write
1,48041627200,48041629800,00000002600,a14,writev
1,48041630600,48041649000,00000018400,a07,poll
1,48041651800,48041652000,00000000200,a2f,recvmsg
1,48041652500,48041652600,00000000100,a2f,recvmsg
1,48005059100,48041770500,00036711400,a4a,fsync
1,48041820700,48041825800,00000005100,a09,mmap
1,48041630600,48041893300,00000262700,a07,poll
1,48041897000,48041898600,00000001600,aca,futex
1,48041902500,48041903300,00000000800,aca,futex
1,48041905600,48041906600,00000001000,aca,futex
1,48041922200,48041922300,00000000100,a00,read
1,48041927000,48041970700,00000043700,a07,poll
1,48041972000,48041973100,00000001100,aca,futex
1,48041974700,48041975500,00000000800,aca,futex
1,48041976900,48041977600,00000000700,aca,futex
1,48041979500,48041981200,00000001700,a2e,sendmsg
1,48042127400,48042133100,00000005700,a01,write
1,48018077200,48042163300,00024086100,ae8,epoll_wait
1,48042174100,48042176800,00000002700,a2f,recvmsg
1,48042195600,48042195900,00000000300,a2f,recvmsg
1,48042239200,48042239800,00000000600,a2e,sendmsg
1,48042246700,48042498600,00000251900,60e,page_fault
1,48041999100,48042499000,00000499900,a07,poll
1,48042522600,48043031600,00000509000,60e,page_fault
1,48043065700,48043613100,00000547400,60e,page_fault
1,48041654400,48043692200,00002037800,a38,clone
1,48043710100,48043719800,00000009700,aca,futex
1,48043770900,48043788100,00000017200,a01,write
1,48043994400,48043996400,00000002000,a2f,recvmsg
1,48043998800,48043999000,00000000200,a00,read
1,48044050600,48044056600,00000006000,a07,poll
1,48044134400,48044162400,00000028000,60e,page_fault
1,48044192100,48044196200,00000004100,a07,poll
1,48044201600,48044208400,00000006800,a2e,sendmsg
1,48042241900,48044212000,00001970100,ae8,epoll_wait
1,48044225600,48044227200,00000001600,a2f,recvmsg
1,48044244800,48044245000,00000000200,a2f,recvmsg
1,48044270700,48044275100,00000004400,a2e,sendmsg
1,48044192100,48044279500,00000087400,a07,poll
1,48044281300,48044281900,00000000600,a00,read
1,48044298000,48044298900,00000000900,a2f,recvmsg
1,48044391700,48044391900,00000000200,a00,read
1,48044399800,48063590000,00019190200,a07,poll
1,48044399800,48063593600,00019193800,a07,poll
1,48063608600,48063608800,00000000200,a2f,recvmsg
1,48063613400,48063613600,00000000200,a2f,recvmsg
1,48063613800,48063614000,00000000200,a2f,recvmsg
1,48063619000,48063619200,00000000200,a2f,recvmsg
1,48063619300,48063619500,00000000200,a2f,recvmsg
1,48063634400,48063634600,00000000200,a2f,recvmsg
1,48063664100,48063667000,00000002900,a14,writev
1,48063663400,48063668500,00000005100,a07,poll
1,48063671600,48063671700,00000000100,a2f,recvmsg
1,48063672500,48063672700,00000000200,a2f,recvmsg
1,48063672900,48063673000,00000000100,a2f,recvmsg
1,48063673800,48063674000,00000000200,a2f,recvmsg
1,48063674100,48063674300,00000000200,a2f,recvmsg
1,48063678400,48063726300,00000047900,a07,poll
1,48063678400,48063728200,00000049800,a07,poll
1,48063730000,48063730200,00000000200,a2f,recvmsg
1,48063730600,48063730800,00000000200,a2f,recvmsg
1,48063731000,48063731200,00000000200,a2f,recvmsg
1,48063731700,48063731900,00000000200,a2f,recvmsg
1,48063732100,48063732200,00000000100,a2f,recvmsg
1,48063732100,48063734000,00000001900,a2f,recvmsg
1,48063734500,48063782800,00000048300,a07,poll
1,48063734500,48063784600,00000050100,a07,poll
1,48063786200,48063786400,00000000200,a2f,recvmsg
1,48063786900,48063787100,00000000200,a2f,recvmsg
1,48063787300,48063787500,00000000200,a2f,recvmsg
1,48063787900,48063788100,00000000200,a2f,recvmsg
1,48063788300,48063788400,00000000100,a2f,recvmsg
1,48063788300,48063790100,00000001800,a2f,recvmsg
1,48063791300,48063840800,00000049500,a07,poll
1,48063841100,48063842400,00000001300,a2f,recvmsg
1,48063791300,48063843400,00000052100,a07,poll
1,48063845000,48063845200,00000000200,a2f,recvmsg
1,48063845700,48063845900,00000000200,a2f,recvmsg
1,48063846100,48063846300,00000000200,a2f,recvmsg
1,48063846700,48063846900,00000000200,a2f,recvmsg
1,48063847100,48063847200,00000000100,a2f,recvmsg
1,48063849200,48063896800,00000047600,a07,poll
1,48063897100,48063898200,00000001100,a2f,recvmsg
1,48063849200,48063899300,00000050100,a07,poll
1,48063901000,48063901200,00000000200,a2f,recvmsg
1,48063901600,48063901800,00000000200,a2f,recvmsg
1,48063901900,48063902100,00000000200,a2f,recvmsg
1,48063902600,48063902800,00000000200,a2f,recvmsg
1,48063903000,48063903200,00000000200,a2f,recvmsg
1,48063905000,48063953600,00000048600,a07,poll
1,48063954900,48063998700,00000043800,a07,poll
1,48064000400,48064043000,00000042600,a07,poll
1,48064044400,48064087500,00000043100,a07,poll
1,48064088900,48064132200,00000043300,a07,poll
1,48064133400,48064175800,00000042400,a07,poll
1,48064177000,48064230200,00000053200,a07,poll
1,48064231500,48064249200,00000017700,a07,poll
1,48064250500,48064266300,00000015800,a07,poll
1,48064267600,48064281200,00000013600,a07,poll
1,48064283000,48064296300,00000013300,a07,poll
1,48064297500,48064311000,00000013500,a07,poll
1,48064312300,48064336100,00000023800,a07,poll
1,48064336300,48064337900,00000001600,a2f,recvmsg
1,48064339100,48064340500,00000001400,a2d,recvfrom
1,48064344500,48064344700,00000000200,a2f,recvmsg
1,48064345200,48064345400,00000000200,a2f,recvmsg
1,48064399300,48064399600,00000000300,a2f,recvmsg
1,48064401600,48064401900,00000000300,a2f,recvmsg
1,48064404900,48064748400,00000343500,a07,poll
1,48064751300,48064751500,00000000200,a2f,recvmsg
1,48064752300,48064752500,00000000200,a2f,recvmsg
1,48064752700,48064752800,00000000100,a2f,recvmsg
1,48064753600,48064753800,00000000200,a2f,recvmsg
1,48064753900,48064754100,00000000200,a2f,recvmsg
1,48042136400,48078910900,00036774500,a4a,fsync
1,48078969200,48078973700,00000004500,a09,mmap
1,48064754500,48079052100,00014297600,a07,poll
1,48079056800,48079058500,00000001700,aca,futex
1,48079062700,48079063500,00000000800,aca,futex
1,48079065600,48079066600,00000001000,aca,futex
1,48079086900,48079087100,00000000200,a00,read
1,48079091900,48079140000,00000048100,a07,poll
1,48079141300,48079142300,00000001000,aca,futex
1,48079143800,48079144600,00000000800,aca,futex
1,48079145700,48079146600,00000000900,aca,futex
1,48079148400,48079150700,00000002300,a2e,sendmsg
1,48079303900,48079312700,00000008800,a01,write
1,48044383000,48079347100,00034964100,ae8,epoll_wait
1,48079359000,48079363500,00000004500,a2f,recvmsg
1,48079382700,48079382900,00000000200,a2f,recvmsg
1,48079403000,48079407900,00000004900,a2e,sendmsg
1,48079428800,48079429600,00000000800,a2e,sendmsg
1,48079169500,48079545400,00000375900,a07,poll
1,48079579000,48079586800,00000007800,60e,page_fault
1,48079623100,48079623300,00000000200,a00,read
1,48079657100,48079659300,00000002200,a01,write
1,48079431900,48079695400,00000263500,ae8,epoll_wait
1,48079699900,48079701900,00000002000,a2f,recvmsg
1,48079710100,48079710300,00000000200,a2f,recvmsg
1,48079722900,48079726000,00000003100,a2e,sendmsg
1,48079662000,48079727800,00000065800,a07,poll
1,48079728600,48079729100,00000000500,a00,read
1,48079739100,48079739900,00000000800,a2f,recvmsg
0,48006867900,48006868600,00000000700,a00,read
0,48006949000,48006949600,00000000600,a00,read
0,48007050200,48007050900,00000000700,a00,read
0,48007131200,48007131700,00000000500,a0c,brk
0,48007134500,48007135100,00000000600,a00,read
0,48007243300,48007243900,00000000600,a00,read
0,48007336400,48007337100,00000000700,a00,read
0,48007454900,48007455600,00000000700,a00,read
0,48007567800,48007568300,00000000500,a00,read
0,48007670800,48007671300,00000000500,a00,read
0,48007772400,48007773000,00000000600,a0c,brk
0,48008133600,48008136500,00000002900,a57,unlink
0,48008158100,48008158600,00000000500,a48,fcntl
0,48008210400,48008221700,00000011300,a01,write
0,48008239500,48008241900,00000002400,a01,write
0,48008258400,48008260500,00000002100,a01,write
0,48012686000,48008426200,-0004259800,a3d,wait4
0,48008443900,48008445300,00000001400,a00,read
0,48008447500,48008447900,00000000400,a00,read
0,48012324700,48008476300,-0003848400,a17,select
0,48008496200,48008496400,00000000200,a2f,recvmsg
0,48014104400,48014104600,00000000200,a2f,recvmsg
0,48014105500,48014105700,00000000200,a2f,recvmsg
0,48008499900,48014113600,00005613700,a17,select
0,48014118100,48014118300,00000000200,a2f,recvmsg
0,48014124600,48014124800,00000000200,a2f,recvmsg
0,48014125100,48014125300,00000000200,a2f,recvmsg
0,48014119100,48014130900,00000011800,a17,select
0,48014134600,48014134800,00000000200,a2f,recvmsg
0,48014140200,48014140300,00000000100,a2f,recvmsg
0,48014140600,48014140800,00000000200,a2f,recvmsg
0,48014135400,48014145900,00000010500,a17,select
0,48014149500,48014149600,00000000100,a2f,recvmsg
0,48014154800,48014154900,00000000100,a2f,recvmsg
0,48014155300,48014155500,00000000200,a2f,recvmsg
0,48014150100,48014161100,00000011000,a17,select
0,48014164900,48014165000,00000000100,a2f,recvmsg
0,48014170200,48014170400,00000000200,a2f,recvmsg
0,48014170700,48014170800,00000000100,a2f,recvmsg
0,48014165500,48014176100,00000010600,a17,select
0,48014179200,48014179300,00000000100,a2f,recvmsg
0,48014184500,48014184600,00000000100,a2f,recvmsg
0,48014185000,48014185200,00000000200,a2f,recvmsg
0,48014185900,48014186100,00000000200,a08,lseek
0,48014195400,48014195400,00000000000,a08,lseek
0,48014179900,48014199700,00000019800,a17,select
0,48014203300,48014203500,00000000200,a2f,recvmsg
0,48014208900,48014209100,00000000200,a2f,recvmsg
0,48014209500,48014209600,00000000100,a2f,recvmsg
0,48014204200,48014216700,00000012500,a17,select
0,48014220200,48014220400,00000000200,a2f,recvmsg
0,48014225800,48014226000,00000000200,a2f,recvmsg
0,48014226400,48014226600,00000000200,a2f,recvmsg
0,48014221000,48014231500,00000010500,a17,select
0,48014234500,48014234700,00000000200,a2f,recvmsg
0,48014239900,48014240000,00000000100,a2f,recvmsg
0,48014240400,48014240600,00000000200,a2f,recvmsg
0,48014235300,48014246100,00000010800,a17,select
0,48014249000,48014249200,00000000200,a2f,recvmsg
0,48014254600,48014254800,00000000200,a2f,recvmsg
0,48014255100,48014255300,00000000200,a2f,recvmsg
0,48014249800,48014260600,00000010800,a17,select
0,48014263800,48014263900,00000000100,a2f,recvmsg
0,48014269300,48014269500,00000000200,a2f,recvmsg
0,48014269700,48014269900,00000000200,a2f,recvmsg
0,48014264400,48014275400,00000011000,a17,select
0,48014278500,48014278600,00000000100,a2f,recvmsg
0,48014284000,48014284200,00000000200,a2f,recvmsg
0,48014284500,48014284700,00000000200,a2f,recvmsg
0,48014279100,48014289800,00000010700,a17,select
0,48014293000,48014293100,00000000100,a2f,recvmsg
0,48014298500,48014298600,00000000100,a2f,recvmsg
0,48014299000,48014299200,00000000200,a2f,recvmsg
0,48014293700,48014303800,00000010100,a17,select
0,48014306900,48014307100,00000000200,a2f,recvmsg
0,48014312200,48014312400,00000000200,a2f,recvmsg
0,48014312700,48014312900,00000000200,a2f,recvmsg
0,48014307500,48014319000,00000011500,a17,select
0,48014322500,48014322600,00000000100,a2f,recvmsg
0,48014328100,48014328300,00000000200,a2f,recvmsg
0,48014328600,48014328700,00000000100,a2f,recvmsg
0,48014323100,48014334100,00000011000,a17,select
0,48014337400,48014337600,00000000200,a2f,recvmsg
0,48014342800,48014343000,00000000200,a2f,recvmsg
0,48014343400,48014343500,00000000100,a2f,recvmsg
0,48014338100,48014348600,00000010500,a17,select
0,48014351800,48014352000,00000000200,a2f,recvmsg
0,48014357300,48014357500,00000000200,a2f,recvmsg
0,48014357800,48014358000,00000000200,a2f,recvmsg
0,48014352600,48014363100,00000010500,a17,select
0,48014366300,48014366400,00000000100,a2f,recvmsg
0,48014371800,48014372000,00000000200,a2f,recvmsg
0,48014372300,48014372500,00000000200,a2f,recvmsg
0,48014367000,48014377600,00000010600,a17,select
0,48014380600,48014380700,00000000100,a2f,recvmsg
0,48014386100,48014386200,00000000100,a2f,recvmsg
0,48014386600,48014386800,00000000200,a2f,recvmsg
0,48014381300,48014391900,00000010600,a17,select
0,48014395000,48014395200,00000000200,a2f,recvmsg
0,48014400500,48014400600,00000000100,a2f,recvmsg
0,48014400900,48014401100,00000000200,a2f,recvmsg
0,48014395800,48014406100,00000010300,a17,select
0,48014409100,48014409300,00000000200,a2f,recvmsg
0,48014414600,48014414800,00000000200,a2f,recvmsg
0,48014415100,48014415300,00000000200,a2f,recvmsg
0,48014409800,48014419800,00000010000,a17,select
0,48014423000,48014423100,00000000100,a2f,recvmsg
0,48014428400,48014428600,00000000200,a2f,recvmsg
0,48014429000,48014429100,00000000100,a2f,recvmsg
0,48014423600,48014436800,00000013200,a17,select
0,48014440200,48014440300,00000000100,a2f,recvmsg
0,48014445600,48014445800,00000000200,a2f,recvmsg
0,48014446100,48014446200,00000000100,a2f,recvmsg
0,48014440800,48014450700,00000009900,a17,select
0,48014453800,48014454000,00000000200,a2f,recvmsg
0,48014459200,48014459300,00000000100,a2f,recvmsg
0,48014459600,48014459800,00000000200,a2f,recvmsg
0,48014454500,48014464300,00000009800,a17,select
0,48014467200,48014467400,00000000200,a2f,recvmsg
0,48014472600,48014472800,00000000200,a2f,recvmsg
0,48014473100,48014473200,00000000100,a2f,recvmsg
0,48014467900,48014478800,00000010900,a17,select
0,48014481900,48014482100,00000000200,a2f,recvmsg
0,48014487400,48014487500,00000000100,a2f,recvmsg
0,48014487900,48014488000,00000000100,a2f,recvmsg
0,48014482600,48014492800,00000010200,a17,select
0,48014495900,48014496000,00000000100,a2f,recvmsg
0,48014501300,48014501400,00000000100,a2f,recvmsg
0,48014501700,48014501900,00000000200,a2f,recvmsg
0,48014496600,48014506600,00000010000,a17,select
0,48014509600,48014509800,00000000200,a2f,recvmsg
0,48014515000,48014515100,00000000100,a2f,recvmsg
0,48014515500,48014515700,00000000200,a2f,recvmsg
0,48014510400,48014521000,00000010600,a17,select
0,48014524000,48014524100,00000000100,a2f,recvmsg
0,48014529400,48014529600,00000000200,a2f,recvmsg
0,48014529800,48014530000,00000000200,a2f,recvmsg
0,48014524700,48014535400,00000010700,a17,select
0,48014538500,48014538600,00000000100,a2f,recvmsg
0,48014543800,48014544000,00000000200,a2f,recvmsg
0,48014544300,48014544500,00000000200,a2f,recvmsg
0,48014539200,48014550200,00000011000,a17,select
0,48014553500,48014553700,00000000200,a2f,recvmsg
0,48014558900,48014559100,00000000200,a2f,recvmsg
0,48014559400,48014559600,00000000200,a2f,recvmsg
0,48014554300,48014565000,00000010700,a17,select
0,48014568300,48014568400,00000000100,a2f,recvmsg
0,48014573600,48014573800,00000000200,a2f,recvmsg
0,48014574200,48014574300,00000000100,a2f,recvmsg
0,48014569000,48014579900,00000010900,a17,select
0,48014583100,48014583300,00000000200,a2f,recvmsg
0,48014588500,48014588700,00000000200,a2f,recvmsg
0,48014589000,48014589200,00000000200,a2f,recvmsg
0,48014583900,48014596300,00000012400,a17,select
0,48014599800,48014600000,00000000200,a2f,recvmsg
0,48014605200,48014605400,00000000200,a2f,recvmsg
0,48014605800,48014605800,00000000000,a2f,recvmsg
0,48014600500,48014610700,00000010200,a17,select
0,48014613700,48014613900,00000000200,a2f,recvmsg
0,48014619100,48014619200,00000000100,a2f,recvmsg
0,48014619600,48014619700,00000000100,a2f,recvmsg
0,48014614500,48014625600,00000011100,a17,select
0,48014628800,48014629000,00000000200,a2f,recvmsg
0,48014634300,48014634400,00000000100,a2f,recvmsg
0,48014634800,48014634900,00000000100,a2f,recvmsg
0,48014629600,48014640700,00000011100,a17,select
0,48014643900,48014644100,00000000200,a2f,recvmsg
0,48014649500,48014649500,00000000000,a2f,recvmsg
0,48014649900,48014650100,00000000200,a2f,recvmsg
0,48014644700,48014655500,00000010800,a17,select
0,48014658800,48014658900,00000000100,a2f,recvmsg
0,48014664200,48014664400,00000000200,a2f,recvmsg
0,48014664700,48014664800,00000000100,a2f,recvmsg
0,48014659400,48014670500,00000011100,a17,select
0,48014673800,48014674000,00000000200,a2f,recvmsg
0,48014679300,48014679400,00000000100,a2f,recvmsg
0,48014679800,48014679900,00000000100,a2f,recvmsg
0,48014674500,48014685200,00000010700,a17,select
0,48014688300,48014688500,00000000200,a2f,recvmsg
0,48014693600,48014693800,00000000200,a2f,recvmsg
0,48014694100,48014694300,00000000200,a2f,recvmsg
0,48014689000,48014699300,00000010300,a17,select
0,48014702500,48014702700,00000000200,a2f,recvmsg
0,48014707900,48014708100,00000000200,a2f,recvmsg
0,48014708400,48014708500,00000000100,a2f,recvmsg
0,48014703200,48014713300,00000010100,a17,select
0,48014716300,48014716500,00000000200,a2f,recvmsg
0,48014721700,48014721800,00000000100,a2f,recvmsg
0,48014722200,48014722400,00000000200,a2f,recvmsg
0,48014717100,48014727600,00000010500,a17,select
0,48014730800,48014731000,00000000200,a2f,recvmsg
0,48014736200,48014736300,00000000100,a2f,recvmsg
0,48014736700,48014736900,00000000200,a2f,recvmsg
0,48014738100,48014738300,00000000200,a08,lseek
0,48014740700,48014743700,00000003000,a00,read
0,48014747500,48014747700,00000000200,a08,lseek
0,48014731500,48014752900,00000021400,a17,select
0,48014756400,48014756600,00000000200,a2f,recvmsg
0,48014762600,48014762800,00000000200,a2f,recvmsg
0,48014763200,48014763400,00000000200,a2f,recvmsg
0,48014757300,48014792500,00000035200,a17,select
0,48014795900,48014796100,00000000200,a2f,recvmsg
0,48014801700,48014801900,00000000200,a2f,recvmsg
0,48014802200,48014802400,00000000200,a2f,recvmsg
0,48014806300,48014807200,00000000900,a00,read
0,48014812700,48014812900,00000000200,a08,lseek
0,48014796800,48014819000,00000022200,a17,select
0,48014822400,48014822600,00000000200,a2f,recvmsg
0,48014828100,48014828100,00000000000,a2f,recvmsg
0,48014828500,48014828700,00000000200,a2f,recvmsg
0,48014823200,48014833300,00000010100,a17,select
0,48014836400,48014836500,00000000100,a2f,recvmsg
0,48014841600,48014841800,00000000200,a2f,recvmsg
0,48014842100,48014842300,00000000200,a2f,recvmsg
0,48014837100,48014846800,00000009700,a17,select
0,48014849700,48014849900,00000000200,a2f,recvmsg
0,48014854900,48014855100,00000000200,a2f,recvmsg
0,48014855400,48014855600,00000000200,a2f,recvmsg
0,48014850500,48014860100,00000009600,a17,select
0,48014863000,48014863200,00000000200,a2f,recvmsg
0,48014868300,48014868500,00000000200,a2f,recvmsg
0,48014868800,48014869000,00000000200,a2f,recvmsg
0,48014863800,48014873600,00000009800,a17,select
0,48014876500,48014876700,00000000200,a2f,recvmsg
0,48014881700,48014881900,00000000200,a2f,recvmsg
0,48014882200,48014882400,00000000200,a2f,recvmsg
0,48014877200,48014886800,00000009600,a17,select
0,48014889700,48014889900,00000000200,a2f,recvmsg
0,48014895000,48014895200,00000000200,a2f,recvmsg
0,48014895500,48014895700,00000000200,a2f,recvmsg
0,48014890500,48014900200,00000009700,a17,select
0,48014903200,48014903300,00000000100,a2f,recvmsg
0,48014908400,48014908600,00000000200,a2f,recvmsg
0,48014908900,48014909100,00000000200,a2f,recvmsg
0,48014903900,48014914200,00000010300,a17,select
0,48014917400,48014917500,00000000100,a2f,recvmsg
0,48014922700,48014922900,00000000200,a2f,recvmsg
0,48014923100,48014923300,00000000200,a2f,recvmsg
0,48014918100,48014928000,00000009900,a17,select
0,48014930900,48014931100,00000000200,a2f,recvmsg
0,48014936300,48014936400,00000000100,a2f,recvmsg
0,48014936700,48014936900,00000000200,a2f,recvmsg
0,48014937500,48014937600,00000000100,a08,lseek
0,48014931700,48014943600,00000011900,a17,select
0,48014946700,48014946800,00000000100,a2f,recvmsg
0,48014952100,48014952300,00000000200,a2f,recvmsg
0,48014952600,48014952800,00000000200,a2f,recvmsg
0,48014947400,48014959600,00000012200,a17,select
0,48014962900,48014963100,00000000200,a2f,recvmsg
0,48014968400,48014968600,00000000200,a2f,recvmsg
0,48014968800,48014969000,00000000200,a2f,recvmsg
0,48014963700,48014974200,00000010500,a17,select
0,48014977100,48014977300,00000000200,a2f,recvmsg
0,48014982400,48014982600,00000000200,a2f,recvmsg
0,48014983000,48014983100,00000000100,a2f,recvmsg
0,48014977900,48014987900,00000010000,a17,select
0,48014990900,48014991000,00000000100,a2f,recvmsg
0,48014996400,48014996600,00000000200,a2f,recvmsg
0,48014997000,48014997100,00000000100,a2f,recvmsg
0,48014991500,48015001900,00000010400,a17,select
0,48015004800,48015005000,00000000200,a2f,recvmsg
0,48015010300,48015010400,00000000100,a2f,recvmsg
0,48015010700,48015010900,00000000200,a2f,recvmsg
0,48015005500,48015015700,00000010200,a17,select
0,48015018700,48015018900,00000000200,a2f,recvmsg
0,48015024100,48015024200,00000000100,a2f,recvmsg
0,48015024600,48015024800,00000000200,a2f,recvmsg
0,48015019400,48015030000,00000010600,a17,select
0,48015033100,48015033300,00000000200,a2f,recvmsg
0,48015038400,48015038600,00000000200,a2f,recvmsg
0,48015038900,48015039000,00000000100,a2f,recvmsg
0,48015033700,48015043900,00000010200,a17,select
0,48015046800,48015047000,00000000200,a2f,recvmsg
0,48015052300,48015052400,00000000100,a2f,recvmsg
0,48015052700,48015052900,00000000200,a2f,recvmsg
0,48015047600,48015057700,00000010100,a17,select
0,48015060800,48015061000,00000000200,a2f,recvmsg
0,48015066100,48015066300,00000000200,a2f,recvmsg
0,48015066600,48015066800,00000000200,a2f,recvmsg
0,48015061600,48015071500,00000009900,a17,select
0,48015074500,48015074600,00000000100,a2f,recvmsg
0,48015079700,48015079900,00000000200,a2f,recvmsg
0,48015080300,48015080400,00000000100,a2f,recvmsg
0,48015075100,48015085100,00000010000,a17,select
0,48015088000,48015088200,00000000200,a2f,recvmsg
0,48015093300,48015093500,00000000200,a2f,recvmsg
0,48015093900,48015094100,00000000200,a2f,recvmsg
0,48015088700,48015099000,00000010300,a17,select
0,48015101900,48015102100,00000000200,a2f,recvmsg
0,48015107300,48015107400,00000000100,a2f,recvmsg
0,48015107800,48015107900,00000000100,a2f,recvmsg
0,48015102600,48015113200,00000010600,a17,select
0,48015116200,48015116400,00000000200,a2f,recvmsg
0,48015121800,48015121900,00000000100,a2f,recvmsg
0,48015122300,48015122500,00000000200,a2f,recvmsg
0,48015116900,48015127200,00000010300,a17,select
0,48015130200,48015130300,00000000100,a2f,recvmsg
0,48015135500,48015135700,00000000200,a2f,recvmsg
0,48015136000,48015136100,00000000100,a2f,recvmsg
0,48015130900,48015141000,00000010100,a17,select
0,48015143900,48015144000,00000000100,a2f,recvmsg
0,48015149700,48015149900,00000000200,a2f,recvmsg
0,48015150300,48015150400,00000000100,a2f,recvmsg
0,48015144600,48015155200,00000010600,a17,select
0,48015158200,48015158400,00000000200,a2f,recvmsg
0,48015163800,48015163900,00000000100,a2f,recvmsg
0,48015164300,48015164400,00000000100,a2f,recvmsg
0,48015158800,48015176600,00000017800,a17,select
0,48015179700,48015179900,00000000200,a2f,recvmsg
0,48015185300,48015185500,00000000200,a2f,recvmsg
0,48015185900,48015186100,00000000200,a2f,recvmsg
0,48015180700,48015191000,00000010300,a17,select
0,48015194000,48015194100,00000000100,a2f,recvmsg
0,48015199200,48015199400,00000000200,a2f,recvmsg
0,48015199800,48015200000,00000000200,a2f,recvmsg
0,48015194800,48015204700,00000009900,a17,select
0,48015207700,48015207800,00000000100,a2f,recvmsg
0,48015213000,48015213200,00000000200,a2f,recvmsg
0,48015213600,48015213800,00000000200,a2f,recvmsg
0,48015208300,48015218700,00000010400,a17,select
0,48015221600,48015221800,00000000200,a2f,recvmsg
0,48015227000,48015227100,00000000100,a2f,recvmsg
0,48015227400,48015227600,00000000200,a2f,recvmsg
0,48015222400,48015232500,00000010100,a17,select
0,48015235300,48015235500,00000000200,a2f,recvmsg
0,48015240600,48015240800,00000000200,a2f,recvmsg
0,48015241200,48015241400,00000000200,a2f,recvmsg
0,48015283900,48015287600,00000003700,a14,writev
0,48015236100,48015291200,00000055100,a17,select
0,48015293600,48015294700,00000001100,a2f,recvmsg
0,48015379400,48015383200,00000003800,a14,writev
0,48015383600,48015386600,00000003000,a14,writev
0,48015465700,48015468000,00000002300,a14,writev
0,48015523100,48015525000,00000001900,a14,writev
0,48015525300,48015526800,00000001500,a14,writev
0,48015581800,48015583400,00000001600,a14,writev
0,48015583600,48015585100,00000001500,a14,writev
0,48015639400,48015641100,00000001700,a14,writev
0,48015641300,48015643000,00000001700,a14,writev
0,48015697500,48015699100,00000001600,a14,writev
0,48015699300,48015700900,00000001600,a14,writev
0,48015704700,48015705400,00000000700,a2f,recvmsg
0,48015753900,48015755600,00000001700,a14,writev
0,48015799100,48015800800,00000001700,a14,writev
0,48015842900,48015844600,00000001700,a14,writev
0,48015887800,48015889400,00000001600,a14,writev
0,48015932600,48015934200,00000001600,a14,writev
0,48015976900,48015978500,00000001600,a14,writev
0,48016004000,48016005800,00000001800,a2f,recvmsg
0,48016030400,48016032300,00000001900,a14,writev
0,48016048900,48016050600,00000001700,a14,writev
0,48016065600,48016067000,00000001400,a14,writev
0,48016080900,48016082400,00000001500,a14,writev
0,48016095800,48016097600,00000001800,a14,writev
0,48016110500,48016112000,00000001500,a14,writev
0,48038602200,48038610200,00000008000,a17,select
0,48038612700,48038614200,00000001500,a14,writev
0,48038614500,48038614700,00000000200,a2f,recvmsg
0,48038615200,48038625800,00000010600,a17,select
0,48038628400,48038629900,00000001500,a14,writev
0,48038630200,48038630400,00000000200,a2f,recvmsg
0,48038630900,48038638900,00000008000,a17,select
0,48038641300,48038642800,00000001500,a14,writev
0,48038643000,48038643200,00000000200,a2f,recvmsg
0,48038643700,48038652100,00000008400,a17,select
0,48038654400,48038655900,00000001500,a14,writev
0,48038656100,48038656200,00000000100,a2f,recvmsg
0,48038656800,48038665500,00000008700,a17,select
0,48038667900,48038669300,00000001400,a14,writev
0,48038669500,48038669700,00000000200,a2f,recvmsg
0,48038670200,48038678700,00000008500,a17,select
0,48038681100,48038682600,00000001500,a14,writev
0,48038682800,48038682900,00000000100,a2f,recvmsg
0,48038683500,48038692400,00000008900,a17,select
0,48038695000,48038696300,00000001300,a14,writev
0,48038696600,48038696800,00000000200,a2f,recvmsg
0,48038697300,48038705400,00000008100,a17,select
0,48038707900,48038709300,00000001400,a14,writev
0,48038709500,48038709700,00000000200,a2f,recvmsg
0,48038710300,48038718500,00000008200,a17,select
0,48038721000,48038722500,00000001500,a14,writev
0,48038722700,48038722800,00000000100,a2f,recvmsg
0,48038723300,48038731200,00000007900,a17,select
0,48038733600,48038735000,00000001400,a14,writev
0,48038735200,48038735400,00000000200,a2f,recvmsg
0,48038735800,48038744900,00000009100,a17,select
0,48038747200,48038748700,00000001500,a14,writev
0,48038748900,48038749100,00000000200,a2f,recvmsg
0,48038749500,48038765900,00000016400,a17,select
0,48038768300,48038769900,00000001600,a14,writev
0,48038770100,48038770200,00000000100,a2f,recvmsg
0,48038770800,48038801800,00000031000,a17,select
0,48038804200,48038805600,00000001400,a14,writev
0,48038805800,48038806000,00000000200,a2f,recvmsg
0,48038806500,48038825500,00000019000,a17,select
0,48038827900,48038829300,00000001400,a14,writev
0,48038829600,48038829700,00000000100,a2f,recvmsg
0,48038830300,48038838200,00000007900,a17,select
0,48038840500,48038842000,00000001500,a14,writev
0,48038842200,48038842300,00000000100,a2f,recvmsg
0,48038842800,48038850500,00000007700,a17,select
0,48038852800,48038854100,00000001300,a14,writev
0,48038854400,48038854600,00000000200,a2f,recvmsg
0,48038855100,48038862800,00000007700,a17,select
0,48038865000,48038866500,00000001500,a14,writev
0,48038866700,48038866900,00000000200,a2f,recvmsg
0,48038867300,48038875200,00000007900,a17,select
0,48038877500,48038878900,00000001400,a14,writev
0,48038879200,48038879300,00000000100,a2f,recvmsg
0,48038879800,48038887400,00000007600,a17,select
0,48038889700,48038891300,00000001600,a14,writev
0,48038891500,48038891600,00000000100,a2f,recvmsg
0,48038892100,48038899700,00000007600,a17,select
0,48038902100,48038903500,00000001400,a14,writev
0,48038903700,48038903900,00000000200,a2f,recvmsg
0,48038904400,48038912500,00000008100,a17,select
0,48038915000,48038916400,00000001400,a14,writev
0,48038916700,48038916800,00000000100,a2f,recvmsg
0,48038917400,48038925000,00000007600,a17,select
0,48038927400,48038928900,00000001500,a14,writev
0,48038929200,48038929300,00000000100,a2f,recvmsg
0,48038929800,48038939800,00000010000,a17,select
0,48038942200,48038943600,00000001400,a14,writev
0,48038943800,48038944000,00000000200,a2f,recvmsg
0,48038944600,48038954500,00000009900,a17,select
0,48038957100,48038958500,00000001400,a14,writev
0,48038958700,48038958900,00000000200,a2f,recvmsg
0,48038959400,48038967800,00000008400,a17,select
0,48038970100,48038971500,00000001400,a14,writev
0,48038971700,48038971900,00000000200,a2f,recvmsg
0,48038972400,48038980400,00000008000,a17,select
0,48038982800,48038984200,00000001400,a14,writev
0,48038984400,48038984600,00000000200,a2f,recvmsg
0,48038985000,48038993000,00000008000,a17,select
0,48038995300,48038996700,00000001400,a14,writev
0,48038996900,48038997100,00000000200,a2f,recvmsg
0,48038997600,48039005600,00000008000,a17,select
0,48039007900,48039009400,00000001500,a14,writev
0,48039009500,48039009700,00000000200,a2f,recvmsg
0,48039010200,48039018800,00000008600,a17,select
0,48039021000,48039022600,00000001600,a14,writev
0,48039022700,48039022900,00000000200,a2f,recvmsg
0,48039023400,48039031500,00000008100,a17,select
0,48039033800,48039035200,00000001400,a14,writev
0,48039035500,48039035700,00000000200,a2f,recvmsg
0,48039036100,48039044100,00000008000,a17,select
0,48039046500,48039047900,00000001400,a14,writev
0,48039048100,48039048300,00000000200,a2f,recvmsg
0,48039048800,48039056900,00000008100,a17,select
0,48039059300,48039060800,00000001500,a14,writev
0,48039061200,48039061300,00000000100,a2f,recvmsg
0,48039061900,48039069800,00000007900,a17,select
0,48039072100,48039073600,00000001500,a14,writev
0,48039073800,48039074000,00000000200,a2f,recvmsg
0,48039074500,48039082600,00000008100,a17,select
0,48039084900,48039086300,00000001400,a14,writev
0,48039086600,48039086800,00000000200,a2f,recvmsg
0,48039087300,48039096200,00000008900,a17,select
0,48039098600,48039100100,00000001500,a14,writev
0,48039100300,48039100500,00000000200,a2f,recvmsg
0,48039100900,48039109300,00000008400,a17,select
0,48039111700,48039113000,00000001300,a14,writev
0,48039113300,48039113500,00000000200,a2f,recvmsg
0,48039113900,48039121900,00000008000,a17,select
0,48039124400,48039125900,00000001500,a14,writev
0,48039126100,48039126300,00000000200,a2f,recvmsg
0,48039126800,48039135000,00000008200,a17,select
0,48039137400,48039138800,00000001400,a14,writev
0,48039139100,48039139300,00000000200,a2f,recvmsg
0,48039139800,48039153200,00000013400,a17,select
0,48039155700,48039157200,00000001500,a14,writev
0,48039157500,48039157600,00000000100,a2f,recvmsg
0,48039158100,48039166500,00000008400,a17,select
0,48039169000,48039170400,00000001400,a14,writev
0,48039170600,48039170800,00000000200,a2f,recvmsg
0,48039171200,48039179200,00000008000,a17,select
0,48039181700,48039183000,00000001300,a14,writev
0,48039183300,48039183500,00000000200,a2f,recvmsg
0,48039184000,48039192000,00000008000,a17,select
0,48039194400,48039195900,00000001500,a14,writev
0,48039196100,48039196300,00000000200,a2f,recvmsg
0,48039196800,48039205000,00000008200,a17,select
0,48039207300,48039208800,00000001500,a14,writev
0,48039208900,48039209100,00000000200,a2f,recvmsg
0,48039209600,48039266000,00000056400,a17,select
0,48039267600,48039269000,00000001400,a2f,recvmsg
0,48039353000,48039356300,00000003300,a14,writev
0,48039356700,48039359200,00000002500,a14,writev
0,48039435400,48039437700,00000002300,a14,writev
0,48039438000,48039439700,00000001700,a14,writev
0,48039499300,48039501000,00000001700,a14,writev
0,48039501200,48039502700,00000001500,a14,writev
0,48039558100,48039559800,00000001700,a14,writev
0,48039560000,48039561500,00000001500,a14,writev
0,48039615900,48039617800,00000001900,a14,writev
0,48039618000,48039619500,00000001500,a14,writev
0,48039673500,48039675200,00000001700,a14,writev
0,48039675400,48039676900,00000001500,a14,writev
0,48039681500,48039682500,00000001000,a2f,recvmsg
0,48039731800,48039733500,00000001700,a14,writev
0,48039776600,48039778100,00000001500,a14,writev
0,48039819800,48039821600,00000001800,a14,writev
0,48039864900,48039866400,00000001500,a14,writev
0,48039909000,48039910700,00000001700,a14,writev
0,48039952300,48039953700,00000001400,a14,writev
0,48039980200,48039982300,00000002100,a2f,recvmsg
0,48040006600,48040008300,00000001700,a14,writev
0,48040025900,48040027800,00000001900,a14,writev
0,48040043500,48040045100,00000001600,a14,writev
0,48040060000,48040061500,00000001500,a14,writev
0,48040075500,48040077100,00000001600,a14,writev
0,48040091200,48040092800,00000001600,a14,writev
0,48040096700,48040098100,00000001400,a14,writev
0,48040098300,48040098600,00000000300,a2f,recvmsg
0,48040099300,48040099700,00000000400,a14,writev
0,48040119300,48040120700,00000001400,a14,writev
0,48040121100,48040121300,00000000200,a2f,recvmsg
0,48040134100,48040136000,00000001900,a14,writev
0,48040138700,48040138900,00000000200,a2f,recvmsg
0,48015283400,48040145900,00024862500,a07,poll
0,48040150700,48040158300,00000007600,a2f,recvmsg
0,48040171100,48040171300,00000000200,a2f,recvmsg
0,48040197200,48040201900,00000004700,a07,poll
0,48040207800,48040215300,00000007500,a2f,recvmsg
0,48040228700,48040229100,00000000400,a2f,recvmsg
0,48040252600,48040257700,00000005100,a07,poll
0,48040263900,48040271800,00000007900,a2f,recvmsg
0,48040286000,48040286200,00000000200,a2f,recvmsg
0,48040139500,48040315800,00000176300,a17,select
0,48040332200,48040333800,00000001600,a14,writev
0,48040334300,48040334500,00000000200,a2f,recvmsg
0,48040348300,48040349200,00000000900,a14,writev
0,48040349500,48040349700,00000000200,a2f,recvmsg
0,48040361700,48040362800,00000001100,a14,writev
0,48040363100,48040363300,00000000200,a2f,recvmsg
0,48040310500,48040368100,00000057600,a07,poll
0,48040369700,48040370700,00000001000,a2f,recvmsg
0,48040380300,48040381200,00000000900,a2d,recvfrom
0,48040382600,48040382800,00000000200,a2f,recvmsg
0,48040383500,48040383700,00000000200,a2f,recvmsg
0,48040431200,48040431500,00000000300,a2f,recvmsg
0,48040434800,48040435000,00000000200,a2f,recvmsg
0,48040438000,48040442000,00000004000,a07,poll
0,48040443400,48040444600,00000001200,a2f,recvmsg
0,48040456700,48040457400,00000000700,a2d,recvfrom
0,48040458800,48040459000,00000000200,a2f,recvmsg
0,48040459800,48040460000,00000000200,a2f,recvmsg
0,48040498900,48040499200,00000000300,a2f,recvmsg
0,48040502400,48040502600,00000000200,a2f,recvmsg
0,48040506800,48040510700,00000003900,a07,poll
0,48040512700,48040514300,00000001600,a2f,recvmsg
0,48040527200,48040528000,00000000800,a2d,recvfrom
0,48040529500,48040529900,00000000400,a2f,recvmsg
0,48040530900,48040531100,00000000200,a2f,recvmsg
0,48040570300,48040570500,00000000200,a2f,recvmsg
0,48040573300,48040573500,00000000200,a2f,recvmsg
0,48040363800,48043448200,00003084400,a17,select
0,48043460100,48043463500,00000003400,a14,writev
0,48043464000,48043464100,00000000100,a2f,recvmsg
0,48043466300,48043478100,00000011800,a17,select
0,48043482200,48043484200,00000002000,a14,writev
0,48043484500,48043484700,00000000200,a2f,recvmsg
0,48043485600,48043546300,00000060700,a17,select
0,48043549800,48043551300,00000001500,a14,writev
0,48043551700,48043551900,00000000200,a2f,recvmsg
0,48043552600,48058268600,00014716000,a17,select
0,48058287500,48058287800,00000000300,a2f,recvmsg
0,48058290700,48061769400,00003478700,a17,select
0,48061774200,48061776000,00000001800,a14,writev
0,48061776300,48061776500,00000000200,a2f,recvmsg
0,48061777100,48061786700,00000009600,a17,select
0,48061790100,48061791600,00000001500,a14,writev
0,48061791900,48061792100,00000000200,a2f,recvmsg
0,48061792600,48061801300,00000008700,a17,select
0,48061804600,48061806100,00000001500,a14,writev
0,48061806300,48061806500,00000000200,a2f,recvmsg
0,48061807100,48061815400,00000008300,a17,select
0,48061818900,48061820700,00000001800,a14,writev
0,48061820900,48061821000,00000000100,a2f,recvmsg
0,48061821600,48061829800,00000008200,a17,select
0,48061832500,48061834200,00000001700,a14,writev
0,48061834500,48061834700,00000000200,a2f,recvmsg
0,48061835300,48061856200,00000020900,a17,select
0,48061859200,48061860700,00000001500,a14,writev
0,48061860900,48061861100,00000000200,a2f,recvmsg
0,48061861700,48061871700,00000010000,a17,select
0,48061874300,48061875900,00000001600,a14,writev
0,48061876100,48061876300,00000000200,a2f,recvmsg
0,48061876800,48061884900,00000008100,a17,select
0,48061887300,48061888900,00000001600,a14,writev
0,48061889100,48061889200,00000000100,a2f,recvmsg
0,48061889800,48061898400,00000008600,a17,select
0,48061900700,48061902200,00000001500,a14,writev
0,48061902500,48061902500,00000000000,a2f,recvmsg
0,48061903100,48061911500,00000008400,a17,select
0,48061914000,48061915500,00000001500,a14,writev
0,48061915800,48061915900,00000000100,a2f,recvmsg
0,48061916400,48061925000,00000008600,a17,select
0,48061927700,48061929200,00000001500,a14,writev
0,48061929400,48061929600,00000000200,a2f,recvmsg
0,48061930100,48061938400,00000008300,a17,select
0,48061941100,48061942600,00000001500,a14,writev
0,48061942800,48061943000,00000000200,a2f,recvmsg
0,48061943500,48061952300,00000008800,a17,select
0,48061954800,48061956400,00000001600,a14,writev
0,48061956600,48061956800,00000000200,a2f,recvmsg
0,48061957300,48061966800,00000009500,a17,select
0,48061969400,48061970900,00000001500,a14,writev
0,48061971100,48061971300,00000000200,a2f,recvmsg
0,48061971900,48061980200,00000008300,a17,select
0,48061982600,48061984100,00000001500,a14,writev
0,48061984200,48061984400,00000000200,a2f,recvmsg
0,48061985000,48061993100,00000008100,a17,select
0,48061995500,48061996800,00000001300,a14,writev
0,48061997100,48061997300,00000000200,a2f,recvmsg
0,48061997700,48062005900,00000008200,a17,select
0,48062008400,48062009800,00000001400,a14,writev
0,48062010100,48062010200,00000000100,a2f,recvmsg
0,48062010800,48062019900,00000009100,a17,select
0,48062022100,48062023600,00000001500,a14,writev
0,48062023800,48062024000,00000000200,a2f,recvmsg
0,48062024500,48062032700,00000008200,a17,select
0,48062035100,48062036500,00000001400,a14,writev
0,48062036800,48062036900,00000000100,a2f,recvmsg
0,48062037400,48062045600,00000008200,a17,select
0,48062048000,48062049500,00000001500,a14,writev
0,48062049700,48062049900,00000000200,a2f,recvmsg
0,48062050500,48062058000,00000007500,a17,select
0,48062060400,48062061900,00000001500,a14,writev
0,48062062100,48062062300,00000000200,a2f,recvmsg
0,48062062800,48062072800,00000010000,a17,select
0,48062075200,48062076600,00000001400,a14,writev
0,48062076800,48062077000,00000000200,a2f,recvmsg
0,48062077400,48062085300,00000007900,a17,select
0,48062087800,48062089200,00000001400,a14,writev
0,48062089500,48062089600,00000000100,a2f,recvmsg
0,48062090200,48062097800,00000007600,a17,select
0,48062100200,48062101700,00000001500,a14,writev
0,48062102000,48062102000,00000000000,a2f,recvmsg
0,48062102600,48062110400,00000007800,a17,select
0,48062112700,48062114100,00000001400,a14,writev
0,48062114300,48062114500,00000000200,a2f,recvmsg
0,48062115100,48062123000,00000007900,a17,select
0,48062125500,48062126900,00000001400,a14,writev
0,48062127200,48062127400,00000000200,a2f,recvmsg
0,48062127900,48062135900,00000008000,a17,select
0,48062138300,48062139800,00000001500,a14,writev
0,48062140000,48062140100,00000000100,a2f,recvmsg
0,48062140700,48062148900,00000008200,a17,select
0,48062151200,48062152600,00000001400,a14,writev
0,48062152900,48062153100,00000000200,a2f,recvmsg
0,48062153500,48062161800,00000008300,a17,select
0,48062164400,48062165900,00000001500,a14,writev
0,48062166100,48062166300,00000000200,a2f,recvmsg
0,48062166800,48062176500,00000009700,a17,select
0,48062179200,48062180500,00000001300,a14,writev
0,48062180800,48062181000,00000000200,a2f,recvmsg
0,48062181500,48062190000,00000008500,a17,select
0,48062192400,48062193800,00000001400,a14,writev
0,48062194100,48062194300,00000000200,a2f,recvmsg
0,48062194800,48062204000,00000009200,a17,select
0,48062206500,48062208000,00000001500,a14,writev
0,48062208300,48062208400,00000000100,a2f,recvmsg
0,48062208900,48062219500,00000010600,a17,select
0,48062221800,48062223300,00000001500,a14,writev
0,48062223600,48062223600,00000000000,a2f,recvmsg
0,48062224200,48062232500,00000008300,a17,select
0,48062234900,48062236200,00000001300,a14,writev
0,48062236500,48062236700,00000000200,a2f,recvmsg
0,48062237100,48062245100,00000008000,a17,select
0,48062247600,48062249000,00000001400,a14,writev
0,48062249200,48062249400,00000000200,a2f,recvmsg
0,48062250000,48062258600,00000008600,a17,select
0,48062261000,48062262400,00000001400,a14,writev
0,48062262700,48062262800,00000000100,a2f,recvmsg
0,48062263400,48062271800,00000008400,a17,select
0,48062274300,48062275700,00000001400,a14,writev
0,48062276000,48062276100,00000000100,a2f,recvmsg
0,48062276700,48062285500,00000008800,a17,select
0,48062288100,48062289600,00000001500,a14,writev
0,48062289800,48062290000,00000000200,a2f,recvmsg
0,48062290500,48062299800,00000009300,a17,select
0,48062302200,48062303700,00000001500,a14,writev
0,48062303900,48062304100,00000000200,a2f,recvmsg
0,48062304600,48062312700,00000008100,a17,select
0,48062315000,48062316600,00000001600,a14,writev
0,48062316700,48062316900,00000000200,a2f,recvmsg
0,48062317500,48062325400,00000007900,a17,select
0,48062327800,48062329200,00000001400,a14,writev
0,48062329400,48062329600,00000000200,a2f,recvmsg
0,48062330000,48062338300,00000008300,a17,select
0,48062340800,48062342300,00000001500,a14,writev
0,48062342500,48062342700,00000000200,a2f,recvmsg
0,48062343300,48062361600,00000018300,a17,select
0,48062364100,48062365500,00000001400,a14,writev
0,48062365700,48062365900,00000000200,a2f,recvmsg
0,48062366300,48062398200,00000031900,a17,select
0,48062400500,48062402100,00000001600,a14,writev
0,48062402300,48062402400,00000000100,a2f,recvmsg
0,48062403100,48062421600,00000018500,a17,select
0,48062424000,48062425400,00000001400,a14,writev
0,48062425600,48062425800,00000000200,a2f,recvmsg
0,48062426400,48062434200,00000007800,a17,select
0,48062436500,48062438000,00000001500,a14,writev
0,48062438300,48062438300,00000000000,a2f,recvmsg
0,48062438900,48062446600,00000007700,a17,select
0,48062448900,48062450300,00000001400,a14,writev
0,48062450500,48062450700,00000000200,a2f,recvmsg
0,48062451300,48062458900,00000007600,a17,select
0,48062461200,48062462600,00000001400,a14,writev
0,48062462900,48062463000,00000000100,a2f,recvmsg
0,48062463500,48062471200,00000007700,a17,select
0,48062473800,48062475100,00000001300,a14,writev
0,48062475400,48062475500,00000000100,a2f,recvmsg
0,48062476100,48062483700,00000007600,a17,select
0,48062485900,48062487500,00000001600,a14,writev
0,48062487700,48062487800,00000000100,a2f,recvmsg
0,48062488400,48062496000,00000007600,a17,select
0,48062498300,48062499800,00000001500,a14,writev
0,48062500000,48062500200,00000000200,a2f,recvmsg
0,48062500800,48062509000,00000008200,a17,select
0,48062511600,48062512900,00000001300,a14,writev
0,48062513200,48062513400,00000000200,a2f,recvmsg
0,48062513900,48062521700,00000007800,a17,select
0,48062523900,48062525400,00000001500,a14,writev
0,48062525700,48062525800,00000000100,a2f,recvmsg
0,48062526300,48062536000,00000009700,a17,select
0,48062538400,48062539700,00000001300,a14,writev
0,48062540000,48062540200,00000000200,a2f,recvmsg
0,48062540700,48062550900,00000010200,a17,select
0,48062553400,48062554800,00000001400,a14,writev
0,48062555000,48062555200,00000000200,a2f,recvmsg
0,48062555800,48062564100,00000008300,a17,select
0,48062566300,48062567800,00000001500,a14,writev
0,48062568100,48062568200,00000000100,a2f,recvmsg
0,48062568800,48062577000,00000008200,a17,select
0,48062579200,48062580700,00000001500,a14,writev
0,48062580900,48062581000,00000000100,a2f,recvmsg
0,48062581600,48062589600,00000008000,a17,select
0,48062591900,48062593300,00000001400,a14,writev
0,48062593500,48062593700,00000000200,a2f,recvmsg
0,48062594100,48062602200,00000008100,a17,select
0,48062604500,48062605800,00000001300,a14,writev
0,48062606100,48062606300,00000000200,a2f,recvmsg
0,48062606800,48062615100,00000008300,a17,select
0,48062617600,48062618900,00000001300,a14,writev
0,48062619200,48062619400,00000000200,a2f,recvmsg
0,48062619900,48062627900,00000008000,a17,select
0,48062630200,48062631600,00000001400,a14,writev
0,48062631900,48062632000,00000000100,a2f,recvmsg
0,48062632500,48062640700,00000008200,a17,select
0,48062643000,48062644500,00000001500,a14,writev
0,48062644800,48062645000,00000000200,a2f,recvmsg
0,48062645400,48062653400,00000008000,a17,select
0,48062655700,48062657100,00000001400,a14,writev
0,48062657300,48062657500,00000000200,a2f,recvmsg
0,48062658000,48062666000,00000008000,a17,select
0,48062668300,48062669700,00000001400,a14,writev
0,48062670000,48062670100,00000000100,a2f,recvmsg
0,48062670600,48062678600,00000008000,a17,select
0,48062680900,48062682200,00000001300,a14,writev
0,48062682500,48062682700,00000000200,a2f,recvmsg
0,48062683200,48062691700,00000008500,a17,select
0,48062694100,48062695500,00000001400,a14,writev
0,48062695700,48062695900,00000000200,a2f,recvmsg
0,48062696400,48062704500,00000008100,a17,select
0,48062706800,48062708200,00000001400,a14,writev
0,48062708400,48062708600,00000000200,a2f,recvmsg
0,48062709200,48062717100,00000007900,a17,select
0,48062719400,48062720900,00000001500,a14,writev
0,48062721200,48062721300,00000000100,a2f,recvmsg
0,48062721800,48062729800,00000008000,a17,select
0,48062732200,48062733600,00000001400,a14,writev
0,48062733800,48062734000,00000000200,a2f,recvmsg
0,48062734600,48062748100,00000013500,a17,select
0,48062750500,48062751900,00000001400,a14,writev
0,48062752100,48062752300,00000000200,a2f,recvmsg
0,48062752900,48062761200,00000008300,a17,select
0,48062763400,48062764800,00000001400,a14,writev
0,48062765100,48062765100,00000000000,a2f,recvmsg
0,48062765700,48062773700,00000008000,a17,select
0,48062776000,48062777400,00000001400,a14,writev
0,48062777700,48062777800,00000000100,a2f,recvmsg
0,48062778400,48062786600,00000008200,a17,select
0,48062788900,48062790400,00000001500,a14,writev
0,48062790600,48062790800,00000000200,a2f,recvmsg
0,48062791400,48062799300,00000007900,a17,select
0,48062801700,48062803100,00000001400,a14,writev
0,48062803400,48062803600,00000000200,a2f,recvmsg
0,48062804100,48062857000,00000052900,a17,select
0,48062858500,48062859800,00000001300,a2f,recvmsg
0,48062943700,48062946500,00000002800,a14,writev
0,48062947000,48062949600,00000002600,a14,writev
0,48063027300,48063029300,00000002000,a14,writev
0,48063087400,48063089200,00000001800,a14,writev
0,48063089400,48063091200,00000001800,a14,writev
0,48063146100,48063148200,00000002100,a14,writev
0,48063148400,48063150000,00000001600,a14,writev
0,48063204400,48063206100,00000001700,a14,writev
0,48063206400,48063207800,00000001400,a14,writev
0,48063261000,48063262700,00000001700,a14,writev
0,48063262900,48063264400,00000001500,a14,writev
0,48063268800,48063269500,00000000700,a2f,recvmsg
0,48063317500,48063319100,00000001600,a14,writev
0,48063360700,48063362100,00000001400,a14,writev
0,48063404700,48063406200,00000001500,a14,writev
0,48063449300,48063450900,00000001600,a14,writev
0,48063493300,48063494700,00000001400,a14,writev
0,48063535900,48063537200,00000001300,a14,writev
0,48063563100,48063565000,00000001900,a2f,recvmsg
0,48063589700,48063591600,00000001900,a14,writev
0,48063609700,48063611700,00000002000,a14,writev
0,48063626700,48063628200,00000001500,a14,writev
0,48063643600,48063645300,00000001700,a14,writev
0,48063659200,48063661000,00000001800,a14,writev
0,48063675400,48063677000,00000001600,a14,writev
0,48063680600,48063682000,00000001400,a14,writev
0,48063682200,48063682400,00000000200,a2f,recvmsg
0,48063683100,48063683500,00000000400,a14,writev
0,48063704100,48063705600,00000001500,a14,writev
0,48063705900,48063706100,00000000200,a2f,recvmsg
0,48063718100,48063719800,00000001700,a14,writev
0,48063722300,48063722400,00000000100,a2f,recvmsg
0,48040578200,48063729600,00023151400,a07,poll
0,48063734500,48063742000,00000007500,a2f,recvmsg
0,48063753800,48063754000,00000000200,a2f,recvmsg
0,48063778800,48063783500,00000004700,a07,poll
0,48063788700,48063795700,00000007000,a2f,recvmsg
0,48063808300,48063808500,00000000200,a2f,recvmsg
0,48063831300,48063836600,00000005300,a07,poll
0,48063842600,48063850100,00000007500,a2f,recvmsg
0,48063863400,48063863800,00000000400,a2f,recvmsg
0,48063723000,48063893500,00000170500,a17,select
0,48063909900,48063911400,00000001500,a14,writev
0,48063911900,48063912100,00000000200,a2f,recvmsg
0,48063925700,48063926800,00000001100,a14,writev
0,48063927100,48063927300,00000000200,a2f,recvmsg
0,48063939100,48063939900,00000000800,a14,writev
0,48063940200,48063940300,00000000100,a2f,recvmsg
0,48063887900,48063945300,00000057400,a07,poll
0,48063946300,48063947200,00000000900,a2f,recvmsg
0,48063956700,48063957700,00000001000,a2d,recvfrom
0,48063959100,48063959300,00000000200,a2f,recvmsg
0,48063960100,48063960200,00000000100,a2f,recvmsg
0,48064008200,48064008600,00000000400,a2f,recvmsg
0,48064011300,48064011500,00000000200,a2f,recvmsg
0,48064014300,48064017800,00000003500,a07,poll
0,48064019100,48064020700,00000001600,a2f,recvmsg
0,48064033700,48064034400,00000000700,a2d,recvfrom
0,48064035700,48064035900,00000000200,a2f,recvmsg
0,48064037200,48064037400,00000000200,a2f,recvmsg
0,48064076700,48064077200,00000000500,a2f,recvmsg
0,48064080300,48064080600,00000000300,a2f,recvmsg
0,48064085100,48064089400,00000004300,a07,poll
0,48064091000,48064093000,00000002000,a2f,recvmsg
0,48064105000,48064105800,00000000800,a2d,recvfrom
0,48064107500,48064107700,00000000200,a2f,recvmsg
0,48064108600,48064108800,00000000200,a2f,recvmsg
0,48064147100,48064147500,00000000400,a2f,recvmsg
0,48064149800,48064150000,00000000200,a2f,recvmsg
0,48063940900,48065634200,00001693300,a17,select
0,48065642900,48065646100,00000003200,a14,writev
0,48065646700,48065646900,00000000200,a2f,recvmsg
0,48065648400,48065659100,00000010700,a17,select
0,48065662700,48065664500,00000001800,a14,writev
0,48065664800,48065664900,00000000100,a2f,recvmsg
0,48065665600,48065721400,00000055800,a17,select
0,48065734200,48065735900,00000001700,a14,writev
0,48065736200,48065736300,00000000100,a2f,recvmsg
0,48068491100,48068491200,00000000100,a0c,brk
0,48068503100,48068506900,00000003800,a15,access
0,48068507500,48068508700,00000001200,a09,mmap
0,48068514500,48068515500,00000001000,a15,access
0,48068524100,48068525200,00000001100,a09,mmap
0,48068529200,48068529700,00000000500,a15,access
0,48068537700,48068538900,00000001200,a00,read
0,48068540800,48068542600,00000001800,a09,mmap
0,48068547000,48068549700,00000002700,a09,mmap
0,48068561100,48068562000,00000000900,a15,access
0,48068565600,48068566500,00000000900,a00,read
0,48068567400,48068568500,00000001100,a09,mmap
0,48068571600,48068573200,00000001600,a09,mmap
0,48068581600,48068582500,00000000900,a15,access
0,48068585900,48068586600,00000000700,a00,read
0,48068587200,48068588300,00000001100,a09,mmap
0,48068597200,48068600700,00000003500,a09,mmap
0,48068602900,48068604000,00000001100,a09,mmap
0,48068614200,48068615100,00000000900,a15,access
0,48068617700,48068618300,00000000600,a00,read
0,48068619000,48068620700,00000001700,a09,mmap
0,48068623800,48068625500,00000001700,a09,mmap
0,48068634000,48068634600,00000000600,a15,access
0,48068638200,48068638900,00000000700,a00,read
0,48068639600,48068641100,00000001500,a09,mmap
0,48068645600,48068648000,00000002400,a09,mmap
0,48068657000,48068657600,00000000600,a15,access
0,48068660300,48068660900,00000000600,a00,read
0,48068661400,48068662500,00000001100,a09,mmap
0,48068663800,48068665200,00000001400,a09,mmap
0,48068668500,48068669900,00000001400,a09,mmap
0,48068676300,48068676900,00000000600,a15,access
0,48068679500,48068679900,00000000400,a00,read
0,48068684700,48068686400,00000001700,a09,mmap
0,48068705200,48068705800,00000000600,a09,mmap
0,48068709600,48068709900,00000000300,a09,mmap
0,48068711000,48068711200,00000000200,a09,mmap
0,48068905800,48068905900,00000000100,a0c,brk
0,48068937100,48068944300,00000007200,a00,read
0,48068956900,48068958500,00000001600,a00,read
0,48068996900,48068997900,00000001000,a00,read
0,48069120900,48069121700,00000000800,a00,read
0,48069192800,48069193200,00000000400,a00,read
0,48069279100,48069279800,00000000700,a00,read
0,48069411100,48069411900,00000000800,a00,read
0,48069540400,48069541100,00000000700,a00,read
0,48069697200,48069698000,00000000800,a00,read
0,48069858200,48069859000,00000000800,a00,read
0,48069895900,48069897200,00000001300,a0c,brk
0,48070013400,48070014100,00000000700,a00,read
0,48070162400,48070163200,00000000800,a00,read
0,48070318300,48070319000,00000000700,a00,read
0,48070478900,48070479800,00000000900,a00,read
0,48070588800,48070589300,00000000500,a00,read
0,48070620100,48070620800,00000000700,a0c,brk
0,48070729900,48070730800,00000000900,a00,read
0,48070980300,48070981100,00000000800,a00,read
0,48070993500,48070994000,00000000500,a00,read
0,48071038700,48071039100,00000000400,a00,read
0,48071059300,48071060000,00000000700,a00,read
0,48071265800,48071266300,00000000500,a00,read
0,48071295500,48071296300,00000000800,a00,read
0,48071393100,48071393900,00000000800,a00,read
0,48071417800,48071419100,00000001300,a0c,brk
0,48071464400,48071464800,00000000400,a00,read
0,48071540400,48071541200,00000000800,a00,read
0,48071693900,48071694400,00000000500,a00,read
0,48071807400,48071808100,00000000700,a00,read
0,48071902300,48071902800,00000000500,a00,read
0,48071914500,48071915000,00000000500,a00,read
0,48071998100,48071998500,00000000400,a00,read
0,48072022600,48072022900,00000000300,a00,read
0,48072045200,48072045800,00000000600,a00,read
0,48072147600,48072148700,00000001100,a0c,brk
0,48072150400,48072151400,00000001000,a00,read
0,48072353400,48072353800,00000000400,a00,read
0,48072436100,48072436800,00000000700,a00,read
0,48072502000,48072502700,00000000700,a00,read
0,48072631400,48072631800,00000000400,a00,read
0,48072663900,48072664400,00000000500,a00,read
0,48072682100,48072684200,00000002100,a02,open
0,48072798500,48072799000,00000000500,a00,read
0,48072869800,48072870200,00000000400,a00,read
0,48072923100,48072924200,00000001100,a0c,brk
0,48072930500,48072931200,00000000700,a00,read
0,48073038100,48073038700,00000000600,a00,read
0,48073189400,48073190300,00000000900,a00,read
0,48073320700,48073321300,00000000600,a00,read
0,48073378700,48073379400,00000000700,a00,read
0,48073434900,48073435500,00000000600,a00,read
0,48073505000,48073505700,00000000700,a00,read
0,48073557600,48073558300,00000000700,a00,read
0,48073645700,48073646400,00000000700,a0c,brk
0,48073677200,48073680900,00000003700,a0c,brk
0,48073695300,48073696000,00000000700,a00,read
0,48073822500,48073823200,00000000700,a00,read
0,48073982800,48073983500,00000000700,a00,read
0,48074102200,48074102900,00000000700,a00,read
0,48074249600,48074250300,00000000700,a00,read
0,48074367700,48074368400,00000000700,a00,read
0,48074530200,48074530900,00000000700,a00,read
0,48074535900,48074536700,00000000800,a0c,brk
0,48074652300,48074653000,00000000700,a00,read
0,48074771100,48074771700,00000000600,a00,read
0,48074914500,48074915200,00000000700,a00,read
0,48075046700,48075047300,00000000600,a00,read
0,48075140500,48075141200,00000000700,a00,read
0,48075253500,48075254100,00000000600,a00,read
0,48075378600,48075379200,00000000600,a00,read
0,48075491000,48075491400,00000000400,a0c,brk
0,48075514200,48075514900,00000000700,a00,read
0,48075684900,48075685600,00000000700,a00,read
0,48075837100,48075837700,00000000600,a00,read
0,48075948500,48075949200,00000000700,a00,read
0,48076116700,48076117600,00000000900,a00,read
0,48076194900,48076195600,00000000700,a00,read
0,48076277800,48076278400,00000000600,a00,read
0,48076345200,48076345800,00000000600,a0c,brk
0,48076359600,48076360100,00000000500,a00,read
0,48076432800,48076433500,00000000700,a00,read
0,48076535300,48076536100,00000000800,a00,read
0,48076638500,48076639200,00000000700,a00,read
0,48076728500,48076729300,00000000800,a00,read
0,48076809700,48076810400,00000000700,a00,read
0,48076910700,48076911300,00000000600,a00,read
0,48076992200,48076992500,00000000300,a0c,brk
0,48076994900,48076995600,00000000700,a00,read
0,48077102500,48077103100,00000000600,a00,read
0,48077196600,48077197300,00000000700,a00,read
0,48077315600,48077316300,00000000700,a00,read
0,48077429300,48077429900,00000000600,a00,read
0,48077533000,48077533600,00000000600,a00,read
0,48077633800,48077634200,00000000400,a0c,brk
0,48086009000,48086012800,00000003800,a57,unlink
0,48086037700,48086038200,00000000500,a48,fcntl
0,48086086500,48086100900,00000014400,a01,write
0,48086118600,48086121500,00000002900,a01,write
0,48086137600,48086139600,00000002000,a01,write
0,48012686000,48086307500,00073621500,a3d,wait4
0,48086327000,48086328500,00000001500,a00,read
0,48086330700,48086331000,00000000300,a00,read
0,48065736900,48086361600,00020624700,a17,select
0,48086383700,48086383900,00000000200,a2f,recvmsg
0,48086398900,48086399100,00000000200,a2f,recvmsg
0,48086399900,48086400100,00000000200,a2f,recvmsg
0,48086387700,48086407300,00000019600,a17,select
0,48086411200,48086411400,00000000200,a2f,recvmsg
0,48086417300,48086417500,00000000200,a2f,recvmsg
0,48086417900,48086418100,00000000200,a2f,recvmsg
0,48086412100,48086423500,00000011400,a17,select
0,48086426700,48086426900,00000000200,a2f,recvmsg
0,48086432000,48086432200,00000000200,a2f,recvmsg
0,48086432500,48086432700,00000000200,a2f,recvmsg
0,48086427500,48086438500,00000011000,a17,select
0,48086442000,48086442100,00000000100,a2f,recvmsg
0,48086447300,48086447500,00000000200,a2f,recvmsg
0,48086447800,48086448000,00000000200,a2f,recvmsg
0,48086442700,48086453700,00000011000,a17,select
0,48086457500,48086457700,00000000200,a2f,recvmsg
0,48086462900,48086463000,00000000100,a2f,recvmsg
0,48086463400,48086463600,00000000200,a2f,recvmsg
0,48086458200,48086468600,00000010400,a17,select
0,48086471700,48086471900,00000000200,a2f,recvmsg
0,48086477000,48086477100,00000000100,a2f,recvmsg
0,48086477400,48086477600,00000000200,a2f,recvmsg
0,48086479000,48086479200,00000000200,a08,lseek
0,48086489000,48086489100,00000000100,a08,lseek
0,48086472500,48086493500,00000021000,a17,select
0,48086497000,48086497200,00000000200,a2f,recvmsg
0,48086502700,48086502800,00000000100,a2f,recvmsg
0,48086503200,48086503400,00000000200,a2f,recvmsg
0,48086497800,48086509500,00000011700,a17,select
0,48086512900,48086513100,00000000200,a2f,recvmsg
0,48086518500,48086518700,00000000200,a2f,recvmsg
0,48086518900,48086519100,00000000200,a2f,recvmsg
0,48086513600,48086524000,00000010400,a17,select
0,48086527000,48086527200,00000000200,a2f,recvmsg
0,48086532300,48086532500,00000000200,a2f,recvmsg
0,48086532800,48086533000,00000000200,a2f,recvmsg
0,48086527800,48086538500,00000010700,a17,select
0,48086541600,48086541700,00000000100,a2f,recvmsg
0,48086547100,48086547300,00000000200,a2f,recvmsg
0,48086547500,48086547700,00000000200,a2f,recvmsg
0,48086542200,48086554000,00000011800,a17,select
0,48086557000,48086557200,00000000200,a2f,recvmsg
0,48086562600,48086562800,00000000200,a2f,recvmsg
0,48086563100,48086563300,00000000200,a2f,recvmsg
0,48086557800,48086568800,00000011000,a17,select
0,48086572000,48086572100,00000000100,a2f,recvmsg
0,48086577500,48086577700,00000000200,a2f,recvmsg
0,48086577900,48086578100,00000000200,a2f,recvmsg
0,48086572600,48086584200,00000011600,a17,select
0,48086587600,48086587800,00000000200,a2f,recvmsg
0,48086593100,48086593200,00000000100,a2f,recvmsg
0,48086593600,48086593800,00000000200,a2f,recvmsg
0,48086588400,48086598500,00000010100,a17,select
0,48086601500,48086601700,00000000200,a2f,recvmsg
0,48086606800,48086607000,00000000200,a2f,recvmsg
0,48086607300,48086607500,00000000200,a2f,recvmsg
0,48086602300,48086613900,00000011600,a17,select
0,48086617300,48086617400,00000000100,a2f,recvmsg
0,48086622700,48086622900,00000000200,a2f,recvmsg
0,48086623300,48086623400,00000000100,a2f,recvmsg
0,48086617900,48086628800,00000010900,a17,select
0,48086632400,48086632500,00000000100,a2f,recvmsg
0,48086637800,48086638000,00000000200,a2f,recvmsg
0,48086638300,48086638500,00000000200,a2f,recvmsg
0,48086633000,48086643800,00000010800,a17,select
0,48086647000,48086647200,00000000200,a2f,recvmsg
0,48086652600,48086652800,00000000200,a2f,recvmsg
0,48086653100,48086653300,00000000200,a2f,recvmsg
0,48086647800,48086659300,00000011500,a17,select
0,48086662500,48086662700,00000000200,a2f,recvmsg
0,48086668000,48086668100,00000000100,a2f,recvmsg
0,48086668500,48086668700,00000000200,a2f,recvmsg
0,48086663200,48086673800,00000010600,a17,select
0,48086676900,48086677000,00000000100,a2f,recvmsg
0,48086682300,48086682400,00000000100,a2f,recvmsg
0,48086682800,48086683000,00000000200,a2f,recvmsg
0,48086677600,48086688200,00000010600,a17,select
0,48086691300,48086691500,00000000200,a2f,recvmsg
0,48086696700,48086696800,00000000100,a2f,recvmsg
0,48086697200,48086697400,00000000200,a2f,recvmsg
0,48086691900,48086703200,00000011300,a17,select
0,48086706300,48086706500,00000000200,a2f,recvmsg
0,48086712000,48086712200,00000000200,a2f,recvmsg
0,48086712500,48086712700,00000000200,a2f,recvmsg
0,48086707000,48086717200,00000010200,a17,select
0,48086720400,48086720600,00000000200,a2f,recvmsg
0,48086726000,48086726000,00000000000,a2f,recvmsg
0,48086726400,48086726600,00000000200,a2f,recvmsg
0,48086721200,48086733300,00000012100,a17,select
0,48086736500,48086736600,00000000100,a2f,recvmsg
0,48086742000,48086742200,00000000200,a2f,recvmsg
0,48086742500,48086742700,00000000200,a2f,recvmsg
0,48086737200,48086747100,00000009900,a17,select
0,48086750400,48086750600,00000000200,a2f,recvmsg
0,48086755600,48086755800,00000000200,a2f,recvmsg
0,48086756200,48086756300,00000000100,a2f,recvmsg
0,48086751000,48086760800,00000009800,a17,select
0,48086763800,48086763900,00000000100,a2f,recvmsg
0,48086769100,48086769300,00000000200,a2f,recvmsg
0,48086769600,48086769700,00000000100,a2f,recvmsg
0,48086764400,48086774300,00000009900,a17,select
0,48086777300,48086777400,00000000100,a2f,recvmsg
0,48086782700,48086782800,00000000100,a2f,recvmsg
0,48086783100,48086783300,00000000200,a2f,recvmsg
0,48086778000,48086788200,00000010200,a17,select
0,48086791300,48086791400,00000000100,a2f,recvmsg
0,48086796600,48086796800,00000000200,a2f,recvmsg
0,48086797200,48086797400,00000000200,a2f,recvmsg
0,48086792000,48086802000,00000010000,a17,select
0,48086805100,48086805200,00000000100,a2f,recvmsg
0,48086810300,48086810500,00000000200,a2f,recvmsg
0,48086810900,48086811100,00000000200,a2f,recvmsg
0,48086805800,48086816500,00000010700,a17,select
0,48086819800,48086820000,00000000200,a2f,recvmsg
0,48086825200,48086825300,00000000100,a2f,recvmsg
0,48086825700,48086825900,00000000200,a2f,recvmsg
0,48086820600,48086831000,00000010400,a17,select
0,48086834200,48086834300,00000000100,a2f,recvmsg
0,48086839600,48086839700,00000000100,a2f,recvmsg
0,48086840000,48086840200,00000000200,a2f,recvmsg
0,48086834900,48086846000,00000011100,a17,select
0,48086849400,48086849500,00000000100,a2f,recvmsg
0,48086854800,48086854900,00000000100,a2f,recvmsg
0,48086855200,48086855400,00000000200,a2f,recvmsg
0,48086850100,48086861900,00000011800,a17,select
0,48086864900,48086865100,00000000200,a2f,recvmsg
0,48086870300,48086870400,00000000100,a2f,recvmsg
0,48086870700,48086870900,00000000200,a2f,recvmsg
0,48086865700,48086876300,00000010600,a17,select
0,48086879700,48086879800,00000000100,a2f,recvmsg
0,48086885100,48086885300,00000000200,a2f,recvmsg
0,48086885600,48086885700,00000000100,a2f,recvmsg
0,48086880300,48086893200,00000012900,a17,select
0,48086896600,48086896700,00000000100,a2f,recvmsg
0,48086902000,48086902200,00000000200,a2f,recvmsg
0,48086902600,48086902700,00000000100,a2f,recvmsg
0,48086897200,48086908400,00000011200,a17,select
0,48086911500,48086911700,00000000200,a2f,recvmsg
0,48086916900,48086917100,00000000200,a2f,recvmsg
0,48086917400,48086917600,00000000200,a2f,recvmsg
0,48086912200,48086922600,00000010400,a17,select
0,48086925700,48086925800,00000000100,a2f,recvmsg
0,48086931100,48086931200,00000000100,a2f,recvmsg
0,48086931500,48086931700,00000000200,a2f,recvmsg
0,48086926400,48086937800,00000011400,a17,select
0,48086940900,48086941100,00000000200,a2f,recvmsg
0,48086946500,48086946700,00000000200,a2f,recvmsg
0,48086947100,48086947300,00000000200,a2f,recvmsg
0,48086941700,48086952700,00000011000,a17,select
0,48086955900,48086956000,00000000100,a2f,recvmsg
0,48086961400,48086961500,00000000100,a2f,recvmsg
0,48086961800,48086962000,00000000200,a2f,recvmsg
0,48086956600,48086967700,00000011100,a17,select
0,48086971000,48086971100,00000000100,a2f,recvmsg
0,48086976400,48086976600,00000000200,a2f,recvmsg
0,48086976800,48086977000,00000000200,a2f,recvmsg
0,48086971600,48086982300,00000010700,a17,select
0,48086985400,48086985600,00000000200,a2f,recvmsg
0,48086990700,48086990900,00000000200,a2f,recvmsg
0,48086991200,48086991400,00000000200,a2f,recvmsg
0,48086986200,48086996500,00000010300,a17,select
0,48086999600,48086999700,00000000100,a2f,recvmsg
0,48087005100,48087005300,00000000200,a2f,recvmsg
0,48087005500,48087005700,00000000200,a2f,recvmsg
0,48087000300,48087010500,00000010200,a17,select
0,48087013400,48087013600,00000000200,a2f,recvmsg
0,48087018700,48087018900,00000000200,a2f,recvmsg
0,48087019200,48087019400,00000000200,a2f,recvmsg
0,48087014200,48087024700,00000010500,a17,select
0,48087027900,48087028100,00000000200,a2f,recvmsg
0,48087033300,48087033500,00000000200,a2f,recvmsg
0,48087033800,48087033900,00000000100,a2f,recvmsg
0,48087035300,48087035400,00000000100,a08,lseek
0,48087037700,48087038700,00000001000,a00,read
0,48087042300,48087042500,00000000200,a08,lseek
0,48087028500,48087047300,00000018800,a17,select
0,48087050700,48087050900,00000000200,a2f,recvmsg
0,48087056400,48087056600,00000000200,a2f,recvmsg
0,48087056900,48087057000,00000000100,a2f,recvmsg
0,48087051500,48087084700,00000033200,a17,select
0,48087088100,48087088300,00000000200,a2f,recvmsg
0,48087093800,48087094000,00000000200,a2f,recvmsg
0,48087094400,48087094500,00000000100,a2f,recvmsg
0,48087098600,48087099300,00000000700,a00,read
0,48087104900,48087105000,00000000100,a08,lseek
0,48087088900,48087110200,00000021300,a17,select
0,48087113600,48087113700,00000000100,a2f,recvmsg
0,48087119100,48087119300,00000000200,a2f,recvmsg
0,48087119600,48087119800,00000000200,a2f,recvmsg
0,48087114300,48087124400,00000010100,a17,select
0,48087127300,48087127500,00000000200,a2f,recvmsg
0,48087132600,48087132700,00000000100,a2f,recvmsg
0,48087133100,48087133300,00000000200,a2f,recvmsg
0,48087128100,48087137800,00000009700,a17,select
0,48087140500,48087140700,00000000200,a2f,recvmsg
0,48087145900,48087145900,00000000000,a2f,recvmsg
0,48087146300,48087146500,00000000200,a2f,recvmsg
0,48087141300,48087150900,00000009600,a17,select
0,48087153800,48087153900,00000000100,a2f,recvmsg
0,48087159200,48087159200,00000000000,a2f,recvmsg
0,48087159600,48087159800,00000000200,a2f,recvmsg
0,48087154500,48087164200,00000009700,a17,select
0,48087167000,48087167200,00000000200,a2f,recvmsg
0,48087172400,48087172500,00000000100,a2f,recvmsg
0,48087172800,48087173000,00000000200,a2f,recvmsg
0,48087167800,48087177400,00000009600,a17,select
0,48087180400,48087180500,00000000100,a2f,recvmsg
0,48087185700,48087185800,00000000100,a2f,recvmsg
0,48087186200,48087186400,00000000200,a2f,recvmsg
0,48087181100,48087190900,00000009800,a17,select
0,48087193800,48087193900,00000000100,a2f,recvmsg
0,48087199100,48087199200,00000000100,a2f,recvmsg
0,48087199500,48087199700,00000000200,a2f,recvmsg
0,48087194500,48087204800,00000010300,a17,select
0,48087207900,48087208100,00000000200,a2f,recvmsg
0,48087213200,48087213400,00000000200,a2f,recvmsg
0,48087213700,48087213900,00000000200,a2f,recvmsg
0,48087208600,48087218300,00000009700,a17,select
0,48087221400,48087221600,00000000200,a2f,recvmsg
0,48087226600,48087226800,00000000200,a2f,recvmsg
0,48087227200,48087227300,00000000100,a2f,recvmsg
0,48087227900,48087228000,00000000100,a08,lseek
0,48087222100,48087234000,00000011900,a17,select
0,48087237200,48087237400,00000000200,a2f,recvmsg
0,48087242700,48087242800,00000000100,a2f,recvmsg
0,48087243200,48087243300,00000000100,a2f,recvmsg
0,48087238000,48087250300,00000012300,a17,select
0,48087253500,48087253700,00000000200,a2f,recvmsg
0,48087259100,48087259300,00000000200,a2f,recvmsg
0,48087259600,48087259800,00000000200,a2f,recvmsg
0,48087254200,48087264800,00000010600,a17,select
0,48087267700,48087267900,00000000200,a2f,recvmsg
0,48087273100,48087273200,00000000100,a2f,recvmsg
0,48087273500,48087273700,00000000200,a2f,recvmsg
0,48087268400,48087278500,00000010100,a17,select
0,48087281500,48087281600,00000000100,a2f,recvmsg
0,48087286700,48087286900,00000000200,a2f,recvmsg
0,48087287200,48087287400,00000000200,a2f,recvmsg
0,48087282200,48087292200,00000010000,a17,select
0,48087295200,48087295300,00000000100,a2f,recvmsg
0,48087300500,48087300600,00000000100,a2f,recvmsg
0,48087301000,48087301200,00000000200,a2f,recvmsg
0,48087295900,48087305700,00000009800,a17,select
0,48087308900,48087309100,00000000200,a2f,recvmsg
0,48087314200,48087314400,00000000200,a2f,recvmsg
0,48087314800,48087315000,00000000200,a2f,recvmsg
0,48087309500,48087320200,00000010700,a17,select
0,48087323200,48087323400,00000000200,a2f,recvmsg
0,48087328400,48087328600,00000000200,a2f,recvmsg
0,48087329000,48087329100,00000000100,a2f,recvmsg
0,48087323900,48087333800,00000009900,a17,select
0,48087336800,48087337000,00000000200,a2f,recvmsg
0,48087342000,48087342200,00000000200,a2f,recvmsg
0,48087342600,48087342800,00000000200,a2f,recvmsg
0,48087337600,48087347400,00000009800,a17,select
0,48087350500,48087350600,00000000100,a2f,recvmsg
0,48087355600,48087355800,00000000200,a2f,recvmsg
0,48087356200,48087356400,00000000200,a2f,recvmsg
0,48087351100,48087361000,00000009900,a17,select
0,48087364100,48087364300,00000000200,a2f,recvmsg
0,48087369300,48087369500,00000000200,a2f,recvmsg
0,48087369900,48087370100,00000000200,a2f,recvmsg
0,48087364800,48087374800,00000010000,a17,select
0,48087377700,48087377900,00000000200,a2f,recvmsg
0,48087383200,48087383400,00000000200,a2f,recvmsg
0,48087383700,48087383800,00000000100,a2f,recvmsg
0,48087378500,48087388600,00000010100,a17,select
0,48087391600,48087391700,00000000100,a2f,recvmsg
0,48087396800,48087397000,00000000200,a2f,recvmsg
0,48087397300,48087397500,00000000200,a2f,recvmsg
0,48087392300,48087402700,00000010400,a17,select
0,48087406200,48087406200,00000000000,a2f,recvmsg
0,48087411400,48087411600,00000000200,a2f,recvmsg
0,48087411900,48087412000,00000000100,a2f,recvmsg
0,48087406800,48087416700,00000009900,a17,select
0,48087419800,48087419900,00000000100,a2f,recvmsg
0,48087425100,48087425200,00000000100,a2f,recvmsg
0,48087425500,48087425700,00000000200,a2f,recvmsg
0,48087420500,48087430400,00000009900,a17,select
0,48087433500,48087433700,00000000200,a2f,recvmsg
0,48087438800,48087439000,00000000200,a2f,recvmsg
0,48087439300,48087439500,00000000200,a2f,recvmsg
0,48087434300,48087444400,00000010100,a17,select
0,48087447500,48087447700,00000000200,a2f,recvmsg
0,48087452800,48087453000,00000000200,a2f,recvmsg
0,48087453300,48087453500,00000000200,a2f,recvmsg
0,48087448200,48087463400,00000015200,a17,select
0,48087466600,48087466800,00000000200,a2f,recvmsg
0,48087472100,48087472300,00000000200,a2f,recvmsg
0,48087472700,48087472700,00000000000,a2f,recvmsg
0,48087467400,48087477700,00000010300,a17,select
0,48087480700,48087480900,00000000200,a2f,recvmsg
0,48087486000,48087486100,00000000100,a2f,recvmsg
0,48087486500,48087486700,00000000200,a2f,recvmsg
0,48087481500,48087491300,00000009800,a17,select
0,48087494200,48087494400,00000000200,a2f,recvmsg
0,48087499800,48087500000,00000000200,a2f,recvmsg
0,48087500300,48087500500,00000000200,a2f,recvmsg
0,48087495000,48087505400,00000010400,a17,select
0,48087508400,48087508600,00000000200,a2f,recvmsg
0,48087513600,48087513800,00000000200,a2f,recvmsg
0,48087514200,48087514300,00000000100,a2f,recvmsg
0,48087509100,48087519200,00000010100,a17,select
0,48087522200,48087522300,00000000100,a2f,recvmsg
0,48087527600,48087527800,00000000200,a2f,recvmsg
0,48087528000,48087528200,00000000200,a2f,recvmsg
0,48087572700,48087576400,00000003700,a14,writev
0,48087522900,48087579900,00000057000,a17,select
0,48087582300,48087583600,00000001300,a2f,recvmsg
0,48087668400,48087671900,00000003500,a14,writev
0,48087672200,48087675600,00000003400,a14,writev
0,48087752700,48087754400,00000001700,a14,writev
0,48087811200,48087812900,00000001700,a14,writev
0,48087813200,48087814700,00000001500,a14,writev
0,48087867900,48087869600,00000001700,a14,writev
0,48087869800,48087871200,00000001400,a14,writev
0,48087926100,48087927700,00000001600,a14,writev
0,48087927900,48087929500,00000001600,a14,writev
0,48087982100,48087983700,00000001600,a14,writev
0,48087983800,48087985500,00000001700,a14,writev
0,48087990400,48087991100,00000000700,a2f,recvmsg
0,48088038600,48088040400,00000001800,a14,writev
0,48088084100,48088085600,00000001500,a14,writev
0,48088128200,48088129800,00000001600,a14,writev
0,48088172800,48088174300,00000001500,a14,writev
0,48088217300,48088219100,00000001800,a14,writev
0,48088261100,48088262600,00000001500,a14,writev
0,48088288400,48088290200,00000001800,a2f,recvmsg
0,48088315200,48088316900,00000001700,a14,writev
0,48088334300,48088336000,00000001700,a14,writev
0,48088350600,48088353000,00000002400,a14,writev
0,48088366500,48088368000,00000001500,a14,writev
0,48088381500,48088383100,00000001600,a14,writev
0,48088396200,48088397800,00000001600,a14,writev
0,48088402200,48088402500,00000000300,a2f,recvmsg
0,48088403200,48088403600,00000000400,a14,writev
0,48088421000,48088422800,00000001800,a14,writev
0,48088423100,48088424400,00000001300,a14,writev
0,48088424800,48088425100,00000000300,a2f,recvmsg
0,48087572100,48088432900,00000860800,a07,poll
0,48088438000,48088444300,00000006300,a2f,recvmsg
0,48088455700,48088456000,00000000300,a2f,recvmsg
0,48088481500,48088485700,00000004200,a07,poll
0,48088491500,48088497200,00000005700,a2f,recvmsg
0,48088510000,48088510100,00000000100,a2f,recvmsg
0,48088531900,48088536700,00000004800,a07,poll
0,48088542200,48088548200,00000006000,a2f,recvmsg
0,48088560500,48088560700,00000000200,a2f,recvmsg
0,48088425800,48088588000,00000162200,a17,select
0,48088603000,48088604300,00000001300,a14,writev
0,48088604800,48088605000,00000000200,a2f,recvmsg
0,48088618500,48088619500,00000001000,a14,writev
0,48088619800,48088620000,00000000200,a2f,recvmsg
0,48088631700,48088632500,00000000800,a14,writev
0,48088632800,48088633000,00000000200,a2f,recvmsg
0,48088583300,48088636900,00000053600,a07,poll
0,48088637500,48088638500,00000001000,a2f,recvmsg
0,48088643100,48088643900,00000000800,a2d,recvfrom
0,48088644800,48088645000,00000000200,a2f,recvmsg
0,48088645600,48088645800,00000000200,a2f,recvmsg
0,48088686200,48088686500,00000000300,a2f,recvmsg
0,48088688700,48088688800,00000000100,a2f,recvmsg
0,48088690900,48088692700,00000001800,a07,poll
0,48088693300,48088694400,00000001100,a2f,recvmsg
0,48088699200,48088699900,00000000700,a2d,recvfrom
0,48088700700,48088700900,00000000200,a2f,recvmsg
0,48088701500,48088701700,00000000200,a2f,recvmsg
0,48088729900,48088730200,00000000300,a2f,recvmsg
0,48088732000,48088732200,00000000200,a2f,recvmsg
0,48088735100,48088737200,00000002100,a07,poll
0,48088737900,48088738800,00000000900,a2f,recvmsg
0,48088744100,48088744800,00000000700,a2d,recvfrom
0,48088745700,48088745900,00000000200,a2f,recvmsg
0,48088746600,48088746800,00000000200,a2f,recvmsg
0,48088775100,48088775400,00000000300,a2f,recvmsg
0,48088777100,48088777300,00000000200,a2f,recvmsg
0,48088787900,48088788100,00000000200,a2f,recvmsg
0,48088788700,48088788900,00000000200,a2f,recvmsg
0,48088633500,48088822100,00000188600,a17,select
0,48088832300,48088834700,00000002400,a14,writev
0,48088836700,48088836900,00000000200,a2f,recvmsg
0,48088845100,48088845200,00000000100,a2f,recvmsg
0,48088845800,48088846000,00000000200,a2f,recvmsg
0,48089273400,48089277800,00000004400,a09,mmap
0,48088843200,48089420700,00000577500,a07,poll
0,48089424300,48089426000,00000001700,aca,futex
0,48089428900,48089429700,00000000800,aca,futex
0,48089458800,48089460100,00000001300,aca,futex
0,48089465500,48089471000,00000005500,a2e,sendmsg
0,47979019100,48089474300,00110455200,ae8,epoll_wait
0,48089486900,48089488800,00000001900,a2f,recvmsg
0,48089502600,48089502900,00000000300,a2f,recvmsg
0,48089560900,48089564800,00000003900,a2e,sendmsg
0,48088843200,48089574800,00000731600,a07,poll
0,48089593000,48089594500,00000001500,a2f,recvmsg
0,48089670200,48089672500,00000002300,a07,poll
0,48089670200,48089833600,00000163400,a07,poll
0,48089835500,48089836700,00000001200,aca,futex
0,48089839000,48089840000,00000001000,aca,futex
0,48089841500,48089842300,00000000800,aca,futex
0,48089845700,48089848700,00000003000,a2e,sendmsg
0,48089851500,48089851700,00000000200,a00,read
0,48089570900,48089871600,00000300700,ae8,epoll_wait
0,48089875700,48089877000,00000001300,a2f,recvmsg
0,48089897200,48089897400,00000000200,a2f,recvmsg
0,48089926300,48089927700,00000001400,a2e,sendmsg
0,48089948600,48089949500,00000000900,a2f,recvmsg
0,48090098100,48090175700,00000077600,a07,poll
0,48090177300,48090178500,00000001200,aca,futex
0,48090180600,48090181500,00000000900,aca,futex
0,48090184100,48090185000,00000000900,aca,futex
0,48090187600,48090190400,00000002800,a2e,sendmsg
0,48089930800,48090192000,00000261200,ae8,epoll_wait
0,48090195500,48090196600,00000001100,a2f,recvmsg
0,48090204900,48090205100,00000000200,a2f,recvmsg
0,48090238900,48090240900,00000002000,a2e,sendmsg
0,48090098100,48090246900,00000148800,a07,poll
0,48090255400,48090256100,00000000700,a2f,recvmsg
0,48090308300,48090309900,00000001600,a07,poll
0,48090308300,48090440400,00000132100,a07,poll
0,48090442000,48090443000,00000001000,aca,futex
0,48090445100,48090446000,00000000900,aca,futex
0,48090447500,48090448200,00000000700,aca,futex
0,48090450800,48090453500,00000002700,a2e,sendmsg
0,48090456000,48090456300,00000000300,a00,read
0,48090245100,48090475500,00000230400,ae8,epoll_wait
0,48090479000,48090480300,00000001300,a2f,recvmsg
0,48090504700,48090505000,00000000300,a2f,recvmsg
0,48090529800,48090531000,00000001200,a2e,sendmsg
0,48090542100,48090542500,00000000400,a00,read
0,48090548500,48090549200,00000000700,a2f,recvmsg
0,48091074000,48091080900,00000006900,a02,open
0,48091094200,48091096700,00000002500,a00,read
0,48091149100,48091149900,00000000800,a00,read
0,48091202800,48091203700,00000000900,a00,read
0,48091254900,48091255600,00000000700,a00,read
0,48091306800,48091307500,00000000700,a00,read
0,48091357800,48091358400,00000000600,a00,read
0,48091406200,48091406900,00000000700,a00,read
0,48091456500,48091457200,00000000700,a00,read
0,48091509400,48091510200,00000000800,a00,read
0,48091561900,48091562700,00000000800,a00,read
0,48091612000,48091612700,00000000700,a00,read
0,48091640300,48091642200,00000001900,a02,open
0,48091645500,48091646500,00000001000,a00,read
0,48091703100,48091704000,00000000900,a00,read
0,48091789200,48091790000,00000000800,a00,read
0,48091863200,48091863800,00000000600,a00,read
0,48091941800,48091942600,00000000800,a00,read
0,48092023000,48092023600,00000000600,a00,read
0,48092101600,48092102400,00000000800,a00,read
0,48092187900,48092188500,00000000600,a00,read
0,48092256100,48092256900,00000000800,a00,read
0,48092314900,48092315600,00000000700,a00,read
0,48088838100,48092408200,00003570100,a17,select
0,48092427400,48092427700,00000000300,a2f,recvmsg
0,48092442900,48092443100,00000000200,a2f,recvmsg
0,48092443700,48092443900,00000000200,a2f,recvmsg
0,48092430800,48092449300,00000018500,a17,select
0,48092453500,48092453700,00000000200,a2f,recvmsg
0,48092459600,48092459800,00000000200,a2f,recvmsg
0,48092460200,48092460300,00000000100,a2f,recvmsg
0,48092465900,48092471700,00000005800,a06,lstat
0,48092472500,48092473600,00000001100,a06,lstat
0,48092495900,48092509300,00000013400,a01,write
0,48092454500,48092518000,00000063500,a17,select
0,48092523800,48092524000,00000000200,a2f,recvmsg
0,48092531700,48092531900,00000000200,a2f,recvmsg
0,48092532400,48092532500,00000000100,a2f,recvmsg
0,48092533900,48092850000,00000316100,a38,clone
0,48098049600,48098049800,00000000200,a0c,brk
0,48098060000,48098063100,00000003100,a15,access
0,48098063800,48098064800,00000001000,a09,mmap
0,48098068700,48098069600,00000000900,a15,access
0,48098075600,48098076600,00000001000,a09,mmap
0,48098080400,48098080900,00000000500,a15,access
0,48098087800,48098089000,00000001200,a00,read
0,48098090600,48098092100,00000001500,a09,mmap
0,48098096300,48098098500,00000002200,a09,mmap
0,48098110300,48098110900,00000000600,a15,access
0,48098114200,48098114700,00000000500,a00,read
0,48098115600,48098116500,00000000900,a09,mmap
0,48098118400,48098119700,00000001300,a09,mmap
0,48098127700,48098128200,00000000500,a15,access
0,48098131000,48098131600,00000000600,a00,read
0,48098132200,48098133200,00000001000,a09,mmap
0,48098134700,48098136800,00000002100,a09,mmap
0,48098141200,48098144300,00000003100,a09,mmap
0,48098146800,48098148000,00000001200,a09,mmap
0,48098157500,48098158200,00000000700,a15,access
0,48098160700,48098161300,00000000600,a00,read
0,48098162000,48098163700,00000001700,a09,mmap
0,48098166100,48098167900,00000001800,a09,mmap
0,48098176200,48098176800,00000000600,a15,access
0,48098180000,48098180600,00000000600,a00,read
0,48098181200,48098182700,00000001500,a09,mmap
0,48098186000,48098188300,00000002300,a09,mmap
0,48098196500,48098197100,00000000600,a15,access
0,48098199600,48098200100,00000000500,a00,read
0,48098206900,48098208100,00000001200,a09,mmap
0,48098214700,48098215300,00000000600,a15,access
0,48098217500,48098218000,00000000500,a00,read
0,48098218700,48098220000,00000001300,a09,mmap
0,48098221700,48098223300,00000001600,a09,mmap
0,48098237200,48098237800,00000000600,a09,mmap
0,48098241600,48098241900,00000000300,a09,mmap
0,48098243200,48098243500,00000000300,a09,mmap
0,48098422600,48098422700,00000000100,a0c,brk
0,48098422800,48098423800,00000001000,a0c,brk
0,48098458500,48098464700,00000006200,a00,read
0,48098476700,48098478200,00000001500,a00,read
0,48098514300,48098515300,00000001000,a00,read
0,48098638100,48098638900,00000000800,a00,read
0,48098709300,48098709800,00000000500,a00,read
0,48098796700,48098797400,00000000700,a00,read
0,48098927700,48098928500,00000000800,a00,read
0,48099056900,48099057500,00000000600,a00,read
0,48099213900,48099214700,00000000800,a00,read
0,48099364100,48099364800,00000000700,a00,read
0,48099401300,48099402800,00000001500,a0c,brk
0,48099517900,48099518600,00000000700,a00,read
0,48099666400,48099667000,00000000600,a00,read
0,48099820900,48099821700,00000000800,a00,read
0,48099981600,48099982300,00000000700,a00,read
0,48100090600,48100091500,00000000900,a00,read
0,48100122100,48100122900,00000000800,a0c,brk
0,48100230500,48100231300,00000000800,a00,read
0,48100470300,48100470800,00000000500,a00,read
0,48100483200,48100483700,00000000500,a00,read
0,48100527100,48100527500,00000000400,a00,read
0,48100546700,48100547500,00000000800,a00,read
0,48100754100,48100754600,00000000500,a00,read
0,48100783900,48100784600,00000000700,a00,read
0,48100881600,48100882400,00000000800,a00,read
0,48100906200,48100907600,00000001400,a0c,brk
0,48100952600,48100952900,00000000300,a00,read
0,48101029400,48101030200,00000000800,a00,read
0,48101182500,48101183000,00000000500,a00,read
0,48101295900,48101296600,00000000700,a00,read
0,48101390500,48101391000,00000000500,a00,read
0,48101402900,48101403400,00000000500,a00,read
0,48101483900,48101484400,00000000500,a00,read
0,48101508500,48101508900,00000000400,a00,read
0,48101531800,48101532400,00000000600,a00,read
0,48101633400,48101634400,00000001000,a0c,brk
0,48101636100,48101637000,00000000900,a00,read
0,48101861700,48101862400,00000000700,a00,read
0,48101946700,48101947600,00000000900,a00,read
0,48102013900,48102014600,00000000700,a00,read
0,48102141900,48102142300,00000000400,a00,read
0,48102174800,48102175300,00000000500,a00,read
0,48102191600,48102192900,00000001300,a02,open
0,48102303400,48102303900,00000000500,a00,read
0,48102374600,48102375000,00000000400,a00,read
0,48102427400,48102428700,00000001300,a0c,brk
0,48102434800,48102435400,00000000600,a00,read
0,48102542500,48102543100,00000000600,a00,read
0,48102693800,48102694700,00000000900,a00,read
0,48102825000,48102825700,00000000700,a00,read
0,48102882900,48102883600,00000000700,a00,read
0,48102939300,48102940000,00000000700,a00,read
0,48103009900,48103010700,00000000800,a00,read
0,48103063300,48103064100,00000000800,a00,read
0,48103152300,48103153300,00000001000,a0c,brk
0,48103185100,48103188500,00000003400,a0c,brk
0,48103203300,48103204400,00000001100,a00,read
0,48103320000,48103320800,00000000800,a00,read
0,48103480000,48103481200,00000001200,a00,read
0,48092529900,48103503100,00010973200,a07,poll
0,48103508700,48103509400,00000000700,a00,read
0,48103626700,48103630300,00000003600,a01,write
0,48103644000,48103644900,00000000900,a2f,recvmsg
0,48103647100,48103647300,00000000200,a00,read
0,48103661400,48103662300,00000000900,aca,futex
0,48103691400,48103749000,00000057600,a07,poll
0,48103754400,48103759100,00000004700,a2e,sendmsg
0,48103761700,48103761900,00000000200,a00,read
0,48103834800,48103836500,00000001700,a00,read
0,48103982700,48103983600,00000000900,a00,read
0,48104101100,48104101800,00000000700,a00,read
0,48104262900,48104263500,00000000600,a00,read
0,48104268900,48104271200,00000002300,a0c,brk
0,48104386400,48104387000,00000000600,a00,read
0,48104505200,48104506000,00000000800,a00,read
0,48104648000,48104648700,00000000700,a00,read
0,48104780900,48104781700,00000000800,a00,read
0,48104874400,48104875100,00000000700,a00,read
0,48104986900,48104987500,00000000600,a00,read
0,48105111000,48105111800,00000000800,a00,read
0,48105222900,48105223700,00000000800,a0c,brk
0,48105246400,48105247100,00000000700,a00,read
0,48105415800,48105416300,00000000500,a00,read
0,48105567200,48105568000,00000000800,a00,read
0,48105677900,48105678600,00000000700,a00,read
0,48105872900,48105874200,00000001300,a00,read
0,48105951500,48105952100,00000000600,a00,read
0,48106033300,48106034000,00000000700,a00,read
0,48106100900,48106102000,00000001100,a0c,brk
0,48106115500,48106116100,00000000600,a00,read
0,48106188400,48106189100,00000000700,a00,read
0,48106290700,48106291500,00000000800,a00,read
0,48106393100,48106393800,00000000700,a00,read
0,48093267900,48093268100,00000000200,a2f,recvmsg
0,48093268700,48093269100,00000000400,a14,writev
0,48093287300,48093289000,00000001700,a14,writev
0,48093289200,48093290800,00000001600,a14,writev
0,48093291300,48093291500,00000000200,a2f,recvmsg
0,48103767900,48093299600,-0010468300,a07,poll
0,48093304300,48093310500,00000006200,a2f,recvmsg
0,48093322200,48093322400,00000000200,a2f,recvmsg
0,48093348800,48093353100,00000004300,a07,poll
0,48093358400,48093364300,00000005900,a2f,recvmsg
0,48093377000,48093377200,00000000200,a2f,recvmsg
0,48093399100,48093403700,00000004600,a07,poll
0,48093409700,48093415400,00000005700,a2f,recvmsg
0,48093427400,48093427600,00000000200,a2f,recvmsg
0,48093292300,48093456700,00000164400,a17,select
0,48093471300,48093472700,00000001400,a14,writev
0,48093473300,48093473400,00000000100,a2f,recvmsg
0,48093487000,48093488100,00000001100,a14,writev
0,48093488500,48093488600,00000000100,a2f,recvmsg
0,48093500500,48093501600,00000001100,a14,writev
0,48093501900,48093502000,00000000100,a2f,recvmsg
0,48093451100,48093506100,00000055000,a07,poll
0,48093506800,48093507700,00000000900,a2f,recvmsg
0,48093512900,48093513700,00000000800,a2d,recvfrom
0,48093514700,48093514900,00000000200,a2f,recvmsg
0,48093515500,48093515700,00000000200,a2f,recvmsg
0,48093555900,48093556200,00000000300,a2f,recvmsg
0,48093558300,48093558500,00000000200,a2f,recvmsg
0,48093560800,48093562700,00000001900,a07,poll
0,48093563100,48093564200,00000001100,a2f,recvmsg
0,48093568900,48093569500,00000000600,a2d,recvfrom
0,48093570300,48093570500,00000000200,a2f,recvmsg
0,48093571200,48093571400,00000000200,a2f,recvmsg
0,48093599900,48093600100,00000000200,a2f,recvmsg
0,48093602000,48093602200,00000000200,a2f,recvmsg
0,48093605300,48093607500,00000002200,a07,poll
0,48093608100,48093609000,00000000900,a2f,recvmsg
0,48093614200,48093614900,00000000700,a2d,recvfrom
0,48093615800,48093615900,00000000100,a2f,recvmsg
0,48093616700,48093616900,00000000200,a2f,recvmsg
0,48093646100,48093646300,00000000200,a2f,recvmsg
0,48093648100,48093648200,00000000100,a2f,recvmsg
0,48093659100,48093659300,00000000200,a2f,recvmsg
0,48093659800,48093660000,00000000200,a2f,recvmsg
0,48093502500,48093692100,00000189600,a17,select
0,48093702300,48093704800,00000002500,a14,writev
0,48093706500,48093706700,00000000200,a2f,recvmsg
0,48093714600,48093714700,00000000100,a2f,recvmsg
0,48093715300,48093715500,00000000200,a2f,recvmsg
0,48094137800,48094142200,00000004400,a09,mmap
0,48094494900,48094499800,00000004900,a02,open
0,48094507900,48094510100,00000002200,a00,read
0,48094562300,48094563200,00000000900,a00,read
0,48094612500,48094613200,00000000700,a00,read
0,48094659000,48094659700,00000000700,a00,read
0,48094706900,48094707600,00000000700,a00,read
0,48094753300,48094754000,00000000700,a00,read
0,48094797900,48094798700,00000000800,a00,read
0,48094843600,48094844300,00000000700,a00,read
0,48094892300,48094892900,00000000600,a00,read
0,48094942500,48094943200,00000000700,a00,read
0,48094990500,48094991200,00000000700,a00,read
0,48095018200,48095020100,00000001900,a02,open
0,48095023300,48095024200,00000000900,a00,read
0,48095079300,48095080200,00000000900,a00,read
0,48095162300,48095163100,00000000800,a00,read
0,48095234700,48095235400,00000000700,a00,read
0,48095329500,48095330200,00000000700,a00,read
0,48095408600,48095409300,00000000700,a00,read
0,48095486300,48095487000,00000000700,a00,read
0,48095569700,48095570400,00000000700,a00,read
0,48095636900,48095637600,00000000700,a00,read
0,48095694800,48095695600,00000000800,a00,read
0,48093707800,48095782200,00002074400,a17,select
0,48095796600,48095796900,00000000300,a2f,recvmsg
0,48095764500,48095807000,00000042500,a07,poll
0,48095820000,48095824500,00000004500,a2e,sendmsg
0,48095834200,48095835100,00000000900,a2e,sendmsg
0,48095844500,48095844600,00000000100,a00,read
0,48095859200,48095859400,00000000200,a2f,recvmsg
0,48095860000,48095860100,00000000100,a2f,recvmsg
0,48095799400,48095867400,00000068000,a17,select
0,48095873100,48095873300,00000000200,a2f,recvmsg
0,48095879900,48095880100,00000000200,a2f,recvmsg
0,48095880500,48095880700,00000000200,a2f,recvmsg
0,48095886700,48095892800,00000006100,a06,lstat
0,48095893600,48095894800,00000001200,a06,lstat
0,48095917800,48095931900,00000014100,a01,write
0,48095874400,48095941300,00000066900,a17,select
0,48095947100,48095947200,00000000100,a2f,recvmsg
0,48095954800,48095954900,00000000100,a2f,recvmsg
0,48095955500,48095955700,00000000200,a2f,recvmsg
0,48095957300,48096301900,00000344600,a38,clone
0,48097079200,48097079400,00000000200,a0c,brk
0,48097089000,48097091900,00000002900,a15,access
0,48097092600,48097093500,00000000900,a09,mmap
0,48097098900,48097099700,00000000800,a15,access
0,48097106100,48097107100,00000001000,a09,mmap
0,48097111300,48097111800,00000000500,a15,access
0,48097118800,48097119900,00000001100,a00,read
0,48097127000,48097129200,00000002200,a09,mmap
0,48097141400,48097142000,00000000600,a15,access
0,48097145400,48097146100,00000000700,a00,read
0,48097146900,48097147800,00000000900,a09,mmap
0,48097149600,48097150900,00000001300,a09,mmap
0,48097157800,48097158400,00000000600,a15,access
0,48097161300,48097161900,00000000600,a00,read
0,48097162600,48097163300,00000000700,a09,mmap
0,48097165900,48097168000,00000002100,a09,mmap
0,48097178600,48097179800,00000001200,a09,mmap
0,48097189500,48097190000,00000000500,a15,access
0,48097192500,48097193100,00000000600,a00,read
0,48097193800,48097195400,00000001600,a09,mmap
0,48097197500,48097199200,00000001700,a09,mmap
0,48097207200,48097207800,00000000600,a15,access
0,48097210700,48097211300,00000000600,a00,read
0,48097212000,48097213500,00000001500,a09,mmap
0,48097216600,48097218900,00000002300,a09,mmap
0,48097227400,48097227900,00000000500,a15,access
0,48097231000,48097231600,00000000600,a00,read
0,48097232100,48097233100,00000001000,a09,mmap
0,48097234400,48097235700,00000001300,a09,mmap
0,48097238300,48097239500,00000001200,a09,mmap
0,48097245700,48097246300,00000000600,a15,access
0,48097248400,48097248800,00000000400,a00,read
0,48097249400,48097250700,00000001300,a09,mmap
0,48097252500,48097254100,00000001600,a09,mmap
0,48097267800,48097268500,00000000700,a09,mmap
0,48097272200,48097272500,00000000300,a09,mmap
0,48097273600,48097273900,00000000300,a09,mmap
0,48097452500,48097452600,00000000100,a0c,brk
0,48097452700,48097453600,00000000900,a0c,brk
0,48097485300,48097486200,00000000900,a00,read
0,48097500400,48097501900,00000001500,a00,read
0,48097540400,48097541300,00000000900,a00,read
0,48097659200,48097659900,00000000700,a00,read
0,48097731300,48097731700,00000000400,a00,read
0,48097817400,48097818000,00000000600,a00,read
0,48097947900,48097948700,00000000800,a00,read
0,48098076200,48098076900,00000000700,a00,read
0,48098231000,48098231600,00000000600,a00,read
0,48098381700,48098382400,00000000700,a00,read
0,48098535200,48098535900,00000000700,a00,read
0,48098683500,48098684200,00000000700,a00,read
0,48098839000,48098839600,00000000600,a00,read
0,48098998500,48098999200,00000000700,a00,read
0,48099107300,48099108000,00000000700,a00,read
0,48099138400,48099139200,00000000800,a0c,brk
0,48099260200,48099261100,00000000900,a00,read
0,48099500900,48099501500,00000000600,a00,read
0,48099513500,48099513800,00000000300,a00,read
0,48099557100,48099557400,00000000300,a00,read
0,48099577000,48099577700,00000000700,a00,read
0,48099783200,48099783500,00000000300,a00,read
0,48099812500,48099813300,00000000800,a00,read
0,48099909800,48099910600,00000000800,a00,read
0,48099934400,48099935600,00000001200,a0c,brk
0,48099980300,48099980700,00000000400,a00,read
0,48100056100,48100056900,00000000800,a00,read
0,48100210900,48100211400,00000000500,a00,read
0,48100322100,48100322600,00000000500,a00,read
0,48100415800,48100416200,00000000400,a00,read
0,48100427800,48100428400,00000000600,a00,read
0,48100510300,48100510700,00000000400,a00,read
0,48100534600,48100535000,00000000400,a00,read
0,48100557700,48100557700,00000000000,a00,read
0,48100659200,48100660300,00000001100,a0c,brk
0,48100661300,48100662600,00000001300,a00,read
0,48100865100,48100865600,00000000500,a00,read
0,48100949200,48100949900,00000000700,a00,read
0,48101012700,48101013400,00000000700,a00,read
0,48101142300,48101142800,00000000500,a00,read
0,48101174700,48101175300,00000000600,a00,read
0,48101192100,48101193400,00000001300,a02,open
0,48101303900,48101304400,00000000500,a00,read
0,48101375000,48101375400,00000000400,a00,read
0,48101427400,48101428500,00000001100,a0c,brk
0,48101434900,48101435600,00000000700,a00,read
0,48101542500,48101543100,00000000600,a00,read
0,48101694200,48101695000,00000000800,a00,read
0,48101825100,48101825900,00000000800,a00,read
0,48101883300,48101884100,00000000800,a00,read
0,48101939800,48101940300,00000000500,a00,read
0,48102010100,48102010700,00000000600,a00,read
0,48102063300,48102063800,00000000500,a00,read
0,48102151500,48102152300,00000000800,a0c,brk
0,48102182600,48102187000,00000004400,a0c,brk
0,48102202100,48102202900,00000000800,a00,read
0,48102317100,48102317900,00000000800,a00,read
0,48102475100,48102475700,00000000600,a00,read
0,48102593000,48102593700,00000000700,a00,read
0,48102738700,48102739400,00000000700,a00,read
0,48102856000,48102856700,00000000700,a00,read
0,48103017700,48103018400,00000000700,a00,read
0,48103023400,48103024200,00000000800,a0c,brk
0,48103138700,48103139300,00000000600,a00,read
0,48103285400,48103286300,00000000900,a00,read
0,48103428500,48103429400,00000000900,a00,read
0,48103560200,48103560800,00000000600,a00,read
0,48103653000,48103653600,00000000600,a00,read
0,48103765100,48103765700,00000000600,a00,read
0,48103888900,48103889500,00000000600,a00,read
0,48104000000,48104000800,00000000800,a0c,brk
0,48104023600,48104024100,00000000500,a00,read
0,48104192500,48104193200,00000000700,a00,read
0,48104345200,48104345800,00000000600,a00,read
0,48104455700,48104456500,00000000800,a00,read
0,48104624400,48104625200,00000000800,a00,read
0,48104702400,48104703000,00000000600,a00,read
0,48104783600,48104784200,00000000600,a00,read
0,48104850700,48104851400,00000000700,a0c,brk
0,48104865000,48104865600,00000000600,a00,read
0,48104937600,48104938300,00000000700,a00,read
0,48105039400,48105040100,00000000700,a00,read
0,48105141900,48105142600,00000000700,a00,read
0,48105231300,48105232000,00000000700,a00,read
0,48105311800,48105312500,00000000700,a00,read
0,48105412800,48105413300,00000000500,a00,read
0,48105493500,48105493900,00000000400,a0c,brk
0,48105496400,48105497000,00000000600,a00,read
0,48105604600,48105605200,00000000600,a00,read
0,48105697200,48105697800,00000000600,a00,read
0,48105815900,48105816600,00000000700,a00,read
0,48105929200,48105929900,00000000700,a00,read
0,48106032300,48106033000,00000000700,a00,read
0,48106132200,48106132700,00000000500,a0c,brk
0,48106493700,48106497400,00000003700,a57,unlink
0,48106521200,48106521800,00000000600,a48,fcntl
0,48106568600,48106583400,00000014800,a01,write
0,48106601000,48106603500,00000002500,a01,write
0,48106619500,48106621700,00000002200,a01,write
0,48096323800,48111263900,00014940100,a3d,wait4
0,48111287900,48111291200,00000003300,a00,read
0,48111293300,48111293600,00000000300,a00,read
0,48095948400,48111324300,00015375900,a17,select
0,48111345200,48111345500,00000000300,a2f,recvmsg
0,48111361000,48111361200,00000000200,a2f,recvmsg
0,48111362000,48111362100,00000000100,a2f,recvmsg
0,48111349000,48111369700,00000020700,a17,select
0,48111373500,48111373700,00000000200,a2f,recvmsg
0,48111379500,48111379700,00000000200,a2f,recvmsg
0,48111380100,48111380300,00000000200,a2f,recvmsg
0,48111374400,48111385600,00000011200,a17,select
0,48111389000,48111389200,00000000200,a2f,recvmsg
0,48111394500,48111394700,00000000200,a2f,recvmsg
0,48111395000,48111395200,00000000200,a2f,recvmsg
0,48111389900,48111400000,00000010100,a17,select
0,48111403700,48111403700,00000000000,a2f,recvmsg
0,48111408900,48111409100,00000000200,a2f,recvmsg
0,48111409400,48111409500,00000000100,a2f,recvmsg
0,48111404300,48111414300,00000010000,a17,select
0,48111418200,48111418300,00000000100,a2f,recvmsg
0,48111423400,48111423600,00000000200,a2f,recvmsg
0,48111423900,48111424100,00000000200,a2f,recvmsg
0,48111418900,48111429100,00000010200,a17,select
0,48111432200,48111432400,00000000200,a2f,recvmsg
0,48111437600,48111437800,00000000200,a2f,recvmsg
0,48111438000,48111438200,00000000200,a2f,recvmsg
0,48111439000,48111439200,00000000200,a08,lseek
0,48111449400,48111449500,00000000100,a08,lseek
0,48111433000,48111453900,00000020900,a17,select
0,48111457300,48111457500,00000000200,a2f,recvmsg
0,48111464500,48111464500,00000000000,a2f,recvmsg
0,48111465100,48111465300,00000000200,a2f,recvmsg
0,48111458100,48111472200,00000014100,a17,select
0,48111475500,48111475700,00000000200,a2f,recvmsg
0,48111480900,48111481100,00000000200,a2f,recvmsg
0,48111481500,48111481600,00000000100,a2f,recvmsg
0,48111476200,48111486400,00000010200,a17,select
0,48111489300,48111489500,00000000200,a2f,recvmsg
0,48111494700,48111494900,00000000200,a2f,recvmsg
0,48111495200,48111495400,00000000200,a2f,recvmsg
0,48111490100,48111500600,00000010500,a17,select
0,48111503700,48111503800,00000000100,a2f,recvmsg
0,48111510100,48111510200,00000000100,a2f,recvmsg
0,48111510500,48111510700,00000000200,a2f,recvmsg
0,48111504400,48111515900,00000011500,a17,select
0,48111519300,48111519500,00000000200,a2f,recvmsg
0,48111525600,48111525700,00000000100,a2f,recvmsg
0,48111526100,48111526300,00000000200,a2f,recvmsg
0,48111519900,48111531900,00000012000,a17,select
0,48111534900,48111535100,00000000200,a2f,recvmsg
0,48111541300,48111541500,00000000200,a2f,recvmsg
0,48111541800,48111542000,00000000200,a2f,recvmsg
0,48111535600,48111547300,00000011700,a17,select
0,48111550600,48111550800,00000000200,a2f,recvmsg
0,48111556100,48111556300,00000000200,a2f,recvmsg
0,48111556700,48111556800,00000000100,a2f,recvmsg
0,48111551400,48111562400,00000011000,a17,select
0,48111565400,48111565500,00000000100,a2f,recvmsg
0,48111570800,48111570900,00000000100,a2f,recvmsg
0,48111571200,48111571400,00000000200,a2f,recvmsg
0,48111566100,48111577600,00000011500,a17,select
0,48111580900,48111581100,00000000200,a2f,recvmsg
0,48111586500,48111586600,00000000100,a2f,recvmsg
0,48111587000,48111587200,00000000200,a2f,recvmsg
0,48111581700,48111592300,00000010600,a17,select
0,48111595600,48111595700,00000000100,a2f,recvmsg
0,48111601200,48111601300,00000000100,a2f,recvmsg
0,48111601600,48111601800,00000000200,a2f,recvmsg
0,48111596300,48111606900,00000010600,a17,select
0,48111610100,48111610200,00000000100,a2f,recvmsg
0,48111615500,48111615700,00000000200,a2f,recvmsg
0,48111616100,48111616300,00000000200,a2f,recvmsg
0,48111610800,48111621300,00000010500,a17,select
0,48111624500,48111624700,00000000200,a2f,recvmsg
0,48111630900,48111631100,00000000200,a2f,recvmsg
0,48111631400,48111631600,00000000200,a2f,recvmsg
0,48111625200,48111636800,00000011600,a17,select
0,48111640000,48111640100,00000000100,a2f,recvmsg
0,48111645500,48111645700,00000000200,a2f,recvmsg
0,48111646000,48111646200,00000000200,a2f,recvmsg
0,48111640700,48111651400,00000010700,a17,select
0,48111654500,48111654600,00000000100,a2f,recvmsg
0,48111660000,48111660200,00000000200,a2f,recvmsg
0,48111660400,48111660600,00000000200,a2f,recvmsg
0,48111655200,48111665500,00000010300,a17,select
0,48111668500,48111668700,00000000200,a2f,recvmsg
0,48111674800,48111675000,00000000200,a2f,recvmsg
0,48111675300,48111675400,00000000100,a2f,recvmsg
0,48111669200,48111680100,00000010900,a17,select
0,48111683300,48111683500,00000000200,a2f,recvmsg
0,48111688700,48111688800,00000000100,a2f,recvmsg
0,48111689200,48111689400,00000000200,a2f,recvmsg
0,48111684100,48111696200,00000012100,a17,select
0,48111699400,48111699600,00000000200,a2f,recvmsg
0,48111704700,48111704900,00000000200,a2f,recvmsg
0,48111705200,48111705400,00000000200,a2f,recvmsg
0,48111700100,48111709700,00000009600,a17,select
0,48111712900,48111713000,00000000100,a2f,recvmsg
0,48111718300,48111718400,00000000100,a2f,recvmsg
0,48111718800,48111719000,00000000200,a2f,recvmsg
0,48111713500,48111723300,00000009800,a17,select
0,48111726400,48111726600,00000000200,a2f,recvmsg
0,48111731600,48111731800,00000000200,a2f,recvmsg
0,48111732200,48111732300,00000000100,a2f,recvmsg
0,48111727000,48111736700,00000009700,a17,select
0,48111739700,48111739800,00000000100,a2f,recvmsg
0,48111744900,48111745100,00000000200,a2f,recvmsg
0,48111745500,48111745700,00000000200,a2f,recvmsg
0,48111740300,48111750300,00000010000,a17,select
0,48111753300,48111753500,00000000200,a2f,recvmsg
0,48111758800,48111759000,00000000200,a2f,recvmsg
0,48111759200,48111759400,00000000200,a2f,recvmsg
0,48111754100,48111764200,00000010100,a17,select
0,48111767100,48111767300,00000000200,a2f,recvmsg
0,48111772500,48111772600,00000000100,a2f,recvmsg
0,48111773000,48111773200,00000000200,a2f,recvmsg
0,48111767900,48111778400,00000010500,a17,select
0,48111781600,48111781800,00000000200,a2f,recvmsg
0,48111786900,48111787100,00000000200,a2f,recvmsg
0,48111787500,48111787500,00000000000,a2f,recvmsg
0,48111782200,48111792900,00000010700,a17,select
0,48111796100,48111796200,00000000100,a2f,recvmsg
0,48111801400,48111801600,00000000200,a2f,recvmsg
0,48111802000,48111802100,00000000100,a2f,recvmsg
0,48111796800,48111807900,00000011100,a17,select
0,48111811200,48111811400,00000000200,a2f,recvmsg
0,48111816500,48111816700,00000000200,a2f,recvmsg
0,48111817100,48111817300,00000000200,a2f,recvmsg
0,48111812000,48111823900,00000011900,a17,select
0,48111827100,48111827300,00000000200,a2f,recvmsg
0,48111832300,48111832500,00000000200,a2f,recvmsg
0,48111832900,48111833100,00000000200,a2f,recvmsg
0,48111827700,48111838400,00000010700,a17,select
0,48111841700,48111841900,00000000200,a2f,recvmsg
0,48111847100,48111847200,00000000100,a2f,recvmsg
0,48111847600,48111847800,00000000200,a2f,recvmsg
0,48111842400,48111855100,00000012700,a17,select
0,48111858300,48111858500,00000000200,a2f,recvmsg
0,48111863700,48111863900,00000000200,a2f,recvmsg
0,48111864300,48111864400,00000000100,a2f,recvmsg
0,48111859100,48111869200,00000010100,a17,select
0,48111872300,48111872500,00000000200,a2f,recvmsg
0,48111877500,48111877700,00000000200,a2f,recvmsg
0,48111878100,48111878300,00000000200,a2f,recvmsg
0,48111873000,48111883100,00000010100,a17,select
0,48111886300,48111886500,00000000200,a2f,recvmsg
0,48111891800,48111891900,00000000100,a2f,recvmsg
0,48111892200,48111892400,00000000200,a2f,recvmsg
0,48111887100,48111898200,00000011100,a17,select
0,48111901500,48111901600,00000000100,a2f,recvmsg
0,48111907000,48111907200,00000000200,a2f,recvmsg
0,48111907500,48111907700,00000000200,a2f,recvmsg
0,48111902200,48111913100,00000010900,a17,select
0,48111916400,48111916600,00000000200,a2f,recvmsg
0,48111921800,48111922000,00000000200,a2f,recvmsg
0,48111922400,48111922500,00000000100,a2f,recvmsg
0,48111917100,48111928200,00000011100,a17,select
0,48111931600,48111931800,00000000200,a2f,recvmsg
0,48111937000,48111937200,00000000200,a2f,recvmsg
0,48111937600,48111937600,00000000000,a2f,recvmsg
0,48111932300,48111942800,00000010500,a17,select
0,48111945900,48111946100,00000000200,a2f,recvmsg
0,48111951200,48111951400,00000000200,a2f,recvmsg
0,48111951800,48111951900,00000000100,a2f,recvmsg
0,48111946600,48111956900,00000010300,a17,select
0,48111960100,48111960200,00000000100,a2f,recvmsg
0,48111965500,48111965700,00000000200,a2f,recvmsg
0,48111966000,48111966100,00000000100,a2f,recvmsg
0,48111960700,48111970800,00000010100,a17,select
0,48111973800,48111973900,00000000100,a2f,recvmsg
0,48111979100,48111979300,00000000200,a2f,recvmsg
0,48111979600,48111979700,00000000100,a2f,recvmsg
0,48111974500,48111985000,00000010500,a17,select
0,48111988100,48111988300,00000000200,a2f,recvmsg
0,48111993500,48111993700,00000000200,a2f,recvmsg
0,48111994000,48111994200,00000000200,a2f,recvmsg
0,48111995500,48111995600,00000000100,a08,lseek
0,48111998400,48111999500,00000001100,a00,read
0,48112003100,48112003200,00000000100,a08,lseek
0,48111988800,48112007900,00000019100,a17,select
0,48112011400,48112011600,00000000200,a2f,recvmsg
0,48112017200,48112017400,00000000200,a2f,recvmsg
0,48112017600,48112017800,00000000200,a2f,recvmsg
0,48112012100,48112045700,00000033600,a17,select
0,48112049100,48112049300,00000000200,a2f,recvmsg
0,48112054900,48112055000,00000000100,a2f,recvmsg
0,48112055400,48112055500,00000000100,a2f,recvmsg
0,48112059400,48112060400,00000001000,a00,read
0,48112065900,48112066000,00000000100,a08,lseek
0,48112049800,48112071100,00000021300,a17,select
0,48112074500,48112074700,00000000200,a2f,recvmsg
0,48112080100,48112080300,00000000200,a2f,recvmsg
0,48112080600,48112080800,00000000200,a2f,recvmsg
0,48112075300,48112085400,00000010100,a17,select
0,48112088400,48112088600,00000000200,a2f,recvmsg
0,48112093600,48112093800,00000000200,a2f,recvmsg
0,48112094200,48112094400,00000000200,a2f,recvmsg
0,48112089100,48112098700,00000009600,a17,select
0,48112101600,48112101800,00000000200,a2f,recvmsg
0,48112106900,48112107000,00000000100,a2f,recvmsg
0,48112107400,48112107600,00000000200,a2f,recvmsg
0,48112102300,48112112000,00000009700,a17,select
0,48112114800,48112115000,00000000200,a2f,recvmsg
0,48112120000,48112120200,00000000200,a2f,recvmsg
0,48112120500,48112120700,00000000200,a2f,recvmsg
0,48112115600,48112125100,00000009500,a17,select
0,48112128100,48112128200,00000000100,a2f,recvmsg
0,48112133300,48112133400,00000000100,a2f,recvmsg
0,48112133800,48112134000,00000000200,a2f,recvmsg
0,48112128800,48112138500,00000009700,a17,select
0,48112141400,48112141600,00000000200,a2f,recvmsg
0,48112146700,48112146800,00000000100,a2f,recvmsg
0,48112147200,48112147400,00000000200,a2f,recvmsg
0,48112142100,48112151800,00000009700,a17,select
0,48112154600,48112154800,00000000200,a2f,recvmsg
0,48112159900,48112160100,00000000200,a2f,recvmsg
0,48112160400,48112160600,00000000200,a2f,recvmsg
0,48112155400,48112165700,00000010300,a17,select
0,48112168800,48112168900,00000000100,a2f,recvmsg
0,48112174000,48112174100,00000000100,a2f,recvmsg
0,48112174500,48112174700,00000000200,a2f,recvmsg
0,48112169400,48112179100,00000009700,a17,select
0,48112182100,48112182300,00000000200,a2f,recvmsg
0,48112187300,48112187500,00000000200,a2f,recvmsg
0,48112187900,48112188100,00000000200,a2f,recvmsg
0,48112188600,48112188700,00000000100,a08,lseek
0,48112182800,48112194600,00000011800,a17,select
0,48112197700,48112197900,00000000200,a2f,recvmsg
0,48112203300,48112203500,00000000200,a2f,recvmsg
0,48112203700,48112203900,00000000200,a2f,recvmsg
0,48112198300,48112210800,00000012500,a17,select
0,48112213900,48112214100,00000000200,a2f,recvmsg
0,48112219300,48112219500,00000000200,a2f,recvmsg
0,48112219900,48112220000,00000000100,a2f,recvmsg
0,48112214600,48112225000,00000010400,a17,select
0,48112228000,48112228200,00000000200,a2f,recvmsg
0,48112233300,48112233400,00000000100,a2f,recvmsg
0,48112233800,48112234000,00000000200,a2f,recvmsg
0,48112228600,48112238800,00000010200,a17,select
0,48112241700,48112241900,00000000200,a2f,recvmsg
0,48112247100,48112247300,00000000200,a2f,recvmsg
0,48112247600,48112247800,00000000200,a2f,recvmsg
0,48112242500,48112252400,00000009900,a17,select
0,48112255300,48112255500,00000000200,a2f,recvmsg
0,48112260600,48112260800,00000000200,a2f,recvmsg
0,48112261200,48112261400,00000000200,a2f,recvmsg
0,48112256000,48112266000,00000010000,a17,select
0,48112269100,48112269200,00000000100,a2f,recvmsg
0,48112274300,48112274500,00000000200,a2f,recvmsg
0,48112274900,48112275000,00000000100,a2f,recvmsg
0,48112269800,48112280100,00000010300,a17,select
0,48112283100,48112283300,00000000200,a2f,recvmsg
0,48112288400,48112288600,00000000200,a2f,recvmsg
0,48112288900,48112289100,00000000200,a2f,recvmsg
0,48112283800,48112293700,00000009900,a17,select
0,48112296700,48112296900,00000000200,a2f,recvmsg
0,48112302100,48112302300,00000000200,a2f,recvmsg
0,48112302600,48112302700,00000000100,a2f,recvmsg
0,48112297400,48112307400,00000010000,a17,select
0,48112310300,48112310500,00000000200,a2f,recvmsg
0,48112315700,48112315900,00000000200,a2f,recvmsg
0,48112316300,48112316500,00000000200,a2f,recvmsg
0,48112311000,48112321200,00000010200,a17,select
0,48112324100,48112324300,00000000200,a2f,recvmsg
0,48112329500,48112329700,00000000200,a2f,recvmsg
0,48112330100,48112330200,00000000100,a2f,recvmsg
0,48112324900,48112334800,00000009900,a17,select
0,48112337900,48112338100,00000000200,a2f,recvmsg
0,48112343400,48112343600,00000000200,a2f,recvmsg
0,48112343900,48112344100,00000000200,a2f,recvmsg
0,48112338600,48112349000,00000010400,a17,select
0,48112351900,48112352100,00000000200,a2f,recvmsg
0,48112357300,48112357500,00000000200,a2f,recvmsg
0,48112357800,48112358000,00000000200,a2f,recvmsg
0,48112352600,48112363200,00000010600,a17,select
0,48112366100,48112366300,00000000200,a2f,recvmsg
0,48112371700,48112371900,00000000200,a2f,recvmsg
0,48112372300,48112372500,00000000200,a2f,recvmsg
0,48112366800,48112377100,00000010300,a17,select
0,48112380200,48112380300,00000000100,a2f,recvmsg
0,48112385500,48112385700,00000000200,a2f,recvmsg
0,48112386000,48112386200,00000000200,a2f,recvmsg
0,48112380800,48112390900,00000010100,a17,select
0,48112393800,48112394000,00000000200,a2f,recvmsg
0,48112399100,48112399300,00000000200,a2f,recvmsg
0,48112399600,48112399800,00000000200,a2f,recvmsg
0,48112394500,48112404400,00000009900,a17,select
0,48112407300,48112407500,00000000200,a2f,recvmsg
0,48112412600,48112412800,00000000200,a2f,recvmsg
0,48112413200,48112413400,00000000200,a2f,recvmsg
0,48112408100,48112423700,00000015600,a17,select
0,48112426800,48112427000,00000000200,a2f,recvmsg
0,48112432400,48112432600,00000000200,a2f,recvmsg
0,48112433000,48112433100,00000000100,a2f,recvmsg
0,48112427600,48112438000,00000010400,a17,select
0,48112441100,48112441100,00000000000,a2f,recvmsg
0,48112446300,48112446500,00000000200,a2f,recvmsg
0,48112446800,48112446900,00000000100,a2f,recvmsg
0,48112441700,48112451600,00000009900,a17,select
0,48112454500,48112454700,00000000200,a2f,recvmsg
0,48112459900,48112460100,00000000200,a2f,recvmsg
0,48112460400,48112460600,00000000200,a2f,recvmsg
0,48112455300,48112465500,00000010200,a17,select
0,48112468500,48112468600,00000000100,a2f,recvmsg
0,48112473700,48112473900,00000000200,a2f,recvmsg
0,48112474300,48112474500,00000000200,a2f,recvmsg
0,48112469200,48112479400,00000010200,a17,select
0,48112482400,48112482600,00000000200,a2f,recvmsg
0,48112487800,48112488000,00000000200,a2f,recvmsg
0,48112488400,48112488600,00000000200,a2f,recvmsg
0,48112532600,48112536500,00000003900,a14,writev
0,48112483100,48112540300,00000057200,a17,select
0,48112542800,48112544100,00000001300,a2f,recvmsg
0,48112629600,48112633000,00000003400,a14,writev
0,48112633300,48112636400,00000003100,a14,writev
0,48112648300,48112648700,00000000400,a14,writev
0,48112713500,48112715300,00000001800,a14,writev
0,48112715600,48112717300,00000001700,a14,writev
0,48112772600,48112774300,00000001700,a14,writev
0,48112774500,48112776000,00000001500,a14,writev
0,48112829600,48112831300,00000001700,a14,writev
0,48112831500,48112832900,00000001400,a14,writev
0,48112885800,48112887600,00000001800,a14,writev
0,48112887800,48112889500,00000001700,a14,writev
0,48112943200,48112945000,00000001800,a14,writev
0,48112945200,48112946600,00000001400,a14,writev
0,48112951000,48112951700,00000000700,a2f,recvmsg
0,48112998700,48113000400,00000001700,a14,writev
0,48113042300,48113043800,00000001500,a14,writev
0,48113086500,48113088000,00000001500,a14,writev
0,48113129800,48113131100,00000001300,a14,writev
0,48113173300,48113174800,00000001500,a14,writev
0,48113216300,48113218100,00000001800,a14,writev
0,48113244200,48113246100,00000001900,a2f,recvmsg
0,48113270500,48113272500,00000002000,a14,writev
0,48113290000,48113291900,00000001900,a14,writev
0,48113308000,48113309700,00000001700,a14,writev
0,48113323900,48113325600,00000001700,a14,writev
0,48113340000,48113341700,00000001700,a14,writev
0,48113354400,48113355900,00000001500,a14,writev
0,48113361600,48113361900,00000000300,a2f,recvmsg
0,48113379300,48113381000,00000001700,a14,writev
0,48113381300,48113382900,00000001600,a14,writev
0,48113383400,48113383500,00000000100,a2f,recvmsg
0,48112532200,48113391200,00000859000,a07,poll
0,48113396000,48113402300,00000006300,a2f,recvmsg
0,48113414000,48113414200,00000000200,a2f,recvmsg
0,48113441000,48113445700,00000004700,a07,poll
0,48113451500,48113457600,00000006100,a2f,recvmsg
0,48113469700,48113469900,00000000200,a2f,recvmsg
0,48113492100,48113496600,00000004500,a07,poll
0,48113502600,48113508400,00000005800,a2f,recvmsg
0,48113521100,48113521300,00000000200,a2f,recvmsg
0,48113384300,48113550200,00000165900,a17,select
0,48113565000,48113566200,00000001200,a14,writev
0,48113566700,48113566900,00000000200,a2f,recvmsg
0,48113580600,48113581500,00000000900,a14,writev
0,48113581800,48113582000,00000000200,a2f,recvmsg
0,48113593700,48113594600,00000000900,a14,writev
0,48113594800,48113595000,00000000200,a2f,recvmsg
0,48113544800,48113599200,00000054400,a07,poll
0,48113599900,48113600900,00000001000,a2f,recvmsg
0,48113605500,48113606300,00000000800,a2d,recvfrom
0,48113607400,48113607600,00000000200,a2f,recvmsg
0,48113608100,48113608300,00000000200,a2f,recvmsg
0,48113648900,48113649200,00000000300,a2f,recvmsg
0,48113651300,48113651400,00000000100,a2f,recvmsg
0,48113653500,48113655500,00000002000,a07,poll
0,48113656000,48113657100,00000001100,a2f,recvmsg
0,48113662200,48113662800,00000000600,a2d,recvfrom
0,48113663600,48113663800,00000000200,a2f,recvmsg
0,48113664500,48113664700,00000000200,a2f,recvmsg
0,48113693100,48113693300,00000000200,a2f,recvmsg
0,48113695500,48113695700,00000000200,a2f,recvmsg
0,48113698800,48113700800,00000002000,a07,poll
0,48113701400,48113702600,00000001200,a2f,recvmsg
0,48113707800,48113708400,00000000600,a2d,recvfrom
0,48113709300,48113709500,00000000200,a2f,recvmsg
0,48113710200,48113710300,00000000100,a2f,recvmsg
0,48113739200,48113739400,00000000200,a2f,recvmsg
0,48113741100,48113741300,00000000200,a2f,recvmsg
0,48113752100,48113752300,00000000200,a2f,recvmsg
0,48113752900,48113753100,00000000200,a2f,recvmsg
0,48113595600,48113785600,00000190000,a17,select
0,48113795800,48113797700,00000001900,a14,writev
0,48113799600,48113799700,00000000100,a2f,recvmsg
0,48113807700,48113807800,00000000100,a2f,recvmsg
0,48113808400,48113808600,00000000200,a2f,recvmsg
0,48114340600,48114348000,00000007400,a02,open
0,48114358300,48114360800,00000002500,a00,read
0,48114412800,48114413600,00000000800,a00,read
0,48114462700,48114463500,00000000800,a00,read
0,48114509100,48114509800,00000000700,a00,read
0,48114556300,48114557100,00000000800,a00,read
0,48114602400,48114603200,00000000800,a00,read
0,48114646700,48114647300,00000000600,a00,read
0,48114692100,48114692600,00000000500,a00,read
0,48114740500,48114741300,00000000800,a00,read
0,48114790300,48114791100,00000000800,a00,read
0,48114838400,48114838900,00000000500,a00,read
0,48114867300,48114869100,00000001800,a02,open
0,48114872300,48114873200,00000000900,a00,read
0,48114928400,48114929300,00000000900,a00,read
0,48115012100,48115013100,00000001000,a00,read
0,48115084600,48115085400,00000000800,a00,read
0,48115161400,48115162100,00000000700,a00,read
0,48115250500,48115251300,00000000800,a00,read
0,48115328100,48115328800,00000000700,a00,read
0,48115412200,48115412900,00000000700,a00,read
0,48115479100,48115479800,00000000700,a00,read
0,48115536900,48115537600,00000000700,a00,read
0,48113801000,48115620100,00001819100,a17,select
0,48115631200,48115631400,00000000200,a2f,recvmsg
0,48115643700,48115643900,00000000200,a2f,recvmsg
0,48115644500,48115644600,00000000100,a2f,recvmsg
0,48115633500,48115650000,00000016500,a17,select
0,48115654000,48115654200,00000000200,a2f,recvmsg
0,48115659900,48115660100,00000000200,a2f,recvmsg
0,48115660500,48115660700,00000000200,a2f,recvmsg
0,48115666000,48115671600,00000005600,a06,lstat
0,48115672500,48115673500,00000001000,a06,lstat
0,48115691900,48115704100,00000012200,a01,write
0,48115654900,48115712700,00000057800,a17,select
0,48115718200,48115718400,00000000200,a2f,recvmsg
0,48115726000,48115726200,00000000200,a2f,recvmsg
0,48115726600,48115726800,00000000200,a2f,recvmsg
0,48115728200,48116042100,00000313900,a38,clone
0,48115724200,48118164900,00002440700,a07,poll
0,48118189200,48118716600,00000527400,60e,page_fault
0,48118831300,48119379900,00000548600,60e,page_fault
0,48119505300,48119511300,00000006000,a01,write
0,48119521000,48119525600,00000004600,a2f,recvmsg
0,48119538700,48119542500,00000003800,a2f,recvmsg
0,48119544700,48119544900,00000000200,a00,read
0,48119547300,48119552300,00000005000,60e,page_fault
0,48119553800,48119557000,00000003200,60e,page_fault
0,48119558200,48119568100,00000009900,aca,futex
0,48119575700,48119578500,00000002800,60e,page_fault
0,48119579000,48119581200,00000002200,60e,page_fault
0,48119582300,48119584600,00000002300,60e,page_fault
0,48119585000,48119587900,00000002900,60e,page_fault
0,48119589000,48119592100,00000003100,60e,page_fault
0,48119593700,48119596900,00000003200,60e,page_fault
0,48119598300,48119601100,00000002800,60e,page_fault
0,48119601700,48119604700,00000003000,60e,page_fault
0,48119605700,48119608500,00000002800,60e,page_fault
0,48119636700,48119639500,00000002800,60e,page_fault
0,48119650600,48119674800,00000024200,a07,poll
0,48119681900,48119689600,00000007700,a2e,sendmsg
0,48119691700,48119695100,00000003400,60e,page_fault
0,48119695400,48119698500,00000003100,60e,page_fault
0,48119698900,48119703000,00000004100,60e,page_fault
0,48119705500,48119705700,00000000200,a00,read
0,48120154100,48120154200,00000000100,a0c,brk
0,48120165300,48120169200,00000003900,a15,access
0,48120170000,48120170800,00000000800,a09,mmap
0,48120175900,48120177900,00000002000,a15,access
0,48120185300,48120186300,00000001000,a09,mmap
0,48120190100,48120190600,00000000500,a15,access
0,48120198600,48120199700,00000001100,a00,read
0,48120201300,48120202800,00000001500,a09,mmap
0,48120207000,48120209100,00000002100,a09,mmap
0,48120221200,48120221800,00000000600,a15,access
0,48120225400,48120226000,00000000600,a00,read
0,48120226700,48120227600,00000000900,a09,mmap
0,48120230400,48120231600,00000001200,a09,mmap
0,48120240100,48120240600,00000000500,a15,access
0,48120243500,48120244200,00000000700,a00,read
0,48120244800,48120245700,00000000900,a09,mmap
0,48120247300,48120249500,00000002200,a09,mmap
0,48120254400,48120257700,00000003300,a09,mmap
0,48120260100,48120261200,00000001100,a09,mmap
0,48120271000,48120271500,00000000500,a15,access
0,48120274200,48120274800,00000000600,a00,read
0,48120275500,48120277100,00000001600,a09,mmap
0,48120280500,48120282100,00000001600,a09,mmap
0,48120290100,48120290600,00000000500,a15,access
0,48120293900,48120294500,00000000600,a00,read
0,48120295100,48120296500,00000001400,a09,mmap
0,48120300700,48120303000,00000002300,a09,mmap
0,48120311400,48120312000,00000000600,a15,access
0,48120314600,48120315100,00000000500,a00,read
0,48120315500,48120316600,00000001100,a09,mmap
0,48120317900,48120319200,00000001300,a09,mmap
0,48120322500,48120323900,00000001400,a09,mmap
0,48120330100,48120330600,00000000500,a15,access
0,48120333200,48120333900,00000000700,a00,read
0,48120334600,48120335900,00000001300,a09,mmap
0,48120338700,48120340500,00000001800,a09,mmap
0,48120354400,48120354900,00000000500,a09,mmap
0,48120358600,48120358900,00000000300,a09,mmap
0,48120360000,48120360300,00000000300,a09,mmap
0,48120536400,48120536500,00000000100,a0c,brk
0,48120536600,48120537300,00000000700,a0c,brk
0,48120574500,48120583100,00000008600,a00,read
0,48120595900,48120597300,00000001400,a00,read
0,48120630900,48120631800,00000000900,a00,read
0,48120754600,48120755500,00000000900,a00,read
0,48120825600,48120826000,00000000400,a00,read
0,48120912600,48120913200,00000000600,a00,read
0,48121044300,48121045200,00000000900,a00,read
0,48121174200,48121175100,00000000900,a00,read
0,48121330600,48121331200,00000000600,a00,read
0,48121481300,48121482000,00000000700,a00,read
0,48121518700,48121520000,00000001300,a0c,brk
0,48121635300,48121636100,00000000800,a00,read
0,48121783800,48121784500,00000000700,a00,read
0,48121939500,48121940200,00000000700,a00,read
0,48122099000,48122099700,00000000700,a00,read
0,48122208300,48122208900,00000000600,a00,read
0,48122239400,48122240300,00000000900,a0c,brk
0,48122348500,48122349300,00000000800,a00,read
0,48122591800,48122592400,00000000600,a00,read
0,48122604800,48122605200,00000000400,a00,read
0,48122649700,48122650000,00000000300,a00,read
0,48122670400,48122671200,00000000800,a00,read
0,48122878300,48122878800,00000000500,a00,read
0,48122908400,48122909300,00000000900,a00,read
0,48123006200,48123007000,00000000800,a00,read
0,48123030700,48123031800,00000001100,a0c,brk
0,48123077000,48123077300,00000000300,a00,read
0,48123153500,48123154400,00000000900,a00,read
0,48123322300,48123322800,00000000500,a00,read
0,48123437900,48123438500,00000000600,a00,read
0,48123533700,48123534300,00000000600,a00,read
0,48123546800,48123547300,00000000500,a00,read
0,48123629600,48123630100,00000000500,a00,read
0,48123654900,48123655300,00000000400,a00,read
0,48123678300,48123678900,00000000600,a00,read
0,48123782800,48123784100,00000001300,a0c,brk
0,48123785900,48123786900,00000001000,a00,read
0,48123986600,48123987100,00000000500,a00,read
0,48124073300,48124074000,00000000700,a00,read
0,48124139800,48124140600,00000000800,a00,read
0,48124270500,48124271100,00000000600,a00,read
0,48124304300,48124304900,00000000600,a00,read
0,48124322000,48124323300,00000001300,a02,open
0,48124435100,48124435700,00000000600,a00,read
0,48124508200,48124508600,00000000400,a00,read
0,48124561900,48124563100,00000001200,a0c,brk
0,48124569700,48124570500,00000000800,a00,read
0,48124680600,48124681200,00000000600,a00,read
0,48124834300,48124835200,00000000900,a00,read
0,48124966500,48124967300,00000000800,a00,read
0,48125024800,48125025500,00000000700,a00,read
0,48125081500,48125082100,00000000600,a00,read
0,48125152100,48125152700,00000000600,a00,read
0,48125205600,48125206300,00000000700,a00,read
0,48125294900,48125295900,00000001000,a0c,brk
0,48125327100,48125330900,00000003800,a0c,brk
0,48125345800,48125346600,00000000800,a00,read
0,48125463700,48125464600,00000000900,a00,read
0,48125623100,48125623800,00000000700,a00,read
0,48125741800,48125742600,00000000800,a00,read
0,48125887600,48125888400,00000000800,a00,read
0,48126005100,48126005600,00000000500,a00,read
0,48126166800,48126167400,00000000600,a00,read
0,48126172400,48126173300,00000000900,a0c,brk
0,48126288200,48126288900,00000000700,a00,read
0,48126406800,48126407600,00000000800,a00,read
0,48126549300,48126550100,00000000800,a00,read
0,48126680700,48126681300,00000000600,a00,read
0,48126774200,48126774700,00000000500,a00,read
0,48126887100,48126887800,00000000700,a00,read
0,48127011300,48127012100,00000000800,a00,read
0,48127123800,48127124400,00000000600,a0c,brk
0,48127147400,48127148000,00000000600,a00,read
0,48127229800,48131237800,00004008000,60e,page_fault
0,48131326800,48131327600,00000000800,a00,read
0,48131479600,48131480300,00000000700,a00,read
0,48131591200,48131591900,00000000700,a00,read
0,48131762200,48131763200,00000001000,a00,read
0,48131840100,48131840900,00000000800,a00,read
0,48131921800,48131922500,00000000700,a00,read
0,48132003700,48132004500,00000000800,a00,read
0,48132077600,48132078200,00000000600,a00,read
0,48132180000,48132180500,00000000500,a00,read
0,48132282300,48132283000,00000000700,a00,read
0,48132371900,48132372500,00000000600,a00,read
0,48132452600,48132453300,00000000700,a00,read
0,48132553700,48132554300,00000000600,a00,read
0,48132634700,48132635200,00000000500,a0c,brk
0,48132637700,48132638300,00000000600,a00,read
0,48132745900,48132746500,00000000600,a00,read
0,48132838700,48132839400,00000000700,a00,read
0,48132957400,48132958300,00000000900,a00,read
0,48133071700,48133072400,00000000700,a00,read
0,48133175100,48133175700,00000000600,a00,read
0,48133277000,48133277600,00000000600,a0c,brk
0,48133637500,48133640600,00000003100,a57,unlink
0,48133664600,48133665200,00000000600,a48,fcntl
0,48133711900,48133726700,00000014800,a01,write
0,48133744700,48133747200,00000002500,a01,write
0,48133763600,48133765800,00000002200,a01,write
0,48116065900,48133931700,00017865800,a3d,wait4
0,48133949800,48133951200,00000001400,a00,read
0,48133953400,48133953800,00000000400,a00,read
0,48115719400,48133985100,00018265700,a17,select
0,48134006900,48134007200,00000000300,a2f,recvmsg
0,48134021400,48134021600,00000000200,a2f,recvmsg
0,48134022600,48134022800,00000000200,a2f,recvmsg
0,48134010500,48134029300,00000018800,a17,select
0,48134033300,48134033500,00000000200,a2f,recvmsg
0,48134039400,48134039600,00000000200,a2f,recvmsg
0,48134040000,48134040200,00000000200,a2f,recvmsg
0,48134034300,48134044900,00000010600,a17,select
0,48134048200,48134048400,00000000200,a2f,recvmsg
0,48134054000,48134054200,00000000200,a2f,recvmsg
0,48134054600,48134054700,00000000100,a2f,recvmsg
0,48134049100,48134060600,00000011500,a17,select
0,48134064200,48134064400,00000000200,a2f,recvmsg
0,48134069500,48134069700,00000000200,a2f,recvmsg
0,48134070000,48134070200,00000000200,a2f,recvmsg
0,48134064900,48134075900,00000011000,a17,select
0,48134079700,48134079900,00000000200,a2f,recvmsg
0,48134085100,48134085200,00000000100,a2f,recvmsg
0,48134085600,48134085800,00000000200,a2f,recvmsg
0,48134080400,48134090900,00000010500,a17,select
0,48134093900,48134094100,00000000200,a2f,recvmsg
0,48134099300,48134099500,00000000200,a2f,recvmsg
0,48134099900,48134100000,00000000100,a2f,recvmsg
0,48134100900,48134101100,00000000200,a08,lseek
0,48134110600,48134110600,00000000000,a08,lseek
0,48134094700,48134115100,00000020400,a17,select
0,48134118600,48134118700,00000000100,a2f,recvmsg
0,48134124100,48134124300,00000000200,a2f,recvmsg
0,48134124700,48134124900,00000000200,a2f,recvmsg
0,48134119400,48134131600,00000012200,a17,select
0,48134134900,48134135000,00000000100,a2f,recvmsg
0,48134140200,48134140400,00000000200,a2f,recvmsg
0,48134140800,48134141000,00000000200,a2f,recvmsg
0,48134135500,48134145700,00000010200,a17,select
0,48134148700,48134148900,00000000200,a2f,recvmsg
0,48134154300,48134154500,00000000200,a2f,recvmsg
0,48134154800,48134155000,00000000200,a2f,recvmsg
0,48134149400,48134160400,00000011000,a17,select
0,48134163600,48134163700,00000000100,a2f,recvmsg
0,48134169200,48134169400,00000000200,a2f,recvmsg
0,48134169700,48134169900,00000000200,a2f,recvmsg
0,48134164200,48134176200,00000012000,a17,select
0,48134179400,48134179500,00000000100,a2f,recvmsg
0,48134185600,48134185800,00000000200,a2f,recvmsg
0,48134186200,48134186400,00000000200,a2f,recvmsg
0,48134180200,48134192000,00000011800,a17,select
0,48134195000,48134195200,00000000200,a2f,recvmsg
0,48134200800,48134200900,00000000100,a2f,recvmsg
0,48134201300,48134201500,00000000200,a2f,recvmsg
0,48134195800,48134206700,00000010900,a17,select
0,48134209900,48134210100,00000000200,a2f,recvmsg
0,48134216400,48134216600,00000000200,a2f,recvmsg
0,48134217000,48134217000,00000000000,a2f,recvmsg
0,48134210600,48134221900,00000011300,a17,select
0,48134224900,48134225000,00000000100,a2f,recvmsg
0,48134230300,48134230300,00000000000,a2f,recvmsg
0,48134230700,48134230900,00000000200,a2f,recvmsg
0,48134225600,48134237100,00000011500,a17,select
0,48134240400,48134240600,00000000200,a2f,recvmsg
0,48134245900,48134246100,00000000200,a2f,recvmsg
0,48134246400,48134246600,00000000200,a2f,recvmsg
0,48134241200,48134251800,00000010600,a17,select
0,48134255100,48134255300,00000000200,a2f,recvmsg
0,48134260600,48134260700,00000000100,a2f,recvmsg
0,48134261000,48134261200,00000000200,a2f,recvmsg
0,48134255900,48134266400,00000010500,a17,select
0,48134269400,48134269600,00000000200,a2f,recvmsg
0,48134274900,48134275100,00000000200,a2f,recvmsg
0,48134275400,48134275600,00000000200,a2f,recvmsg
0,48134270200,48134280900,00000010700,a17,select
0,48134284000,48134284100,00000000100,a2f,recvmsg
0,48134289400,48134289600,00000000200,a2f,recvmsg
0,48134290000,48134290200,00000000200,a2f,recvmsg
0,48134284700,48134295100,00000010400,a17,select
0,48134298200,48134298400,00000000200,a2f,recvmsg
0,48134303500,48134303700,00000000200,a2f,recvmsg
0,48134304000,48134304200,00000000200,a2f,recvmsg
0,48134298800,48134309400,00000010600,a17,select
0,48134312400,48134312600,00000000200,a2f,recvmsg
0,48134317900,48134318100,00000000200,a2f,recvmsg
0,48134318500,48134318600,00000000100,a2f,recvmsg
0,48134313200,48134323600,00000010400,a17,select
0,48134326600,48134326700,00000000100,a2f,recvmsg
0,48134331900,48134332100,00000000200,a2f,recvmsg
0,48134332500,48134332700,00000000200,a2f,recvmsg
0,48134327200,48134337100,00000009900,a17,select
0,48134340200,48134340400,00000000200,a2f,recvmsg
0,48134345400,48134345600,00000000200,a2f,recvmsg
0,48134346000,48134346200,00000000200,a2f,recvmsg
0,48134340900,48134352900,00000012000,a17,select
0,48134356000,48134356100,00000000100,a2f,recvmsg
0,48134361400,48134361500,00000000100,a2f,recvmsg
0,48134361900,48134362100,00000000200,a2f,recvmsg
0,48134356700,48134366600,00000009900,a17,select
0,48134369600,48134369800,00000000200,a2f,recvmsg
0,48134374800,48134375000,00000000200,a2f,recvmsg
0,48134375400,48134375600,00000000200,a2f,recvmsg
0,48134370400,48134380100,00000009700,a17,select
0,48134382900,48134383100,00000000200,a2f,recvmsg
0,48134388300,48134388500,00000000200,a2f,recvmsg
0,48134388800,48134389000,00000000200,a2f,recvmsg
0,48134383700,48134393500,00000009800,a17,select
0,48134396500,48134396600,00000000100,a2f,recvmsg
0,48134401800,48134402000,00000000200,a2f,recvmsg
0,48134402300,48134402500,00000000200,a2f,recvmsg
0,48134397200,48134407400,00000010200,a17,select
0,48134410500,48134410700,00000000200,a2f,recvmsg
0,48134416700,48134416900,00000000200,a2f,recvmsg
0,48134417200,48134417400,00000000200,a2f,recvmsg
0,48134411200,48134422200,00000011000,a17,select
0,48134425200,48134425400,00000000200,a2f,recvmsg
0,48134430500,48134430700,00000000200,a2f,recvmsg
0,48134431100,48134431300,00000000200,a2f,recvmsg
0,48134426000,48134436500,00000010500,a17,select
0,48134439600,48134439800,00000000200,a2f,recvmsg
0,48134445000,48134445100,00000000100,a2f,recvmsg
0,48134445500,48134445700,00000000200,a2f,recvmsg
0,48134440300,48134450800,00000010500,a17,select
0,48134454000,48134454200,00000000200,a2f,recvmsg
0,48134459300,48134459500,00000000200,a2f,recvmsg
0,48134459900,48134460100,00000000200,a2f,recvmsg
0,48134454700,48134466600,00000011900,a17,select
0,48134470000,48134470200,00000000200,a2f,recvmsg
0,48134475400,48134475600,00000000200,a2f,recvmsg
0,48134476000,48134476200,00000000200,a2f,recvmsg
0,48134470800,48134481600,00000010800,a17,select
0,48134484700,48134484800,00000000100,a2f,recvmsg
0,48134489900,48134490100,00000000200,a2f,recvmsg
0,48134490500,48134490600,00000000100,a2f,recvmsg
0,48134485300,48134496100,00000010800,a17,select
0,48134499300,48134499400,00000000100,a2f,recvmsg
0,48134504600,48134504700,00000000100,a2f,recvmsg
0,48134505100,48134505300,00000000200,a2f,recvmsg
0,48134500000,48134512700,00000012700,a17,select
0,48134515800,48134515900,00000000100,a2f,recvmsg
0,48134521200,48134521300,00000000100,a2f,recvmsg
0,48134521800,48134521900,00000000100,a2f,recvmsg
0,48134516500,48134526800,00000010300,a17,select
0,48134529900,48134530000,00000000100,a2f,recvmsg
0,48134535100,48134535300,00000000200,a2f,recvmsg
0,48134535700,48134535900,00000000200,a2f,recvmsg
0,48134530500,48134540900,00000010400,a17,select
0,48134544000,48134544200,00000000200,a2f,recvmsg
0,48134549500,48134549500,00000000000,a2f,recvmsg
0,48134549900,48134550100,00000000200,a2f,recvmsg
0,48134544800,48134557000,00000012200,a17,select
0,48134560000,48134560200,00000000200,a2f,recvmsg
0,48134565500,48134565600,00000000100,a2f,recvmsg
0,48134566000,48134566200,00000000200,a2f,recvmsg
0,48134560800,48134571500,00000010700,a17,select
0,48134574500,48134574700,00000000200,a2f,recvmsg
0,48134579900,48134580100,00000000200,a2f,recvmsg
0,48134580400,48134580600,00000000200,a2f,recvmsg
0,48134575300,48134586300,00000011000,a17,select
0,48134589500,48134589700,00000000200,a2f,recvmsg
0,48134594900,48134595100,00000000200,a2f,recvmsg
0,48134595400,48134595600,00000000200,a2f,recvmsg
0,48134590300,48134601800,00000011500,a17,select
0,48134604900,48134605000,00000000100,a2f,recvmsg
0,48134610300,48134610400,00000000100,a2f,recvmsg
0,48134610800,48134611000,00000000200,a2f,recvmsg
0,48134605600,48134616000,00000010400,a17,select
0,48134619000,48134619200,00000000200,a2f,recvmsg
0,48134624400,48134624600,00000000200,a2f,recvmsg
0,48134624900,48134625100,00000000200,a2f,recvmsg
0,48134619800,48134629700,00000009900,a17,select
0,48134632700,48134632900,00000000200,a2f,recvmsg
0,48134638000,48134638100,00000000100,a2f,recvmsg
0,48134638500,48134638700,00000000200,a2f,recvmsg
0,48134633400,48134644000,00000010600,a17,select
0,48134647000,48134647200,00000000200,a2f,recvmsg
0,48134652400,48134652600,00000000200,a2f,recvmsg
0,48134652900,48134653100,00000000200,a2f,recvmsg
0,48134654400,48134654500,00000000100,a08,lseek
0,48134657200,48134658000,00000000800,a00,read
0,48134661700,48134661800,00000000100,a08,lseek
0,48134647800,48134666600,00000018800,a17,select
0,48134669900,48134670000,00000000100,a2f,recvmsg
0,48134675500,48134675700,00000000200,a2f,recvmsg
0,48134676100,48134676300,00000000200,a2f,recvmsg
0,48134670700,48134704900,00000034200,a17,select
0,48134708400,48134708500,00000000100,a2f,recvmsg
0,48134714100,48134714200,00000000100,a2f,recvmsg
0,48134714600,48134714800,00000000200,a2f,recvmsg
0,48134718700,48134719500,00000000800,a00,read
0,48134725100,48134725200,00000000100,a08,lseek
0,48134709100,48134730700,00000021600,a17,select
0,48134734000,48134734100,00000000100,a2f,recvmsg
0,48134739500,48134739700,00000000200,a2f,recvmsg
0,48134740000,48134740200,00000000200,a2f,recvmsg
0,48134734800,48134744900,00000010100,a17,select
0,48134747700,48134747900,00000000200,a2f,recvmsg
0,48134752900,48134753100,00000000200,a2f,recvmsg
0,48134753500,48134753700,00000000200,a2f,recvmsg
0,48134748500,48134758100,00000009600,a17,select
0,48134760900,48134761000,00000000100,a2f,recvmsg
0,48134766100,48134766200,00000000100,a2f,recvmsg
0,48134766600,48134766700,00000000100,a2f,recvmsg
0,48134761600,48134771200,00000009600,a17,select
0,48134774000,48134774200,00000000200,a2f,recvmsg
0,48134779300,48134779400,00000000100,a2f,recvmsg
0,48134779700,48134779900,00000000200,a2f,recvmsg
0,48134774700,48134784400,00000009700,a17,select
0,48134787300,48134787500,00000000200,a2f,recvmsg
0,48134792600,48134792700,00000000100,a2f,recvmsg
0,48134793000,48134793200,00000000200,a2f,recvmsg
0,48134788000,48134797600,00000009600,a17,select
0,48134800500,48134800600,00000000100,a2f,recvmsg
0,48134805700,48134805900,00000000200,a2f,recvmsg
0,48134806200,48134806300,00000000100,a2f,recvmsg
0,48134801200,48134810700,00000009500,a17,select
0,48134813600,48134813700,00000000100,a2f,recvmsg
0,48134818900,48134819000,00000000100,a2f,recvmsg
0,48134819300,48134819500,00000000200,a2f,recvmsg
0,48134814300,48134824600,00000010300,a17,select
0,48134827600,48134827800,00000000200,a2f,recvmsg
0,48134832800,48134833000,00000000200,a2f,recvmsg
0,48134833300,48134833500,00000000200,a2f,recvmsg
0,48134828400,48134838100,00000009700,a17,select
0,48134840900,48134841100,00000000200,a2f,recvmsg
0,48134846100,48134846300,00000000200,a2f,recvmsg
0,48134846600,48134846800,00000000200,a2f,recvmsg
0,48134847400,48134847500,00000000100,a08,lseek
0,48134841700,48134853500,00000011800,a17,select
0,48134856700,48134856800,00000000100,a2f,recvmsg
0,48134862100,48134862300,00000000200,a2f,recvmsg
0,48134862600,48134862800,00000000200,a2f,recvmsg
0,48134857400,48134869500,00000012100,a17,select
0,48134872500,48134872700,00000000200,a2f,recvmsg
0,48134877800,48134878000,00000000200,a2f,recvmsg
0,48134878300,48134878500,00000000200,a2f,recvmsg
0,48134873200,48134883700,00000010500,a17,select
0,48134886600,48134886700,00000000100,a2f,recvmsg
0,48134891800,48134892000,00000000200,a2f,recvmsg
0,48134892300,48134892500,00000000200,a2f,recvmsg
0,48134887300,48134897200,00000009900,a17,select
0,48134900200,48134900400,00000000200,a2f,recvmsg
0,48134905500,48134905600,00000000100,a2f,recvmsg
0,48134906000,48134906200,00000000200,a2f,recvmsg
0,48134900900,48134910800,00000009900,a17,select
0,48134913700,48134913900,00000000200,a2f,recvmsg
0,48134919000,48134919200,00000000200,a2f,recvmsg
0,48134919600,48134919800,00000000200,a2f,recvmsg
0,48134914400,48134924700,00000010300,a17,select
0,48134927600,48134927800,00000000200,a2f,recvmsg
0,48134933000,48134933200,00000000200,a2f,recvmsg
0,48134933500,48134933600,00000000100,a2f,recvmsg
0,48134928400,48134938900,00000010500,a17,select
0,48134941800,48134942000,00000000200,a2f,recvmsg
0,48134947000,48134947200,00000000200,a2f,recvmsg
0,48134947600,48134947800,00000000200,a2f,recvmsg
0,48134942600,48134952400,00000009800,a17,select
0,48134955400,48134955600,00000000200,a2f,recvmsg
0,48134960800,48134960900,00000000100,a2f,recvmsg
0,48134961300,48134961500,00000000200,a2f,recvmsg
0,48134956200,48134966100,00000009900,a17,select
0,48134969100,48134969200,00000000100,a2f,recvmsg
0,48134974200,48134974400,00000000200,a2f,recvmsg
0,48134974800,48134975000,00000000200,a2f,recvmsg
0,48134969700,48134979600,00000009900,a17,select
0,48134982600,48134982700,00000000100,a2f,recvmsg
0,48134987800,48134988000,00000000200,a2f,recvmsg
0,48134988400,48134988400,00000000000,a2f,recvmsg
0,48134983300,48134993200,00000009900,a17,select
0,48134996100,48134996300,00000000200,a2f,recvmsg
0,48135001500,48135001700,00000000200,a2f,recvmsg
0,48135002000,48135002100,00000000100,a2f,recvmsg
0,48134996900,48135006800,00000009900,a17,select
0,48135009700,48135009900,00000000200,a2f,recvmsg
0,48135015000,48135015100,00000000100,a2f,recvmsg
0,48135015500,48135015700,00000000200,a2f,recvmsg
0,48135010500,48135020900,00000010400,a17,select
0,48135024000,48135024100,00000000100,a2f,recvmsg
0,48135029200,48135029400,00000000200,a2f,recvmsg
0,48135029800,48135030000,00000000200,a2f,recvmsg
0,48135024600,48135034500,00000009900,a17,select
0,48135037500,48135037600,00000000100,a2f,recvmsg
0,48135042700,48135042900,00000000200,a2f,recvmsg
0,48135043200,48135043400,00000000200,a2f,recvmsg
0,48135038100,48135048100,00000010000,a17,select
0,48135051000,48135051100,00000000100,a2f,recvmsg
0,48135056400,48135056600,00000000200,a2f,recvmsg
0,48135056800,48135057000,00000000200,a2f,recvmsg
0,48135051700,48135061800,00000010100,a17,select
0,48135064800,48135065000,00000000200,a2f,recvmsg
0,48135070100,48135070300,00000000200,a2f,recvmsg
0,48135070700,48135070900,00000000200,a2f,recvmsg
0,48135065600,48135081200,00000015600,a17,select
0,48135084200,48135084400,00000000200,a2f,recvmsg
0,48135090000,48135090100,00000000100,a2f,recvmsg
0,48135090500,48135090700,00000000200,a2f,recvmsg
0,48135085100,48135095600,00000010500,a17,select
0,48135098600,48135098600,00000000000,a2f,recvmsg
0,48135103800,48135104000,00000000200,a2f,recvmsg
0,48135104300,48135104400,00000000100,a2f,recvmsg
0,48135099300,48135109200,00000009900,a17,select
0,48135112100,48135112300,00000000200,a2f,recvmsg
0,48135117500,48135117600,00000000100,a2f,recvmsg
0,48135117900,48135118100,00000000200,a2f,recvmsg
0,48135112900,48135123000,00000010100,a17,select
0,48135126000,48135126100,00000000100,a2f,recvmsg
0,48135131200,48135131400,00000000200,a2f,recvmsg
0,48135131800,48135131900,00000000100,a2f,recvmsg
0,48135126800,48135136700,00000009900,a17,select
0,48135139600,48135139800,00000000200,a2f,recvmsg
0,48135144900,48135145000,00000000100,a2f,recvmsg
0,48135145400,48135145600,00000000200,a2f,recvmsg
0,48135189800,48135193600,00000003800,a14,writev
0,48135140400,48135197200,00000056800,a17,select
0,48135199600,48135201000,00000001400,a2f,recvmsg
0,48135297600,48135301000,00000003400,a14,writev
0,48135301500,48135304300,00000002800,a14,writev
0,48135380800,48135383200,00000002400,a14,writev
0,48135438600,48135440400,00000001800,a14,writev
0,48135440600,48135442100,00000001500,a14,writev
0,48135498300,48135499900,00000001600,a14,writev
0,48135500100,48135501800,00000001700,a14,writev
0,48135557400,48135559300,00000001900,a14,writev
0,48135559500,48135560900,00000001400,a14,writev
0,48135615300,48135616900,00000001600,a14,writev
0,48135617100,48135618500,00000001400,a14,writev
0,48135622400,48135623100,00000000700,a2f,recvmsg
0,48135670200,48135672100,00000001900,a14,writev
0,48135716600,48135718200,00000001600,a14,writev
0,48135761300,48135762900,00000001600,a14,writev
0,48135805800,48135807600,00000001800,a14,writev
0,48135849700,48135851200,00000001500,a14,writev
0,48135894400,48135896000,00000001600,a14,writev
0,48135921300,48135923200,00000001900,a2f,recvmsg
0,48135948300,48135950100,00000001800,a14,writev
0,48135967000,48135968900,00000001900,a14,writev
0,48135983900,48135985600,00000001700,a14,writev
0,48135999600,48136001300,00000001700,a14,writev
0,48136014900,48136016800,00000001900,a14,writev
0,48136029600,48136031500,00000001900,a14,writev
0,48136036200,48136036500,00000000300,a2f,recvmsg
0,48136037200,48136037500,00000000300,a14,writev
0,48136055800,48136057600,00000001800,a14,writev
0,48136057900,48136059200,00000001300,a14,writev
0,48136059600,48136059800,00000000200,a2f,recvmsg
0,48135189300,48136067700,00000878400,a07,poll
0,48136072800,48136079000,00000006200,a2f,recvmsg
0,48136091000,48136091200,00000000200,a2f,recvmsg
0,48136117400,48136122100,00000004700,a07,poll
0,48136128100,48136133900,00000005800,a2f,recvmsg
0,48136146400,48136146600,00000000200,a2f,recvmsg
0,48136168700,48136173500,00000004800,a07,poll
0,48136179100,48136184900,00000005800,a2f,recvmsg
0,48136197800,48136198000,00000000200,a2f,recvmsg
0,48136060600,48136227900,00000167300,a17,select
0,48136242800,48136244300,00000001500,a14,writev
0,48136244800,48136245000,00000000200,a2f,recvmsg
0,48136258700,48136259600,00000000900,a14,writev
0,48136260000,48136260200,00000000200,a2f,recvmsg
0,48136272200,48136273300,00000001100,a14,writev
0,48136273600,48136273800,00000000200,a2f,recvmsg
0,48136222200,48136278000,00000055800,a07,poll
0,48136278600,48136279600,00000001000,a2f,recvmsg
0,48136284400,48136285300,00000000900,a2d,recvfrom
0,48136286200,48136286400,00000000200,a2f,recvmsg
0,48136287100,48136287300,00000000200,a2f,recvmsg
0,48136328200,48136328500,00000000300,a2f,recvmsg
0,48136330600,48136330800,00000000200,a2f,recvmsg
0,48136333100,48136335000,00000001900,a07,poll
0,48136335500,48136336600,00000001100,a2f,recvmsg
0,48136341600,48136342400,00000000800,a2d,recvfrom
0,48136343100,48136343300,00000000200,a2f,recvmsg
0,48136343900,48136344100,00000000200,a2f,recvmsg
0,48136372100,48136372300,00000000200,a2f,recvmsg
0,48136374100,48136374300,00000000200,a2f,recvmsg
0,48136377300,48136379400,00000002100,a07,poll
0,48136380100,48136381100,00000001000,a2f,recvmsg
0,48136386800,48136387400,00000000600,a2d,recvfrom
0,48136388400,48136388600,00000000200,a2f,recvmsg
0,48136389200,48136389400,00000000200,a2f,recvmsg
0,48136418500,48136418700,00000000200,a2f,recvmsg
0,48136420400,48136420600,00000000200,a2f,recvmsg
0,48136431600,48136431800,00000000200,a2f,recvmsg
0,48136432400,48136432500,00000000100,a2f,recvmsg
0,48136274300,48136466200,00000191900,a17,select
0,48136476000,48136478000,00000002000,a14,writev
0,48136479800,48136479900,00000000100,a2f,recvmsg
0,48136487800,48136487900,00000000100,a2f,recvmsg
0,48136488500,48136488700,00000000200,a2f,recvmsg
0,48136909900,48136914200,00000004300,a09,mmap
0,48137143200,48137149200,00000006000,a07,poll
0,48137156200,48137162000,00000005800,a2e,sendmsg
0,48090533800,48137165800,00046632000,ae8,epoll_wait
0,48137178500,48137180300,00000001800,a2f,recvmsg
0,48137194400,48137194700,00000000300,a2f,recvmsg
0,48137251100,48137255100,00000004000,a2e,sendmsg
0,48137143200,48137265000,00000121800,a07,poll
0,48137282800,48137283900,00000001100,a2f,recvmsg
0,48137358800,48137361200,00000002400,a07,poll
0,48137358800,48137527500,00000168700,a07,poll
0,48137530600,48137532200,00000001600,aca,futex
0,48137534400,48137535400,00000001000,aca,futex
0,48137536900,48137537800,00000000900,aca,futex
0,48137541200,48137544100,00000002900,a2e,sendmsg
0,48137546800,48137547100,00000000300,a00,read
0,48137260900,48137567200,00000306300,ae8,epoll_wait
0,48137571100,48137572600,00000001500,a2f,recvmsg
0,48137597800,48137598100,00000000300,a2f,recvmsg
0,48137626900,48137628100,00000001200,a2e,sendmsg
0,48137644600,48137647400,00000002800,a2f,recvmsg
0,48137651500,48137652200,00000000700,a2f,recvmsg
0,48137664000,48137666400,00000002400,a2e,sendmsg
0,48137631200,48137667900,00000036700,ae8,epoll_wait
0,48137670600,48137671200,00000000600,a2f,recvmsg
0,48137678600,48137678800,00000000200,a2f,recvmsg
0,48137709700,48137711300,00000001600,a2e,sendmsg
0,48137651100,48137716900,00000065800,a07,poll
0,48137724600,48137725300,00000000700,a2f,recvmsg
0,48137774700,48137776400,00000001700,a07,poll
0,48137774700,48137882900,00000108200,a07,poll
0,48137884500,48137885700,00000001200,aca,futex
0,48137887700,48137888600,00000000900,aca,futex
0,48137889900,48137890700,00000000800,aca,futex
0,48137893300,48137895500,00000002200,a2e,sendmsg
0,48137898100,48137898200,00000000100,a00,read
0,48137714900,48137916500,00000201600,ae8,epoll_wait
0,48137920100,48137921300,00000001200,a2f,recvmsg
0,48137939100,48137939400,00000000300,a2f,recvmsg
0,48137964000,48137965200,00000001200,a2e,sendmsg
0,48138157000,48138157200,00000000200,a00,read
0,48138158900,48138159600,00000000700,a2f,recvmsg
0,48138251900,48138254400,00000002500,a07,poll
0,48138570400,48138577300,00000006900,a02,open
0,48138588100,48138590800,00000002700,a00,read
0,48138645600,48138646400,00000000800,a00,read
0,48138698500,48138699200,00000000700,a00,read
0,48138749300,48138750000,00000000700,a00,read
0,48138800700,48138801500,00000000800,a00,read
0,48138850700,48138851300,00000000600,a00,read
0,48138899100,48138899900,00000000800,a00,read
0,48138948900,48138949800,00000000900,a00,read
0,48139001600,48139002400,00000000800,a00,read
0,48139053900,48139054600,00000000700,a00,read
0,48139103800,48139104500,00000000700,a00,read
0,48139132300,48139134200,00000001900,a02,open
0,48139137500,48139138300,00000000800,a00,read
0,48139194200,48139195000,00000000800,a00,read
0,48139294700,48139295700,00000001000,a00,read
0,48139369100,48139369800,00000000700,a00,read
0,48139447800,48139448600,00000000800,a00,read
0,48139528000,48139528800,00000000800,a00,read
0,48139607000,48139607600,00000000600,a00,read
0,48139693100,48139693800,00000000700,a00,read
0,48139761500,48139762400,00000000900,a00,read
0,48139820400,48139821200,00000000800,a00,read
0,48136481100,48139911400,00003430300,a17,select
0,48139930000,48139930200,00000000200,a2f,recvmsg
0,48143242200,48143242400,00000000200,a2f,recvmsg
0,48143243100,48143243300,00000000200,a2f,recvmsg
0,48139933100,48143249200,00003316100,a17,select
0,48143254200,48143254400,00000000200,a2f,recvmsg
0,48143260700,48143260800,00000000100,a2f,recvmsg
0,48143261300,48143261500,00000000200,a2f,recvmsg
0,48143267200,48143273600,00000006400,a06,lstat
0,48143274400,48143275800,00000001400,a06,lstat
0,48143298600,48143312300,00000013700,a01,write
0,48143255300,48143321800,00000066500,a17,select
0,48143327500,48143327500,00000000000,a2f,recvmsg
0,48143335200,48143335400,00000000200,a2f,recvmsg
0,48143336000,48143336200,00000000200,a2f,recvmsg
0,48143337800,48143645400,00000307600,a38,clone
0,48144119000,48144119100,00000000100,a0c,brk
0,48144129300,48144131400,00000002100,a15,access
0,48144132200,48144133100,00000000900,a09,mmap
0,48144138000,48144138800,00000000800,a15,access
0,48144146200,48144147200,00000001000,a09,mmap
0,48144151100,48144151600,00000000500,a15,access
0,48144158500,48144159800,00000001300,a00,read
0,48144167100,48144169300,00000002200,a09,mmap
0,48144182100,48144182700,00000000600,a15,access
0,48144186000,48144186700,00000000700,a00,read
0,48144187500,48144188300,00000000800,a09,mmap
0,48144191000,48144192300,00000001300,a09,mmap
0,48144200600,48144201200,00000000600,a15,access
0,48144204200,48144204900,00000000700,a00,read
0,48144205500,48144206600,00000001100,a09,mmap
0,48144208100,48144210400,00000002300,a09,mmap
0,48144220600,48144221800,00000001200,a09,mmap
0,48144230900,48144231600,00000000700,a15,access
0,48144234100,48144234800,00000000700,a00,read
0,48144235700,48144237300,00000001600,a09,mmap
0,48144240000,48144241800,00000001800,a09,mmap
0,48144250100,48144250700,00000000600,a15,access
0,48144253700,48144254500,00000000800,a00,read
0,48144255200,48144256700,00000001500,a09,mmap
0,48144260800,48144263100,00000002300,a09,mmap
0,48144271900,48144272500,00000000600,a15,access
0,48144274900,48144275600,00000000700,a00,read
0,48144276000,48144277200,00000001200,a09,mmap
0,48144278600,48144279900,00000001300,a09,mmap
0,48144283200,48144284400,00000001200,a09,mmap
0,48144290800,48144291500,00000000700,a15,access
0,48144293800,48144294600,00000000800,a00,read
0,48144295200,48144296500,00000001300,a09,mmap
0,48144299200,48144300900,00000001700,a09,mmap
0,48144315400,48144316000,00000000600,a09,mmap
0,48144319900,48144320200,00000000300,a09,mmap
0,48144323900,48144324200,00000000300,a09,mmap
0,48144506400,48144506600,00000000200,a0c,brk
0,48144506700,48144507500,00000000800,a0c,brk
0,48144540000,48144541300,00000001300,a00,read
0,48144553000,48144554400,00000001400,a00,read
0,48144594300,48144595100,00000000800,a00,read
0,48144713700,48144714500,00000000800,a00,read
0,48144786500,48144786900,00000000400,a00,read
0,48144872200,48144872900,00000000700,a00,read
0,48145003300,48145004100,00000000800,a00,read
0,48145134400,48145135100,00000000700,a00,read
0,48145291000,48145291800,00000000800,a00,read
0,48145442000,48145442700,00000000700,a00,read
0,48145479400,48145480800,00000001400,a0c,brk
0,48145596100,48145596700,00000000600,a00,read
0,48145746700,48145747400,00000000700,a00,read
0,48145901500,48145902200,00000000700,a00,read
0,48146060900,48146061600,00000000700,a00,read
0,48146169600,48146170200,00000000600,a00,read
0,48146200900,48146201700,00000000800,a0c,brk
0,48146309800,48146310500,00000000700,a00,read
0,48146551600,48146552100,00000000500,a00,read
0,48146564100,48146564600,00000000500,a00,read
0,48146607700,48146608100,00000000400,a00,read
0,48146627700,48146628400,00000000700,a00,read
0,48146833800,48146834200,00000000400,a00,read
0,48146862700,48146863500,00000000800,a00,read
0,48146960600,48146961300,00000000700,a00,read
0,48146985200,48146986400,00000001200,a0c,brk
0,48147031100,48147031500,00000000400,a00,read
0,48147108300,48147109000,00000000700,a00,read
0,48147287000,48147287600,00000000600,a00,read
0,48147400900,48147401500,00000000600,a00,read
0,48147494700,48147495300,00000000600,a00,read
0,48147507100,48147507500,00000000400,a00,read
0,48147589600,48147590000,00000000400,a00,read
0,48147613700,48147614000,00000000300,a00,read
0,48147635700,48147636200,00000000500,a00,read
0,48147738100,48147739300,00000001200,a0c,brk
0,48147740300,48147741300,00000001000,a00,read
0,48147943900,48147944300,00000000400,a00,read
0,48148027700,48148028300,00000000600,a00,read
0,48148091800,48148092500,00000000700,a00,read
0,48148221400,48148221800,00000000400,a00,read
0,48148254000,48148254600,00000000600,a00,read
0,48148271100,48148272400,00000001300,a02,open
0,48148383400,48148383900,00000000500,a00,read
0,48148454800,48148455200,00000000400,a00,read
0,48148507400,48148508600,00000001200,a0c,brk
0,48148514900,48148515600,00000000700,a00,read
0,48148623600,48148624200,00000000600,a00,read
0,48148774800,48148775700,00000000900,a00,read
0,48148905400,48148906000,00000000600,a00,read
0,48148963500,48148964300,00000000800,a00,read
0,48149020200,48149020900,00000000700,a00,read
0,48149090300,48149091000,00000000700,a00,read
0,48149143800,48149144500,00000000700,a00,read
0,48149232700,48149233500,00000000800,a0c,brk
0,48149264700,48149268900,00000004200,a0c,brk
0,48149283300,48149284100,00000000800,a00,read
0,48149398700,48149399600,00000000900,a00,read
0,48149557100,48149557700,00000000600,a00,read
0,48149674100,48149674900,00000000800,a00,read
0,48149819700,48149820300,00000000600,a00,read
0,48149936800,48149937600,00000000800,a00,read
0,48150099200,48150099900,00000000700,a00,read
0,48150104800,48150105500,00000000700,a0c,brk
0,48150220400,48150221100,00000000700,a00,read
0,48150338700,48150339400,00000000700,a00,read
0,48150480200,48150481000,00000000800,a00,read
0,48150612000,48150612800,00000000800,a00,read
0,48150706600,48150707200,00000000600,a00,read
0,48150819100,48150819700,00000000600,a00,read
0,48150943300,48150944000,00000000700,a00,read
0,48151078400,48151079100,00000000700,a00,read
0,48151258000,48151258600,00000000600,a00,read
0,48151408400,48151409100,00000000700,a00,read
0,48151519500,48151520200,00000000700,a00,read
0,48151688900,48151689900,00000001000,a00,read
0,48151766600,48151767300,00000000700,a00,read
0,48151848400,48151849100,00000000700,a00,read
0,48151916100,48151916800,00000000700,a0c,brk
0,48151930300,48151930900,00000000600,a00,read
0,48152003400,48152004200,00000000800,a00,read
0,48152104600,48152105400,00000000800,a00,read
0,48152207600,48152208100,00000000500,a00,read
0,48152297400,48152298000,00000000600,a00,read
0,48152378600,48152379100,00000000500,a00,read
0,48152479800,48152480500,00000000700,a00,read
0,48152561000,48152561400,00000000400,a0c,brk
0,48152563900,48152564500,00000000600,a00,read
0,48152671100,48152671700,00000000600,a00,read
0,48152763800,48152764400,00000000600,a00,read
0,48152882700,48152883400,00000000700,a00,read
0,48152996400,48152997000,00000000600,a00,read
0,48153100000,48153100600,00000000600,a00,read
0,48153199800,48153200100,00000000300,a0c,brk
0,48153561700,48153565100,00000003400,a57,unlink
0,48153588300,48153589000,00000000700,a48,fcntl
0,48153636000,48153650600,00000014600,a01,write
0,48153668900,48153671300,00000002400,a01,write
0,48153687400,48153689700,00000002300,a01,write
0,48143667200,48159231500,00015564300,a3d,wait4
0,48159253200,48159258400,00000005200,a00,read
0,48159260600,48159261000,00000000400,a00,read
0,48143328700,48159287600,00015958900,a17,select
0,48159306900,48159307200,00000000300,a2f,recvmsg
0,48159268600,48159318800,00000050200,a07,poll
0,48159322900,48159323300,00000000400,a00,read
0,48159432700,48159435300,00000002600,a01,write
0,48159448400,48159449200,00000000800,a2f,recvmsg
0,48159451500,48159451600,00000000100,a00,read
0,48159460000,48159460800,00000000800,aca,futex
0,48159471200,48159471400,00000000200,a2f,recvmsg
0,48159472000,48159472200,00000000200,a2f,recvmsg
0,48159310500,48159482700,00000172200,a17,select
0,48159488700,48159488900,00000000200,a2f,recvmsg
0,48159496500,48159496700,00000000200,a2f,recvmsg
0,48159497100,48159497300,00000000200,a2f,recvmsg
0,48159490200,48159503300,00000013100,a17,select
0,48159506800,48159507000,00000000200,a2f,recvmsg
0,48159512500,48159512600,00000000100,a2f,recvmsg
0,48159513000,48159513200,00000000200,a2f,recvmsg
0,48159507700,48159519000,00000011300,a17,select
0,48159522600,48159522800,00000000200,a2f,recvmsg
0,48159528000,48159528200,00000000200,a2f,recvmsg
0,48159528600,48159528700,00000000100,a2f,recvmsg
0,48159523300,48159534500,00000011200,a17,select
0,48159538300,48159538500,00000000200,a2f,recvmsg
0,48159543800,48159543900,00000000100,a2f,recvmsg
0,48159544200,48159544400,00000000200,a2f,recvmsg
0,48159539100,48159549500,00000010400,a17,select
0,48159552700,48159552900,00000000200,a2f,recvmsg
0,48159558000,48159558200,00000000200,a2f,recvmsg
0,48159558500,48159558700,00000000200,a2f,recvmsg
0,48159560300,48159560600,00000000300,a08,lseek
0,48159571000,48159571100,00000000100,a08,lseek
0,48159553500,48159575600,00000022100,a17,select
0,48159579200,48159579400,00000000200,a2f,recvmsg
0,48159584900,48159585100,00000000200,a2f,recvmsg
0,48159585400,48159585600,00000000200,a2f,recvmsg
0,48159580000,48159592700,00000012700,a17,select
0,48159595900,48159596100,00000000200,a2f,recvmsg
0,48159601400,48159601600,00000000200,a2f,recvmsg
0,48159602000,48159602200,00000000200,a2f,recvmsg
0,48159596700,48159606900,00000010200,a17,select
0,48159610000,48159610100,00000000100,a2f,recvmsg
0,48159615300,48159615400,00000000100,a2f,recvmsg
0,48159615800,48159616000,00000000200,a2f,recvmsg
0,48159610600,48159621400,00000010800,a17,select
0,48159624400,48159624500,00000000100,a2f,recvmsg
0,48159629900,48159630100,00000000200,a2f,recvmsg
0,48159630400,48159630600,00000000200,a2f,recvmsg
0,48159625100,48159635800,00000010700,a17,select
0,48159639000,48159639200,00000000200,a2f,recvmsg
0,48159644500,48159644700,00000000200,a2f,recvmsg
0,48159645000,48159645200,00000000200,a2f,recvmsg
0,48159639800,48159650800,00000011000,a17,select
0,48159654000,48159654100,00000000100,a2f,recvmsg
0,48159659400,48159659500,00000000100,a2f,recvmsg
0,48159659900,48159660000,00000000100,a2f,recvmsg
0,48159654600,48159665900,00000011300,a17,select
0,48159669300,48159669400,00000000100,a2f,recvmsg
0,48159674800,48159675000,00000000200,a2f,recvmsg
0,48159675200,48159675400,00000000200,a2f,recvmsg
0,48159669900,48159680100,00000010200,a17,select
0,48159683000,48159683200,00000000200,a2f,recvmsg
0,48159688600,48159688800,00000000200,a2f,recvmsg
0,48159689100,48159689300,00000000200,a2f,recvmsg
0,48159683800,48159695600,00000011800,a17,select
0,48159698900,48159699000,00000000100,a2f,recvmsg
0,48159463300,48159702800,00000239500,aca,futex
0,48159730900,48159732600,00000001700,a01,write
0,48159749800,48159752900,00000003100,a2e,sendmsg
0,48159767500,48159767700,00000000200,a2f,recvmsg
0,48159768200,48159768200,00000000000,a2f,recvmsg
0,48159699600,48159776000,00000076400,a17,select
0,48159781400,48159781500,00000000100,a2f,recvmsg
0,48159788100,48159788300,00000000200,a2f,recvmsg
0,48159788600,48159788800,00000000200,a2f,recvmsg
0,48159782600,48159794200,00000011600,a17,select
0,48159797500,48159797700,00000000200,a2f,recvmsg
0,48159803100,48159803200,00000000100,a2f,recvmsg
0,48159803600,48159803800,00000000200,a2f,recvmsg
0,48159798300,48159810800,00000012500,a17,select
0,48159814000,48159814100,00000000100,a2f,recvmsg
0,48159819500,48159819600,00000000100,a2f,recvmsg
0,48159819900,48159820100,00000000200,a2f,recvmsg
0,48159814700,48159825200,00000010500,a17,select
0,48159828300,48159828500,00000000200,a2f,recvmsg
0,48159833700,48159833900,00000000200,a2f,recvmsg
0,48159834300,48159834500,00000000200,a2f,recvmsg
0,48159829000,48159839600,00000010600,a17,select
0,48159842800,48159843000,00000000200,a2f,recvmsg
0,48159848200,48159848400,00000000200,a2f,recvmsg
0,48159848800,48159849000,00000000200,a2f,recvmsg
0,48159843600,48159853900,00000010300,a17,select
1,48043716700,48112179200,00068462500,a3d,wait4
1,48112201100,48112204700,00000003600,a00,read
1,48112207000,48112207500,00000000500,a00,read
1,48112217200,48112225500,00000008300,a14,writev
1,48112229100,48112258200,00000029100,a07,poll
1,48112263400,48112263500,00000000100,a2f,recvmsg
1,48112264400,48112264600,00000000200,a2f,recvmsg
1,48112267100,48112268900,00000001800,a14,writev
1,48112269200,48112277200,00000008000,a07,poll
1,48112278700,48112278700,00000000000,a2f,recvmsg
1,48112279100,48112279300,00000000200,a2f,recvmsg
1,48112281200,48112282900,00000001700,a14,writev
1,48112283300,48112291200,00000007900,a07,poll
1,48112292400,48112292600,00000000200,a2f,recvmsg
1,48112292900,48112293100,00000000200,a2f,recvmsg
1,48112294700,48112296200,00000001500,a14,writev
1,48112297200,48112304700,00000007500,a07,poll
1,48112305900,48112306100,00000000200,a2f,recvmsg
1,48112306500,48112306600,00000000100,a2f,recvmsg
1,48112308900,48112310800,00000001900,a14,writev
1,48112311000,48112319500,00000008500,a07,poll
1,48112320700,48112320900,00000000200,a2f,recvmsg
1,48112321200,48112321400,00000000200,a2f,recvmsg
1,48112323200,48112324700,00000001500,a14,writev
1,48112325000,48112332600,00000007600,a07,poll
1,48112334600,48112334800,00000000200,a2f,recvmsg
1,48112335100,48112335300,00000000200,a2f,recvmsg
1,48112336600,48112336800,00000000200,a08,lseek
1,48112336600,48112346800,00000010200,a08,lseek
1,48112347700,48112349500,00000001800,a14,writev
1,48112350700,48112357500,00000006800,a07,poll
1,48112359500,48112359700,00000000200,a2f,recvmsg
1,48112360100,48112360300,00000000200,a2f,recvmsg
1,48112363100,48112364700,00000001600,a14,writev
1,48112365200,48112372700,00000007500,a07,poll
1,48112374000,48112374200,00000000200,a2f,recvmsg
1,48112374500,48112374700,00000000200,a2f,recvmsg
1,48112376100,48112377700,00000001600,a14,writev
1,48112378100,48112385300,00000007200,a07,poll
1,48112386700,48112386800,00000000100,a2f,recvmsg
1,48112387100,48112387300,00000000200,a2f,recvmsg
1,48112389000,48112390700,00000001700,a14,writev
1,48112391000,48112398300,00000007300,a07,poll
1,48112400500,48112400600,00000000100,a2f,recvmsg
1,48112401000,48112401200,00000000200,a2f,recvmsg
1,48112403000,48112404600,00000001600,a14,writev
1,48112404900,48112412400,00000007500,a07,poll
1,48112413700,48112413900,00000000200,a2f,recvmsg
1,48112414200,48112414400,00000000200,a2f,recvmsg
1,48112416300,48112417900,00000001600,a14,writev
1,48112418300,48112425800,00000007500,a07,poll
1,48112427100,48112427300,00000000200,a2f,recvmsg
1,48112427600,48112427800,00000000200,a2f,recvmsg
1,48112430200,48112431800,00000001600,a14,writev
1,48112432200,48112439700,00000007500,a07,poll
1,48112441000,48112441100,00000000100,a2f,recvmsg
1,48112441500,48112441700,00000000200,a2f,recvmsg
1,48112442900,48112444400,00000001500,a14,writev
1,48112444800,48112452000,00000007200,a07,poll
1,48112453400,48112453500,00000000100,a2f,recvmsg
1,48112453700,48112453900,00000000200,a2f,recvmsg
1,48112456500,48112458200,00000001700,a14,writev
1,48112458700,48112466300,00000007600,a07,poll
1,48112467700,48112467900,00000000200,a2f,recvmsg
1,48112468200,48112468400,00000000200,a2f,recvmsg
1,48112470200,48112471800,00000001600,a14,writev
1,48112472100,48112479700,00000007600,a07,poll
1,48112480900,48112481100,00000000200,a2f,recvmsg
1,48112481400,48112481600,00000000200,a2f,recvmsg
1,48112484100,48112485800,00000001700,a14,writev
1,48112486200,48112493500,00000007300,a07,poll
1,48112494900,48112495100,00000000200,a2f,recvmsg
1,48112495300,48112495500,00000000200,a2f,recvmsg
1,48112497200,48112498800,00000001600,a14,writev
1,48112499100,48112506500,00000007400,a07,poll
1,48112507800,48112508000,00000000200,a2f,recvmsg
1,48112508300,48112508500,00000000200,a2f,recvmsg
1,48112510100,48112511700,00000001600,a14,writev
1,48112512100,48112519300,00000007200,a07,poll
1,48112520500,48112520700,00000000200,a2f,recvmsg
1,48112521000,48112521200,00000000200,a2f,recvmsg
1,48112523800,48112525400,00000001600,a14,writev
1,48112525700,48112533200,00000007500,a07,poll
1,48112535200,48112535400,00000000200,a2f,recvmsg
1,48112535700,48112535900,00000000200,a2f,recvmsg
1,48112537400,48112539000,00000001600,a14,writev
1,48112539400,48112546700,00000007300,a07,poll
1,48112548100,48112548200,00000000100,a2f,recvmsg
1,48112548500,48112548600,00000000100,a2f,recvmsg
1,48112549800,48112551300,00000001500,a14,writev
1,48112551700,48112559200,00000007500,a07,poll
1,48112560500,48112560600,00000000100,a2f,recvmsg
1,48112560900,48112561100,00000000200,a2f,recvmsg
1,48112566000,48112567700,00000001700,a14,writev
1,48112568000,48112575500,00000007500,a07,poll
1,48112576800,48112577000,00000000200,a2f,recvmsg
1,48112577200,48112577400,00000000200,a2f,recvmsg
1,48112578600,48112580100,00000001500,a14,writev
1,48112580400,48112587900,00000007500,a07,poll
1,48112589100,48112589200,00000000100,a2f,recvmsg
1,48112589600,48112589800,00000000200,a2f,recvmsg
1,48112590900,48112592500,00000001600,a14,writev
1,48112592800,48112600300,00000007500,a07,poll
1,48112601700,48112601800,00000000100,a2f,recvmsg
1,48112602100,48112602300,00000000200,a2f,recvmsg
1,48112603500,48112605000,00000001500,a14,writev
1,48112605300,48112612700,00000007400,a07,poll
1,48112614000,48112614200,00000000200,a2f,recvmsg
1,48112614500,48112614700,00000000200,a2f,recvmsg
1,48112616300,48112617900,00000001600,a14,writev
1,48112618200,48112625500,00000007300,a07,poll
1,48112626800,48112627000,00000000200,a2f,recvmsg
1,48112627300,48112627500,00000000200,a2f,recvmsg
1,48112628700,48112630300,00000001600,a14,writev
1,48112630600,48112638000,00000007400,a07,poll
1,48112639300,48112639500,00000000200,a2f,recvmsg
1,48112639700,48112639900,00000000200,a2f,recvmsg
1,48112641700,48112643400,00000001700,a14,writev
1,48112643600,48112651100,00000007500,a07,poll
1,48112652300,48112652500,00000000200,a2f,recvmsg
1,48112652800,48112653000,00000000200,a2f,recvmsg
1,48112654900,48112656400,00000001500,a14,writev
1,48112656800,48112664400,00000007600,a07,poll
1,48112665700,48112665900,00000000200,a2f,recvmsg
1,48112666200,48112666300,00000000100,a2f,recvmsg
1,48112669500,48112671400,00000001900,a14,writev
1,48112671700,48112679500,00000007800,a07,poll
1,48112680700,48112680900,00000000200,a2f,recvmsg
1,48112681200,48112681400,00000000200,a2f,recvmsg
1,48112683400,48112685000,00000001600,a14,writev
1,48112685300,48112692600,00000007300,a07,poll
1,48112693800,48112694000,00000000200,a2f,recvmsg
1,48112694300,48112694500,00000000200,a2f,recvmsg
1,48112697400,48112699000,00000001600,a14,writev
1,48112699400,48112707000,00000007600,a07,poll
1,48112708200,48112708400,00000000200,a2f,recvmsg
1,48112708700,48112708900,00000000200,a2f,recvmsg
1,48112712700,48112714200,00000001500,a14,writev
1,48112714600,48112722000,00000007400,a07,poll
1,48112723300,48112723500,00000000200,a2f,recvmsg
1,48112723800,48112724000,00000000200,a2f,recvmsg
1,48112725500,48112727100,00000001600,a14,writev
1,48112727500,48112734800,00000007300,a07,poll
1,48112736200,48112736400,00000000200,a2f,recvmsg
1,48112736600,48112736800,00000000200,a2f,recvmsg
1,48112738400,48112740000,00000001600,a14,writev
1,48112740300,48112747800,00000007500,a07,poll
1,48112749000,48112749200,00000000200,a2f,recvmsg
1,48112749500,48112749700,00000000200,a2f,recvmsg
1,48112752100,48112753700,00000001600,a14,writev
1,48112754100,48112761600,00000007500,a07,poll
1,48112763000,48112763200,00000000200,a2f,recvmsg
1,48112763400,48112763600,00000000200,a2f,recvmsg
1,48112765600,48112767200,00000001600,a14,writev
1,48112767500,48112775100,00000007600,a07,poll
1,48112776500,48112776500,00000000000,a2f,recvmsg
1,48112776800,48112777000,00000000200,a2f,recvmsg
1,48112779600,48112781300,00000001700,a14,writev
1,48112781600,48112789500,00000007900,a07,poll
1,48112790800,48112790900,00000000100,a2f,recvmsg
1,48112791200,48112791400,00000000200,a2f,recvmsg
1,48112793200,48112794800,00000001600,a14,writev
1,48112795200,48112802600,00000007400,a07,poll
1,48112803900,48112804100,00000000200,a2f,recvmsg
1,48112804400,48112804600,00000000200,a2f,recvmsg
1,48112806100,48112807700,00000001600,a14,writev
1,48112808000,48112815500,00000007500,a07,poll
1,48112816700,48112816900,00000000200,a2f,recvmsg
1,48112817200,48112817400,00000000200,a2f,recvmsg
1,48112818700,48112820200,00000001500,a14,writev
1,48112820500,48112827800,00000007300,a07,poll
1,48112829200,48112829300,00000000100,a2f,recvmsg
1,48112829700,48112829700,00000000000,a2f,recvmsg
1,48112831700,48112833400,00000001700,a14,writev
1,48112833600,48112841100,00000007500,a07,poll
1,48112842400,48112842600,00000000200,a2f,recvmsg
1,48112842900,48112843000,00000000100,a2f,recvmsg
1,48112844200,48112844300,00000000100,a08,lseek
1,48112846800,48112847800,00000001000,a00,read
1,48112851500,48112851600,00000000100,a08,lseek
1,48112852600,48112854400,00000001800,a14,writev
1,48112854700,48112861900,00000007200,a07,poll
1,48112863500,48112863600,00000000100,a2f,recvmsg
1,48112863900,48112864100,00000000200,a2f,recvmsg
1,48112887800,48112889500,00000001700,a14,writev
1,48112889900,48112897300,00000007400,a07,poll
1,48112898700,48112898900,00000000200,a2f,recvmsg
1,48112899200,48112899400,00000000200,a2f,recvmsg
1,48112903200,48112903900,00000000700,a00,read
1,48112909500,48112909500,00000000000,a08,lseek
1,48112911100,48112912700,00000001600,a14,writev
1,48112913000,48112920300,00000007300,a07,poll
1,48112921700,48112921800,00000000100,a2f,recvmsg
1,48112922200,48112922400,00000000200,a2f,recvmsg
1,48112923500,48112925200,00000001700,a14,writev
1,48112925500,48112932900,00000007400,a07,poll
1,48112934200,48112934300,00000000100,a2f,recvmsg
1,48112934600,48112934800,00000000200,a2f,recvmsg
1,48112936100,48112937600,00000001500,a14,writev
1,48112937900,48112945200,00000007300,a07,poll
1,48112946500,48112946600,00000000100,a2f,recvmsg
1,48112947000,48112947100,00000000100,a2f,recvmsg
1,48112948300,48112949900,00000001600,a14,writev
1,48112950200,48112957400,00000007200,a07,poll
1,48112958800,48112958900,00000000100,a2f,recvmsg
1,48112959200,48112959400,00000000200,a2f,recvmsg
1,48112960600,48112962200,00000001600,a14,writev
1,48112962500,48112970000,00000007500,a07,poll
1,48112971200,48112971400,00000000200,a2f,recvmsg
1,48112971800,48112972000,00000000200,a2f,recvmsg
1,48112973000,48112974600,00000001600,a14,writev
1,48112975000,48112982300,00000007300,a07,poll
1,48112983600,48112983700,00000000100,a2f,recvmsg
1,48112984000,48112984200,00000000200,a2f,recvmsg
1,48112985400,48112986900,00000001500,a14,writev
1,48112987200,48112994500,00000007300,a07,poll
1,48112995700,48112995900,00000000200,a2f,recvmsg
1,48112996200,48112996400,00000000200,a2f,recvmsg
1,48112998200,48112999800,00000001600,a14,writev
1,48113000100,48113007700,00000007600,a07,poll
1,48113009000,48113009100,00000000100,a2f,recvmsg
1,48113009500,48113009700,00000000200,a2f,recvmsg
1,48113010900,48113012400,00000001500,a14,writev
1,48113012700,48113020100,00000007400,a07,poll
1,48113021400,48113021600,00000000200,a2f,recvmsg
1,48113021800,48113022000,00000000200,a2f,recvmsg
1,48113022600,48113022600,00000000000,a08,lseek
1,48113025100,48113026800,00000001700,a14,writev
1,48113027200,48113034600,00000007400,a07,poll
1,48113036000,48113036100,00000000100,a2f,recvmsg
1,48113036500,48113036700,00000000200,a2f,recvmsg
1,48113040000,48113041600,00000001600,a14,writev
1,48113042000,48113049500,00000007500,a07,poll
1,48113050800,48113050900,00000000100,a2f,recvmsg
1,48113051300,48113051500,00000000200,a2f,recvmsg
1,48113053200,48113054800,00000001600,a14,writev
1,48113055200,48113062300,00000007100,a07,poll
1,48113063600,48113063800,00000000200,a2f,recvmsg
1,48113064100,48113064300,00000000200,a2f,recvmsg
1,48113065800,48113067400,00000001600,a14,writev
1,48113067800,48113075000,00000007200,a07,poll
1,48113076400,48113076500,00000000100,a2f,recvmsg
1,48113076800,48113077000,00000000200,a2f,recvmsg
1,48113078600,48113080200,00000001600,a14,writev
1,48113080500,48113087800,00000007300,a07,poll
1,48113089000,48113089200,00000000200,a2f,recvmsg
1,48113089500,48113089700,00000000200,a2f,recvmsg
1,48113091100,48113092700,00000001600,a14,writev
1,48113093000,48113100400,00000007400,a07,poll
1,48113101700,48113101900,00000000200,a2f,recvmsg
1,48113102200,48113102400,00000000200,a2f,recvmsg
1,48113104200,48113105800,00000001600,a14,writev
1,48113106200,48113113400,00000007200,a07,poll
1,48113114700,48113114800,00000000100,a2f,recvmsg
1,48113115200,48113115300,00000000100,a2f,recvmsg
1,48113116800,48113118400,00000001600,a14,writev
1,48113118600,48113125900,00000007300,a07,poll
1,48113127200,48113127300,00000000100,a2f,recvmsg
1,48113127700,48113127900,00000000200,a2f,recvmsg
1,48113129200,48113130900,00000001700,a14,writev
1,48113131200,48113138600,00000007400,a07,poll
1,48113139900,48113140000,00000000100,a2f,recvmsg
1,48113140400,48113140600,00000000200,a2f,recvmsg
1,48113142000,48113143600,00000001600,a14,writev
1,48113143900,48113151200,00000007300,a07,poll
1,48113152600,48113152700,00000000100,a2f,recvmsg
1,48113153000,48113153200,00000000200,a2f,recvmsg
1,48113154600,48113156200,00000001600,a14,writev
1,48113156500,48113164000,00000007500,a07,poll
1,48113165300,48113165500,00000000200,a2f,recvmsg
1,48113165800,48113166000,00000000200,a2f,recvmsg
1,48113167400,48113168900,00000001500,a14,writev
1,48113169300,48113176500,00000007200,a07,poll
1,48113177800,48113178000,00000000200,a2f,recvmsg
1,48113178300,48113178500,00000000200,a2f,recvmsg
1,48113180500,48113182100,00000001600,a14,writev
1,48113182500,48113189700,00000007200,a07,poll
1,48113191000,48113191200,00000000200,a2f,recvmsg
1,48113191500,48113191700,00000000200,a2f,recvmsg
1,48113193000,48113194600,00000001600,a14,writev
1,48113195000,48113202300,00000007300,a07,poll
1,48113203700,48113203900,00000000200,a2f,recvmsg
1,48113204100,48113204300,00000000200,a2f,recvmsg
1,48113205900,48113207500,00000001600,a14,writev
1,48113207800,48113215100,00000007300,a07,poll
1,48113216300,48113216500,00000000200,a2f,recvmsg
1,48113216800,48113217000,00000000200,a2f,recvmsg
1,48113218400,48113219900,00000001500,a14,writev
1,48113220300,48113227600,00000007300,a07,poll
1,48113228900,48113229000,00000000100,a2f,recvmsg
1,48113229400,48113229600,00000000200,a2f,recvmsg
1,48113236500,48113238300,00000001800,a14,writev
1,48113238600,48113245900,00000007300,a07,poll
1,48113247400,48113247500,00000000100,a2f,recvmsg
1,48113247800,48113248000,00000000200,a2f,recvmsg
1,48113249600,48113251200,00000001600,a14,writev
1,48113251500,48113258800,00000007300,a07,poll
1,48113260000,48113260200,00000000200,a2f,recvmsg
1,48113260500,48113260700,00000000200,a2f,recvmsg
1,48113262200,48113263800,00000001600,a14,writev
1,48113264100,48113271500,00000007400,a07,poll
1,48113272800,48113272900,00000000100,a2f,recvmsg
1,48113273200,48113273400,00000000200,a2f,recvmsg
1,48113275100,48113276600,00000001500,a14,writev
1,48113277000,48113284200,00000007200,a07,poll
1,48113285600,48113285700,00000000100,a2f,recvmsg
1,48113286000,48113286200,00000000200,a2f,recvmsg
1,48113287700,48113289400,00000001700,a14,writev
1,48113289700,48113297100,00000007400,a07,poll
1,48113298400,48113298500,00000000100,a2f,recvmsg
1,48113298800,48113299000,00000000200,a2f,recvmsg
1,48113342800,48113347400,00000004600,a14,writev
1,48113348100,48113445800,00000097700,a07,poll
1,48113348100,48113449300,00000101200,a07,poll
1,48113462400,48113462500,00000000100,a2f,recvmsg
1,48113466900,48113467100,00000000200,a2f,recvmsg
1,48113467400,48113467600,00000000200,a2f,recvmsg
1,48113472500,48113472600,00000000100,a2f,recvmsg
1,48113472800,48113473000,00000000200,a2f,recvmsg
1,48113478100,48113478900,00000000800,a00,read
1,48113489800,48113490000,00000000200,a2f,recvmsg
1,48113473800,48113526200,00000052400,a07,poll
1,48113529000,48113529200,00000000200,a2f,recvmsg
1,48113529900,48113530100,00000000200,a2f,recvmsg
1,48113530300,48113530500,00000000200,a2f,recvmsg
1,48113531300,48113531500,00000000200,a2f,recvmsg
1,48113531700,48113531800,00000000100,a2f,recvmsg
1,48113539300,48113582500,00000043200,a07,poll
1,48113582700,48113583800,00000001100,a2f,recvmsg
1,48113539300,48113585000,00000045700,a07,poll
1,48113587000,48113587100,00000000100,a2f,recvmsg
1,48113587700,48113587800,00000000100,a2f,recvmsg
1,48113587900,48113588100,00000000200,a2f,recvmsg
1,48113588600,48113588800,00000000200,a2f,recvmsg
1,48113589000,48113589200,00000000200,a2f,recvmsg
1,48113591000,48113639600,00000048600,a07,poll
1,48113639800,48113641000,00000001200,a2f,recvmsg
1,48113591000,48113642100,00000051100,a07,poll
1,48113644900,48113645100,00000000200,a2f,recvmsg
1,48113645600,48113645800,00000000200,a2f,recvmsg
1,48113646000,48113646100,00000000100,a2f,recvmsg
1,48113646700,48113646700,00000000000,a2f,recvmsg
1,48113646900,48113647100,00000000200,a2f,recvmsg
1,48113648800,48113696100,00000047300,a07,poll
1,48113696200,48113697300,00000001100,a2f,recvmsg
1,48113648800,48113698400,00000049600,a07,poll
1,48113700000,48113700200,00000000200,a2f,recvmsg
1,48113700700,48113700900,00000000200,a2f,recvmsg
1,48113701100,48113701300,00000000200,a2f,recvmsg
1,48113701800,48113701900,00000000100,a2f,recvmsg
1,48113702000,48113702200,00000000200,a2f,recvmsg
1,48113703900,48113753300,00000049400,a07,poll
1,48113753600,48113754700,00000001100,a2f,recvmsg
1,48113703900,48113755800,00000051900,a07,poll
1,48113757400,48113757600,00000000200,a2f,recvmsg
1,48113758100,48113758300,00000000200,a2f,recvmsg
1,48113758500,48113758700,00000000200,a2f,recvmsg
1,48113759100,48113759300,00000000200,a2f,recvmsg
1,48113759500,48113759600,00000000100,a2f,recvmsg
1,48113761300,48113809100,00000047800,a07,poll
1,48113810300,48113853700,00000043400,a07,poll
1,48113854800,48113898100,00000043300,a07,poll
1,48113899300,48113941900,00000042600,a07,poll
1,48113944200,48113986500,00000042300,a07,poll
1,48113987900,48114030500,00000042600,a07,poll
1,48114032000,48114084300,00000052300,a07,poll
1,48114085500,48114103700,00000018200,a07,poll
1,48114105000,48114120700,00000015700,a07,poll
1,48114121900,48114136900,00000015000,a07,poll
1,48114138300,48114152900,00000014600,a07,poll
1,48114154300,48114167800,00000013500,a07,poll
1,48114169100,48114173800,00000004700,a07,poll
1,48114176300,48114176400,00000000100,a2f,recvmsg
1,48114176900,48114177100,00000000200,a2f,recvmsg
1,48114198800,48114200400,00000001600,a07,poll
1,48114200800,48114202200,00000001400,a2f,recvmsg
1,48114206900,48114208200,00000001300,a2d,recvfrom
1,48114198800,48114210800,00000012000,a07,poll
1,48114213500,48114213700,00000000200,a2f,recvmsg
1,48114214600,48114214800,00000000200,a2f,recvmsg
1,48114214900,48114215100,00000000200,a2f,recvmsg
1,48114216100,48114216300,00000000200,a2f,recvmsg
1,48114216500,48114216600,00000000100,a2f,recvmsg
1,48114222000,48114222200,00000000200,a2f,recvmsg
1,48114222700,48114222900,00000000200,a2f,recvmsg
1,48114280600,48114280900,00000000300,a2f,recvmsg
1,48114283400,48114283600,00000000200,a2f,recvmsg
1,48114286400,48114289900,00000003500,a07,poll
1,48114292300,48114292500,00000000200,a2f,recvmsg
1,48114292900,48114293100,00000000200,a2f,recvmsg
1,48114845500,48114852900,00000007400,a02,open
1,48114871000,48114874100,00000003100,a00,read
1,48114925600,48114926600,00000001000,a00,read
1,48114975200,48114976100,00000000900,a00,read
1,48115022100,48115023000,00000000900,a00,read
1,48115070300,48115071100,00000000800,a00,read
1,48115116600,48115117300,00000000700,a00,read
1,48115161300,48115162100,00000000800,a00,read
1,48115206800,48115207500,00000000700,a00,read
1,48115255200,48115256000,00000000800,a00,read
1,48115305100,48115305800,00000000700,a00,read
1,48115353100,48115353700,00000000600,a00,read
1,48115382100,48115383700,00000001600,a02,open
1,48115387000,48115387900,00000000900,a00,read
1,48115441800,48115442500,00000000700,a00,read
1,48115525600,48115526400,00000000800,a00,read
1,48079316700,48115592400,00036275700,a4a,fsync
1,48115597800,48115598500,00000000700,a00,read
1,48115647800,48115652300,00000004500,a09,mmap
1,48115674400,48115675100,00000000700,a00,read
1,48114286400,48115729200,00001442800,a07,poll
1,48115733400,48115735200,00000001800,aca,futex
1,48115738900,48115739800,00000000900,aca,futex
1,48115742000,48115742800,00000000800,aca,futex
1,48115752400,48115753100,00000000700,a00,read
1,48115762100,48115762400,00000000300,a00,read
1,48079809600,48115770600,00035961000,ae8,epoll_wait
1,48115797600,48115797800,00000000200,a2f,recvmsg
1,48115817700,48115822100,00000004400,a2e,sendmsg
1,48115829000,48115829700,00000000700,a00,read
1,48115766800,48115881200,00000114400,a07,poll
1,48115882800,48115883800,00000001000,aca,futex
1,48115885400,48115886300,00000000900,aca,futex
1,48115887600,48115888500,00000000900,aca,futex
1,48115891000,48115893300,00000002300,a2e,sendmsg
1,48115825200,48115900400,00000075200,ae8,epoll_wait
1,48115903700,48115904700,00000001000,a2f,recvmsg
1,48115912500,48115912700,00000000200,a2f,recvmsg
1,48115912500,48115913300,00000000800,a00,read
1,48115934700,48115935700,00000001000,a2e,sendmsg
1,48115978400,48115979300,00000000900,a00,read
1,48116036600,48116037200,00000000600,a00,read
1,48116095800,48116104400,00000008600,a01,write
1,48116105600,48116112900,00000007300,a14,writev
1,48116113700,48116137400,00000023700,a07,poll
1,48116207000,48116207300,00000000300,a00,read
1,48116243400,48116246100,00000002700,a01,write
1,48115937800,48116267200,00000329400,ae8,epoll_wait
1,48116271700,48116273800,00000002100,a2f,recvmsg
1,48116283000,48116283200,00000000200,a2f,recvmsg
1,48116296400,48116299400,00000003000,a2e,sendmsg
1,48116248800,48116301200,00000052400,a07,poll
1,48116301900,48116302400,00000000500,a00,read
1,48116311300,48116312100,00000000800,a2f,recvmsg
1,48116108400,48116925600,00000817200,a4a,fsync
1,48116978400,48116984900,00000006500,a09,mmap
1,48116369300,48117049800,00000680500,a07,poll
1,48117053400,48117055100,00000001700,aca,futex
1,48117058600,48117059500,00000000900,aca,futex
1,48117061300,48117062300,00000001000,aca,futex
1,48117078000,48117078200,00000000200,a00,read
1,48116378200,48117085800,00000707600,ae8,epoll_wait
1,48117111600,48117111900,00000000300,a2f,recvmsg
1,48117131000,48117135400,00000004400,a2e,sendmsg
1,48117082600,48117190800,00000108200,a07,poll
1,48117192300,48117193400,00000001100,aca,futex
1,48117195100,48117195900,00000000800,aca,futex
1,48117197400,48117198100,00000000700,aca,futex
1,48117200600,48117202700,00000002100,a2e,sendmsg
1,48117139000,48117209900,00000070900,ae8,epoll_wait
1,48117212700,48117213700,00000001000,a2f,recvmsg
1,48117221800,48117222000,00000000200,a2f,recvmsg
1,48117244200,48117245300,00000001100,a2e,sendmsg
1,48117401600,48117411100,00000009500,a01,write
1,48117264400,48117442400,00000178000,a07,poll
1,48117499900,48117500200,00000000300,a00,read
1,48117537500,48117540400,00000002900,a01,write
1,48117543100,48117547200,00000004100,a07,poll
1,48117548300,48117551000,00000002700,a2f,recvmsg
1,48117247200,48117553100,00000305900,ae8,epoll_wait
1,48117567000,48117568100,00000001100,a2f,recvmsg
1,48117576600,48117576900,00000000300,a2f,recvmsg
1,48117589900,48117592600,00000002700,a2e,sendmsg
1,48117543100,48117594300,00000051200,a07,poll
1,48117594900,48117595300,00000000400,a00,read
1,48117603800,48117604500,00000000700,a2f,recvmsg
1,48117688200,48117689000,00000000800,a2f,recvmsg
1,48117689900,48117690100,00000000200,a2f,recvmsg
1,48117692600,48117696600,00000004000,a14,writev
1,48117697300,48117720600,00000023300,a07,poll
1,48117722500,48117722700,00000000200,a2f,recvmsg
1,48117723000,48117723200,00000000200,a2f,recvmsg
1,48117730200,48117733700,00000003500,a06,lstat
1,48117734500,48117735400,00000000900,a06,lstat
1,48117753300,48117760900,00000007600,a01,write
1,48117764300,48117767600,00000003300,a14,writev
1,48117768200,48117780900,00000012700,a07,poll
1,48117783300,48117783500,00000000200,a2f,recvmsg
1,48117784100,48117784300,00000000200,a2f,recvmsg
1,48117785600,48118101300,00000315700,a38,clone
1,48118618400,48118618500,00000000100,a0c,brk
1,48118628600,48118631800,00000003200,a15,access
1,48118632600,48118633600,00000001000,a09,mmap
1,48118638100,48118639900,00000001800,a15,access
1,48118646500,48118647500,00000001000,a09,mmap
1,48118651300,48118651700,00000000400,a15,access
1,48118659600,48118660800,00000001200,a00,read
1,48118662200,48118663900,00000001700,a09,mmap
1,48118668000,48118670100,00000002100,a09,mmap
1,48118681800,48118682500,00000000700,a15,access
1,48118686200,48118686900,00000000700,a00,read
1,48118687500,48118688500,00000001000,a09,mmap
1,48118691500,48118693000,00000001500,a09,mmap
1,48118700800,48118701500,00000000700,a15,access
1,48118704300,48118705100,00000000800,a00,read
1,48118705800,48118706500,00000000700,a09,mmap
1,48118708200,48118710300,00000002100,a09,mmap
1,48118715200,48118718400,00000003200,a09,mmap
1,48118720400,48118721500,00000001100,a09,mmap
1,48118730100,48118730800,00000000700,a15,access
1,48118733300,48118734000,00000000700,a00,read
1,48118734700,48118736300,00000001600,a09,mmap
1,48118739500,48118741200,00000001700,a09,mmap
1,48118749700,48118750100,00000000400,a15,access
1,48118753300,48118753900,00000000600,a00,read
1,48118760100,48118762500,00000002400,a09,mmap
1,48118770900,48118771500,00000000600,a15,access
1,48118773900,48118774500,00000000600,a00,read
1,48118775000,48118776100,00000001100,a09,mmap
1,48118777400,48118778800,00000001400,a09,mmap
1,48118782000,48118783100,00000001100,a09,mmap
1,48118789500,48118790200,00000000700,a15,access
1,48118792600,48118793200,00000000600,a00,read
1,48118793800,48118795200,00000001400,a09,mmap
1,48118797900,48118799600,00000001700,a09,mmap
1,48118813300,48118813900,00000000600,a09,mmap
1,48118817800,48118818100,00000000300,a09,mmap
1,48118819200,48118819500,00000000300,a09,mmap
1,48119000700,48119000800,00000000100,a0c,brk
1,48119000900,48119001700,00000000800,a0c,brk
1,48119036500,48119037300,00000000800,a00,read
1,48119050300,48119051700,00000001400,a00,read
1,48119084800,48119085700,00000000900,a00,read
1,48119208100,48119209000,00000000900,a00,read
1,48119279400,48119279900,00000000500,a00,read
1,48119365400,48119366100,00000000700,a00,read
1,48119496500,48119497300,00000000800,a00,read
1,48119626100,48119626800,00000000700,a00,read
1,48119782400,48119783100,00000000700,a00,read
1,48119933100,48119933800,00000000700,a00,read
1,48119970300,48119971800,00000001500,a0c,brk
1,48120086600,48120087300,00000000700,a00,read
1,48120246900,48120247600,00000000700,a00,read
1,48120401800,48120402700,00000000900,a00,read
1,48120562600,48120563300,00000000700,a00,read
1,48120671600,48120672300,00000000700,a00,read
1,48120702800,48120703500,00000000700,a0c,brk
1,48120812900,48120813600,00000000700,a00,read
1,48121057600,48121058300,00000000700,a00,read
1,48121070500,48121071000,00000000500,a00,read
1,48121115500,48121115800,00000000300,a00,read
1,48121135500,48121136300,00000000800,a00,read
1,48121342200,48121342600,00000000400,a00,read
1,48121371400,48121372300,00000000900,a00,read
1,48121468800,48121469400,00000000600,a00,read
1,48121539600,48121540000,00000000400,a00,read
1,48121617400,48121618200,00000000800,a00,read
1,48121771000,48121771400,00000000400,a00,read
1,48121882700,48121883200,00000000500,a00,read
1,48121977100,48121977700,00000000600,a00,read
1,48121989600,48121990100,00000000500,a00,read
1,48122070300,48122070800,00000000500,a00,read
1,48122095500,48122095800,00000000300,a00,read
1,48122118000,48122118500,00000000500,a00,read
1,48122219400,48122220400,00000001000,a0c,brk
1,48122222200,48122223200,00000001000,a00,read
1,48122423400,48122423800,00000000400,a00,read
1,48122506600,48122507200,00000000600,a00,read
1,48122570700,48122571200,00000000500,a00,read
1,48122698800,48122699300,00000000500,a00,read
1,48122731700,48122732300,00000000600,a00,read
1,48122748400,48122750000,00000001600,a02,open
1,48122861200,48122861700,00000000500,a00,read
1,48122932000,48122932400,00000000400,a00,read
1,48122984700,48122985900,00000001200,a0c,brk
1,48122993500,48122994300,00000000800,a00,read
1,48123100600,48123101200,00000000600,a00,read
1,48123251500,48123252500,00000001000,a00,read
1,48123382600,48123383300,00000000700,a00,read
1,48123440700,48123441300,00000000600,a00,read
1,48123496600,48123497400,00000000800,a00,read
1,48123566900,48123567600,00000000700,a00,read
1,48123620200,48123620900,00000000700,a00,read
1,48123708600,48123709200,00000000600,a0c,brk
1,48123741000,48123744600,00000003600,a0c,brk
1,48123758900,48123759800,00000000900,a00,read
1,48123874200,48123875100,00000000900,a00,read
1,48124033300,48124034000,00000000700,a00,read
1,48124150600,48124151300,00000000700,a00,read
1,48124302200,48124303000,00000000800,a00,read
1,48124419700,48124420300,00000000600,a00,read
1,48124581200,48124581800,00000000600,a00,read
1,48124586800,48124587600,00000000800,a0c,brk
1,48124702900,48124703600,00000000700,a00,read
1,48124821300,48124822000,00000000700,a00,read
1,48124963300,48124964000,00000000700,a00,read
1,48125094500,48125095200,00000000700,a00,read
1,48125187400,48125188100,00000000700,a00,read
1,48125300000,48125300700,00000000700,a00,read
1,48125424100,48125424900,00000000800,a00,read
1,48125537500,48125538100,00000000600,a0c,brk
1,48125560700,48125561400,00000000700,a00,read
1,48125729800,48125730400,00000000600,a00,read
1,48125880300,48125880900,00000000600,a00,read
1,48125991000,48125991700,00000000700,a00,read
1,48126159900,48126160700,00000000800,a00,read
1,48126237200,48126238000,00000000800,a00,read
1,48126319400,48126320100,00000000700,a00,read
1,48126387100,48126387700,00000000600,a0c,brk
1,48126401200,48126401800,00000000600,a00,read
1,48126474300,48126474900,00000000600,a00,read
1,48126576000,48126576600,00000000600,a00,read
1,48126678200,48126678800,00000000600,a00,read
1,48126768100,48126768700,00000000600,a00,read
1,48126848900,48126849500,00000000600,a00,read
1,48126950700,48126951400,00000000700,a00,read
1,48127032000,48127032200,00000000200,a0c,brk
1,48127034600,48127035400,00000000800,a00,read
1,48127142100,48127142600,00000000500,a00,read
1,48127234900,48127235500,00000000600,a00,read
1,48127353800,48127354400,00000000600,a00,read
1,48127467400,48127468100,00000000700,a00,read
1,48127571600,48127572200,00000000600,a00,read
1,48127671800,48127672200,00000000400,a0c,brk
1,48128031400,48128035000,00000003600,a57,unlink
1,48128035700,48128060100,00000024400,a02,open
1,48128061400,48128062000,00000000600,a48,fcntl
1,48128108800,48128123200,00000014400,a01,write
1,48128141200,48128143600,00000002400,a01,write
1,48117768200,48128240200,00010472000,a07,poll
1,48117768200,48128243500,00010475300,a07,poll
1,48128256800,48128257000,00000000200,a2f,recvmsg
1,48128261600,48128261800,00000000200,a2f,recvmsg
1,48128262100,48128262300,00000000200,a2f,recvmsg
1,48128267600,48128267700,00000000100,a2f,recvmsg
1,48128267900,48128268100,00000000200,a2f,recvmsg
1,48128283400,48128283700,00000000300,a2f,recvmsg
1,48128318400,48128321400,00000003000,a07,poll
1,48128324300,48128324500,00000000200,a2f,recvmsg
1,48128325300,48128325400,00000000100,a2f,recvmsg
1,48128325600,48128325800,00000000200,a2f,recvmsg
1,48128326600,48128326800,00000000200,a2f,recvmsg
1,48128327000,48128327200,00000000200,a2f,recvmsg
1,48128327400,48128377600,00000050200,a07,poll
1,48128327400,48128379300,00000051900,a07,poll
1,48128381100,48128381200,00000000100,a2f,recvmsg
1,48128381700,48128381900,00000000200,a2f,recvmsg
1,48128382100,48128382200,00000000100,a2f,recvmsg
1,48128382800,48128382900,00000000100,a2f,recvmsg
1,48128383100,48128383200,00000000100,a2f,recvmsg
1,48128385800,48128435000,00000049200,a07,poll
1,48128435200,48128437100,00000001900,a2f,recvmsg
1,48128385800,48128438200,00000052400,a07,poll
1,48128439900,48128440100,00000000200,a2f,recvmsg
1,48128440500,48128440700,00000000200,a2f,recvmsg
1,48128440900,48128441100,00000000200,a2f,recvmsg
1,48128441600,48128441800,00000000200,a2f,recvmsg
1,48128442000,48128442000,00000000000,a2f,recvmsg
1,48128443900,48128492500,00000048600,a07,poll
1,48128443900,48128494500,00000050600,a07,poll
1,48128496200,48128496400,00000000200,a2f,recvmsg
1,48128496900,48128497100,00000000200,a2f,recvmsg
1,48128497100,48128497300,00000000200,a2f,recvmsg
1,48128497900,48128498000,00000000100,a2f,recvmsg
1,48128498200,48128498400,00000000200,a2f,recvmsg
1,48128498200,48128500100,00000001900,a2f,recvmsg
1,48128500800,48128556400,00000055600,a07,poll
1,48128556700,48128557800,00000001100,a2f,recvmsg
1,48128500800,48128558900,00000058100,a07,poll
1,48128560600,48128560800,00000000200,a2f,recvmsg
1,48128561300,48128561500,00000000200,a2f,recvmsg
1,48128561700,48128561700,00000000000,a2f,recvmsg
1,48128562300,48128562500,00000000200,a2f,recvmsg
1,48128562700,48128562800,00000000100,a2f,recvmsg
1,48128565300,48128612900,00000047600,a07,poll
1,48128614400,48128657400,00000043000,a07,poll
1,48128658600,48128701400,00000042800,a07,poll
1,48128702900,48128744200,00000041300,a07,poll
1,48128745500,48128788200,00000042700,a07,poll
1,48128789400,48128830700,00000041300,a07,poll
1,48128831900,48128885700,00000053800,a07,poll
1,48128886800,48128904000,00000017200,a07,poll
1,48128905300,48128921400,00000016100,a07,poll
1,48128922700,48128937500,00000014800,a07,poll
1,48128938700,48128952800,00000014100,a07,poll
1,48128954000,48128968300,00000014300,a07,poll
1,48128970100,48128997700,00000027600,a07,poll
1,48128997900,48128999400,00000001500,a2f,recvmsg
1,48129000600,48129002200,00000001600,a2d,recvfrom
1,48129005900,48129006200,00000000300,a2f,recvmsg
1,48129006600,48129006800,00000000200,a2f,recvmsg
1,48129060900,48129061200,00000000300,a2f,recvmsg
1,48129063300,48129063500,00000000200,a2f,recvmsg
1,48129066000,48129418900,00000352900,a07,poll
1,48129421800,48129422000,00000000200,a2f,recvmsg
1,48129422700,48129422800,00000000100,a2f,recvmsg
1,48129423000,48129423200,00000000200,a2f,recvmsg
1,48129424100,48129424300,00000000200,a2f,recvmsg
1,48129424400,48129424600,00000000200,a2f,recvmsg
1,48136163000,48136166400,00000003400,a01,write
1,48118123300,48136333700,00018210400,a3d,wait4
1,48136356000,48136358800,00000002800,a00,read
1,48136361100,48136361400,00000000300,a00,read
1,48136370900,48136380300,00000009400,a14,writev
1,48136383300,48136412500,00000029200,a07,poll
1,48136417500,48136417800,00000000300,a2f,recvmsg
1,48136418600,48136418800,00000000200,a2f,recvmsg
1,48136421500,48136423300,00000001800,a14,writev
1,48136423700,48136431900,00000008200,a07,poll
1,48136433300,48136433400,00000000100,a2f,recvmsg
1,48136433700,48136433900,00000000200,a2f,recvmsg
1,48136435800,48136437500,00000001700,a14,writev
1,48136437800,48136445500,00000007700,a07,poll
1,48136446700,48136446900,00000000200,a2f,recvmsg
1,48136447200,48136447400,00000000200,a2f,recvmsg
1,48136449100,48136450700,00000001600,a14,writev
1,48136451000,48136459200,00000008200,a07,poll
1,48136460400,48136460600,00000000200,a2f,recvmsg
1,48136460900,48136461100,00000000200,a2f,recvmsg
1,48136462600,48136464100,00000001500,a14,writev
1,48136464500,48136472600,00000008100,a07,poll
1,48136473900,48136474000,00000000100,a2f,recvmsg
1,48136474400,48136474600,00000000200,a2f,recvmsg
1,48136475500,48136477100,00000001600,a14,writev
1,48136477400,48136485000,00000007600,a07,poll
1,48136486300,48136486500,00000000200,a2f,recvmsg
1,48136486700,48136486900,00000000200,a2f,recvmsg
1,48136488300,48136488500,00000000200,a08,lseek
1,48136498700,48136498700,00000000000,a08,lseek
1,48136499700,48136501400,00000001700,a14,writev
1,48136501700,48136509300,00000007600,a07,poll
1,48136510800,48136510900,00000000100,a2f,recvmsg
1,48136511300,48136511300,00000000000,a2f,recvmsg
1,48136515000,48136516700,00000001700,a14,writev
1,48136517000,48136524400,00000007400,a07,poll
1,48136525800,48136525900,00000000100,a2f,recvmsg
1,48136526300,48136526500,00000000200,a2f,recvmsg
1,48136527900,48136529300,00000001400,a14,writev
1,48117669100,48136535400,00018866300,ae8,epoll_wait
1,48136529700,48136536900,00000007200,a07,poll
1,48136538300,48136538400,00000000100,a2f,recvmsg
1,48136538700,48136538900,00000000200,a2f,recvmsg
1,48136541900,48136543600,00000001700,a14,writev
1,48136546400,48136548300,00000001900,a2f,recvmsg
1,48136543900,48136551200,00000007300,a07,poll
1,48136553300,48136553500,00000000200,a2f,recvmsg
1,48136553800,48136554000,00000000200,a2f,recvmsg
1,48136556400,48136558000,00000001600,a14,writev
1,48136558300,48136565700,00000007400,a07,poll
1,48136567100,48136567300,00000000200,a2f,recvmsg
1,48136567600,48136567800,00000000200,a2f,recvmsg
1,48136571000,48136571200,00000000200,a2f,recvmsg
1,48136569600,48136571200,00000001600,a14,writev
1,48136571600,48136578800,00000007200,a07,poll
1,48136580100,48136580300,00000000200,a2f,recvmsg
1,48136580600,48136580800,00000000200,a2f,recvmsg
1,48136582400,48136584000,00000001600,a14,writev
1,48136584400,48136591900,00000007500,a07,poll
1,48136593200,48136593300,00000000100,a2f,recvmsg
1,48136593700,48136593800,00000000100,a2f,recvmsg
1,48136595100,48136596800,00000001700,a14,writev
1,48136594400,48136599000,00000004600,a2e,sendmsg
1,48136598000,48136604400,00000006400,a07,poll
1,48136605700,48136605900,00000000200,a2f,recvmsg
1,48136606200,48136606300,00000000100,a2f,recvmsg
1,48136606500,48136607800,00000001300,a2e,sendmsg
1,48136609100,48136610600,00000001500,a14,writev
1,48136611000,48136614300,00000003300,a07,poll
1,48136616100,48136616800,00000000700,a00,read
1,48136611000,48136618800,00000007800,a07,poll
1,48136620100,48136620300,00000000200,a2f,recvmsg
1,48136620600,48136620800,00000000200,a2f,recvmsg
1,48136622500,48136624200,00000001700,a14,writev
1,48136624500,48136632000,00000007500,a07,poll
1,48136633200,48136633400,00000000200,a2f,recvmsg
1,48136633700,48136633900,00000000200,a2f,recvmsg
1,48136634000,48136635600,00000001600,a2f,recvmsg
1,48136635500,48136637100,00000001600,a14,writev
1,48136637500,48136644900,00000007400,a07,poll
1,48136646200,48136646300,00000000100,a2f,recvmsg
1,48136646600,48136646900,00000000300,a2f,recvmsg
1,48136648500,48136650100,00000001600,a14,writev
1,48136650400,48136657900,00000007500,a07,poll
1,48136660000,48136660200,00000000200,a2f,recvmsg
1,48136660600,48136660800,00000000200,a2f,recvmsg
1,48136662400,48136664000,00000001600,a14,writev
1,48136664400,48136671600,00000007200,a07,poll
1,48136672900,48136673200,00000000300,a2f,recvmsg
1,48136673500,48136673700,00000000200,a2f,recvmsg
1,48136675400,48136677000,00000001600,a14,writev
1,48136677300,48136684500,00000007200,a07,poll
1,48136685900,48136686100,00000000200,a2f,recvmsg
1,48136686300,48136686500,00000000200,a2f,recvmsg
1,48136688100,48136689600,00000001500,a14,writev
1,48136689900,48136697200,00000007300,a07,poll
1,48136698500,48136698700,00000000200,a2f,recvmsg
1,48136699000,48136699200,00000000200,a2f,recvmsg
1,48136700300,48136702000,00000001700,a14,writev
1,48136707700,48136709900,00000002200,a07,poll
1,48136711100,48136711200,00000000100,a2f,recvmsg
1,48136711600,48136711800,00000000200,a2f,recvmsg
1,48136716500,48136717300,00000000800,a2f,recvmsg
1,48136716500,48136718100,00000001600,a14,writev
1,48136719800,48136720000,00000000200,a00,read
1,48136719500,48136725600,00000006100,a07,poll
1,48136726900,48136727000,00000000100,a2f,recvmsg
1,48136727400,48136727600,00000000200,a2f,recvmsg
1,48136728600,48136730200,00000001600,a14,writev
1,48136730500,48136737800,00000007300,a07,poll
1,48136739200,48136739300,00000000100,a2f,recvmsg
1,48136739600,48136739800,00000000200,a2f,recvmsg
1,48136741000,48136742600,00000001600,a14,writev
1,48136742900,48136750200,00000007300,a07,poll
1,48136751500,48136751700,00000000200,a2f,recvmsg
1,48136752000,48136752200,00000000200,a2f,recvmsg
1,48136753300,48136754800,00000001500,a14,writev
1,48136757500,48136762600,00000005100,a07,poll
1,48136764000,48136764100,00000000100,a2f,recvmsg
1,48136764400,48136764600,00000000200,a2f,recvmsg
1,48136766100,48136767700,00000001600,a14,writev
1,48136768500,48136772700,00000004200,a07,poll
1,48136768500,48136775300,00000006800,a07,poll
1,48136776700,48136776900,00000000200,a2f,recvmsg
1,48136777200,48136777300,00000000100,a2f,recvmsg
1,48136778700,48136780300,00000001600,a14,writev
1,48136780700,48136787900,00000007200,a07,poll
1,48136789200,48136789400,00000000200,a2f,recvmsg
1,48136789700,48136789900,00000000200,a2f,recvmsg
1,48136791600,48136793100,00000001500,a14,writev
1,48136793500,48136800800,00000007300,a07,poll
1,48136802100,48136802200,00000000100,a2f,recvmsg
1,48136802500,48136802700,00000000200,a2f,recvmsg
1,48136804500,48136806100,00000001600,a14,writev
1,48136806400,48136813700,00000007300,a07,poll
1,48136815100,48136815300,00000000200,a2f,recvmsg
1,48136815500,48136815700,00000000200,a2f,recvmsg
1,48136818800,48136820400,00000001600,a14,writev
1,48136820700,48136828300,00000007600,a07,poll
1,48136829500,48136829700,00000000200,a2f,recvmsg
1,48136830000,48136830200,00000000200,a2f,recvmsg
1,48136832300,48136833800,00000001500,a14,writev
1,48136834200,48136841500,00000007300,a07,poll
1,48136842700,48136842900,00000000200,a2f,recvmsg
1,48136843200,48136843400,00000000200,a2f,recvmsg
1,48136845300,48136846800,00000001500,a14,writev
1,48136847100,48136854400,00000007300,a07,poll
1,48136855700,48136855900,00000000200,a2f,recvmsg
1,48136856200,48136856400,00000000200,a2f,recvmsg
1,48136860300,48136861900,00000001600,a14,writev
1,48136862200,48136869600,00000007400,a07,poll
1,48136871000,48136871200,00000000200,a2f,recvmsg
1,48136871500,48136871700,00000000200,a2f,recvmsg
1,48136873100,48136874700,00000001600,a14,writev
1,48136875000,48136882500,00000007500,a07,poll
1,48136883800,48136884000,00000000200,a2f,recvmsg
1,48136884300,48136884500,00000000200,a2f,recvmsg
1,48136887000,48136888500,00000001500,a14,writev
1,48136888900,48136896800,00000007900,a07,poll
1,48136898000,48136898200,00000000200,a2f,recvmsg
1,48136898500,48136898700,00000000200,a2f,recvmsg
1,48136901000,48136902700,00000001700,a14,writev
1,48136903000,48136910300,00000007300,a07,poll
1,48136911700,48136911900,00000000200,a2f,recvmsg
1,48136912200,48136912300,00000000100,a2f,recvmsg
1,48136914200,48136915900,00000001700,a14,writev
1,48136916100,48136923700,00000007600,a07,poll
1,48136925100,48136925300,00000000200,a2f,recvmsg
1,48136925500,48136925700,00000000200,a2f,recvmsg
1,48136928000,48136929500,00000001500,a14,writev
1,48136929900,48136937300,00000007400,a07,poll
1,48136938600,48136938800,00000000200,a2f,recvmsg
1,48136939000,48136939200,00000000200,a2f,recvmsg
1,48136941000,48136942600,00000001600,a14,writev
1,48136942900,48136950200,00000007300,a07,poll
1,48136951500,48136951700,00000000200,a2f,recvmsg
1,48136952000,48136952100,00000000100,a2f,recvmsg
1,48136953700,48136955300,00000001600,a14,writev
1,48136955600,48136962900,00000007300,a07,poll
1,48136964200,48136964400,00000000200,a2f,recvmsg
1,48136964700,48136964900,00000000200,a2f,recvmsg
1,48136966200,48136967700,00000001500,a14,writev
1,48136968100,48136975300,00000007200,a07,poll
1,48136976800,48136976900,00000000100,a2f,recvmsg
1,48136977200,48136977400,00000000200,a2f,recvmsg
1,48136979200,48136980800,00000001600,a14,writev
1,48136981100,48136988500,00000007400,a07,poll
1,48136989800,48136990000,00000000200,a2f,recvmsg
1,48136990200,48136990400,00000000200,a2f,recvmsg
1,48136991600,48136991700,00000000100,a08,lseek
1,48136994400,48136995300,00000000900,a00,read
1,48136998900,48136999000,00000000100,a08,lseek
1,48137000000,48137001600,00000001600,a14,writev
1,48137002000,48137009200,00000007200,a07,poll
1,48137010700,48137010900,00000000200,a2f,recvmsg
1,48137011200,48137011400,00000000200,a2f,recvmsg
1,48137035800,48137037500,00000001700,a14,writev
1,48137037800,48137045200,00000007400,a07,poll
1,48137046700,48137046800,00000000100,a2f,recvmsg
1,48137047100,48137047300,00000000200,a2f,recvmsg
1,48137051200,48137052000,00000000800,a00,read
1,48137057400,48137057500,00000000100,a08,lseek
1,48137059000,48137060800,00000001800,a14,writev
1,48137061200,48137068500,00000007300,a07,poll
1,48137069900,48137070100,00000000200,a2f,recvmsg
1,48137070400,48137070600,00000000200,a2f,recvmsg
1,48137071800,48137073400,00000001600,a14,writev
1,48137073700,48137081100,00000007400,a07,poll
1,48137082300,48137082500,00000000200,a2f,recvmsg
1,48137082800,48137083000,00000000200,a2f,recvmsg
1,48137084100,48137085600,00000001500,a14,writev
1,48137085900,48137093200,00000007300,a07,poll
1,48137094500,48137094600,00000000100,a2f,recvmsg
1,48137094900,48137095100,00000000200,a2f,recvmsg
1,48137096400,48137098000,00000001600,a14,writev
1,48137098300,48137105600,00000007300,a07,poll
1,48137107000,48137107100,00000000100,a2f,recvmsg
1,48137107400,48137107600,00000000200,a2f,recvmsg
1,48137108700,48137110300,00000001600,a14,writev
1,48137110600,48137117900,00000007300,a07,poll
1,48137119300,48137119300,00000000000,a2f,recvmsg
1,48137119700,48137119800,00000000100,a2f,recvmsg
1,48137121000,48137122500,00000001500,a14,writev
1,48137122900,48137130100,00000007200,a07,poll
1,48137131300,48137131500,00000000200,a2f,recvmsg
1,48137131800,48137132000,00000000200,a2f,recvmsg
1,48137133100,48137134700,00000001600,a14,writev
1,48137135000,48137142600,00000007600,a07,poll
1,48137143900,48137144000,00000000100,a2f,recvmsg
1,48137144300,48137144500,00000000200,a2f,recvmsg
1,48137146300,48137147800,00000001500,a14,writev
1,48137148200,48137155800,00000007600,a07,poll
1,48137157100,48137157200,00000000100,a2f,recvmsg
1,48137157500,48137157700,00000000200,a2f,recvmsg
1,48137159100,48137160600,00000001500,a14,writev
1,48137160900,48137168200,00000007300,a07,poll
1,48137169500,48137169600,00000000100,a2f,recvmsg
1,48137170000,48137170100,00000000100,a2f,recvmsg
1,48137170600,48137170700,00000000100,a08,lseek
1,48137173500,48137175200,00000001700,a14,writev
1,48137175600,48137182800,00000007200,a07,poll
1,48137184100,48137184300,00000000200,a2f,recvmsg
1,48137184600,48137184800,00000000200,a2f,recvmsg
1,48137188200,48137189800,00000001600,a14,writev
1,48137190200,48137197700,00000007500,a07,poll
1,48137199100,48137199200,00000000100,a2f,recvmsg
1,48137199500,48137199700,00000000200,a2f,recvmsg
1,48137201400,48137202900,00000001500,a14,writev
1,48137203300,48137210500,00000007200,a07,poll
1,48137211900,48137212100,00000000200,a2f,recvmsg
1,48137212400,48137212500,00000000100,a2f,recvmsg
1,48137214000,48137215600,00000001600,a14,writev
1,48137216000,48137223300,00000007300,a07,poll
1,48137224600,48137224700,00000000100,a2f,recvmsg
1,48137225100,48137225300,00000000200,a2f,recvmsg
1,48137226600,48137228100,00000001500,a14,writev
1,48137228500,48137235600,00000007100,a07,poll
1,48137237100,48137237200,00000000100,a2f,recvmsg
1,48137237500,48137237700,00000000200,a2f,recvmsg
1,48137239100,48137240700,00000001600,a14,writev
1,48137241000,48137248300,00000007300,a07,poll
1,48137249700,48137249900,00000000200,a2f,recvmsg
1,48137250200,48137250400,00000000200,a2f,recvmsg
1,48137252300,48137253900,00000001600,a14,writev
1,48137257900,48137259800,00000001900,a2f,recvmsg
1,48137254200,48137261500,00000007300,a07,poll
1,48137262700,48137262900,00000000200,a2f,recvmsg
1,48137263200,48137263400,00000000200,a2f,recvmsg
1,48137264800,48137266400,00000001600,a14,writev
1,48137269300,48137269500,00000000200,a2f,recvmsg
1,48137270100,48137274000,00000003900,a07,poll
1,48137275300,48137275500,00000000200,a2f,recvmsg
1,48137275800,48137276000,00000000200,a2f,recvmsg
1,48137277400,48137278900,00000001500,a14,writev
1,48137279200,48137286500,00000007300,a07,poll
1,48137287800,48137288000,00000000200,a2f,recvmsg
1,48137288300,48137288400,00000000100,a2f,recvmsg
1,48137289800,48137291500,00000001700,a14,writev
1,48137291800,48137299000,00000007200,a07,poll
1,48137300200,48137300400,00000000200,a2f,recvmsg
1,48137300700,48137300900,00000000200,a2f,recvmsg
1,48137302300,48137303800,00000001500,a14,writev
1,48137304200,48137311500,00000007300,a07,poll
1,48137312900,48137313000,00000000100,a2f,recvmsg
1,48137313300,48137313500,00000000200,a2f,recvmsg
1,48137314900,48137316500,00000001600,a14,writev
1,48137316800,48137324200,00000007400,a07,poll
1,48137325500,48137325700,00000000200,a2f,recvmsg
1,48137326000,48137326200,00000000200,a2f,recvmsg
1,48137328300,48137329900,00000001600,a14,writev
1,48137330200,48137337600,00000007400,a07,poll
1,48137338800,48137339000,00000000200,a2f,recvmsg
1,48137339300,48137339500,00000000200,a2f,recvmsg
1,48137340900,48137342400,00000001500,a14,writev
1,48137342800,48137350100,00000007300,a07,poll
1,48137351300,48137351500,00000000200,a2f,recvmsg
1,48137351800,48137352000,00000000200,a2f,recvmsg
1,48137353400,48137354900,00000001500,a14,writev
1,48137355200,48137362500,00000007300,a07,poll
1,48137363800,48137364000,00000000200,a2f,recvmsg
1,48137364300,48137364400,00000000100,a2f,recvmsg
1,48137365900,48137367500,00000001600,a14,writev
1,48137367900,48137375200,00000007300,a07,poll
1,48137376500,48137376600,00000000100,a2f,recvmsg
1,48137377000,48137377100,00000000100,a2f,recvmsg
1,48137384000,48137385500,00000001500,a14,writev
1,48137385800,48137393100,00000007300,a07,poll
1,48137394800,48137394900,00000000100,a2f,recvmsg
1,48137395200,48137395400,00000000200,a2f,recvmsg
1,48137397000,48137398600,00000001600,a14,writev
1,48137398900,48137406200,00000007300,a07,poll
1,48137407500,48137407600,00000000100,a2f,recvmsg
1,48137408000,48137408100,00000000100,a2f,recvmsg
1,48137409600,48137411200,00000001600,a14,writev
1,48137411500,48137418800,00000007300,a07,poll
1,48137420100,48137420300,00000000200,a2f,recvmsg
1,48137420600,48137420800,00000000200,a2f,recvmsg
1,48137422400,48137424000,00000001600,a14,writev
1,48137424300,48137431600,00000007300,a07,poll
1,48137432900,48137433000,00000000100,a2f,recvmsg
1,48137433400,48137433600,00000000200,a2f,recvmsg
1,48137435100,48137436600,00000001500,a14,writev
1,48137436900,48137444300,00000007400,a07,poll
1,48137445600,48137445800,00000000200,a2f,recvmsg
1,48137446100,48137446200,00000000100,a2f,recvmsg
1,48137490100,48137494700,00000004600,a14,writev
1,48137495400,48137593500,00000098100,a07,poll
1,48137495400,48137597200,00000101800,a07,poll
1,48137610300,48137610500,00000000200,a2f,recvmsg
1,48137615200,48137615300,00000000100,a2f,recvmsg
1,48137615600,48137615800,00000000200,a2f,recvmsg
1,48137620700,48137620800,00000000100,a2f,recvmsg
1,48137620900,48137621100,00000000200,a2f,recvmsg
1,48137634800,48137635000,00000000200,a2f,recvmsg
1,48137665800,48137670300,00000004500,a07,poll
1,48137672900,48137673100,00000000200,a2f,recvmsg
1,48137673900,48137674100,00000000200,a2f,recvmsg
1,48137674200,48137674400,00000000200,a2f,recvmsg
1,48137675300,48137675500,00000000200,a2f,recvmsg
1,48137675600,48137675800,00000000200,a2f,recvmsg
1,48137680000,48137727000,00000047000,a07,poll
1,48137727200,48137728400,00000001200,a2f,recvmsg
1,48137680000,48137729600,00000049600,a07,poll
1,48137731300,48137731400,00000000100,a2f,recvmsg
1,48137732000,48137732100,00000000100,a2f,recvmsg
1,48137732300,48137732500,00000000200,a2f,recvmsg
1,48137733000,48137733100,00000000100,a2f,recvmsg
1,48137733300,48137733500,00000000200,a2f,recvmsg
1,48137735200,48137785800,00000050600,a07,poll
1,48137786000,48137787200,00000001200,a2f,recvmsg
1,48137735200,48137788300,00000053100,a07,poll
1,48137790100,48137790300,00000000200,a2f,recvmsg
1,48137790900,48137791000,00000000100,a2f,recvmsg
1,48137791200,48137791400,00000000200,a2f,recvmsg
1,48137791900,48137792000,00000000100,a2f,recvmsg
1,48137792200,48137792400,00000000200,a2f,recvmsg
1,48137794100,48137843200,00000049100,a07,poll
1,48137843400,48137844600,00000001200,a2f,recvmsg
1,48137794100,48137845600,00000051500,a07,poll
1,48137847300,48137847500,00000000200,a2f,recvmsg
1,48137848000,48137848200,00000000200,a2f,recvmsg
1,48137848400,48137848600,00000000200,a2f,recvmsg
1,48137849000,48137849200,00000000200,a2f,recvmsg
1,48137849400,48137849500,00000000100,a2f,recvmsg
1,48137851300,48137900200,00000048900,a07,poll
1,48137900300,48137901600,00000001300,a2f,recvmsg
1,48137851300,48137902600,00000051300,a07,poll
1,48137904900,48137905100,00000000200,a2f,recvmsg
1,48137905600,48137905800,00000000200,a2f,recvmsg
1,48137905900,48137906000,00000000100,a2f,recvmsg
1,48137906600,48137906700,00000000100,a2f,recvmsg
1,48137906900,48137907100,00000000200,a2f,recvmsg
1,48137909600,48137956000,00000046400,a07,poll
1,48137958400,48138001100,00000042700,a07,poll
1,48138002400,48138044500,00000042100,a07,poll
1,48138045900,48138088300,00000042400,a07,poll
1,48138089500,48138132200,00000042700,a07,poll
1,48138133400,48138176500,00000043100,a07,poll
1,48138177700,48138229400,00000051700,a07,poll
1,48138230600,48138247900,00000017300,a07,poll
1,48138249400,48138264000,00000014600,a07,poll
1,48138265200,48138280600,00000015400,a07,poll
1,48138282000,48138295500,00000013500,a07,poll
1,48138296900,48138311000,00000014100,a07,poll
1,48138312200,48138317200,00000005000,a07,poll
1,48138319800,48138319900,00000000100,a2f,recvmsg
1,48138320500,48138320600,00000000100,a2f,recvmsg
1,48138340800,48138342400,00000001600,a07,poll
1,48138342800,48138344200,00000001400,a2f,recvmsg
1,48138345500,48138346700,00000001200,a2d,recvfrom
1,48138350900,48138351200,00000000300,a2f,recvmsg
1,48138351700,48138351900,00000000200,a2f,recvmsg
1,48138340800,48138354100,00000013300,a07,poll
1,48138357000,48138357100,00000000100,a2f,recvmsg
1,48138358100,48138358300,00000000200,a2f,recvmsg
1,48138358500,48138358600,00000000100,a2f,recvmsg
1,48138359500,48138359700,00000000200,a2f,recvmsg
1,48138359900,48138360000,00000000100,a2f,recvmsg
1,48138417500,48138417900,00000000400,a2f,recvmsg
1,48138420300,48138420600,00000000300,a2f,recvmsg
1,48138423300,48138426600,00000003300,a07,poll
1,48138429000,48138429200,00000000200,a2f,recvmsg
1,48138429700,48138429900,00000000200,a2f,recvmsg
1,48138887900,48138892000,00000004100,a09,mmap
1,48139083300,48139088600,00000005300,a01,write
1,48142390400,48142392100,00000001700,aca,futex
1,48142396000,48142396900,00000000900,aca,futex
1,48142398600,48142399600,00000001000,aca,futex
1,48142416600,48142416800,00000000200,a00,read
1,48142421500,48142466600,00000045100,a07,poll
1,48142467800,48142468900,00000001100,aca,futex
1,48142470400,48142471300,00000000900,aca,futex
1,48142472500,48142473300,00000000800,aca,futex
1,48142475000,48142476700,00000001700,a2e,sendmsg
1,48142629000,48142636300,00000007300,a01,write
1,48136609700,48142667100,00006057400,ae8,epoll_wait
1,48142678700,48142682300,00000003600,a2f,recvmsg
1,48142702100,48142702400,00000000300,a2f,recvmsg
1,48142721500,48142726200,00000004700,a2e,sendmsg
1,48142749400,48142750200,00000000800,a2e,sendmsg
1,48144084200,48144092000,00000007800,60e,page_fault
1,48142495600,48144092300,00001596700,a07,poll
1,48144092800,48144095900,00000003100,60e,page_fault
1,48144106400,48144109100,00000002700,60e,page_fault
1,48144115000,48144118200,00000003200,60e,page_fault
1,48144120700,48144123600,00000002900,60e,page_fault
1,48144125900,48144129000,00000003100,60e,page_fault
1,48144129900,48144134000,00000004100,aca,futex
1,48144137300,48144137700,00000000400,aca,futex
1,48144141400,48144143600,00000002200,60e,page_fault
1,48144152900,48144156900,00000004000,60e,page_fault
1,48144157300,48144161100,00000003800,60e,page_fault
1,48144162100,48144165000,00000002900,60e,page_fault
1,48144165500,48144167700,00000002200,60e,page_fault
1,48144168300,48144171500,00000003200,60e,page_fault
1,48144178600,48144178800,00000000200,aca,futex
1,48144192000,48144195400,00000003400,60e,page_fault
1,48144206600,48144210100,00000003500,60e,page_fault
1,48144211600,48144214000,00000002400,60e,page_fault
1,48144238500,48144240700,00000002200,a01,write
1,48144245600,48144246000,00000000400,aca,futex
1,48144246100,48144246200,00000000100,aca,futex
1,48144253800,48144257600,00000003800,60e,page_fault
1,48144258500,48144260900,00000002400,60e,page_fault
1,48142752300,48144272800,00001520500,ae8,epoll_wait
1,48144284100,48144287100,00000003000,a2f,recvmsg
1,48144303200,48144303400,00000000200,a2f,recvmsg
1,48144327500,48144332100,00000004600,a2e,sendmsg
1,48144266100,48144335700,00000069600,a07,poll
1,48144337800,48144338500,00000000700,a00,read
1,48144355000,48144356000,00000001000,a2f,recvmsg
1,48144437000,48153892700,00009455700,a07,poll
1,48144437000,48153896300,00009459300,a07,poll
1,48153909600,48153909800,00000000200,a2f,recvmsg
1,48153914100,48153914300,00000000200,a2f,recvmsg
1,48153914600,48153914800,00000000200,a2f,recvmsg
1,48144437000,48159874400,00015437400,a07,poll
1,48144437000,48159877600,00015440600,a07,poll
1,48159890400,48159890600,00000000200,a2f,recvmsg
1,48159895400,48159895600,00000000200,a2f,recvmsg
1,48159895800,48159896000,00000000200,a2f,recvmsg
1,48159901300,48159901500,00000000200,a2f,recvmsg
1,48159901700,48159901800,00000000100,a2f,recvmsg
1,48159915600,48159915800,00000000200,a2f,recvmsg
1,48159948600,48159953500,00000004900,a07,poll
1,48159956000,48159956200,00000000200,a2f,recvmsg
1,48159957000,48159957200,00000000200,a2f,recvmsg
1,48159957300,48159957500,00000000200,a2f,recvmsg
1,48159958400,48159958600,00000000200,a2f,recvmsg
1,48159958800,48159958900,00000000100,a2f,recvmsg
1,48159950500,48159961700,00000011200,a14,writev
1,48159963100,48160009600,00000046500,a07,poll
1,48160009900,48160011000,00000001100,a2f,recvmsg
1,48159963100,48160012300,00000049200,a07,poll
1,48160014000,48160014100,00000000100,a2f,recvmsg
1,48160014600,48160014800,00000000200,a2f,recvmsg
1,48160015000,48160015100,00000000100,a2f,recvmsg
1,48160015700,48160015800,00000000100,a2f,recvmsg
1,48160016000,48160016200,00000000200,a2f,recvmsg
1,48160018000,48160069200,00000051200,a07,poll
1,48160069400,48160070500,00000001100,a2f,recvmsg
1,48160018000,48160071500,00000053500,a07,poll
1,48160073200,48160073400,00000000200,a2f,recvmsg
1,48160073900,48160074000,00000000100,a2f,recvmsg
1,48160074200,48160074400,00000000200,a2f,recvmsg
1,48160074900,48160075100,00000000200,a2f,recvmsg
1,48160075200,48160075400,00000000200,a2f,recvmsg
1,48160077100,48160128400,00000051300,a07,poll
1,48160128600,48160129800,00000001200,a2f,recvmsg
1,48160077100,48160130900,00000053800,a07,poll
1,48160132500,48160132600,00000000100,a2f,recvmsg
1,48160133200,48160133300,00000000100,a2f,recvmsg
1,48160133500,48160133700,00000000200,a2f,recvmsg
1,48160134100,48160134300,00000000200,a2f,recvmsg
1,48160134500,48160134700,00000000200,a2f,recvmsg
1,48160136300,48160185900,00000049600,a07,poll
1,48160186200,48160187200,00000001000,a2f,recvmsg
1,48160136300,48160188300,00000052000,a07,poll
1,48160189800,48160190000,00000000200,a2f,recvmsg
1,48160190500,48160190700,00000000200,a2f,recvmsg
1,48160190900,48160191000,00000000100,a2f,recvmsg
1,48160191500,48160191700,00000000200,a2f,recvmsg
1,48160191800,48160192000,00000000200,a2f,recvmsg
1,48160193700,48160241300,00000047600,a07,poll
1,48160242500,48160287400,00000044900,a07,poll
1,48160288500,48160332100,00000043600,a07,poll
1,48160333400,48160376900,00000043500,a07,poll
1,48160379300,48160420500,00000041200,a07,poll
1,48160422600,48160465200,00000042600,a07,poll
1,48160466400,48160519300,00000052900,a07,poll
1,48160520400,48160538100,00000017700,a07,poll
1,48160539300,48160554700,00000015400,a07,poll
1,48160555800,48160570600,00000014800,a07,poll
1,48160571800,48160586000,00000014200,a07,poll
1,48160587300,48160600700,00000013400,a07,poll
1,48160601900,48160626800,00000024900,a07,poll
1,48160627100,48160628600,00000001500,a2f,recvmsg
1,48160630200,48160631800,00000001600,a2d,recvfrom
1,48160635700,48160635900,00000000200,a2f,recvmsg
1,48160636400,48160636600,00000000200,a2f,recvmsg
1,48160692200,48160692600,00000000400,a2f,recvmsg
1,48160694600,48160694900,00000000300,a2f,recvmsg
1,48160697600,48161048000,00000350400,a07,poll
1,48161051100,48161051300,00000000200,a2f,recvmsg
1,48161052000,48161052200,00000000200,a2f,recvmsg
1,48161052400,48161052600,00000000200,a2f,recvmsg
1,48161053400,48161053600,00000000200,a2f,recvmsg
1,48161053700,48161053800,00000000100,a2f,recvmsg
1,48161054200,48161880300,00000826100,a07,poll
1,48161054200,48161883600,00000829400,a07,poll
1,48161896800,48161897000,00000000200,a2f,recvmsg
1,48161901800,48161901900,00000000100,a2f,recvmsg
1,48161902200,48161902400,00000000200,a2f,recvmsg
1,48161907300,48161907500,00000000200,a2f,recvmsg
1,48161907700,48161907800,00000000100,a2f,recvmsg
1,48161921600,48161921800,00000000200,a2f,recvmsg
1,48161956000,48161960800,00000004800,a07,poll
1,48161963300,48161963500,00000000200,a2f,recvmsg
1,48161964300,48161964400,00000000100,a2f,recvmsg
1,48161964600,48161964800,00000000200,a2f,recvmsg
1,48161965600,48161965800,00000000200,a2f,recvmsg
1,48161966000,48161966100,00000000100,a2f,recvmsg
1,48161957800,48161969100,00000011300,a14,writev
1,48161970300,48162017000,00000046700,a07,poll
1,48161970300,48162018900,00000048600,a07,poll
1,48162020700,48162020900,00000000200,a2f,recvmsg
1,48162021500,48162021600,00000000100,a2f,recvmsg
1,48162021800,48162022000,00000000200,a2f,recvmsg
1,48162022600,48162022600,00000000000,a2f,recvmsg
1,48162022800,48162023000,00000000200,a2f,recvmsg
1,48162022800,48162024700,00000001900,a2f,recvmsg
1,48162025300,48162075300,00000050000,a07,poll
1,48162075600,48162076700,00000001100,a2f,recvmsg
1,48162025300,48162077900,00000052600,a07,poll
1,48162080600,48162080800,00000000200,a2f,recvmsg
1,48162081300,48162081500,00000000200,a2f,recvmsg
1,48162081600,48162081700,00000000100,a2f,recvmsg
1,48162082200,48162082400,00000000200,a2f,recvmsg
1,48162082600,48162082800,00000000200,a2f,recvmsg
1,48162084500,48162132900,00000048400,a07,poll
1,48162133200,48162134300,00000001100,a2f,recvmsg
1,48162084500,48162135400,00000050900,a07,poll
1,48162137100,48162137300,00000000200,a2f,recvmsg
1,48162137900,48162138000,00000000100,a2f,recvmsg
1,48162138200,48162138400,00000000200,a2f,recvmsg
1,48162138800,48162139000,00000000200,a2f,recvmsg
1,48162139200,48162139300,00000000100,a2f,recvmsg
1,48162141000,48162189700,00000048700,a07,poll
1,48162189800,48162191000,00000001200,a2f,recvmsg
1,48162141000,48162192200,00000051200,a07,poll
1,48162193800,48162194000,00000000200,a2f,recvmsg
1,48162194500,48162194700,00000000200,a2f,recvmsg
1,48162194900,48162195100,00000000200,a2f,recvmsg
1,48162195500,48162195700,00000000200,a2f,recvmsg
1,48162195900,48162196000,00000000100,a2f,recvmsg
1,48162197700,48162246500,00000048800,a07,poll
1,48162247700,48162291300,00000043600,a07,poll
1,48162292400,48162336200,00000043800,a07,poll
1,48162338500,48162381500,00000043000,a07,poll
1,48162382700,48162425300,00000042600,a07,poll
1,48162426400,48162468700,00000042300,a07,poll
1,48162469800,48162522300,00000052500,a07,poll
1,48162523600,48162540400,00000016800,a07,poll
1,48162541600,48162556500,00000014900,a07,poll
1,48162557800,48162571300,00000013500,a07,poll
1,48162572600,48162586900,00000014300,a07,poll
1,48162588200,48162602000,00000013800,a07,poll
1,48162603400,48162627800,00000024400,a07,poll
1,48162628000,48162629400,00000001400,a2f,recvmsg
1,48162631200,48162632600,00000001400,a2d,recvfrom
1,48162636300,48162636500,00000000200,a2f,recvmsg
1,48162637000,48162637100,00000000100,a2f,recvmsg
1,48162692900,48162693300,00000000400,a2f,recvmsg
1,48162695600,48162695800,00000000200,a2f,recvmsg
1,48162698200,48163047100,00000348900,a07,poll
1,48163049900,48163050000,00000000100,a2f,recvmsg
1,48163050800,48163050900,00000000100,a2f,recvmsg
1,48163051100,48163051300,00000000200,a2f,recvmsg
1,48163052200,48163052300,00000000100,a2f,recvmsg
1,48163052400,48163052600,00000000200,a2f,recvmsg
1,48144449000,48165123500,00020674500,ae8,epoll_wait
1,48165134800,48165136700,00000001900,a2f,recvmsg
1,48165160800,48165161000,00000000200,a2f,recvmsg
1,48165184100,48165188000,00000003900,a2e,sendmsg
1,48165195400,48165196300,00000000900,a2e,sendmsg
1,48163052900,48165203600,00002150700,a07,poll
1,48165205100,48165206000,00000000900,a00,read
1,48165221900,48165222900,00000001000,a2f,recvmsg
1,48165305800,48165306800,00000001000,a2f,recvmsg
1,48165309300,48165309400,00000000100,a00,read
1,48165359100,48165363700,00000004600,a07,poll
1,48165850400,48165852700,00000002300,a2f,recvmsg
1,48165861900,48165862100,00000000200,a2f,recvmsg
1,48142640400,48166079900,00023439500,a4a,fsync
1,48166089000,48166117400,00000028400,a52,rename
1,48166158000,48166165300,00000007300,a09,mmap
1,48165862700,48166238100,00000375400,a07,poll
1,48166242400,48166244000,00000001600,aca,futex
1,48166247800,48166248600,00000000800,aca,futex
1,48166250600,48166251700,00000001100,aca,futex
1,48166271500,48166271700,00000000200,a00,read
1,48165198200,48166279800,00001081600,ae8,epoll_wait
1,48166307300,48166307600,00000000300,a2f,recvmsg
1,48166328200,48166332700,00000004500,a2e,sendmsg
1,48166276000,48166392100,00000116100,a07,poll
1,48166393700,48166394600,00000000900,aca,futex
1,48166396400,48166397300,00000000900,aca,futex
1,48166398700,48166399600,00000000900,aca,futex
1,48166402300,48166404500,00000002200,a2e,sendmsg
1,48166335800,48166412100,00000076300,ae8,epoll_wait
1,48166414900,48166416100,00000001200,a2f,recvmsg
1,48166423900,48166424100,00000000200,a2f,recvmsg
1,48166445400,48166446300,00000000900,a2e,sendmsg
1,48166611800,48166621400,00000009600,a01,write
1,48166465200,48166663400,00000198200,a07,poll
1,48166788000,48166790000,00000002000,a01,write
1,48166448400,48166812500,00000364100,ae8,epoll_wait
1,48166818200,48166820800,00000002600,a2f,recvmsg
1,48166830900,48166831100,00000000200,a2f,recvmsg
1,48166847700,48166851400,00000003700,a2e,sendmsg
1,48166793200,48166853500,00000060300,a07,poll
1,48166854400,48166855000,00000000600,a00,read
1,48166865800,48166866600,00000000800,a2f,recvmsg
1,48166626400,48179389600,00012763200,a4a,fsync
1,48179443800,48179448800,00000005000,a09,mmap
1,48166944500,48179524400,00012579900,a07,poll
1,48179528200,48179529700,00000001500,aca,futex
1,48179533700,48179534500,00000000800,aca,futex
1,48179536300,48179537200,00000000900,aca,futex
1,48179556400,48179556700,00000000300,a00,read
1,48166955000,48179564900,00012609900,ae8,epoll_wait
1,48179593200,48179593500,00000000300,a2f,recvmsg
1,48179561300,48179672900,00000111600,a07,poll
1,48179674300,48179675300,00000001000,aca,futex
1,48179676900,48179677700,00000000800,aca,futex
1,48179679100,48179679800,00000000700,aca,futex
1,48179682200,48179684400,00000002200,a2e,sendmsg
1,48179848200,48179854800,00000006600,a01,write
1,48179619100,48179875000,00000255900,ae8,epoll_wait
1,48179879100,48179880800,00000001700,a2f,recvmsg
1,48179889300,48179889500,00000000200,a2f,recvmsg
1,48179912100,48179913800,00000001700,a2e,sendmsg
1,48179704200,48184007400,00004303200,a07,poll
1,48184063500,48184063800,00000000300,a00,read
1,48184107700,48184302100,00000194400,a07,poll
1,48179916200,48184322800,00004406600,ae8,epoll_wait
1,48184327500,48184329500,00000002000,a2f,recvmsg
1,48184338600,48184338800,00000000200,a2f,recvmsg
1,48184351700,48184355100,00000003400,a2e,sendmsg
1,48184317300,48184356800,00000039500,a07,poll
1,48184357900,48184358200,00000000300,a00,read
1,48184367600,48184368300,00000000700,a2f,recvmsg
1,48184427600,48185400200,00000972600,a07,poll
1,48184427600,48185403000,00000975400,a07,poll
1,48185414900,48185415100,00000000200,a2f,recvmsg
1,48185418800,48185418900,00000000100,a2f,recvmsg
1,48185419200,48185419300,00000000100,a2f,recvmsg
1,48185422600,48185422800,00000000200,a2f,recvmsg
1,48185423000,48185423100,00000000100,a2f,recvmsg
1,48185436600,48185436800,00000000200,a2f,recvmsg
1,48185464000,48185477500,00000013500,a07,poll
1,48185464000,48185479700,00000015700,a07,poll
1,48185482200,48185482400,00000000200,a2f,recvmsg
1,48185483300,48185483400,00000000100,a2f,recvmsg
1,48185483600,48185483800,00000000200,a2f,recvmsg
1,48185484600,48185484800,00000000200,a2f,recvmsg
1,48185485000,48185485200,00000000200,a2f,recvmsg
1,48185485000,48185487100,00000002100,a2f,recvmsg
1,48185487700,48185536300,00000048600,a07,poll
1,48185536500,48185537600,00000001100,a2f,recvmsg
1,48185487700,48185538800,00000051100,a07,poll
1,48185540500,48185540700,00000000200,a2f,recvmsg
1,48185541100,48185541300,00000000200,a2f,recvmsg
1,48185541500,48185541700,00000000200,a2f,recvmsg
1,48185542200,48185542400,00000000200,a2f,recvmsg
1,48185542600,48185542700,00000000100,a2f,recvmsg
1,48185544500,48185594300,00000049800,a07,poll
1,48185594600,48185595700,00000001100,a2f,recvmsg
1,48185544500,48185596800,00000052300,a07,poll
1,48185598500,48185598600,00000000100,a2f,recvmsg
1,48185599200,48185599400,00000000200,a2f,recvmsg
1,48185599500,48185599700,00000000200,a2f,recvmsg
1,48185600100,48185600300,00000000200,a2f,recvmsg
1,48185600500,48185600700,00000000200,a2f,recvmsg
1,48185602400,48185651800,00000049400,a07,poll
1,48185652000,48185654000,00000002000,a2f,recvmsg
1,48185602400,48185655100,00000052700,a07,poll
1,48185656800,48185657000,00000000200,a2f,recvmsg
1,48185657500,48185657700,00000000200,a2f,recvmsg
1,48185657900,48185658100,00000000200,a2f,recvmsg
1,48185658600,48185658700,00000000100,a2f,recvmsg
1,48185658800,48185659000,00000000200,a2f,recvmsg
1,48185660900,48185709300,00000048400,a07,poll
1,48185709500,48185710500,00000001000,a2f,recvmsg
1,48185660900,48185711700,00000050800,a07,poll
1,48185713400,48185713600,00000000200,a2f,recvmsg
1,48185714000,48185714200,00000000200,a2f,recvmsg
1,48185714400,48185714500,00000000100,a2f,recvmsg
1,48185715100,48185715300,00000000200,a2f,recvmsg
1,48185715400,48185715600,00000000200,a2f,recvmsg
1,48185717400,48185765900,00000048500,a07,poll
1,48185767800,48185772400,00000004600,a07,poll
1,48185767800,48185775800,00000008000,a07,poll
1,48185789300,48185789500,00000000200,a2f,recvmsg
1,48185794000,48185794200,00000000200,a2f,recvmsg
1,48185794500,48185794600,00000000100,a2f,recvmsg
1,48185799600,48185799800,00000000200,a2f,recvmsg
1,48185799900,48185800100,00000000200,a2f,recvmsg
1,48185804900,48185805500,00000000600,a00,read
1,48185800900,48185810800,00000009900,a07,poll
1,48185815200,48185815400,00000000200,a2f,recvmsg
1,48185849800,48185852600,00000002800,a07,poll
1,48185855000,48185855200,00000000200,a2f,recvmsg
1,48185849800,48185855500,00000005700,a07,poll
1,48185856000,48185856200,00000000200,a2f,recvmsg
1,48185856300,48185856400,00000000100,a2f,recvmsg
1,48185857300,48185857500,00000000200,a2f,recvmsg
1,48185857700,48185857800,00000000100,a2f,recvmsg
1,48185858100,48185899600,00000041500,a07,poll
1,48185901000,48185910200,00000009200,a07,poll
1,48185901000,48185911900,00000010900,a07,poll
1,48185913700,48185913900,00000000200,a2f,recvmsg
1,48185914400,48185914600,00000000200,a2f,recvmsg
1,48185914700,48185914900,00000000200,a2f,recvmsg
1,48185915300,48185915500,00000000200,a2f,recvmsg
1,48185915700,48185915900,00000000200,a2f,recvmsg
1,48185918400,48185943500,00000025100,a07,poll
1,48185944700,48185966300,00000021600,a07,poll
1,48185944700,48185968200,00000023500,a07,poll
1,48185969800,48185970000,00000000200,a2f,recvmsg
1,48185970400,48185970600,00000000200,a2f,recvmsg
1,48185970800,48185971000,00000000200,a2f,recvmsg
1,48185971500,48185971700,00000000200,a2f,recvmsg
1,48185971900,48185972000,00000000100,a2f,recvmsg
1,48185971900,48185973800,00000001900,a2f,recvmsg
1,48185974500,48185987000,00000012500,a07,poll
1,48185988200,48186022300,00000034100,a07,poll
1,48186022500,48186024600,00000002100,a2f,recvmsg
1,48185988200,48186025700,00000037500,a07,poll
1,48186027400,48186027600,00000000200,a2f,recvmsg
1,48186028200,48186028300,00000000100,a2f,recvmsg
1,48186028500,48186028700,00000000200,a2f,recvmsg
1,48186029100,48186029300,00000000200,a2f,recvmsg
1,48186029500,48186029700,00000000200,a2f,recvmsg
1,48186031400,48186041300,00000009900,a07,poll
1,48186042500,48186061600,00000019100,a07,poll
1,48186062800,48186078000,00000015200,a07,poll
1,48186062800,48186078700,00000015900,a07,poll
1,48186078900,48186080100,00000001200,a2f,recvmsg
1,48186079600,48186081200,00000001600,a07,poll
1,48186082800,48186082900,00000000100,a2f,recvmsg
1,48186083500,48186083600,00000000100,a2f,recvmsg
1,48186083800,48186084000,00000000200,a2f,recvmsg
1,48186084400,48186084600,00000000200,a2f,recvmsg
1,48186084800,48186085000,00000000200,a2f,recvmsg
1,48186087200,48186093800,00000006600,a07,poll
1,48186095200,48186109300,00000014100,a07,poll
1,48186110700,48186124000,00000013300,a07,poll
1,48186125100,48186135000,00000009900,a07,poll
1,48186136500,48186150000,00000013500,a07,poll
1,48186150300,48186151700,00000001400,a2f,recvmsg
1,48186152900,48186154400,00000001500,a2d,recvfrom
1,48186158300,48186158400,00000000100,a2f,recvmsg
1,48186158900,48186159100,00000000200,a2f,recvmsg
1,48186136500,48186179400,00000042900,a07,poll
1,48186213700,48186214100,00000000400,a2f,recvmsg
1,48186216300,48186216500,00000000200,a2f,recvmsg
1,48186219300,48186223200,00000003900,a07,poll
1,48186224600,48186267900,00000043300,a07,poll
1,48186269000,48186312700,00000043700,a07,poll
1,48186314000,48186357300,00000043300,a07,poll
1,48186358700,48186411700,00000053000,a07,poll
1,48186412900,48186431000,00000018100,a07,poll
1,48186432900,48186447800,00000014900,a07,poll
1,48186449400,48186463900,00000014500,a07,poll
1,48186465100,48186479000,00000013900,a07,poll
1,48186480100,48186494400,00000014300,a07,poll
1,48186495600,48186519900,00000024300,a07,poll
1,48186520200,48186521700,00000001500,a2f,recvmsg
1,48186525600,48186527300,00000001700,a2d,recvfrom
1,48186531200,48186531400,00000000200,a2f,recvmsg
1,48186531900,48186532100,00000000200,a2f,recvmsg
1,48186495600,48186573500,00000077900,a07,poll
1,48186576300,48186576500,00000000200,a2f,recvmsg
1,48186577400,48186577500,00000000100,a2f,recvmsg
1,48186577700,48186577900,00000000200,a2f,recvmsg
1,48186578800,48186579000,00000000200,a2f,recvmsg
1,48186579200,48186579400,00000000200,a2f,recvmsg
1,48186585800,48186586000,00000000200,a2f,recvmsg
1,48186588300,48186588500,00000000200,a2f,recvmsg
1,48186591200,48186945600,00000354400,a07,poll
1,48186948200,48186948400,00000000200,a2f,recvmsg
1,48186949100,48186949400,00000000300,a2f,recvmsg
1,48186949600,48186949800,00000000200,a2f,recvmsg
1,48186950600,48186950700,00000000100,a2f,recvmsg
1,48186950900,48186951100,00000000200,a2f,recvmsg
1,48184436500,48188677700,00004241200,ae8,epoll_wait
1,48188687200,48188688900,00000001700,a2f,recvmsg
1,48188710700,48188710900,00000000200,a2f,recvmsg
1,48188732100,48188736600,00000004500,a2e,sendmsg
1,48188743800,48188744700,00000000900,a2e,sendmsg
1,48186951400,48188751300,00001799900,a07,poll
1,48188753200,48188753800,00000000600,a00,read
1,48188770300,48188771500,00000001200,a2f,recvmsg
1,48188850500,48188851100,00000000600,a2f,recvmsg
1,48188853900,48188854000,00000000100,a00,read
1,48188904500,48188909000,00000004500,a07,poll
1,48189394600,48189396600,00000002000,a2f,recvmsg
1,48189406400,48189406700,00000000300,a2f,recvmsg
1,48189916200,48189916400,00000000200,a0c,brk
1,48189926600,48189929600,00000003000,a15,access
1,48189930300,48189931200,00000000900,a09,mmap
1,48189936000,48189937900,00000001900,a15,access
1,48189944400,48189945400,00000001000,a09,mmap
1,48189949200,48189949700,00000000500,a15,access
1,48189957500,48189958400,00000000900,a00,read
1,48189960000,48189961600,00000001600,a09,mmap
1,48189966000,48189968100,00000002100,a09,mmap
1,48189979900,48189980500,00000000600,a15,access
1,48189983900,48189984500,00000000600,a00,read
1,48189985200,48189986100,00000000900,a09,mmap
1,48189988900,48189990300,00000001400,a09,mmap
1,48189998300,48189998900,00000000600,a15,access
1,48190001700,48190002200,00000000500,a00,read
1,48190003200,48190003900,00000000700,a09,mmap
1,48190005600,48190007600,00000002000,a09,mmap
1,48190012500,48190015700,00000003200,a09,mmap
1,48190017800,48190018900,00000001100,a09,mmap
1,48190027600,48190028400,00000000800,a15,access
1,48190030900,48190031600,00000000700,a00,read
1,48190032300,48190033800,00000001500,a09,mmap
1,48190037000,48190038600,00000001600,a09,mmap
1,48190046800,48190047400,00000000600,a15,access
1,48190050500,48190051100,00000000600,a00,read
1,48190051700,48190053300,00000001600,a09,mmap
1,48190057200,48190059500,00000002300,a09,mmap
1,48190068000,48190068500,00000000500,a15,access
1,48190071100,48190071700,00000000600,a00,read
1,48190072100,48190073000,00000000900,a09,mmap
1,48190074300,48190075700,00000001400,a09,mmap
1,48190079000,48190080100,00000001100,a09,mmap
1,48190086300,48190086900,00000000600,a15,access
1,48190089200,48190089900,00000000700,a00,read
1,48190090600,48190092000,00000001400,a09,mmap
1,48190094700,48190096400,00000001700,a09,mmap
1,48190110700,48190111300,00000000600,a09,mmap
1,48190115000,48190115300,00000000300,a09,mmap
1,48190116300,48190116700,00000000400,a09,mmap
1,48190290300,48190290500,00000000200,a0c,brk
1,48190290500,48190291300,00000000800,a0c,brk
1,48190328800,48190329600,00000000800,a00,read
1,48190341400,48190342700,00000001300,a00,read
1,48190377500,48190378400,00000000900,a00,read
1,48190500500,48190501300,00000000800,a00,read
1,48190574600,48190575100,00000000500,a00,read
1,48190660500,48190661200,00000000700,a00,read
1,48190791500,48190792300,00000000800,a00,read
1,48190922100,48190922800,00000000700,a00,read
1,48191078900,48191079500,00000000600,a00,read
1,48191229400,48191230200,00000000800,a00,read
1,48191266900,48191268100,00000001200,a0c,brk
1,48191383500,48191384200,00000000700,a00,read
1,48191533900,48191534600,00000000700,a00,read
1,48191689200,48191689900,00000000700,a00,read
1,48191885000,48191886100,00000001100,a00,read
1,48191995100,48191995900,00000000800,a00,read
1,48192026500,48192027400,00000000900,a0c,brk
1,48192136400,48192137300,00000000900,a00,read
1,48192380700,48192381300,00000000600,a00,read
1,48192393300,48192393700,00000000400,a00,read
1,48192437800,48192438100,00000000300,a00,read
1,48192458500,48192459200,00000000700,a00,read
1,48192666200,48192666600,00000000400,a00,read
1,48192696200,48192697000,00000000800,a00,read
1,48192793900,48192794600,00000000700,a00,read
1,48192818200,48192819500,00000001300,a0c,brk
1,48192864600,48192865000,00000000400,a00,read
1,48192942000,48192942800,00000000800,a00,read
1,48193095000,48193095400,00000000400,a00,read
1,48193206400,48193206900,00000000500,a00,read
1,48193301000,48193301500,00000000500,a00,read
1,48193313200,48193313700,00000000500,a00,read
1,48193393500,48193393900,00000000400,a00,read
1,48193417500,48193417800,00000000300,a00,read
1,48193440400,48193440400,00000000000,a00,read
1,48193542100,48193543200,00000001100,a0c,brk
1,48193546300,48193547300,00000001000,a00,read
1,48193747600,48193748100,00000000500,a00,read
1,48193830600,48193831200,00000000600,a00,read
1,48193894900,48193895500,00000000600,a00,read
1,48194023500,48194023900,00000000400,a00,read
1,48194056100,48194056600,00000000500,a00,read
1,48194073500,48194074900,00000001400,a02,open
1,48194185700,48194186100,00000000400,a00,read
1,48194256600,48194257000,00000000400,a00,read
1,48194310600,48194311600,00000001000,a0c,brk
1,48194318200,48194318800,00000000600,a00,read
1,48194427300,48194427900,00000000600,a00,read
1,48194577800,48194578700,00000000900,a00,read
1,48194708300,48194708900,00000000600,a00,read
1,48194766300,48194767000,00000000700,a00,read
1,48194822600,48194823400,00000000800,a00,read
1,48194892900,48194893700,00000000800,a00,read
1,48194945900,48194946700,00000000800,a00,read
1,48195034200,48195035100,00000000900,a0c,brk
1,48195067400,48195071000,00000003600,a0c,brk
1,48195085100,48195085900,00000000800,a00,read
1,48195200000,48195200800,00000000800,a00,read
1,48195361900,48195362600,00000000700,a00,read
1,48195481600,48195482500,00000000900,a00,read
1,48195630800,48195631500,00000000700,a00,read
1,48195750800,48195751400,00000000600,a00,read
1,48199924600,48199925600,00000001000,a00,read
1,48199930900,48199931900,00000001000,a0c,brk
1,48200049000,48200049600,00000000600,a00,read
1,48200169900,48200170700,00000000800,a00,read
1,48200314600,48200315200,00000000600,a00,read
1,48200449300,48200449900,00000000600,a00,read
1,48200544800,48200545400,00000000600,a00,read
1,48200659300,48200660000,00000000700,a00,read
1,48200785600,48200786300,00000000700,a00,read
1,48200900800,48200901400,00000000600,a0c,brk
1,48200924600,48200925200,00000000600,a00,read
1,48201097300,48201098000,00000000700,a00,read
1,48201287700,48201288500,00000000800,a00,read
1,48201401200,48201402000,00000000800,a00,read
1,48201574500,48201575300,00000000800,a00,read
1,48201654100,48201654700,00000000600,a00,read
1,48201738200,48201738900,00000000700,a00,read
1,48201807100,48201808200,00000001100,a0c,brk
1,48201822000,48201822700,00000000700,a00,read
1,48201896600,48201897300,00000000700,a00,read
1,48202000700,48202001400,00000000700,a00,read
1,48202105600,48202106300,00000000700,a00,read
1,48202197700,48202198200,00000000500,a00,read
1,48202280400,48202281100,00000000700,a00,read
1,48202385300,48202385900,00000000600,a00,read
1,48202468500,48202468900,00000000400,a0c,brk
1,48202471500,48202472100,00000000600,a00,read
1,48202581500,48202582100,00000000600,a00,read
1,48202676600,48202677200,00000000600,a00,read
1,48202800400,48202800900,00000000500,a00,read
1,48202916700,48202917400,00000000700,a00,read
1,48203023600,48203024200,00000000600,a00,read
1,48203126100,48203126500,00000000400,a0c,brk
1,48203485000,48203488500,00000003500,a57,unlink
1,48203514800,48203515200,00000000400,a48,fcntl
1,48203562700,48203577100,00000014400,a01,write
1,48203594800,48203597300,00000002500,a01,write
1,48203613600,48203615900,00000002300,a01,write
1,48189407300,48205535700,00016128400,a07,poll
1,48189407300,48205538500,00016131200,a07,poll
1,48205547800,48205548000,00000000200,a2f,recvmsg
1,48205553000,48205553100,00000000100,a2f,recvmsg
1,48205553400,48205553500,00000000100,a2f,recvmsg
1,48205553800,48205554000,00000000200,a2f,recvmsg
1,48205557700,48205557900,00000000200,a2f,recvmsg
1,48205558100,48205558300,00000000200,a2f,recvmsg
1,48205571200,48205571500,00000000300,a2f,recvmsg
1,48205606000,48205614400,00000008400,a07,poll
1,48205606000,48205616700,00000010700,a07,poll
1,48205619100,48205619300,00000000200,a2f,recvmsg
1,48205620000,48205620100,00000000100,a2f,recvmsg
1,48205620300,48205620500,00000000200,a2f,recvmsg
1,48205621400,48205621600,00000000200,a2f,recvmsg
1,48205621800,48205621900,00000000100,a2f,recvmsg
1,48205621800,48205623900,00000002100,a2f,recvmsg
1,48205624600,48205674300,00000049700,a07,poll
1,48205674500,48205675600,00000001100,a2f,recvmsg
1,48205624600,48205676900,00000052300,a07,poll
1,48205678600,48205678800,00000000200,a2f,recvmsg
1,48205679200,48205679400,00000000200,a2f,recvmsg
1,48205679600,48205679800,00000000200,a2f,recvmsg
1,48205680300,48205680500,00000000200,a2f,recvmsg
1,48205680700,48205680800,00000000100,a2f,recvmsg
1,48205682600,48205731900,00000049300,a07,poll
1,48205732100,48205733100,00000001000,a2f,recvmsg
1,48205682600,48205734200,00000051600,a07,poll
1,48205736800,48205737000,00000000200,a2f,recvmsg
1,48205737500,48205737700,00000000200,a2f,recvmsg
1,48205737800,48205738000,00000000200,a2f,recvmsg
1,48205738500,48205738700,00000000200,a2f,recvmsg
1,48205738800,48205739000,00000000200,a2f,recvmsg
1,48205740700,48205789500,00000048800,a07,poll
1,48205789700,48205790800,00000001100,a2f,recvmsg
1,48205740700,48205791800,00000051100,a07,poll
1,48205793500,48205793700,00000000200,a2f,recvmsg
1,48205794200,48205794300,00000000100,a2f,recvmsg
1,48205794500,48205794700,00000000200,a2f,recvmsg
1,48205795100,48205795300,00000000200,a2f,recvmsg
1,48205795500,48205795700,00000000200,a2f,recvmsg
1,48205797300,48205847500,00000050200,a07,poll
1,48205847800,48205849600,00000001800,a2f,recvmsg
1,48205797300,48205850600,00000053300,a07,poll
1,48205852300,48205852500,00000000200,a2f,recvmsg
1,48205853000,48205853200,00000000200,a2f,recvmsg
1,48205853400,48205853500,00000000100,a2f,recvmsg
1,48205854000,48205854200,00000000200,a2f,recvmsg
1,48205854300,48205854500,00000000200,a2f,recvmsg
1,48205856200,48205904200,00000048000,a07,poll
1,48205905500,48205949600,00000044100,a07,poll
1,48205950700,48205994800,00000044100,a07,poll
1,48205997300,48206039200,00000041900,a07,poll
1,48206040400,48206084500,00000044100,a07,poll
1,48206085700,48206128800,00000043100,a07,poll
1,48206129900,48206182200,00000052300,a07,poll
1,48206183500,48206200600,00000017100,a07,poll
1,48206201800,48206217800,00000016000,a07,poll
1,48206219000,48206232700,00000013700,a07,poll
1,48206233900,48206248100,00000014200,a07,poll
1,48206249400,48206262600,00000013200,a07,poll
1,48206263900,48206288300,00000024400,a07,poll
1,48206288500,48206290000,00000001500,a2f,recvmsg
1,48206291500,48206293200,00000001700,a2d,recvfrom
1,48206296800,48206297100,00000000300,a2f,recvmsg
1,48206297500,48206297700,00000000200,a2f,recvmsg
1,48206353400,48206353800,00000000400,a2f,recvmsg
1,48206356000,48206356200,00000000200,a2f,recvmsg
1,48206358400,48206711400,00000353000,a07,poll
1,48206714200,48206714400,00000000200,a2f,recvmsg
1,48206715200,48206715400,00000000200,a2f,recvmsg
1,48206715600,48206715800,00000000200,a2f,recvmsg
1,48206716600,48206716700,00000000100,a2f,recvmsg
1,48206716900,48206717100,00000000200,a2f,recvmsg
0,48159843600,48154283900,-0005559700,a17,select
0,48154301000,48154304000,00000003000,a14,writev
0,48154304600,48154304800,00000000200,a2f,recvmsg
0,48154307600,48154318500,00000010900,a17,select
0,48154321400,48154323100,00000001700,a14,writev
0,48154323400,48154323500,00000000100,a2f,recvmsg
0,48154324100,48154332700,00000008600,a17,select
0,48154335400,48154337000,00000001600,a14,writev
0,48154337200,48154337400,00000000200,a2f,recvmsg
0,48154337900,48154345900,00000008000,a17,select
0,48154348900,48154350500,00000001600,a14,writev
0,48154350700,48154350900,00000000200,a2f,recvmsg
0,48154351400,48154360500,00000009100,a17,select
0,48154363700,48154365300,00000001600,a14,writev
0,48154365500,48154365600,00000000100,a2f,recvmsg
0,48154366200,48154374400,00000008200,a17,select
0,48154377000,48154378400,00000001400,a14,writev
0,48154378600,48154378800,00000000200,a2f,recvmsg
0,48154379200,48154399200,00000020000,a17,select
0,48154401900,48154403300,00000001400,a14,writev
0,48154403600,48154403600,00000000000,a2f,recvmsg
0,48154404200,48154414400,00000010200,a17,select
0,48154417000,48154418500,00000001500,a14,writev
0,48154418800,48154418900,00000000100,a2f,recvmsg
0,48154419400,48154427400,00000008000,a17,select
0,48154429800,48154431200,00000001400,a14,writev
0,48154431400,48154431600,00000000200,a2f,recvmsg
0,48154432100,48154440200,00000008100,a17,select
0,48154442500,48154444000,00000001500,a14,writev
0,48154444200,48154444400,00000000200,a2f,recvmsg
0,48154444900,48154454300,00000009400,a17,select
0,48154456800,48154458200,00000001400,a14,writev
0,48154458500,48154458600,00000000100,a2f,recvmsg
0,48154459100,48154467800,00000008700,a17,select
0,48154470200,48154471700,00000001500,a14,writev
0,48154471900,48154472000,00000000100,a2f,recvmsg
0,48154472500,48154481500,00000009000,a17,select
0,48154483900,48154485400,00000001500,a14,writev
0,48154485700,48154485900,00000000200,a2f,recvmsg
0,48154486400,48154494100,00000007700,a17,select
0,48154496400,48154497800,00000001400,a14,writev
0,48154498100,48154498300,00000000200,a2f,recvmsg
0,48154498700,48154507900,00000009200,a17,select
0,48154510500,48154512000,00000001500,a14,writev
0,48154512300,48154512500,00000000200,a2f,recvmsg
0,48154513000,48154521400,00000008400,a17,select
0,48154524000,48154525400,00000001400,a14,writev
0,48154525600,48154525800,00000000200,a2f,recvmsg
0,48154526300,48154535500,00000009200,a17,select
0,48154538000,48154539300,00000001300,a14,writev
0,48154539600,48154539700,00000000100,a2f,recvmsg
0,48154540300,48154548400,00000008100,a17,select
0,48154550800,48154552300,00000001500,a14,writev
0,48154552500,48154552700,00000000200,a2f,recvmsg
0,48154553300,48154561300,00000008000,a17,select
0,48154563600,48154565100,00000001500,a14,writev
0,48154565200,48154565400,00000000200,a2f,recvmsg
0,48154565900,48154575000,00000009100,a17,select
0,48154577400,48154578900,00000001500,a14,writev
0,48154579200,48154579400,00000000200,a2f,recvmsg
0,48154579900,48154588700,00000008800,a17,select
0,48154591200,48154592600,00000001400,a14,writev
0,48154592800,48154593000,00000000200,a2f,recvmsg
0,48154593500,48154601100,00000007600,a17,select
0,48154603500,48154605000,00000001500,a14,writev
0,48154605200,48154605400,00000000200,a2f,recvmsg
0,48154605900,48154617400,00000011500,a17,select
0,48154619800,48154621300,00000001500,a14,writev
0,48154621600,48154621700,00000000100,a2f,recvmsg
0,48154622200,48154629700,00000007500,a17,select
0,48154632100,48154633600,00000001500,a14,writev
0,48154633800,48154634000,00000000200,a2f,recvmsg
0,48154634500,48154642200,00000007700,a17,select
0,48154644600,48154646200,00000001600,a14,writev
0,48154646400,48154646600,00000000200,a2f,recvmsg
0,48154647000,48154654600,00000007600,a17,select
0,48154657000,48154658400,00000001400,a14,writev
0,48154658700,48154658800,00000000100,a2f,recvmsg
0,48154659400,48154667600,00000008200,a17,select
0,48154669800,48154671300,00000001500,a14,writev
0,48154671500,48154671700,00000000200,a2f,recvmsg
0,48154672200,48154680000,00000007800,a17,select
0,48154682300,48154683800,00000001500,a14,writev
0,48154684000,48154684200,00000000200,a2f,recvmsg
0,48154684700,48154693000,00000008300,a17,select
0,48154695400,48154696800,00000001400,a14,writev
0,48154697100,48154697300,00000000200,a2f,recvmsg
0,48154697800,48154706000,00000008200,a17,select
0,48154708700,48154710200,00000001500,a14,writev
0,48154710500,48154710600,00000000100,a2f,recvmsg
0,48154711100,48154721000,00000009900,a17,select
0,48154723800,48154725200,00000001400,a14,writev
0,48154725500,48154725700,00000000200,a2f,recvmsg
0,48154726200,48154734600,00000008400,a17,select
0,48154737000,48154738400,00000001400,a14,writev
0,48154738600,48154738800,00000000200,a2f,recvmsg
0,48154739300,48154748700,00000009400,a17,select
0,48154751300,48154752800,00000001500,a14,writev
0,48154753000,48154753200,00000000200,a2f,recvmsg
0,48154753700,48154764000,00000010300,a17,select
0,48154766400,48154767800,00000001400,a14,writev
0,48154768100,48154768300,00000000200,a2f,recvmsg
0,48154768700,48154776800,00000008100,a17,select
0,48154779200,48154780700,00000001500,a14,writev
0,48154780900,48154781100,00000000200,a2f,recvmsg
0,48154781600,48154789600,00000008000,a17,select
0,48154792100,48154793500,00000001400,a14,writev
0,48154793700,48154793900,00000000200,a2f,recvmsg
0,48154794400,48154803400,00000009000,a17,select
0,48154806100,48154807500,00000001400,a14,writev
0,48154807700,48154807900,00000000200,a2f,recvmsg
0,48154808300,48154816900,00000008600,a17,select
0,48154819400,48154820900,00000001500,a14,writev
0,48154821100,48154821300,00000000200,a2f,recvmsg
0,48154821700,48154831000,00000009300,a17,select
0,48154833800,48154835200,00000001400,a14,writev
0,48154835400,48154835600,00000000200,a2f,recvmsg
0,48154836100,48154844400,00000008300,a17,select
0,48154846800,48154848300,00000001500,a14,writev
0,48154848600,48154848700,00000000100,a2f,recvmsg
0,48154849300,48154857500,00000008200,a17,select
0,48154859800,48154861300,00000001500,a14,writev
0,48154861500,48154861600,00000000100,a2f,recvmsg
0,48154862100,48154869900,00000007800,a17,select
0,48154872200,48154873600,00000001400,a14,writev
0,48154873900,48154874100,00000000200,a2f,recvmsg
0,48154874600,48154883000,00000008400,a17,select
0,48154885400,48154887000,00000001600,a14,writev
0,48154887200,48154887400,00000000200,a2f,recvmsg
0,48154887900,48154903900,00000016000,a17,select
0,48154906300,48154907700,00000001400,a14,writev
0,48154908000,48154908200,00000000200,a2f,recvmsg
0,48154908700,48154939200,00000030500,a17,select
0,48154941500,48154943100,00000001600,a14,writev
0,48154943300,48154943500,00000000200,a2f,recvmsg
0,48154944000,48154962200,00000018200,a17,select
0,48154964600,48154966000,00000001400,a14,writev
0,48154966300,48154966400,00000000100,a2f,recvmsg
0,48154967000,48154974900,00000007900,a17,select
0,48154977400,48154978700,00000001300,a14,writev
0,48154979000,48154979200,00000000200,a2f,recvmsg
0,48154979600,48154987100,00000007500,a17,select
0,48154989500,48154990900,00000001400,a14,writev
0,48154991200,48154991400,00000000200,a2f,recvmsg
0,48154991900,48154999500,00000007600,a17,select
0,48155001900,48155003200,00000001300,a14,writev
0,48155003500,48155003600,00000000100,a2f,recvmsg
0,48155004100,48155011700,00000007600,a17,select
0,48155014200,48155015700,00000001500,a14,writev
0,48155016000,48155016100,00000000100,a2f,recvmsg
0,48155016700,48155024300,00000007600,a17,select
0,48155026700,48155028100,00000001400,a14,writev
0,48155028400,48155028500,00000000100,a2f,recvmsg
0,48155029000,48155036500,00000007500,a17,select
0,48155038800,48155040200,00000001400,a14,writev
0,48155040500,48155040600,00000000100,a2f,recvmsg
0,48155041200,48155049500,00000008300,a17,select
0,48155052000,48155053500,00000001500,a14,writev
0,48155053700,48155053900,00000000200,a2f,recvmsg
0,48155054400,48155062100,00000007700,a17,select
0,48155064500,48155065900,00000001400,a14,writev
0,48155066100,48155066300,00000000200,a2f,recvmsg
0,48155066700,48155076400,00000009700,a17,select
0,48155078800,48155080300,00000001500,a14,writev
0,48155080600,48155080800,00000000200,a2f,recvmsg
0,48155081300,48155091300,00000010000,a17,select
0,48155093800,48155095200,00000001400,a14,writev
0,48155095500,48155095700,00000000200,a2f,recvmsg
0,48155096200,48155104500,00000008300,a17,select
0,48155106700,48155108200,00000001500,a14,writev
0,48155108400,48155108500,00000000100,a2f,recvmsg
0,48155109000,48155117000,00000008000,a17,select
0,48155119300,48155120800,00000001500,a14,writev
0,48155121000,48155121200,00000000200,a2f,recvmsg
0,48155121700,48155129800,00000008100,a17,select
0,48155132200,48155133500,00000001300,a14,writev
0,48155133700,48155133900,00000000200,a2f,recvmsg
0,48155134400,48155142400,00000008000,a17,select
0,48155144700,48155146300,00000001600,a14,writev
0,48155146500,48155146600,00000000100,a2f,recvmsg
0,48155147100,48155155500,00000008400,a17,select
0,48155157900,48155159300,00000001400,a14,writev
0,48155159500,48155159700,00000000200,a2f,recvmsg
0,48155160100,48155167900,00000007800,a17,select
0,48155170200,48155171600,00000001400,a14,writev
0,48155171900,48155172100,00000000200,a2f,recvmsg
0,48155172600,48155180600,00000008000,a17,select
0,48155182900,48155184400,00000001500,a14,writev
0,48155184600,48155184800,00000000200,a2f,recvmsg
0,48155185300,48155193300,00000008000,a17,select
0,48155195600,48155197000,00000001400,a14,writev
0,48155197300,48155197500,00000000200,a2f,recvmsg
0,48155197900,48155205800,00000007900,a17,select
0,48155208200,48155209700,00000001500,a14,writev
0,48155210000,48155210200,00000000200,a2f,recvmsg
0,48155210700,48155218600,00000007900,a17,select
0,48155220800,48155222300,00000001500,a14,writev
0,48155222500,48155222600,00000000100,a2f,recvmsg
0,48155223200,48155231800,00000008600,a17,select
0,48155234000,48155235500,00000001500,a14,writev
0,48155235700,48155235800,00000000100,a2f,recvmsg
0,48155236300,48155244300,00000008000,a17,select
0,48155246700,48155248100,00000001400,a14,writev
0,48155248400,48155248600,00000000200,a2f,recvmsg
0,48155249100,48155257100,00000008000,a17,select
0,48155259400,48155260800,00000001400,a14,writev
0,48155261000,48155261200,00000000200,a2f,recvmsg
0,48155261700,48155269600,00000007900,a17,select
0,48155271900,48155273400,00000001500,a14,writev
0,48155273700,48155273800,00000000100,a2f,recvmsg
0,48155274300,48155288000,00000013700,a17,select
0,48155290400,48155291800,00000001400,a14,writev
0,48155292100,48155292200,00000000100,a2f,recvmsg
0,48155292800,48155300800,00000008000,a17,select
0,48155303100,48155304500,00000001400,a14,writev
0,48155304700,48155304900,00000000200,a2f,recvmsg
0,48155305400,48155313500,00000008100,a17,select
0,48155315700,48155317300,00000001600,a14,writev
0,48155317500,48155317600,00000000100,a2f,recvmsg
0,48155318100,48155326300,00000008200,a17,select
0,48155328700,48155330000,00000001300,a14,writev
0,48155330300,48155330500,00000000200,a2f,recvmsg
0,48155330900,48155339000,00000008100,a17,select
0,48155341300,48155342800,00000001500,a14,writev
0,48155343100,48155343200,00000000100,a2f,recvmsg
0,48155343800,48155397300,00000053500,a17,select
0,48155398500,48155399700,00000001200,a2f,recvmsg
0,48155484600,48155487500,00000002900,a14,writev
0,48155488000,48155490800,00000002800,a14,writev
0,48155569500,48155571300,00000001800,a14,writev
0,48155626800,48155628300,00000001500,a14,writev
0,48155628600,48155630200,00000001600,a14,writev
0,48155683800,48155685400,00000001600,a14,writev
0,48155685600,48155687000,00000001400,a14,writev
0,48155740300,48155741900,00000001600,a14,writev
0,48155742100,48155743500,00000001400,a14,writev
0,48155797500,48155799200,00000001700,a14,writev
0,48155799400,48155801200,00000001800,a14,writev
0,48155805600,48155806400,00000000800,a2f,recvmsg
0,48155853300,48155855000,00000001700,a14,writev
0,48155897700,48155899600,00000001900,a14,writev
0,48155942400,48155943900,00000001500,a14,writev
0,48155986300,48155987800,00000001500,a14,writev
0,48156030300,48156032200,00000001900,a14,writev
0,48156074800,48156076500,00000001700,a14,writev
0,48156102200,48156104100,00000001900,a2f,recvmsg
0,48156128400,48156130100,00000001700,a14,writev
0,48156147600,48156149500,00000001900,a14,writev
0,48156164900,48156166600,00000001700,a14,writev
0,48156180900,48156182700,00000001800,a14,writev
0,48156197100,48156198700,00000001600,a14,writev
0,48156212100,48156213700,00000001600,a14,writev
0,48156218000,48156219400,00000001400,a14,writev
0,48156219700,48156219900,00000000200,a2f,recvmsg
0,48156220500,48156221000,00000000500,a14,writev
0,48156240900,48156242200,00000001300,a14,writev
0,48156242700,48156242800,00000000100,a2f,recvmsg
0,48156254500,48156256100,00000001600,a14,writev
0,48156258500,48156258700,00000000200,a2f,recvmsg
0,48159850400,48156265700,-0003584700,a07,poll
0,48156270600,48156276800,00000006200,a2f,recvmsg
0,48156288500,48156288700,00000000200,a2f,recvmsg
0,48156314300,48156319000,00000004700,a07,poll
0,48156324700,48156330900,00000006200,a2f,recvmsg
0,48156344200,48156344400,00000000200,a2f,recvmsg
0,48156367800,48156372500,00000004700,a07,poll
0,48156378500,48156384800,00000006300,a2f,recvmsg
0,48156398400,48156398600,00000000200,a2f,recvmsg
0,48156259200,48156428700,00000169500,a17,select
0,48156444400,48156445900,00000001500,a14,writev
0,48156446400,48156446500,00000000100,a2f,recvmsg
0,48156460500,48156461300,00000000800,a14,writev
0,48156461600,48156461800,00000000200,a2f,recvmsg
0,48156473400,48156474500,00000001100,a14,writev
0,48156474700,48156474900,00000000200,a2f,recvmsg
0,48156422800,48156479100,00000056300,a07,poll
0,48156479700,48156480600,00000000900,a2f,recvmsg
0,48156486200,48156487100,00000000900,a2d,recvfrom
0,48156488000,48156488100,00000000100,a2f,recvmsg
0,48156488800,48156489000,00000000200,a2f,recvmsg
0,48156530100,48156530500,00000000400,a2f,recvmsg
0,48156532800,48156533000,00000000200,a2f,recvmsg
0,48156535400,48156537700,00000002300,a07,poll
0,48156538200,48156539400,00000001200,a2f,recvmsg
0,48156544900,48156545800,00000000900,a2d,recvfrom
0,48156546600,48156546800,00000000200,a2f,recvmsg
0,48156547600,48156547800,00000000200,a2f,recvmsg
0,48156578100,48156578300,00000000200,a2f,recvmsg
0,48156580300,48156580500,00000000200,a2f,recvmsg
0,48156584000,48156586400,00000002400,a07,poll
0,48156587100,48156588400,00000001300,a2f,recvmsg
0,48156595000,48156595700,00000000700,a2d,recvfrom
0,48156596600,48156596800,00000000200,a2f,recvmsg
0,48156597500,48156597700,00000000200,a2f,recvmsg
0,48156629100,48156629300,00000000200,a2f,recvmsg
0,48156631100,48156631300,00000000200,a2f,recvmsg
0,48156475400,48158168200,00001692800,a17,select
0,48158179800,48158180000,00000000200,a2f,recvmsg
0,48156634900,48159188200,00002553300,a07,poll
0,48159301500,48159302300,00000000800,a2f,recvmsg
0,48159304700,48159304900,00000000200,a00,read
0,48159349700,48159588900,00000239200,a07,poll
0,48159593900,48159597000,00000003100,a2e,sendmsg
0,48159599800,48159600000,00000000200,a00,read
0,48158181500,48159750600,00001569100,a17,select
0,48159763600,48159766100,00000002500,a14,writev
0,48159766500,48159766700,00000000200,a2f,recvmsg
0,48159768900,48159817400,00000048500,a17,select
0,48159820400,48159821700,00000001300,a14,writev
0,48159822000,48159822200,00000000200,a2f,recvmsg
0,48159822800,48178438600,00018615800,a17,select
0,48178455600,48178457900,00000002300,a14,writev
0,48178458500,48178458800,00000000300,a2f,recvmsg
0,48178461900,48178473000,00000011100,a17,select
0,48178476100,48178477600,00000001500,a14,writev
0,48178477800,48178478000,00000000200,a2f,recvmsg
0,48178478500,48178487200,00000008700,a17,select
0,48178489800,48178491300,00000001500,a14,writev
0,48178491600,48178491700,00000000100,a2f,recvmsg
0,48178492200,48178500700,00000008500,a17,select
0,48178503500,48178505000,00000001500,a14,writev
0,48178505100,48178505300,00000000200,a2f,recvmsg
0,48178505800,48178513800,00000008000,a17,select
0,48178516900,48178518400,00000001500,a14,writev
0,48178518600,48178518800,00000000200,a2f,recvmsg
0,48178519300,48178526800,00000007500,a17,select
0,48178529300,48178530800,00000001500,a14,writev
0,48178531000,48178531200,00000000200,a2f,recvmsg
0,48178531700,48178551000,00000019300,a17,select
0,48178553700,48178555100,00000001400,a14,writev
0,48178555300,48178555500,00000000200,a2f,recvmsg
0,48178556000,48178566300,00000010300,a17,select
0,48178568800,48178570100,00000001300,a14,writev
0,48178570400,48178570600,00000000200,a2f,recvmsg
0,48178571100,48178579000,00000007900,a17,select
0,48178581300,48178582800,00000001500,a14,writev
0,48178583000,48178583100,00000000100,a2f,recvmsg
0,48178583600,48178593200,00000009600,a17,select
0,48178595500,48178597000,00000001500,a14,writev
0,48178597200,48178597400,00000000200,a2f,recvmsg
0,48178597900,48178607700,00000009800,a17,select
0,48178610000,48178611500,00000001500,a14,writev
0,48178611700,48178611900,00000000200,a2f,recvmsg
0,48178612400,48178620900,00000008500,a17,select
0,48178623100,48178624600,00000001500,a14,writev
0,48178624800,48178625000,00000000200,a2f,recvmsg
0,48178625500,48178633700,00000008200,a17,select
0,48178636200,48178637700,00000001500,a14,writev
0,48178637900,48178638100,00000000200,a2f,recvmsg
0,48178638600,48178646400,00000007800,a17,select
0,48178648700,48178650200,00000001500,a14,writev
0,48178650400,48178650600,00000000200,a2f,recvmsg
0,48178651100,48178660300,00000009200,a17,select
0,48178662900,48178664700,00000001800,a14,writev
0,48178664800,48178665000,00000000200,a2f,recvmsg
0,48178665500,48178673900,00000008400,a17,select
0,48178676200,48178677800,00000001600,a14,writev
0,48178678000,48178678100,00000000100,a2f,recvmsg
0,48178678700,48178686800,00000008100,a17,select
0,48178689300,48178690700,00000001400,a14,writev
0,48178690900,48178691100,00000000200,a2f,recvmsg
0,48178691500,48178699700,00000008200,a17,select
0,48178702200,48178703700,00000001500,a14,writev
0,48178704000,48178704100,00000000100,a2f,recvmsg
0,48178704600,48178713700,00000009100,a17,select
0,48178716000,48178717400,00000001400,a14,writev
0,48178717700,48178717900,00000000200,a2f,recvmsg
0,48178718300,48178726700,00000008400,a17,select
0,48178729100,48178730400,00000001300,a14,writev
0,48178730600,48178730800,00000000200,a2f,recvmsg
0,48178731300,48178739200,00000007900,a17,select
0,48178741600,48178743000,00000001400,a14,writev
0,48178743200,48178743400,00000000200,a2f,recvmsg
0,48178744000,48178751700,00000007700,a17,select
0,48178754200,48178755700,00000001500,a14,writev
0,48178755900,48178756000,00000000100,a2f,recvmsg
0,48178756500,48178767700,00000011200,a17,select
0,48178770000,48178771300,00000001300,a14,writev
0,48178771600,48178771700,00000000100,a2f,recvmsg
0,48178772300,48178779900,00000007600,a17,select
0,48178782300,48178783700,00000001400,a14,writev
0,48178783900,48178784100,00000000200,a2f,recvmsg
0,48178784600,48178792200,00000007600,a17,select
0,48178794500,48178795900,00000001400,a14,writev
0,48178796200,48178796400,00000000200,a2f,recvmsg
0,48178796900,48178804500,00000007600,a17,select
0,48178806800,48178808400,00000001600,a14,writev
0,48178808700,48178808900,00000000200,a2f,recvmsg
0,48178809300,48178817300,00000008000,a17,select
0,48178819600,48178821000,00000001400,a14,writev
0,48178821300,48178821500,00000000200,a2f,recvmsg
0,48178822000,48178830000,00000008000,a17,select
0,48178832300,48178833700,00000001400,a14,writev
0,48178833900,48178834100,00000000200,a2f,recvmsg
0,48178834600,48178842800,00000008200,a17,select
0,48178845200,48178846600,00000001400,a14,writev
0,48178846900,48178847000,00000000100,a2f,recvmsg
0,48178847500,48178855800,00000008300,a17,select
0,48178858200,48178859600,00000001400,a14,writev
0,48178859800,48178860000,00000000200,a2f,recvmsg
0,48178860400,48178870000,00000009600,a17,select
0,48178872600,48178874000,00000001400,a14,writev
0,48178874300,48178874400,00000000100,a2f,recvmsg
0,48178875000,48178883400,00000008400,a17,select
0,48178885800,48178887200,00000001400,a14,writev
0,48178887500,48178887600,00000000100,a2f,recvmsg
0,48178888200,48178896500,00000008300,a17,select
0,48178898800,48178900300,00000001500,a14,writev
0,48178900400,48178900600,00000000200,a2f,recvmsg
0,48178901200,48178911500,00000010300,a17,select
0,48178913900,48178915500,00000001600,a14,writev
0,48178915600,48178915800,00000000200,a2f,recvmsg
0,48178916300,48178924400,00000008100,a17,select
0,48178926800,48178928300,00000001500,a14,writev
0,48178928600,48178928700,00000000100,a2f,recvmsg
0,48178929200,48178938400,00000009200,a17,select
0,48178940900,48178942400,00000001500,a14,writev
0,48178942700,48178942900,00000000200,a2f,recvmsg
0,48178943400,48178952300,00000008900,a17,select
0,48178954800,48178956200,00000001400,a14,writev
0,48178956400,48178956600,00000000200,a2f,recvmsg
0,48178957100,48178965500,00000008400,a17,select
0,48178968100,48178969500,00000001400,a14,writev
0,48178969700,48178969900,00000000200,a2f,recvmsg
0,48178970500,48178979200,00000008700,a17,select
0,48178981700,48178983100,00000001400,a14,writev
0,48178983400,48178983500,00000000100,a2f,recvmsg
0,48178984000,48178992200,00000008200,a17,select
0,48178994700,48178996000,00000001300,a14,writev
0,48178996300,48178996500,00000000200,a2f,recvmsg
0,48178997000,48179004800,00000007800,a17,select
0,48179007300,48179008700,00000001400,a14,writev
0,48179008900,48179009200,00000000300,a2f,recvmsg
0,48179009700,48179017400,00000007700,a17,select
0,48179019700,48179021100,00000001400,a14,writev
0,48179021400,48179021500,00000000100,a2f,recvmsg
0,48179022000,48179030400,00000008400,a17,select
0,48179032900,48179034300,00000001400,a14,writev
0,48179034600,48179034700,00000000100,a2f,recvmsg
0,48179035200,48179051300,00000016100,a17,select
0,48179053700,48179055100,00000001400,a14,writev
0,48179055300,48179055500,00000000200,a2f,recvmsg
0,48179056000,48179087100,00000031100,a17,select
0,48179089500,48179090900,00000001400,a14,writev
0,48179091200,48179091400,00000000200,a2f,recvmsg
0,48179091900,48179110500,00000018600,a17,select
0,48179112900,48179114400,00000001500,a14,writev
0,48179114600,48179114800,00000000200,a2f,recvmsg
0,48179115300,48179123000,00000007700,a17,select
0,48179125400,48179126800,00000001400,a14,writev
0,48179127100,48179127200,00000000100,a2f,recvmsg
0,48179127800,48179135300,00000007500,a17,select
0,48179137600,48179139000,00000001400,a14,writev
0,48179139300,48179139500,00000000200,a2f,recvmsg
0,48179139900,48179147600,00000007700,a17,select
0,48179149900,48179151300,00000001400,a14,writev
0,48179151600,48179151800,00000000200,a2f,recvmsg
0,48179152300,48179159900,00000007600,a17,select
0,48179162300,48179163800,00000001500,a14,writev
0,48179164000,48179164200,00000000200,a2f,recvmsg
0,48179164600,48179172100,00000007500,a17,select
0,48179174400,48179175800,00000001400,a14,writev
0,48179176100,48179176300,00000000200,a2f,recvmsg
0,48179176800,48179184400,00000007600,a17,select
0,48179187000,48179188400,00000001400,a14,writev
0,48179188700,48179188900,00000000200,a2f,recvmsg
0,48179189300,48179197500,00000008200,a17,select
0,48179199900,48179201400,00000001500,a14,writev
0,48179201600,48179201800,00000000200,a2f,recvmsg
0,48179202300,48179210200,00000007900,a17,select
0,48179212600,48179214000,00000001400,a14,writev
0,48179214200,48179214400,00000000200,a2f,recvmsg
0,48179214900,48179224900,00000010000,a17,select
0,48179227200,48179228700,00000001500,a14,writev
0,48179228900,48179229000,00000000100,a2f,recvmsg
0,48179229600,48179239500,00000009900,a17,select
0,48179242000,48179243500,00000001500,a14,writev
0,48179243800,48179243900,00000000100,a2f,recvmsg
0,48179244400,48179252600,00000008200,a17,select
0,48179255000,48179256400,00000001400,a14,writev
0,48179256600,48179256800,00000000200,a2f,recvmsg
0,48179257300,48179265200,00000007900,a17,select
0,48179267500,48179269000,00000001500,a14,writev
0,48179269200,48179269400,00000000200,a2f,recvmsg
0,48179270000,48179277800,00000007800,a17,select
0,48179280000,48179281400,00000001400,a14,writev
0,48179281700,48179281800,00000000100,a2f,recvmsg
0,48179282300,48179290300,00000008000,a17,select
0,48179292700,48179294000,00000001300,a14,writev
0,48179294300,48179294400,00000000100,a2f,recvmsg
0,48179295000,48179303500,00000008500,a17,select
0,48179305800,48179307200,00000001400,a14,writev
0,48179307400,48179307600,00000000200,a2f,recvmsg
0,48179308100,48179316100,00000008000,a17,select
0,48179318400,48179319800,00000001400,a14,writev
0,48179320100,48179320200,00000000100,a2f,recvmsg
0,48179320700,48179328500,00000007800,a17,select
0,48179330800,48179332200,00000001400,a14,writev
0,48179332500,48179332600,00000000100,a2f,recvmsg
0,48179333200,48179341100,00000007900,a17,select
0,48179343300,48179344800,00000001500,a14,writev
0,48179345000,48179345100,00000000100,a2f,recvmsg
0,48179345700,48179353500,00000007800,a17,select
0,48179355900,48179357300,00000001400,a14,writev
0,48179357500,48179357700,00000000200,a2f,recvmsg
0,48179358200,48179366000,00000007800,a17,select
0,48179368400,48179369900,00000001500,a14,writev
0,48179370200,48179370300,00000000100,a2f,recvmsg
0,48179370900,48179379500,00000008600,a17,select
0,48179381800,48179383300,00000001500,a14,writev
0,48179383500,48179383700,00000000200,a2f,recvmsg
0,48179384200,48179392100,00000007900,a17,select
0,48179394400,48179395900,00000001500,a14,writev
0,48179396100,48179396200,00000000100,a2f,recvmsg
0,48179396700,48179404500,00000007800,a17,select
0,48179406900,48179408300,00000001400,a14,writev
0,48179408500,48179408700,00000000200,a2f,recvmsg
0,48179409200,48179417100,00000007900,a17,select
0,48179419500,48179420900,00000001400,a14,writev
0,48179421200,48179421300,00000000100,a2f,recvmsg
0,48179421900,48179435200,00000013300,a17,select
0,48179437600,48179439000,00000001400,a14,writev
0,48179439200,48179439400,00000000200,a2f,recvmsg
0,48179439900,48179448200,00000008300,a17,select
0,48179450600,48179452000,00000001400,a14,writev
0,48179452200,48179452400,00000000200,a2f,recvmsg
0,48179452900,48179460800,00000007900,a17,select
0,48179463100,48179464600,00000001500,a14,writev
0,48179464800,48179465000,00000000200,a2f,recvmsg
0,48179465500,48179473700,00000008200,a17,select
0,48179476000,48179477400,00000001400,a14,writev
0,48179477700,48179477900,00000000200,a2f,recvmsg
0,48179478300,48179486300,00000008000,a17,select
0,48179488600,48179490100,00000001500,a14,writev
0,48179490300,48179490500,00000000200,a2f,recvmsg
0,48179491000,48179544400,00000053400,a17,select
0,48179545700,48179546900,00000001200,a2f,recvmsg
0,48179631600,48179634700,00000003100,a14,writev
0,48179635100,48179637900,00000002800,a14,writev
0,48179713700,48179715500,00000001800,a14,writev
0,48179770800,48179772700,00000001900,a14,writev
0,48179772900,48179774500,00000001600,a14,writev
0,48179829000,48179831500,00000002500,a14,writev
0,48179831800,48179833800,00000002000,a14,writev
0,48179887400,48179889000,00000001600,a14,writev
0,48179889200,48179891200,00000002000,a14,writev
0,48179944300,48179945900,00000001600,a14,writev
0,48179946100,48179947700,00000001600,a14,writev
0,48179952300,48179952900,00000000600,a2f,recvmsg
0,48180000300,48180001800,00000001500,a14,writev
0,48180045300,48180047000,00000001700,a14,writev
0,48180088800,48180090300,00000001500,a14,writev
0,48180132300,48180134000,00000001700,a14,writev
0,48180176600,48180178100,00000001500,a14,writev
0,48180220300,48180222300,00000002000,a14,writev
0,48180247400,48180249400,00000002000,a2f,recvmsg
0,48180273200,48180275300,00000002100,a14,writev
0,48180292100,48180293700,00000001600,a14,writev
0,48180308300,48180309800,00000001500,a14,writev
0,48180324400,48180326400,00000002000,a14,writev
0,48180339600,48180341400,00000001800,a14,writev
0,48180355200,48180356800,00000001600,a14,writev
0,48180361300,48180362900,00000001600,a14,writev
0,48180363200,48180363300,00000000100,a2f,recvmsg
0,48180364100,48180364600,00000000500,a14,writev
0,48180384000,48180385500,00000001500,a14,writev
0,48180385900,48180386100,00000000200,a2f,recvmsg
0,48180397600,48180399400,00000001800,a14,writev
0,48180401600,48180401800,00000000200,a2f,recvmsg
0,48159606200,48180408800,00020802600,a07,poll
0,48180414300,48180420300,00000006000,a2f,recvmsg
0,48180431700,48180431900,00000000200,a2f,recvmsg
0,48180457400,48180461800,00000004400,a07,poll
0,48180467200,48180473900,00000006700,a2f,recvmsg
0,48180486800,48180487000,00000000200,a2f,recvmsg
0,48180508900,48180513500,00000004600,a07,poll
0,48180519600,48180525300,00000005700,a2f,recvmsg
0,48180538700,48180539000,00000000300,a2f,recvmsg
0,48180402400,48180569100,00000166700,a17,select
0,48180585100,48180586400,00000001300,a14,writev
0,48180586900,48180587100,00000000200,a2f,recvmsg
0,48180600800,48180602100,00000001300,a14,writev
0,48180602400,48180602600,00000000200,a2f,recvmsg
0,48180614600,48180615600,00000001000,a14,writev
0,48180615900,48180616000,00000000100,a2f,recvmsg
0,48180564000,48180620400,00000056400,a07,poll
0,48180621000,48180621900,00000000900,a2f,recvmsg
0,48180627400,48180628300,00000000900,a2d,recvfrom
0,48180629200,48180629300,00000000100,a2f,recvmsg
0,48180630100,48180630200,00000000100,a2f,recvmsg
0,48180671400,48180671700,00000000300,a2f,recvmsg
0,48180674000,48180674100,00000000100,a2f,recvmsg
0,48180676600,48180679000,00000002400,a07,poll
0,48180679600,48180681100,00000001500,a2f,recvmsg
0,48180687100,48180687900,00000000800,a2d,recvfrom
0,48180688600,48180688800,00000000200,a2f,recvmsg
0,48180689600,48180689700,00000000100,a2f,recvmsg
0,48180720400,48180720500,00000000100,a2f,recvmsg
0,48180723100,48180723200,00000000100,a2f,recvmsg
0,48180726500,48180728900,00000002400,a07,poll
0,48180729700,48180731000,00000001300,a2f,recvmsg
0,48180737600,48180738200,00000000600,a2d,recvfrom
0,48180739500,48180739600,00000000100,a2f,recvmsg
0,48180740300,48180740500,00000000200,a2f,recvmsg
0,48180771300,48180771600,00000000300,a2f,recvmsg
0,48180773200,48180773400,00000000200,a2f,recvmsg
0,48180777200,48181141800,00000364600,a07,poll
0,48181159500,48181165100,00000005600,a2e,sendmsg
0,48181176500,48181177300,00000000800,aca,futex
0,48137967800,48181183600,00043215800,ae8,epoll_wait
0,48181196300,48181197800,00000001500,a2f,recvmsg
0,48181212700,48181213000,00000000300,a2f,recvmsg
0,48181271300,48181275700,00000004400,a2e,sendmsg
0,48181179600,48181284900,00000105300,a07,poll
0,48181301800,48181303100,00000001300,a2f,recvmsg
0,48181379100,48181381500,00000002400,a07,poll
0,48181379100,48181523700,00000144600,a07,poll
0,48181525900,48181527400,00000001500,aca,futex
0,48181529700,48181530600,00000000900,aca,futex
0,48181532100,48181532900,00000000800,aca,futex
0,48181536200,48181539200,00000003000,a2e,sendmsg
0,48181542000,48181542300,00000000300,a00,read
0,48181560300,48181562200,00000001900,a07,poll
0,48181569200,48181570600,00000001400,a2e,sendmsg
0,48181574200,48181574300,00000000100,a00,read
0,48181281500,48181580200,00000298700,ae8,epoll_wait
0,48181584100,48181585600,00000001500,a2f,recvmsg
0,48181604600,48181604800,00000000200,a2f,recvmsg
0,48181606000,48181606500,00000000500,a2f,recvmsg
0,48181612500,48181612600,00000000100,a2f,recvmsg
0,48181640200,48181642700,00000002500,a2e,sendmsg
0,48181672300,48181673600,00000001300,a2e,sendmsg
0,48181578000,48181679100,00000101100,a07,poll
0,48181682100,48181684300,00000002200,a2f,recvmsg
0,48181690200,48181691100,00000000900,a2f,recvmsg
0,48181836400,48181838800,00000002400,a07,poll
0,48181846100,48181846800,00000000700,a2f,recvmsg
0,48181897900,48181899500,00000001600,a07,poll
0,48181897900,48182007300,00000109400,a07,poll
0,48182009000,48182010300,00000001300,aca,futex
0,48182012400,48182013300,00000000900,aca,futex
0,48182014800,48182015600,00000000800,aca,futex
0,48182018200,48182020900,00000002700,a2e,sendmsg
0,48182023500,48182023700,00000000200,a00,read
0,48181677100,48182042600,00000365500,ae8,epoll_wait
0,48182046300,48182047500,00000001200,a2f,recvmsg
0,48182066300,48182066600,00000000300,a2f,recvmsg
0,48182091800,48182094200,00000002400,a2e,sendmsg
0,48182040900,48182099600,00000058700,a07,poll
0,48182100100,48182100600,00000000500,a00,read
0,48182109500,48182110300,00000000800,a2f,recvmsg
0,48182242600,48182245000,00000002400,a07,poll
0,48182565800,48182573000,00000007200,a02,open
0,48182584200,48182586700,00000002500,a00,read
0,48182641800,48182642600,00000000800,a00,read
0,48182694900,48182695700,00000000800,a00,read
0,48182746000,48182746700,00000000700,a00,read
0,48182798200,48182799000,00000000800,a00,read
0,48182849300,48182850100,00000000800,a00,read
0,48182898300,48182899000,00000000700,a00,read
0,48182948800,48182949400,00000000600,a00,read
0,48183001900,48183002600,00000000700,a00,read
0,48183053300,48183054000,00000000700,a00,read
0,48183103200,48183104100,00000000900,a00,read
0,48183131900,48183133900,00000002000,a02,open
0,48183137600,48183138500,00000000900,a00,read
0,48183193300,48183194200,00000000900,a00,read
0,48183279500,48183280200,00000000700,a00,read
0,48183353700,48183354500,00000000800,a00,read
0,48183433000,48183433700,00000000700,a00,read
0,48183512700,48183513500,00000000800,a00,read
0,48183591100,48183591700,00000000600,a00,read
0,48183678100,48183678800,00000000700,a00,read
0,48183745000,48183745600,00000000600,a00,read
0,48183803900,48183804600,00000000700,a00,read
0,48180616500,48183896200,00003279700,a17,select
0,48183914500,48183914700,00000000200,a2f,recvmsg
0,48183932300,48183932500,00000000200,a2f,recvmsg
0,48183933200,48183933300,00000000100,a2f,recvmsg
0,48183917800,48183939200,00000021400,a17,select
0,48183943700,48183943800,00000000100,a2f,recvmsg
0,48183950000,48183950200,00000000200,a2f,recvmsg
0,48183950500,48183950700,00000000200,a2f,recvmsg
0,48183956100,48183962500,00000006400,a06,lstat
0,48183963300,48183964200,00000000900,a06,lstat
0,48183986600,48184000700,00000014100,a01,write
0,48183944600,48184009600,00000065000,a17,select
0,48184015600,48184015800,00000000200,a2f,recvmsg
0,48184023700,48184023900,00000000200,a2f,recvmsg
0,48184024400,48184024600,00000000200,a2f,recvmsg
0,48184026000,48184338300,00000312300,a38,clone
0,48184810800,48184810900,00000000100,a0c,brk
0,48184822100,48184824600,00000002500,a15,access
0,48184825500,48184826400,00000000900,a09,mmap
0,48184831200,48184833200,00000002000,a15,access
0,48184839200,48184840200,00000001000,a09,mmap
0,48184843800,48184844300,00000000500,a15,access
0,48184851400,48184852600,00000001200,a00,read
0,48184854200,48184855700,00000001500,a09,mmap
0,48184859800,48184862000,00000002200,a09,mmap
0,48184873600,48184874200,00000000600,a15,access
0,48184877600,48184878200,00000000600,a00,read
0,48184878900,48184879700,00000000800,a09,mmap
0,48184882200,48184883400,00000001200,a09,mmap
0,48184891700,48184892300,00000000600,a15,access
0,48184895000,48184895600,00000000600,a00,read
0,48184896300,48184897100,00000000800,a09,mmap
0,48184898800,48184900700,00000001900,a09,mmap
0,48184905500,48184908700,00000003200,a09,mmap
0,48184910900,48184912000,00000001100,a09,mmap
0,48184921000,48184921600,00000000600,a15,access
0,48184924200,48184924800,00000000600,a00,read
0,48184925500,48184927100,00000001600,a09,mmap
0,48184930000,48184931500,00000001500,a09,mmap
0,48184939800,48184940400,00000000600,a15,access
0,48184943500,48184944200,00000000700,a00,read
0,48184944700,48184946200,00000001500,a09,mmap
0,48184950200,48184952400,00000002200,a09,mmap
0,48184960800,48184961300,00000000500,a15,access
0,48184963900,48184964400,00000000500,a00,read
0,48184964900,48184965900,00000001000,a09,mmap
0,48184967200,48184968600,00000001400,a09,mmap
0,48184971600,48184972900,00000001300,a09,mmap
0,48184979000,48184979600,00000000600,a15,access
0,48184982700,48184983300,00000000600,a00,read
0,48184984000,48184985300,00000001300,a09,mmap
0,48184987800,48184989500,00000001700,a09,mmap
0,48185003200,48185003900,00000000700,a09,mmap
0,48185007600,48185007900,00000000300,a09,mmap
0,48185009100,48185009400,00000000300,a09,mmap
0,48185187100,48185187300,00000000200,a0c,brk
0,48185187400,48185188100,00000000700,a0c,brk
0,48185225300,48185226400,00000001100,a00,read
0,48185238400,48185239700,00000001300,a00,read
0,48185273600,48185274500,00000000900,a00,read
0,48185397300,48185398200,00000000900,a00,read
0,48185468600,48185469100,00000000500,a00,read
0,48185554400,48185555100,00000000700,a00,read
0,48185685200,48185686100,00000000900,a00,read
0,48185814400,48185815100,00000000700,a00,read
0,48185971500,48185972100,00000000600,a00,read
0,48186122700,48186123400,00000000700,a00,read
0,48186160100,48186161200,00000001100,a0c,brk
0,48186298300,48186299100,00000000800,a00,read
0,48186448100,48186448900,00000000800,a00,read
0,48186604100,48186604800,00000000700,a00,read
0,48186764700,48186765400,00000000700,a00,read
0,48186874100,48186874700,00000000600,a00,read
0,48186905400,48186906500,00000001100,a0c,brk
0,48187017100,48187017700,00000000600,a00,read
0,48187259900,48187260500,00000000600,a00,read
0,48187273400,48187273700,00000000300,a00,read
0,48187317600,48187318100,00000000500,a00,read
0,48187338200,48187338200,00000000000,a00,read
0,48187545200,48187545500,00000000300,a00,read
0,48187574400,48187575300,00000000900,a00,read
0,48187674000,48187674700,00000000700,a00,read
0,48187744700,48187745000,00000000300,a00,read
0,48187820800,48187821500,00000000700,a00,read
0,48187974300,48187974700,00000000400,a00,read
0,48188087000,48188087600,00000000600,a00,read
0,48188181200,48188181700,00000000500,a00,read
0,48188193700,48188194200,00000000500,a00,read
0,48188274300,48188274700,00000000400,a00,read
0,48188298300,48188298700,00000000400,a00,read
0,48188320700,48188321200,00000000500,a00,read
0,48188424100,48188425100,00000001000,a0c,brk
0,48188427000,48188428000,00000001000,a00,read
0,48188628300,48188628600,00000000300,a00,read
0,48188711600,48188712200,00000000600,a00,read
0,48188776700,48188777400,00000000700,a00,read
0,48188905100,48188905600,00000000500,a00,read
0,48188937500,48188938000,00000000500,a00,read
0,48188955700,48188957200,00000001500,a02,open
0,48189068000,48189068500,00000000500,a00,read
0,48189140800,48189141200,00000000400,a00,read
0,48189194100,48189195100,00000001000,a0c,brk
0,48189201300,48189202000,00000000700,a00,read
0,48189309200,48189309900,00000000700,a00,read
0,48189460100,48189460900,00000000800,a00,read
0,48189590900,48189591600,00000000700,a00,read
0,48189648900,48189649700,00000000800,a00,read
0,48189705400,48189705900,00000000500,a00,read
0,48189776200,48189777000,00000000800,a00,read
0,48189829500,48189830200,00000000700,a00,read
0,48189919400,48189920200,00000000800,a0c,brk
0,48189950700,48189954500,00000003800,a0c,brk
0,48189969400,48189969400,00000000000,a00,read
0,48190083600,48190084400,00000000800,a00,read
0,48190252000,48190252700,00000000700,a00,read
0,48190369200,48190370000,00000000800,a00,read
0,48190515300,48190516000,00000000700,a00,read
0,48190632800,48190633500,00000000700,a00,read
0,48190795700,48190796300,00000000600,a00,read
0,48190801200,48190802000,00000000800,a0c,brk
0,48190916400,48190917100,00000000700,a00,read
0,48191034700,48191035600,00000000900,a00,read
0,48191176600,48191177300,00000000700,a00,read
0,48191307700,48191308400,00000000700,a00,read
0,48191400900,48191401700,00000000800,a00,read
0,48191513300,48191514100,00000000800,a00,read
0,48191638600,48191639300,00000000700,a00,read
0,48191750100,48191750700,00000000600,a0c,brk
0,48191773600,48191774400,00000000800,a00,read
0,48191943200,48191943800,00000000600,a00,read
0,48192093400,48192094000,00000000600,a00,read
0,48192203600,48192204300,00000000700,a00,read
0,48192373200,48192374000,00000000800,a00,read
0,48192450600,48192451200,00000000600,a00,read
0,48192532300,48192533000,00000000700,a00,read
0,48192600100,48192600900,00000000800,a0c,brk
0,48192614300,48192614900,00000000600,a00,read
0,48192687400,48192688100,00000000700,a00,read
0,48192788500,48192789200,00000000700,a00,read
0,48192891400,48192892100,00000000700,a00,read
0,48192981100,48192981800,00000000700,a00,read
0,48193063400,48193064100,00000000700,a00,read
0,48193164700,48193165300,00000000600,a00,read
0,48193245800,48193246200,00000000400,a0c,brk
0,48193248800,48193249400,00000000600,a00,read
0,48193356100,48193356800,00000000700,a00,read
0,48193449000,48193449700,00000000700,a00,read
0,48193568000,48193568500,00000000500,a00,read
0,48193682300,48193682900,00000000600,a00,read
0,48193785300,48193785900,00000000600,a00,read
0,48193885700,48193886100,00000000400,a0c,brk
0,48202254500,48202258100,00000003600,a57,unlink
0,48202282400,48202282900,00000000500,a48,fcntl
0,48202330000,48202345400,00000015400,a01,write
0,48202363800,48202366500,00000002700,a01,write
0,48202383000,48202385400,00000002400,a01,write
0,48184362700,48202552300,00018189600,a3d,wait4
0,48202571400,48202572900,00000001500,a00,read
0,48202575100,48202575500,00000000400,a00,read
0,48184016900,48202606700,00018589800,a17,select
0,48202628100,48202628300,00000000200,a2f,recvmsg
0,48202643000,48202643200,00000000200,a2f,recvmsg
0,48202644000,48202644200,00000000200,a2f,recvmsg
0,48202631500,48202651400,00000019900,a17,select
0,48202655400,48202655500,00000000100,a2f,recvmsg
0,48202661400,48202661600,00000000200,a2f,recvmsg
0,48202661900,48202662100,00000000200,a2f,recvmsg
0,48202656200,48202667400,00000011200,a17,select
0,48202670800,48202671000,00000000200,a2f,recvmsg
0,48202676400,48202676600,00000000200,a2f,recvmsg
0,48202676900,48202677100,00000000200,a2f,recvmsg
0,48202671600,48202682700,00000011100,a17,select
0,48202686400,48202686400,00000000000,a2f,recvmsg
0,48202691700,48202691800,00000000100,a2f,recvmsg
0,48202692100,48202692300,00000000200,a2f,recvmsg
0,48202687000,48202697800,00000010800,a17,select
0,48202701600,48202701800,00000000200,a2f,recvmsg
0,48202707100,48202707300,00000000200,a2f,recvmsg
0,48202707500,48202707700,00000000200,a2f,recvmsg
0,48202702400,48202712900,00000010500,a17,select
0,48202715900,48202716100,00000000200,a2f,recvmsg
0,48202721300,48202721500,00000000200,a2f,recvmsg
0,48202721800,48202722000,00000000200,a2f,recvmsg
0,48202723500,48202723700,00000000200,a08,lseek
0,48202733800,48202733900,00000000100,a08,lseek
0,48202716700,48202738300,00000021600,a17,select
0,48202741800,48202742000,00000000200,a2f,recvmsg
0,48202747500,48202747700,00000000200,a2f,recvmsg
0,48202748000,48202748200,00000000200,a2f,recvmsg
0,48202742600,48202754400,00000011800,a17,select
0,48202757700,48202757900,00000000200,a2f,recvmsg
0,48202763200,48202763400,00000000200,a2f,recvmsg
0,48202763700,48202763900,00000000200,a2f,recvmsg
0,48202758400,48202768600,00000010200,a17,select
0,48202771800,48202771900,00000000100,a2f,recvmsg
0,48202777100,48202777300,00000000200,a2f,recvmsg
0,48202777600,48202777800,00000000200,a2f,recvmsg
0,48202772400,48202783300,00000010900,a17,select
0,48202786300,48202786400,00000000100,a2f,recvmsg
0,48202792000,48202792200,00000000200,a2f,recvmsg
0,48202792500,48202792700,00000000200,a2f,recvmsg
0,48202787000,48202797900,00000010900,a17,select
0,48202801100,48202801300,00000000200,a2f,recvmsg
0,48202806600,48202806800,00000000200,a2f,recvmsg
0,48202807100,48202807300,00000000200,a2f,recvmsg
0,48202801900,48202812800,00000010900,a17,select
0,48202815900,48202816100,00000000200,a2f,recvmsg
0,48202821400,48202821500,00000000100,a2f,recvmsg
0,48202821900,48202822100,00000000200,a2f,recvmsg
0,48202816700,48202828300,00000011600,a17,select
0,48202831700,48202831900,00000000200,a2f,recvmsg
0,48202837200,48202837400,00000000200,a2f,recvmsg
0,48202837700,48202837900,00000000200,a2f,recvmsg
0,48202832500,48202842600,00000010100,a17,select
0,48202845700,48202845900,00000000200,a2f,recvmsg
0,48202851200,48202851400,00000000200,a2f,recvmsg
0,48202851700,48202851800,00000000100,a2f,recvmsg
0,48202846400,48202858000,00000011600,a17,select
0,48202861300,48202861500,00000000200,a2f,recvmsg
0,48202866800,48202866900,00000000100,a2f,recvmsg
0,48202867200,48202867400,00000000200,a2f,recvmsg
0,48202862100,48202872900,00000010800,a17,select
0,48202876300,48202876400,00000000100,a2f,recvmsg
0,48202881700,48202881900,00000000200,a2f,recvmsg
0,48202882200,48202882400,00000000200,a2f,recvmsg
0,48202876900,48202887600,00000010700,a17,select
0,48202890800,48202890900,00000000100,a2f,recvmsg
0,48202896200,48202896300,00000000100,a2f,recvmsg
0,48202896700,48202896900,00000000200,a2f,recvmsg
0,48202891500,48202902000,00000010500,a17,select
0,48202905200,48202905400,00000000200,a2f,recvmsg
0,48202911700,48202911900,00000000200,a2f,recvmsg
0,48202912300,48202912500,00000000200,a2f,recvmsg
0,48202906000,48202917600,00000011600,a17,select
0,48202920700,48202920800,00000000100,a2f,recvmsg
0,48202926200,48202926300,00000000100,a2f,recvmsg
0,48202926700,48202926900,00000000200,a2f,recvmsg
0,48202921400,48202932200,00000010800,a17,select
0,48202935400,48202935600,00000000200,a2f,recvmsg
0,48202940900,48202941000,00000000100,a2f,recvmsg
0,48202941300,48202941500,00000000200,a2f,recvmsg
0,48202936100,48202946600,00000010500,a17,select
0,48202949900,48202950100,00000000200,a2f,recvmsg
0,48202955400,48202955500,00000000100,a2f,recvmsg
0,48202955900,48202956100,00000000200,a2f,recvmsg
0,48202950600,48202960700,00000010100,a17,select
0,48202963900,48202964100,00000000200,a2f,recvmsg
0,48202969300,48202969500,00000000200,a2f,recvmsg
0,48202969700,48202969900,00000000200,a2f,recvmsg
0,48202964700,48202976700,00000012000,a17,select
0,48202979700,48202979900,00000000200,a2f,recvmsg
0,48202985200,48202985300,00000000100,a2f,recvmsg
0,48202985700,48202985900,00000000200,a2f,recvmsg
0,48202980500,48202990400,00000009900,a17,select
0,48202993500,48202993600,00000000100,a2f,recvmsg
0,48202998800,48202998900,00000000100,a2f,recvmsg
0,48202999300,48202999500,00000000200,a2f,recvmsg
0,48202994200,48203003900,00000009700,a17,select
0,48203006900,48203007100,00000000200,a2f,recvmsg
0,48203012400,48203012500,00000000100,a2f,recvmsg
0,48203012900,48203013100,00000000200,a2f,recvmsg
0,48203007600,48203017600,00000010000,a17,select
0,48203020800,48203020800,00000000000,a2f,recvmsg
0,48203026200,48203026400,00000000200,a2f,recvmsg
0,48203026600,48203026800,00000000200,a2f,recvmsg
0,48203021400,48203031800,00000010400,a17,select
0,48203034800,48203035000,00000000200,a2f,recvmsg
0,48203041200,48203041400,00000000200,a2f,recvmsg
0,48203041700,48203041800,00000000100,a2f,recvmsg
0,48203035600,48203046600,00000011000,a17,select
0,48203049600,48203049800,00000000200,a2f,recvmsg
0,48203055000,48203055200,00000000200,a2f,recvmsg
0,48203055500,48203055700,00000000200,a2f,recvmsg
0,48203050400,48203060900,00000010500,a17,select
0,48203064200,48203064300,00000000100,a2f,recvmsg
0,48203069500,48203069700,00000000200,a2f,recvmsg
0,48203070000,48203070200,00000000200,a2f,recvmsg
0,48203064800,48203075400,00000010600,a17,select
0,48203078500,48203078700,00000000200,a2f,recvmsg
0,48203083800,48203084000,00000000200,a2f,recvmsg
0,48203084400,48203084500,00000000100,a2f,recvmsg
0,48203079300,48203091900,00000012600,a17,select
0,48203095300,48203095400,00000000100,a2f,recvmsg
0,48203100600,48203100800,00000000200,a2f,recvmsg
0,48203101200,48203101300,00000000100,a2f,recvmsg
0,48203096000,48203106900,00000010900,a17,select
0,48203110000,48203110100,00000000100,a2f,recvmsg
0,48203115300,48203115400,00000000100,a2f,recvmsg
0,48203115800,48203115900,00000000100,a2f,recvmsg
0,48203110600,48203121500,00000010900,a17,select
0,48203124700,48203124900,00000000200,a2f,recvmsg
0,48203130100,48203130300,00000000200,a2f,recvmsg
0,48203130600,48203130800,00000000200,a2f,recvmsg
0,48203125300,48203138000,00000012700,a17,select
0,48203141300,48203141400,00000000100,a2f,recvmsg
0,48203146800,48203146900,00000000100,a2f,recvmsg
0,48203147300,48203147500,00000000200,a2f,recvmsg
0,48203142000,48203152400,00000010400,a17,select
0,48203155500,48203155700,00000000200,a2f,recvmsg
0,48203160900,48203161100,00000000200,a2f,recvmsg
0,48203161400,48203161500,00000000100,a2f,recvmsg
0,48203156200,48203166600,00000010400,a17,select
0,48203169900,48203170000,00000000100,a2f,recvmsg
0,48203175200,48203175400,00000000200,a2f,recvmsg
0,48203175800,48203175900,00000000100,a2f,recvmsg
0,48203170600,48203182100,00000011500,a17,select
0,48203185300,48203185400,00000000100,a2f,recvmsg
0,48203190700,48203190900,00000000200,a2f,recvmsg
0,48203191200,48203191400,00000000200,a2f,recvmsg
0,48203186000,48203197600,00000011600,a17,select
0,48203200900,48203201100,00000000200,a2f,recvmsg
0,48203206300,48203206500,00000000200,a2f,recvmsg
0,48203206800,48203207000,00000000200,a2f,recvmsg
0,48203201500,48203212700,00000011200,a17,select
0,48203216000,48203216200,00000000200,a2f,recvmsg
0,48203221400,48203221600,00000000200,a2f,recvmsg
0,48203221900,48203222100,00000000200,a2f,recvmsg
0,48203216700,48203227300,00000010600,a17,select
0,48203230500,48203230600,00000000100,a2f,recvmsg
0,48203235900,48203236100,00000000200,a2f,recvmsg
0,48203236500,48203236600,00000000100,a2f,recvmsg
0,48203231200,48203241600,00000010400,a17,select
0,48203244800,48203244900,00000000100,a2f,recvmsg
0,48203250100,48203250300,00000000200,a2f,recvmsg
0,48203250700,48203250700,00000000000,a2f,recvmsg
0,48203245400,48203255500,00000010100,a17,select
0,48203258500,48203258700,00000000200,a2f,recvmsg
0,48203264000,48203264000,00000000000,a2f,recvmsg
0,48203264400,48203264600,00000000200,a2f,recvmsg
0,48203259300,48203269900,00000010600,a17,select
0,48203273100,48203273200,00000000100,a2f,recvmsg
0,48203278500,48203278700,00000000200,a2f,recvmsg
0,48203279100,48203279200,00000000100,a2f,recvmsg
0,48203280600,48203280700,00000000100,a08,lseek
0,48203283100,48203284200,00000001100,a00,read
0,48203287900,48203288000,00000000100,a08,lseek
0,48203273700,48203292700,00000019000,a17,select
0,48203296000,48203296200,00000000200,a2f,recvmsg
0,48203301800,48203302000,00000000200,a2f,recvmsg
0,48203302300,48203302500,00000000200,a2f,recvmsg
0,48203296700,48203331200,00000034500,a17,select
0,48203334600,48203334800,00000000200,a2f,recvmsg
0,48203340300,48203340500,00000000200,a2f,recvmsg
0,48203340900,48203341000,00000000100,a2f,recvmsg
0,48203345100,48203345800,00000000700,a00,read
0,48203351400,48203351400,00000000000,a08,lseek
0,48203335400,48203356500,00000021100,a17,select
0,48203359800,48203360000,00000000200,a2f,recvmsg
0,48203365300,48203365500,00000000200,a2f,recvmsg
0,48203365900,48203366000,00000000100,a2f,recvmsg
0,48203360600,48203370400,00000009800,a17,select
0,48203373500,48203373600,00000000100,a2f,recvmsg
0,48203378700,48203378900,00000000200,a2f,recvmsg
0,48203379200,48203379400,00000000200,a2f,recvmsg
0,48203374200,48203383700,00000009500,a17,select
0,48203386700,48203386900,00000000200,a2f,recvmsg
0,48203392000,48203392200,00000000200,a2f,recvmsg
0,48203392600,48203392800,00000000200,a2f,recvmsg
0,48203387400,48203397100,00000009700,a17,select
0,48203400200,48203400400,00000000200,a2f,recvmsg
0,48203405800,48203406000,00000000200,a2f,recvmsg
0,48203406400,48203406500,00000000100,a2f,recvmsg
0,48203400900,48203410900,00000010000,a17,select
0,48203414000,48203414100,00000000100,a2f,recvmsg
0,48203419200,48203419400,00000000200,a2f,recvmsg
0,48203419800,48203419800,00000000000,a2f,recvmsg
0,48203414600,48203424200,00000009600,a17,select
0,48203427200,48203427400,00000000200,a2f,recvmsg
0,48203432400,48203432600,00000000200,a2f,recvmsg
0,48203433000,48203433100,00000000100,a2f,recvmsg
0,48203427800,48203437500,00000009700,a17,select
0,48203440400,48203440500,00000000100,a2f,recvmsg
0,48203445500,48203445700,00000000200,a2f,recvmsg
0,48203446100,48203446300,00000000200,a2f,recvmsg
0,48203441000,48203451300,00000010300,a17,select
0,48203454400,48203454600,00000000200,a2f,recvmsg
0,48203459700,48203459900,00000000200,a2f,recvmsg
0,48203460300,48203460500,00000000200,a2f,recvmsg
0,48203455100,48203465000,00000009900,a17,select
0,48203468000,48203468100,00000000100,a2f,recvmsg
0,48203473200,48203473400,00000000200,a2f,recvmsg
0,48203473700,48203473900,00000000200,a2f,recvmsg
0,48203474600,48203474700,00000000100,a08,lseek
0,48203468700,48203480600,00000011900,a17,select
0,48203483700,48203483900,00000000200,a2f,recvmsg
0,48203489200,48203489400,00000000200,a2f,recvmsg
0,48203489800,48203490000,00000000200,a2f,recvmsg
0,48203484400,48203496600,00000012200,a17,select
0,48203499700,48203499900,00000000200,a2f,recvmsg
0,48203505200,48203505300,00000000100,a2f,recvmsg
0,48203505700,48203505800,00000000100,a2f,recvmsg
0,48203500500,48203511000,00000010500,a17,select
0,48203513900,48203514100,00000000200,a2f,recvmsg
0,48203519200,48203519400,00000000200,a2f,recvmsg
0,48203519700,48203519900,00000000200,a2f,recvmsg
0,48203514700,48203524600,00000009900,a17,select
0,48203527700,48203527800,00000000100,a2f,recvmsg
0,48203533000,48203533100,00000000100,a2f,recvmsg
0,48203533500,48203533700,00000000200,a2f,recvmsg
0,48203528300,48203538300,00000010000,a17,select
0,48203541400,48203541600,00000000200,a2f,recvmsg
0,48203546800,48203547000,00000000200,a2f,recvmsg
0,48203547300,48203547400,00000000100,a2f,recvmsg
0,48203542200,48203552200,00000010000,a17,select
0,48203555100,48203555300,00000000200,a2f,recvmsg
0,48203560500,48203560700,00000000200,a2f,recvmsg
0,48203561000,48203561200,00000000200,a2f,recvmsg
0,48203555900,48203566400,00000010500,a17,select
0,48203569400,48203569600,00000000200,a2f,recvmsg
0,48203574700,48203574800,00000000100,a2f,recvmsg
0,48203575200,48203575400,00000000200,a2f,recvmsg
0,48203570100,48203580000,00000009900,a17,select
0,48203583100,48203583200,00000000100,a2f,recvmsg
0,48203588500,48203588700,00000000200,a2f,recvmsg
0,48203588900,48203589100,00000000200,a2f,recvmsg
0,48203583700,48203593800,00000010100,a17,select
0,48203596700,48203596900,00000000200,a2f,recvmsg
0,48203602100,48203602200,00000000100,a2f,recvmsg
0,48203602600,48203602800,00000000200,a2f,recvmsg
0,48203597500,48203607600,00000010100,a17,select
0,48203610500,48203610700,00000000200,a2f,recvmsg
0,48203615800,48203616000,00000000200,a2f,recvmsg
0,48203616400,48203616600,00000000200,a2f,recvmsg
0,48203611200,48203621300,00000010100,a17,select
0,48203624300,48203624500,00000000200,a2f,recvmsg
0,48203629700,48203629900,00000000200,a2f,recvmsg
0,48203630200,48203630400,00000000200,a2f,recvmsg
0,48203625000,48203635000,00000010000,a17,select
0,48203638100,48203638200,00000000100,a2f,recvmsg
0,48203643300,48203643500,00000000200,a2f,recvmsg
0,48203643800,48203644000,00000000200,a2f,recvmsg
0,48203638700,48203649500,00000010800,a17,select
0,48203652600,48203652700,00000000100,a2f,recvmsg
0,48203658000,48203658200,00000000200,a2f,recvmsg
0,48203658500,48203658700,00000000200,a2f,recvmsg
0,48203653300,48203663800,00000010500,a17,select
0,48203666800,48203667000,00000000200,a2f,recvmsg
0,48203672400,48203672500,00000000100,a2f,recvmsg
0,48203672900,48203673100,00000000200,a2f,recvmsg
0,48203667600,48203677800,00000010200,a17,select
0,48203680900,48203681000,00000000100,a2f,recvmsg
0,48203686200,48203686400,00000000200,a2f,recvmsg
0,48203686700,48203686900,00000000200,a2f,recvmsg
0,48203681600,48203691500,00000009900,a17,select
0,48203694600,48203694800,00000000200,a2f,recvmsg
0,48203700000,48203700200,00000000200,a2f,recvmsg
0,48203700500,48203700700,00000000200,a2f,recvmsg
0,48203695300,48203712800,00000017500,a17,select
0,48203716000,48203716100,00000000100,a2f,recvmsg
0,48203721500,48203721700,00000000200,a2f,recvmsg
0,48203722000,48203722200,00000000200,a2f,recvmsg
0,48203716800,48203727300,00000010500,a17,select
0,48203730200,48203730400,00000000200,a2f,recvmsg
0,48203735500,48203735600,00000000100,a2f,recvmsg
0,48203736000,48203736200,00000000200,a2f,recvmsg
0,48203731000,48203740900,00000009900,a17,select
0,48203743800,48203743900,00000000100,a2f,recvmsg
0,48203749000,48203749200,00000000200,a2f,recvmsg
0,48203749500,48203749700,00000000200,a2f,recvmsg
0,48203744500,48203754600,00000010100,a17,select
0,48203757500,48203757700,00000000200,a2f,recvmsg
0,48203762700,48203762900,00000000200,a2f,recvmsg
0,48203763300,48203763500,00000000200,a2f,recvmsg
0,48203758200,48203768300,00000010100,a17,select
0,48203771200,48203771300,00000000100,a2f,recvmsg
0,48203776500,48203776600,00000000100,a2f,recvmsg
0,48203777000,48203777100,00000000100,a2f,recvmsg
0,48203821100,48203824600,00000003500,a14,writev
0,48203771900,48203828300,00000056400,a17,select
0,48203830800,48203832100,00000001300,a2f,recvmsg
0,48203917800,48203921900,00000004100,a14,writev
0,48203922400,48203925500,00000003100,a14,writev
0,48204003100,48204005200,00000002100,a14,writev
0,48204060900,48204062700,00000001800,a14,writev
0,48204062900,48204064500,00000001600,a14,writev
0,48204119200,48204121000,00000001800,a14,writev
0,48204121200,48204122800,00000001600,a14,writev
0,48204176500,48204178800,00000002300,a14,writev
0,48204179000,48204180700,00000001700,a14,writev
0,48204233700,48204235400,00000001700,a14,writev
0,48204235700,48204237200,00000001500,a14,writev
0,48204242400,48204243100,00000000700,a2f,recvmsg
0,48204290700,48204292300,00000001600,a14,writev
0,48204335300,48204337100,00000001800,a14,writev
0,48204380400,48204382100,00000001700,a14,writev
0,48204424800,48204427200,00000002400,a14,writev
0,48204469600,48204471000,00000001400,a14,writev
0,48204513100,48204514500,00000001400,a14,writev
0,48204539600,48204541500,00000001900,a2f,recvmsg
0,48204566500,48204568100,00000001600,a14,writev
0,48204584600,48204586200,00000001600,a14,writev
0,48204600900,48204602300,00000001400,a14,writev
0,48204615700,48204617100,00000001400,a14,writev
0,48204631100,48204632700,00000001600,a14,writev
0,48204646000,48204647900,00000001900,a14,writev
0,48204652900,48204653200,00000000300,a2f,recvmsg
0,48204653900,48204654300,00000000400,a14,writev
0,48204672000,48204673600,00000001600,a14,writev
0,48204673800,48204675000,00000001200,a14,writev
0,48204675500,48204675700,00000000200,a2f,recvmsg
0,48203820700,48204683300,00000862600,a07,poll
0,48204688400,48204694700,00000006300,a2f,recvmsg
0,48204706500,48204706700,00000000200,a2f,recvmsg
0,48204733000,48204738000,00000005000,a07,poll
0,48204743900,48204749700,00000005800,a2f,recvmsg
0,48204762200,48204762400,00000000200,a2f,recvmsg
0,48204784700,48204789300,00000004600,a07,poll
0,48204794700,48204800700,00000006000,a2f,recvmsg
0,48204813700,48204813900,00000000200,a2f,recvmsg
0,48204676400,48204843200,00000166800,a17,select
0,48204858100,48204859500,00000001400,a14,writev
0,48204860000,48204860000,00000000000,a2f,recvmsg
0,48204873400,48204874400,00000001000,a14,writev
0,48204874700,48204874900,00000000200,a2f,recvmsg
0,48204886900,48204888000,00000001100,a14,writev
0,48204888300,48204888400,00000000100,a2f,recvmsg
0,48204837700,48204892400,00000054700,a07,poll
0,48204893300,48204894200,00000000900,a2f,recvmsg
0,48204898900,48204899800,00000000900,a2d,recvfrom
0,48204900700,48204900800,00000000100,a2f,recvmsg
0,48204901500,48204901700,00000000200,a2f,recvmsg
0,48204942600,48204942900,00000000300,a2f,recvmsg
0,48204945000,48204945200,00000000200,a2f,recvmsg
0,48204947400,48204949300,00000001900,a07,poll
0,48204949800,48204950800,00000001000,a2f,recvmsg
0,48204955700,48204956400,00000000700,a2d,recvfrom
0,48204957200,48204957400,00000000200,a2f,recvmsg
0,48204958000,48204958200,00000000200,a2f,recvmsg
0,48204986700,48204986900,00000000200,a2f,recvmsg
0,48204988900,48204989100,00000000200,a2f,recvmsg
0,48204992000,48204994200,00000002200,a07,poll
0,48204994700,48204995700,00000001000,a2f,recvmsg
0,48205001200,48205001800,00000000600,a2d,recvfrom
0,48205002800,48205003000,00000000200,a2f,recvmsg
0,48205003700,48205003900,00000000200,a2f,recvmsg
0,48205032900,48205033000,00000000100,a2f,recvmsg
0,48205034800,48205034900,00000000100,a2f,recvmsg
0,48205045800,48205046000,00000000200,a2f,recvmsg
0,48205046500,48205046700,00000000200,a2f,recvmsg
0,48204888900,48205079900,00000191000,a17,select
0,48205090100,48205092300,00000002200,a14,writev
0,48205094100,48205094300,00000000200,a2f,recvmsg
0,48205102400,48205102600,00000000200,a2f,recvmsg
0,48205103200,48205103200,00000000000,a2f,recvmsg
0,48205822700,48205829500,00000006800,a02,open
0,48205840100,48205842800,00000002700,a00,read
0,48205894000,48205894800,00000000800,a00,read
0,48205943500,48205944200,00000000700,a00,read
0,48205989300,48205990100,00000000800,a00,read
0,48206037400,48206038000,00000000600,a00,read
0,48206083500,48206084200,00000000700,a00,read
0,48206128100,48206128900,00000000800,a00,read
0,48206173800,48206174600,00000000800,a00,read
0,48206242500,48206243300,00000000800,a00,read
0,48206292800,48206293500,00000000700,a00,read
0,48206341100,48206341900,00000000800,a00,read
0,48206369700,48206371500,00000001800,a02,open
0,48206374800,48206375700,00000000900,a00,read
0,48206430000,48206430900,00000000900,a00,read
0,48206514200,48206514900,00000000700,a00,read
0,48206586000,48206586800,00000000800,a00,read
0,48206663400,48206664100,00000000700,a00,read
0,48206741700,48206742500,00000000800,a00,read
0,48206818400,48206819000,00000000600,a00,read
0,48206903000,48206903700,00000000700,a00,read
0,48206970700,48206971300,00000000600,a00,read
0,48207028600,48207029300,00000000700,a00,read
0,48205095600,48207115000,00002019400,a17,select
0,48207128100,48207128400,00000000300,a2f,recvmsg
0,48207097700,48207140400,00000042700,a07,poll
0,48207162100,48207166800,00000004700,a2e,sendmsg
0,48207173100,48207173300,00000000200,a00,read
0,48207176600,48207177600,00000001000,a2e,sendmsg
0,48207201600,48207201800,00000000200,a2f,recvmsg
0,48207202400,48207202500,00000000100,a2f,recvmsg
0,48207130700,48207210300,00000079600,a17,select
0,48207216200,48207216400,00000000200,a2f,recvmsg
0,48207223000,48207223200,00000000200,a2f,recvmsg
0,48207223600,48207223700,00000000100,a2f,recvmsg
0,48207230200,48207236700,00000006500,a06,lstat
0,48207237400,48207238700,00000001300,a06,lstat
0,48207262100,48207277400,00000015300,a01,write
0,48207217400,48207286700,00000069300,a17,select
0,48207292400,48207292600,00000000200,a2f,recvmsg
0,48207300000,48207300200,00000000200,a2f,recvmsg
0,48207300800,48207301000,00000000200,a2f,recvmsg
0,48207302600,48207645000,00000342400,a38,clone
0,48207298300,48208403500,00001105200,a07,poll
0,48208524400,48208525100,00000000700,a2f,recvmsg
0,48208527400,48208527600,00000000200,a00,read
0,48208674600,48208674700,00000000100,a0c,brk
0,48208687100,48208690900,00000003800,a15,access
0,48208691700,48208692700,00000001000,a09,mmap
0,48208697000,48208698000,00000001000,a15,access
0,48208704800,48208705700,00000000900,a09,mmap
0,48208710000,48208710600,00000000600,a15,access
0,48208718500,48208720100,00000001600,a00,read
0,48208721600,48208723800,00000002200,a09,mmap
0,48208728300,48208730400,00000002100,a09,mmap
0,48208742800,48208743600,00000000800,a15,access
0,48208747400,48208747900,00000000500,a00,read
0,48208748800,48208749600,00000000800,a09,mmap
0,48208752100,48208753400,00000001300,a09,mmap
0,48208761900,48208762400,00000000500,a15,access
0,48208765600,48208766400,00000000800,a00,read
0,48208767000,48208767900,00000000900,a09,mmap
0,48208769600,48208772100,00000002500,a09,mmap
0,48208777100,48208780700,00000003600,a09,mmap
0,48208783000,48208784200,00000001200,a09,mmap
0,48208794700,48208795300,00000000600,a15,access
0,48208797900,48208798500,00000000600,a00,read
0,48208799100,48208800600,00000001500,a09,mmap
0,48208804300,48208806200,00000001900,a09,mmap
0,48208814300,48208814900,00000000600,a15,access
0,48208818200,48208818900,00000000700,a00,read
0,48208819600,48208821500,00000001900,a09,mmap
0,48208825700,48208828100,00000002400,a09,mmap
0,48208577300,48208840500,00000263200,a07,poll
0,48208848100,48208853400,00000005300,a2e,sendmsg
0,48208857600,48208857700,00000000100,a00,read
0,48208867600,48208868800,00000001200,a15,access
0,48208872600,48208873200,00000000600,a00,read
0,48208883400,48208885300,00000001900,a09,mmap
0,48208893000,48208893700,00000000700,a15,access
0,48208896300,48208896900,00000000600,a00,read
0,48208897500,48208898900,00000001400,a09,mmap
0,48208901500,48208903300,00000001800,a09,mmap
0,48208918200,48208918800,00000000600,a09,mmap
0,48208923000,48208923400,00000000400,a09,mmap
0,48208924500,48208924800,00000000300,a09,mmap
0,48209121800,48209122000,00000000200,a0c,brk
0,48209122100,48209123300,00000001200,a0c,brk
0,48209157300,48209158300,00000001000,a00,read
0,48209169400,48209170900,00000001500,a00,read
0,48209207800,48209209000,00000001200,a00,read
0,48209332300,48209333000,00000000700,a00,read
0,48209403700,48209404100,00000000400,a00,read
0,48209490900,48209491700,00000000800,a00,read
0,48209621600,48209622400,00000000800,a00,read
0,48209751100,48209751900,00000000800,a00,read
0,48209906600,48209907300,00000000700,a00,read
0,48210056100,48210056800,00000000700,a00,read
0,48210093200,48210094600,00000001400,a0c,brk
0,48210219600,48210220400,00000000800,a00,read
0,48210368500,48210369200,00000000700,a00,read
0,48226472600,48226472800,00000000200,a2f,recvmsg
0,48226478000,48226478200,00000000200,a2f,recvmsg
0,48226478500,48226478700,00000000200,a2f,recvmsg
0,48226473400,48226483200,00000009800,a17,select
0,48226486300,48226486500,00000000200,a2f,recvmsg
0,48226491500,48226491700,00000000200,a2f,recvmsg
0,48226492000,48226492200,00000000200,a2f,recvmsg
0,48226487100,48226499900,00000012800,a17,select
0,48226503000,48226503200,00000000200,a2f,recvmsg
0,48226508500,48226508600,00000000100,a2f,recvmsg
0,48226508900,48226509100,00000000200,a2f,recvmsg
0,48226503800,48226513500,00000009700,a17,select
0,48226516600,48226516800,00000000200,a2f,recvmsg
0,48226521900,48226522100,00000000200,a2f,recvmsg
0,48226522400,48226522600,00000000200,a2f,recvmsg
0,48226517400,48226527100,00000009700,a17,select
0,48226530000,48226530200,00000000200,a2f,recvmsg
0,48226535200,48226535400,00000000200,a2f,recvmsg
0,48226535800,48226536000,00000000200,a2f,recvmsg
0,48226530800,48226540500,00000009700,a17,select
0,48226543400,48226543600,00000000200,a2f,recvmsg
0,48226548700,48226548900,00000000200,a2f,recvmsg
0,48226549200,48226549400,00000000200,a2f,recvmsg
0,48226544200,48226554500,00000010300,a17,select
0,48226557600,48226557800,00000000200,a2f,recvmsg
0,48226563100,48226563200,00000000100,a2f,recvmsg
0,48226563600,48226563700,00000000100,a2f,recvmsg
0,48226558300,48226568400,00000010100,a17,select
0,48226571400,48226571500,00000000100,a2f,recvmsg
0,48226576900,48226577000,00000000100,a2f,recvmsg
0,48226577300,48226577500,00000000200,a2f,recvmsg
0,48226572100,48226582900,00000010800,a17,select
0,48226586100,48226586300,00000000200,a2f,recvmsg
0,48226591500,48226591600,00000000100,a2f,recvmsg
0,48226592000,48226592200,00000000200,a2f,recvmsg
0,48226586800,48226597300,00000010500,a17,select
0,48226600400,48226600600,00000000200,a2f,recvmsg
0,48226605700,48226605800,00000000100,a2f,recvmsg
0,48226606200,48226606400,00000000200,a2f,recvmsg
0,48226601200,48226612100,00000010900,a17,select
0,48226615400,48226615500,00000000100,a2f,recvmsg
0,48226620700,48226620800,00000000100,a2f,recvmsg
0,48226621200,48226621400,00000000200,a2f,recvmsg
0,48226616100,48226626900,00000010800,a17,select
0,48226629900,48226630100,00000000200,a2f,recvmsg
0,48226635100,48226635300,00000000200,a2f,recvmsg
0,48226635700,48226635900,00000000200,a2f,recvmsg
0,48226630600,48226641300,00000010700,a17,select
0,48226644500,48226644700,00000000200,a2f,recvmsg
0,48226649800,48226650000,00000000200,a2f,recvmsg
0,48226650300,48226650500,00000000200,a2f,recvmsg
0,48226645300,48226658000,00000012700,a17,select
0,48226661200,48226661400,00000000200,a2f,recvmsg
0,48226666600,48226666800,00000000200,a2f,recvmsg
0,48226667100,48226667300,00000000200,a2f,recvmsg
0,48226662000,48226672100,00000010100,a17,select
0,48226675200,48226675400,00000000200,a2f,recvmsg
0,48226680500,48226680700,00000000200,a2f,recvmsg
0,48226681100,48226681200,00000000100,a2f,recvmsg
0,48226675900,48226686200,00000010300,a17,select
0,48226689300,48226689500,00000000200,a2f,recvmsg
0,48226694700,48226694800,00000000100,a2f,recvmsg
0,48226695200,48226695300,00000000100,a2f,recvmsg
0,48226690100,48226701200,00000011100,a17,select
0,48226704300,48226704400,00000000100,a2f,recvmsg
0,48226709900,48226710000,00000000100,a2f,recvmsg
0,48226710300,48226710500,00000000200,a2f,recvmsg
0,48226705000,48226716000,00000011000,a17,select
0,48226719200,48226719400,00000000200,a2f,recvmsg
0,48226724500,48226724700,00000000200,a2f,recvmsg
0,48226725100,48226725200,00000000100,a2f,recvmsg
0,48226719900,48226731800,00000011900,a17,select
0,48226734900,48226735100,00000000200,a2f,recvmsg
0,48226740400,48226740500,00000000100,a2f,recvmsg
0,48226740900,48226741000,00000000100,a2f,recvmsg
0,48226735700,48226746300,00000010600,a17,select
0,48226749700,48226749800,00000000100,a2f,recvmsg
0,48226754900,48226755000,00000000100,a2f,recvmsg
0,48226755400,48226755600,00000000200,a2f,recvmsg
0,48226750300,48226760600,00000010300,a17,select
0,48226763700,48226763800,00000000100,a2f,recvmsg
0,48226768900,48226769100,00000000200,a2f,recvmsg
0,48226769500,48226769700,00000000200,a2f,recvmsg
0,48226764400,48226774500,00000010100,a17,select
0,48226777600,48226777700,00000000100,a2f,recvmsg
0,48226782900,48226783100,00000000200,a2f,recvmsg
0,48226783400,48226783600,00000000200,a2f,recvmsg
0,48226778300,48226788900,00000010600,a17,select
0,48226791900,48226792100,00000000200,a2f,recvmsg
0,48226797300,48226797400,00000000100,a2f,recvmsg
0,48226797700,48226797900,00000000200,a2f,recvmsg
0,48226799400,48226799600,00000000200,a08,lseek
0,48226802700,48226804200,00000001500,a00,read
0,48226807900,48226808000,00000000100,a08,lseek
0,48226792700,48226812800,00000020100,a17,select
0,48226816200,48226816400,00000000200,a2f,recvmsg
0,48226821900,48226822100,00000000200,a2f,recvmsg
0,48226822300,48226822500,00000000200,a2f,recvmsg
0,48226816900,48226850600,00000033700,a17,select
0,48226853900,48226854100,00000000200,a2f,recvmsg
0,48226859500,48226859700,00000000200,a2f,recvmsg
0,48226860000,48226860100,00000000100,a2f,recvmsg
0,48226864200,48226865300,00000001100,a00,read
0,48226870800,48226870900,00000000100,a08,lseek
0,48226854600,48226876200,00000021600,a17,select
0,48226879600,48226879700,00000000100,a2f,recvmsg
0,48226885200,48226885400,00000000200,a2f,recvmsg
0,48226885800,48226885900,00000000100,a2f,recvmsg
0,48226880400,48226890500,00000010100,a17,select
0,48226893500,48226893600,00000000100,a2f,recvmsg
0,48226898800,48226898900,00000000100,a2f,recvmsg
0,48226899300,48226899500,00000000200,a2f,recvmsg
0,48226894200,48226903900,00000009700,a17,select
0,48226906800,48226907000,00000000200,a2f,recvmsg
0,48226912000,48226912200,00000000200,a2f,recvmsg
0,48226912500,48226912800,00000000300,a2f,recvmsg
0,48226907600,48226917200,00000009600,a17,select
0,48226920200,48226920300,00000000100,a2f,recvmsg
0,48226925400,48226925600,00000000200,a2f,recvmsg
0,48226926000,48226926200,00000000200,a2f,recvmsg
0,48226920900,48226930500,00000009600,a17,select
0,48226933600,48226933800,00000000200,a2f,recvmsg
0,48226938800,48226939000,00000000200,a2f,recvmsg
0,48226939300,48226939500,00000000200,a2f,recvmsg
0,48226934300,48226943900,00000009600,a17,select
0,48226946900,48226947100,00000000200,a2f,recvmsg
0,48226952200,48226952300,00000000100,a2f,recvmsg
0,48226952700,48226952900,00000000200,a2f,recvmsg
0,48226947600,48226957200,00000009600,a17,select
0,48226960200,48226960300,00000000100,a2f,recvmsg
0,48226965400,48226965500,00000000100,a2f,recvmsg
0,48226965900,48226966100,00000000200,a2f,recvmsg
0,48226960800,48226971100,00000010300,a17,select
0,48226974200,48226974400,00000000200,a2f,recvmsg
0,48226979500,48226979700,00000000200,a2f,recvmsg
0,48226979900,48226980100,00000000200,a2f,recvmsg
0,48226975000,48226984600,00000009600,a17,select
0,48226987500,48226987700,00000000200,a2f,recvmsg
0,48226992800,48226993000,00000000200,a2f,recvmsg
0,48226993300,48226993400,00000000100,a2f,recvmsg
0,48226994100,48226994200,00000000100,a08,lseek
0,48226988300,48227000300,00000012000,a17,select
0,48227003300,48227003500,00000000200,a2f,recvmsg
0,48227008800,48227009000,00000000200,a2f,recvmsg
0,48227009300,48227009500,00000000200,a2f,recvmsg
0,48227004100,48227016400,00000012300,a17,select
0,48227019600,48227019700,00000000100,a2f,recvmsg
0,48227025000,48227025100,00000000100,a2f,recvmsg
0,48227025400,48227025600,00000000200,a2f,recvmsg
0,48227020200,48227030700,00000010500,a17,select
0,48227033600,48227033800,00000000200,a2f,recvmsg
0,48227038900,48227039100,00000000200,a2f,recvmsg
0,48227039500,48227039600,00000000100,a2f,recvmsg
0,48227034400,48227044400,00000010000,a17,select
0,48227047400,48227047500,00000000100,a2f,recvmsg
0,48227052700,48227052900,00000000200,a2f,recvmsg
0,48227053200,48227053400,00000000200,a2f,recvmsg
0,48227048100,48227058000,00000009900,a17,select
0,48227061000,48227061100,00000000100,a2f,recvmsg
0,48227066200,48227066400,00000000200,a2f,recvmsg
0,48227066800,48227067000,00000000200,a2f,recvmsg
0,48227061600,48227071600,00000010000,a17,select
0,48227074600,48227074700,00000000100,a2f,recvmsg
0,48227079800,48227080000,00000000200,a2f,recvmsg
0,48227080300,48227080500,00000000200,a2f,recvmsg
0,48227075200,48227085600,00000010400,a17,select
0,48227088500,48227088700,00000000200,a2f,recvmsg
0,48227093800,48227094000,00000000200,a2f,recvmsg
0,48227094300,48227094500,00000000200,a2f,recvmsg
0,48227089300,48227099300,00000010000,a17,select
0,48227102200,48227102300,00000000100,a2f,recvmsg
0,48227107300,48227107500,00000000200,a2f,recvmsg
0,48227107800,48227108000,00000000200,a2f,recvmsg
0,48227102900,48227112700,00000009800,a17,select
0,48227115600,48227115800,00000000200,a2f,recvmsg
0,48227120900,48227121000,00000000100,a2f,recvmsg
0,48227121400,48227121600,00000000200,a2f,recvmsg
0,48227116300,48227126200,00000009900,a17,select
0,48227129200,48227129400,00000000200,a2f,recvmsg
0,48227134400,48227134600,00000000200,a2f,recvmsg
0,48227135000,48227135200,00000000200,a2f,recvmsg
0,48227129900,48227139900,00000010000,a17,select
0,48227142900,48227143100,00000000200,a2f,recvmsg
0,48227148100,48227148300,00000000200,a2f,recvmsg
0,48227148700,48227148800,00000000100,a2f,recvmsg
0,48227143500,48227153500,00000010000,a17,select
0,48227156500,48227156600,00000000100,a2f,recvmsg
0,48227161800,48227162000,00000000200,a2f,recvmsg
0,48227162200,48227162400,00000000200,a2f,recvmsg
0,48227157200,48227167800,00000010600,a17,select
0,48227170700,48227170900,00000000200,a2f,recvmsg
0,48227176200,48227176400,00000000200,a2f,recvmsg
0,48227176700,48227176900,00000000200,a2f,recvmsg
0,48227171400,48227181600,00000010200,a17,select
0,48227184600,48227184700,00000000100,a2f,recvmsg
0,48227189800,48227190000,00000000200,a2f,recvmsg
0,48227190400,48227190600,00000000200,a2f,recvmsg
0,48227185200,48227195200,00000010000,a17,select
0,48227198200,48227198300,00000000100,a2f,recvmsg
0,48227203600,48227203800,00000000200,a2f,recvmsg
0,48227204100,48227204300,00000000200,a2f,recvmsg
0,48227198900,48227209000,00000010100,a17,select
0,48227212000,48227212200,00000000200,a2f,recvmsg
0,48227217300,48227217400,00000000100,a2f,recvmsg
0,48227217800,48227218000,00000000200,a2f,recvmsg
0,48227212800,48227228700,00000015900,a17,select
0,48227232000,48227232100,00000000100,a2f,recvmsg
0,48227237500,48227237600,00000000100,a2f,recvmsg
0,48227238000,48227238200,00000000200,a2f,recvmsg
0,48227232700,48227243200,00000010500,a17,select
0,48227246100,48227246300,00000000200,a2f,recvmsg
0,48227251400,48227251500,00000000100,a2f,recvmsg
0,48227251800,48227252000,00000000200,a2f,recvmsg
0,48227246900,48227256700,00000009800,a17,select
0,48227259600,48227259800,00000000200,a2f,recvmsg
0,48227264800,48227265000,00000000200,a2f,recvmsg
0,48227265400,48227265600,00000000200,a2f,recvmsg
0,48227260400,48227270500,00000010100,a17,select
0,48227273400,48227273500,00000000100,a2f,recvmsg
0,48227278500,48227278700,00000000200,a2f,recvmsg
0,48227279100,48227279200,00000000100,a2f,recvmsg
0,48227274100,48227284000,00000009900,a17,select
0,48227287000,48227287100,00000000100,a2f,recvmsg
0,48227292100,48227292300,00000000200,a2f,recvmsg
0,48227292700,48227292900,00000000200,a2f,recvmsg
0,48227315200,48227341400,00000026200,a57,unlink
0,48227342500,48227346500,00000004000,a14,writev
0,48227287600,48227350300,00000062700,a17,select
0,48227352900,48227354100,00000001200,a2f,recvmsg
0,48227438400,48227441900,00000003500,a14,writev
0,48227442400,48227445300,00000002900,a14,writev
0,48227521300,48227523200,00000001900,a14,writev
0,48227523400,48227525000,00000001600,a14,writev
0,48227580400,48227582100,00000001700,a14,writev
0,48227582200,48227584000,00000001800,a14,writev
0,48227638300,48227640200,00000001900,a14,writev
0,48227640400,48227642100,00000001700,a14,writev
0,48227696000,48227697600,00000001600,a14,writev
0,48227697800,48227699400,00000001600,a14,writev
0,48227753100,48227755100,00000002000,a14,writev
0,48227755300,48227757000,00000001700,a14,writev
0,48227761700,48227762500,00000000800,a2f,recvmsg
0,48227809900,48227811700,00000001800,a14,writev
0,48227855100,48227856600,00000001500,a14,writev
0,48227899700,48227901300,00000001600,a14,writev
0,48227943500,48227945400,00000001900,a14,writev
0,48227987700,48227989200,00000001500,a14,writev
0,48228031400,48228032800,00000001400,a14,writev
0,48228058200,48228060200,00000002000,a2f,recvmsg
0,48228085300,48228087200,00000001900,a14,writev
0,48228105500,48228107500,00000002000,a14,writev
0,48228121900,48228123800,00000001900,a14,writev
0,48228137900,48228139600,00000001700,a14,writev
0,48228153700,48228155300,00000001600,a14,writev
0,48228168300,48228169700,00000001400,a14,writev
0,48228174900,48228175200,00000000300,a2f,recvmsg
0,48228175800,48228176300,00000000500,a14,writev
0,48228194100,48228195800,00000001700,a14,writev
0,48228196100,48228197500,00000001400,a14,writev
0,48228198000,48228198200,00000000200,a2f,recvmsg
0,48227342100,48228206400,00000864300,a07,poll
0,48228211700,48228218400,00000006700,a2f,recvmsg
0,48228229500,48228229700,00000000200,a2f,recvmsg
0,48228255500,48228259700,00000004200,a07,poll
0,48228265500,48228271800,00000006300,a2f,recvmsg
0,48228284400,48228284600,00000000200,a2f,recvmsg
0,48228305900,48228310300,00000004400,a07,poll
0,48228315800,48228321800,00000006000,a2f,recvmsg
0,48228334200,48228334400,00000000200,a2f,recvmsg
0,48228199100,48228363000,00000163900,a17,select
0,48228378000,48228379400,00000001400,a14,writev
0,48228379900,48228380100,00000000200,a2f,recvmsg
0,48228393700,48228394800,00000001100,a14,writev
0,48228395100,48228395300,00000000200,a2f,recvmsg
0,48228407100,48228408100,00000001000,a14,writev
0,48228408400,48228408500,00000000100,a2f,recvmsg
0,48228357200,48228415400,00000058200,a07,poll
0,48228416100,48228417000,00000000900,a2f,recvmsg
0,48228421400,48228424400,00000003000,a2d,recvfrom
0,48228425400,48228425600,00000000200,a2f,recvmsg
0,48228426100,48228426300,00000000200,a2f,recvmsg
0,48228466600,48228466900,00000000300,a2f,recvmsg
0,48228469000,48228469100,00000000100,a2f,recvmsg
0,48228471300,48228473300,00000002000,a07,poll
0,48228473800,48228474900,00000001100,a2f,recvmsg
0,48228479700,48228480400,00000000700,a2d,recvfrom
0,48228481200,48228481300,00000000100,a2f,recvmsg
0,48228482000,48228482200,00000000200,a2f,recvmsg
0,48228510900,48228511200,00000000300,a2f,recvmsg
0,48228513100,48228513300,00000000200,a2f,recvmsg
0,48228516300,48228518400,00000002100,a07,poll
0,48228518800,48228520000,00000001200,a2f,recvmsg
0,48228525400,48228526100,00000000700,a2d,recvfrom
0,48228526900,48228527100,00000000200,a2f,recvmsg
0,48228527800,48228528000,00000000200,a2f,recvmsg
0,48228557200,48228557500,00000000300,a2f,recvmsg
0,48228559200,48228559400,00000000200,a2f,recvmsg
0,48228570400,48228570600,00000000200,a2f,recvmsg
0,48228571300,48228571500,00000000200,a2f,recvmsg
0,48228409000,48228606200,00000197200,a17,select
0,48228616200,48228618800,00000002600,a14,writev
0,48228620700,48228620900,00000000200,a2f,recvmsg
0,48228628900,48228629000,00000000100,a2f,recvmsg
0,48228629600,48228629800,00000000200,a2f,recvmsg
0,48229040800,48229045000,00000004200,a09,mmap
0,48229390500,48229395700,00000005200,a02,open
0,48229404100,48229406200,00000002100,a00,read
0,48229458300,48229459100,00000000800,a00,read
0,48229508500,48229509200,00000000700,a00,read
0,48229554600,48229555400,00000000800,a00,read
0,48229602700,48229603400,00000000700,a00,read
0,48229648900,48229649600,00000000700,a00,read
0,48229693600,48229694400,00000000800,a00,read
0,48229739800,48229740500,00000000700,a00,read
0,48229788200,48229789100,00000000900,a00,read
0,48229858800,48229859700,00000000900,a00,read
0,48229907600,48229908200,00000000600,a00,read
0,48229935700,48229937600,00000001900,a02,open
0,48229941000,48229941900,00000000900,a00,read
0,48229996900,48229997600,00000000700,a00,read
0,48230080300,48230081200,00000000900,a00,read
0,48230152100,48230152800,00000000700,a00,read
0,48230228800,48230229400,00000000600,a00,read
0,48230307200,48230307900,00000000700,a00,read
0,48230383800,48230384500,00000000700,a00,read
0,48230467000,48230467800,00000000800,a00,read
0,48230534200,48230534900,00000000700,a00,read
0,48230591700,48230592400,00000000700,a00,read
0,48228622100,48230679000,00002056900,a17,select
0,48230693500,48230693800,00000000300,a2f,recvmsg
0,48230660500,48230703800,00000043300,a07,poll
0,48230717000,48230721200,00000004200,a2e,sendmsg
0,48230727200,48230727400,00000000200,a00,read
0,48230730000,48230731100,00000001100,a2e,sendmsg
0,48230758300,48230758600,00000000300,a2f,recvmsg
0,48230759000,48230759200,00000000200,a2f,recvmsg
0,48230696200,48230766600,00000070400,a17,select
0,48230772600,48230772800,00000000200,a2f,recvmsg
0,48230779700,48230779800,00000000100,a2f,recvmsg
0,48230780200,48230780500,00000000300,a2f,recvmsg
0,48230786700,48230792300,00000005600,a06,lstat
0,48230793100,48230794300,00000001200,a06,lstat
0,48230817500,48230832100,00000014600,a01,write
0,48230774000,48230841500,00000067500,a17,select
0,48230847900,48230848100,00000000200,a2f,recvmsg
0,48230855700,48230855800,00000000100,a2f,recvmsg
0,48230856400,48230856600,00000000200,a2f,recvmsg
0,48230858000,48231203700,00000345700,a38,clone
0,48234415300,48234415500,00000000200,a00,read
0,48234417100,48234417900,00000000800,a2f,recvmsg
0,48234526100,48234528500,00000002400,a07,poll
0,48234849600,48234857500,00000007900,a02,open
0,48234869000,48234872000,00000003000,a00,read
0,48234927600,48234928500,00000000900,a00,read
0,48234979700,48234980500,00000000800,a00,read
0,48235029800,48235030500,00000000700,a00,read
0,48235081500,48235082200,00000000700,a00,read
0,48235130600,48235131300,00000000700,a00,read
0,48235179000,48235179800,00000000800,a00,read
0,48235228600,48235229300,00000000700,a00,read
0,48235280300,48235281000,00000000700,a00,read
0,48235331700,48235332300,00000000600,a00,read
0,48235381200,48235381900,00000000700,a00,read
0,48235409100,48235410900,00000001800,a02,open
0,48235414000,48235414900,00000000900,a00,read
0,48235470700,48235471500,00000000800,a00,read
0,48235556400,48235557200,00000000800,a00,read
0,48235629100,48235630000,00000000900,a00,read
0,48235707600,48235708300,00000000700,a00,read
0,48235786900,48235787600,00000000700,a00,read
0,48235865200,48235865900,00000000700,a00,read
0,48235950600,48235951300,00000000700,a00,read
0,48236018300,48236019000,00000000700,a00,read
0,48236077000,48236077800,00000000800,a00,read
0,48230849100,48236169300,00005320200,a17,select
0,48236187400,48236187600,00000000200,a2f,recvmsg
0,48236202200,48236202400,00000000200,a2f,recvmsg
0,48236203100,48236203300,00000000200,a2f,recvmsg
0,48236190700,48236208900,00000018200,a17,select
0,48236213300,48236213500,00000000200,a2f,recvmsg
0,48236219200,48236219400,00000000200,a2f,recvmsg
0,48236219800,48236220000,00000000200,a2f,recvmsg
0,48236225500,48236231400,00000005900,a06,lstat
0,48236232300,48236233300,00000001000,a06,lstat
0,48236256600,48236271100,00000014500,a01,write
0,48236214200,48236280300,00000066100,a17,select
0,48236286100,48236286300,00000000200,a2f,recvmsg
0,48236294200,48236294300,00000000100,a2f,recvmsg
0,48236294900,48236295100,00000000200,a2f,recvmsg
0,48236296400,48236608700,00000312300,a38,clone
0,48238588800,48238589000,00000000200,a0c,brk
0,48238600100,48238602500,00000002400,a15,access
0,48238603200,48238604100,00000000900,a09,mmap
0,48238608100,48238611000,00000002900,a15,access
0,48238617600,48238618700,00000001100,a09,mmap
0,48238622800,48238623500,00000000700,a15,access
0,48238631000,48238632200,00000001200,a00,read
0,48238633800,48238635300,00000001500,a09,mmap
0,48238640100,48238642200,00000002100,a09,mmap
0,48238654400,48238655000,00000000600,a15,access
0,48238658600,48238659200,00000000600,a00,read
0,48238662900,48238664400,00000001500,a09,mmap
0,48238672600,48238673200,00000000600,a15,access
0,48238676000,48238676600,00000000600,a00,read
0,48238677200,48238678000,00000000800,a09,mmap
0,48238679600,48238681700,00000002100,a09,mmap
0,48238685700,48238689200,00000003500,a09,mmap
0,48238691300,48238692500,00000001200,a09,mmap
0,48238701300,48238702000,00000000700,a15,access
0,48238704700,48238705300,00000000600,a00,read
0,48238706000,48238707500,00000001500,a09,mmap
0,48238710000,48238711700,00000001700,a09,mmap
0,48238720000,48238720500,00000000500,a15,access
0,48238723800,48238724500,00000000700,a00,read
0,48238725100,48238726600,00000001500,a09,mmap
0,48238730200,48238732600,00000002400,a09,mmap
0,48238740800,48238741500,00000000700,a15,access
0,48238744100,48238744600,00000000500,a00,read
0,48238745100,48238746200,00000001100,a09,mmap
0,48238747600,48238748900,00000001300,a09,mmap
0,48238751600,48238753200,00000001600,a09,mmap
0,48238759300,48238759800,00000000500,a15,access
0,48238762500,48238763000,00000000500,a00,read
0,48238763600,48238764900,00000001300,a09,mmap
0,48238766900,48238768500,00000001600,a09,mmap
0,48238782500,48238783200,00000000700,a09,mmap
0,48238787000,48238787400,00000000400,a09,mmap
0,48238788400,48238788700,00000000300,a09,mmap
0,48238967700,48238967800,00000000100,a0c,brk
0,48238967900,48238968800,00000000900,a0c,brk
0,48239004000,48239009700,00000005700,a00,read
0,48239021600,48239023100,00000001500,a00,read
0,48239060300,48239061200,00000000900,a00,read
0,48239182900,48239183600,00000000700,a00,read
0,48239254000,48239254500,00000000500,a00,read
0,48239339400,48239340100,00000000700,a00,read
0,48239470200,48239471000,00000000800,a00,read
0,48239599300,48239600000,00000000700,a00,read
0,48239755100,48239755800,00000000700,a00,read
0,48239906500,48239907100,00000000600,a00,read
0,48239943800,48239945100,00000001300,a0c,brk
0,48240060000,48240060700,00000000700,a00,read
0,48240209200,48240209900,00000000700,a00,read
0,48240364600,48240365200,00000000600,a00,read
0,48240525100,48240525800,00000000700,a00,read
0,48240634500,48240635100,00000000600,a00,read
0,48240665700,48240666400,00000000700,a0c,brk
0,48240775700,48240776500,00000000800,a00,read
0,48241017900,48241018500,00000000600,a00,read
0,48241030000,48241030400,00000000400,a00,read
0,48241074200,48241074800,00000000600,a00,read
0,48241095000,48241095700,00000000700,a00,read
0,48241302400,48241303000,00000000600,a00,read
0,48241332800,48241333800,00000001000,a00,read
0,48241434100,48241434900,00000000800,a00,read
0,48241459300,48241460800,00000001500,a0c,brk
0,48241506300,48241506700,00000000400,a00,read
0,48236292300,48241565100,00005272800,a07,poll
0,48241569000,48241569800,00000000800,a00,read
0,48241702200,48241703100,00000000900,a2f,recvmsg
0,48241705300,48241705500,00000000200,a00,read
0,48241802400,48241804000,00000001600,a00,read
0,48241962000,48241962600,00000000600,a00,read
0,48241755400,48241984600,00000229200,a07,poll
0,48241991400,48241996200,00000004800,a2e,sendmsg
0,48242000300,48242000500,00000000200,a00,read
0,48242117200,48242118000,00000000800,a00,read
0,48242216500,48242217000,00000000500,a00,read
0,48242228800,48242229200,00000000400,a00,read
0,48242246800,48242260000,00000013200,60e,page_fault
0,48242327300,48242327700,00000000400,a00,read
0,48242352100,48242352400,00000000300,a00,read
0,48242374400,48242374900,00000000500,a00,read
0,48242479100,48242481900,00000002800,a0c,brk
0,48242483700,48242484800,00000001100,a00,read
0,48242685200,48242685600,00000000400,a00,read
0,48242769000,48242769600,00000000600,a00,read
0,48242833300,48242834100,00000000800,a00,read
0,48242962300,48242962700,00000000400,a00,read
0,48242995100,48242995700,00000000600,a00,read
0,48243014000,48243015500,00000001500,a02,open
0,48243127900,48243128400,00000000500,a00,read
0,48243201500,48243201800,00000000300,a00,read
0,48243254000,48243255200,00000001200,a0c,brk
0,48243262200,48243262800,00000000600,a00,read
0,48243369800,48243370400,00000000600,a00,read
0,48243519700,48243520600,00000000900,a00,read
0,48243650500,48243651300,00000000800,a00,read
0,48243709200,48243709900,00000000700,a00,read
0,48243765300,48243766000,00000000700,a00,read
0,48243835300,48243836000,00000000700,a00,read
0,48243888400,48243889000,00000000600,a00,read
0,48243977900,48243978600,00000000700,a0c,brk
0,48244009800,48244013800,00000004000,a0c,brk
0,48244028000,48244028700,00000000700,a00,read
0,48244143100,48244143900,00000000800,a00,read
0,48244301900,48244302700,00000000800,a00,read
0,48244419600,48244420400,00000000800,a00,read
0,48244565600,48244566200,00000000600,a00,read
0,48244682700,48244683400,00000000700,a00,read
0,48244845400,48244846100,00000000700,a00,read
0,48244966100,48244966700,00000000600,a00,read
0,48245084500,48245085100,00000000600,a00,read
0,48245226100,48245226900,00000000800,a00,read
0,48245357300,48245358000,00000000700,a00,read
0,48245450600,48245451300,00000000700,a00,read
0,48245563200,48245563900,00000000700,a00,read
0,48245686900,48245687700,00000000800,a00,read
0,48245799000,48245799700,00000000700,a0c,brk
0,48245822300,48245823000,00000000700,a00,read
0,48245991200,48245991900,00000000700,a00,read
0,48246141500,48246142200,00000000700,a00,read
0,48250264500,48250265300,00000000800,a00,read
0,48250435200,48250436100,00000000900,a00,read
0,48250512900,48250513500,00000000600,a00,read
0,48250595300,48250596100,00000000800,a00,read
0,48250663300,48250664100,00000000800,a0c,brk
0,48250677900,48250678400,00000000500,a00,read
0,48250751200,48250751900,00000000700,a00,read
0,48250853200,48250853900,00000000700,a00,read
0,48250956300,48250957100,00000000800,a00,read
0,48251046300,48251046900,00000000600,a00,read
0,48251127300,48251128000,00000000700,a00,read
0,48251228800,48251229400,00000000600,a00,read
0,48251310100,48251310500,00000000400,a0c,brk
0,48251312900,48251313600,00000000700,a00,read
0,48251420400,48251421100,00000000700,a00,read
0,48251513200,48251513900,00000000700,a00,read
0,48251632800,48251633500,00000000700,a00,read
0,48251746200,48251747000,00000000800,a00,read
0,48251849600,48251850300,00000000700,a00,read
0,48251949800,48251950200,00000000400,a0c,brk
0,48252309700,48252313100,00000003400,a57,unlink
0,48252337000,48252337600,00000000600,a48,fcntl
0,48252387700,48252401500,00000013800,a01,write
0,48252419500,48252422100,00000002600,a01,write
0,48252438300,48252440200,00000001900,a01,write
0,48236630900,48252608700,00015977800,a3d,wait4
0,48252629100,48252630500,00000001400,a00,read
0,48252632600,48252633000,00000000400,a00,read
0,48236287400,48252664000,00016376600,a17,select
0,48252685700,48252685900,00000000200,a2f,recvmsg
0,48252700500,48252700700,00000000200,a2f,recvmsg
0,48252701500,48252701700,00000000200,a2f,recvmsg
0,48252689400,48252708200,00000018800,a17,select
0,48252712200,48252712400,00000000200,a2f,recvmsg
0,48252718300,48252718500,00000000200,a2f,recvmsg
0,48252718800,48252719000,00000000200,a2f,recvmsg
0,48252713100,48252724500,00000011400,a17,select
0,48252728100,48252728300,00000000200,a2f,recvmsg
0,48252733800,48252734000,00000000200,a2f,recvmsg
0,48252734200,48252734400,00000000200,a2f,recvmsg
0,48252728800,48252740100,00000011300,a17,select
0,48252743800,48252744000,00000000200,a2f,recvmsg
0,48252749200,48252749400,00000000200,a2f,recvmsg
0,48252749700,48252749900,00000000200,a2f,recvmsg
0,48252744600,48252754800,00000010200,a17,select
0,48252758500,48252758700,00000000200,a2f,recvmsg
0,48252763700,48252763900,00000000200,a2f,recvmsg
0,48252764300,48252764400,00000000100,a2f,recvmsg
0,48252759200,48252769500,00000010300,a17,select
0,48252772500,48252772700,00000000200,a2f,recvmsg
0,48252777900,48252778100,00000000200,a2f,recvmsg
0,48252778500,48252778700,00000000200,a2f,recvmsg
0,48252779400,48252779600,00000000200,a08,lseek
0,48252789100,48252789100,00000000000,a08,lseek
0,48252773300,48252793500,00000020200,a17,select
0,48252796900,48252797100,00000000200,a2f,recvmsg
0,48252802600,48252802800,00000000200,a2f,recvmsg
0,48252803100,48252803300,00000000200,a2f,recvmsg
0,48252797700,48252810100,00000012400,a17,select
0,48252813500,48252813700,00000000200,a2f,recvmsg
0,48252819000,48252819200,00000000200,a2f,recvmsg
0,48252819500,48252819600,00000000100,a2f,recvmsg
0,48252814200,48252824500,00000010300,a17,select
0,48252827500,48252827700,00000000200,a2f,recvmsg
0,48252832900,48252833100,00000000200,a2f,recvmsg
0,48252833400,48252833600,00000000200,a2f,recvmsg
0,48252828300,48252839000,00000010700,a17,select
0,48252842100,48252842300,00000000200,a2f,recvmsg
0,48252847700,48252847900,00000000200,a2f,recvmsg
0,48252848100,48252848300,00000000200,a2f,recvmsg
0,48252842800,48252853700,00000010900,a17,select
0,48252857200,48252857300,00000000100,a2f,recvmsg
0,48252862800,48252863000,00000000200,a2f,recvmsg
0,48252863200,48252863400,00000000200,a2f,recvmsg
0,48252857800,48252868900,00000011100,a17,select
0,48252871900,48252872100,00000000200,a2f,recvmsg
0,48252877500,48252877600,00000000100,a2f,recvmsg
0,48252878000,48252878200,00000000200,a2f,recvmsg
0,48252872700,48252883200,00000010500,a17,select
0,48252886600,48252886700,00000000100,a2f,recvmsg
0,48252892000,48252892200,00000000200,a2f,recvmsg
0,48252892500,48252892700,00000000200,a2f,recvmsg
0,48252887300,48252897400,00000010100,a17,select
0,48252900400,48252900500,00000000100,a2f,recvmsg
0,48252905800,48252905900,00000000100,a2f,recvmsg
0,48252906300,48252906500,00000000200,a2f,recvmsg
0,48252901100,48252912600,00000011500,a17,select
0,48252916100,48252916300,00000000200,a2f,recvmsg
0,48252922600,48252922800,00000000200,a2f,recvmsg
0,48252923100,48252923300,00000000200,a2f,recvmsg
0,48252916700,48252928600,00000011900,a17,select
0,48252931800,48252931900,00000000100,a2f,recvmsg
0,48252937300,48252937300,00000000000,a2f,recvmsg
0,48252937700,48252937900,00000000200,a2f,recvmsg
0,48252932500,48252943000,00000010500,a17,select
0,48252946200,48252946400,00000000200,a2f,recvmsg
0,48252951600,48252951700,00000000100,a2f,recvmsg
0,48252952100,48252952300,00000000200,a2f,recvmsg
0,48252946900,48252957200,00000010300,a17,select
0,48252960300,48252960500,00000000200,a2f,recvmsg
0,48252965900,48252966100,00000000200,a2f,recvmsg
0,48252966400,48252966600,00000000200,a2f,recvmsg
0,48252961100,48252971700,00000010600,a17,select
0,48252974700,48252974900,00000000200,a2f,recvmsg
0,48252980100,48252980300,00000000200,a2f,recvmsg
0,48252980600,48252980800,00000000200,a2f,recvmsg
0,48252975400,48252986000,00000010600,a17,select
0,48252989100,48252989300,00000000200,a2f,recvmsg
0,48252994700,48252994800,00000000100,a2f,recvmsg
0,48252995200,48252995400,00000000200,a2f,recvmsg
0,48252989900,48253000300,00000010400,a17,select
0,48253003500,48253003600,00000000100,a2f,recvmsg
0,48253008900,48253009000,00000000100,a2f,recvmsg
0,48253009400,48253009500,00000000100,a2f,recvmsg
0,48253004100,48253014000,00000009900,a17,select
0,48253017100,48253017300,00000000200,a2f,recvmsg
0,48253022500,48253022700,00000000200,a2f,recvmsg
0,48253022900,48253023100,00000000200,a2f,recvmsg
0,48253017900,48253029900,00000012000,a17,select
0,48253033000,48253033100,00000000100,a2f,recvmsg
0,48253038500,48253038700,00000000200,a2f,recvmsg
0,48253039000,48253039200,00000000200,a2f,recvmsg
0,48253033700,48253043600,00000009900,a17,select
0,48253046800,48253046900,00000000100,a2f,recvmsg
0,48253052000,48253052100,00000000100,a2f,recvmsg
0,48253052500,48253052700,00000000200,a2f,recvmsg
0,48253047500,48253057100,00000009600,a17,select
0,48253060200,48253060300,00000000100,a2f,recvmsg
0,48253065500,48253065700,00000000200,a2f,recvmsg
0,48253066000,48253066200,00000000200,a2f,recvmsg
0,48253060800,48253070600,00000009800,a17,select
0,48253073700,48253073900,00000000200,a2f,recvmsg
0,48253079000,48253079100,00000000100,a2f,recvmsg
0,48253079500,48253079700,00000000200,a2f,recvmsg
0,48253074300,48253084600,00000010300,a17,select
0,48253087600,48253087800,00000000200,a2f,recvmsg
0,48253093000,48253093100,00000000100,a2f,recvmsg
0,48253093500,48253093700,00000000200,a2f,recvmsg
0,48253088400,48253098300,00000009900,a17,select
0,48253101400,48253101500,00000000100,a2f,recvmsg
0,48253106800,48253107000,00000000200,a2f,recvmsg
0,48253107400,48253107500,00000000100,a2f,recvmsg
0,48253102100,48253112800,00000010700,a17,select
0,48253115900,48253116100,00000000200,a2f,recvmsg
0,48253121600,48253121700,00000000100,a2f,recvmsg
0,48253122100,48253122300,00000000200,a2f,recvmsg
0,48253116700,48253127500,00000010800,a17,select
0,48253130600,48253130800,00000000200,a2f,recvmsg
0,48253135900,48253136000,00000000100,a2f,recvmsg
0,48253136400,48253136600,00000000200,a2f,recvmsg
0,48253131200,48253142300,00000011100,a17,select
0,48253145600,48253145800,00000000200,a2f,recvmsg
0,48253151000,48253151100,00000000100,a2f,recvmsg
0,48253151500,48253151700,00000000200,a2f,recvmsg
0,48253146300,48253157100,00000010800,a17,select
0,48253160100,48253160200,00000000100,a2f,recvmsg
0,48253165300,48253165500,00000000200,a2f,recvmsg
0,48253165800,48253166000,00000000200,a2f,recvmsg
0,48253160800,48253171400,00000010600,a17,select
0,48253174700,48253174800,00000000100,a2f,recvmsg
0,48253180000,48253180200,00000000200,a2f,recvmsg
0,48253180500,48253180600,00000000100,a2f,recvmsg
0,48253175400,48253188000,00000012600,a17,select
0,48253191200,48253191400,00000000200,a2f,recvmsg
0,48253196600,48253196700,00000000100,a2f,recvmsg
0,48253197100,48253197300,00000000200,a2f,recvmsg
0,48253191900,48253202100,00000010200,a17,select
0,48253205200,48253205300,00000000100,a2f,recvmsg
0,48253210600,48253210700,00000000100,a2f,recvmsg
0,48253211000,48253211200,00000000200,a2f,recvmsg
0,48253205900,48253217100,00000011200,a17,select
0,48253220400,48253220500,00000000100,a2f,recvmsg
0,48253225900,48253226000,00000000100,a2f,recvmsg
0,48253226300,48253226500,00000000200,a2f,recvmsg
0,48253221100,48253232200,00000011100,a17,select
0,48253235400,48253235600,00000000200,a2f,recvmsg
0,48253240800,48253241000,00000000200,a2f,recvmsg
0,48253241300,48253241400,00000000100,a2f,recvmsg
0,48253236100,48253246800,00000010700,a17,select
0,48253250000,48253250200,00000000200,a2f,recvmsg
0,48253255500,48253255700,00000000200,a2f,recvmsg
0,48253256000,48253256200,00000000200,a2f,recvmsg
0,48253250800,48253261900,00000011100,a17,select
0,48253265200,48253265400,00000000200,a2f,recvmsg
0,48253270800,48253271000,00000000200,a2f,recvmsg
0,48253271300,48253271500,00000000200,a2f,recvmsg
0,48253266000,48253276700,00000010700,a17,select
0,48253279700,48253279900,00000000200,a2f,recvmsg
0,48253285100,48253285200,00000000100,a2f,recvmsg
0,48253285600,48253285800,00000000200,a2f,recvmsg
0,48253280500,48253290700,00000010200,a17,select
0,48253293900,48253294000,00000000100,a2f,recvmsg
0,48253299300,48253299500,00000000200,a2f,recvmsg
0,48253299900,48253300000,00000000100,a2f,recvmsg
0,48253294500,48253304700,00000010200,a17,select
0,48253307800,48253307800,00000000000,a2f,recvmsg
0,48253313200,48253313400,00000000200,a2f,recvmsg
0,48253313600,48253313800,00000000200,a2f,recvmsg
0,48253308400,48253319100,00000010700,a17,select
0,48253322200,48253322400,00000000200,a2f,recvmsg
0,48253327600,48253327700,00000000100,a2f,recvmsg
0,48253328100,48253328300,00000000200,a2f,recvmsg
0,48253329500,48253329700,00000000200,a08,lseek
0,48253332300,48253333200,00000000900,a00,read
0,48253336900,48253337000,00000000100,a08,lseek
0,48253323000,48253341900,00000018900,a17,select
0,48253345200,48253345400,00000000200,a2f,recvmsg
0,48253350800,48253351000,00000000200,a2f,recvmsg
0,48253351400,48253351500,00000000100,a2f,recvmsg
0,48253345900,48253379900,00000034000,a17,select
0,48253383500,48253383600,00000000100,a2f,recvmsg
0,48253389200,48253389400,00000000200,a2f,recvmsg
0,48253389700,48253389900,00000000200,a2f,recvmsg
0,48253393900,48253394700,00000000800,a00,read
0,48253400200,48253400300,00000000100,a08,lseek
0,48253384200,48253405500,00000021300,a17,select
0,48253408900,48253409000,00000000100,a2f,recvmsg
0,48253414400,48253414600,00000000200,a2f,recvmsg
0,48253415000,48253415200,00000000200,a2f,recvmsg
0,48253409700,48253419700,00000010000,a17,select
0,48253422700,48253422900,00000000200,a2f,recvmsg
0,48253428000,48253428200,00000000200,a2f,recvmsg
0,48253428600,48253428700,00000000100,a2f,recvmsg
0,48253423500,48253433100,00000009600,a17,select
0,48253436000,48253436200,00000000200,a2f,recvmsg
0,48253441200,48253441400,00000000200,a2f,recvmsg
0,48253441800,48253441900,00000000100,a2f,recvmsg
0,48253436700,48253446400,00000009700,a17,select
0,48253449300,48253449400,00000000100,a2f,recvmsg
0,48253454600,48253454800,00000000200,a2f,recvmsg
0,48253455100,48253455300,00000000200,a2f,recvmsg
0,48253450000,48253459700,00000009700,a17,select
0,48253462800,48253462900,00000000100,a2f,recvmsg
0,48253468000,48253468200,00000000200,a2f,recvmsg
0,48253468600,48253468800,00000000200,a2f,recvmsg
0,48253463500,48253473100,00000009600,a17,select
0,48253476000,48253476200,00000000200,a2f,recvmsg
0,48253481300,48253481500,00000000200,a2f,recvmsg
0,48253481900,48253482100,00000000200,a2f,recvmsg
0,48253476700,48253486400,00000009700,a17,select
0,48253489400,48253489600,00000000200,a2f,recvmsg
0,48253494600,48253494800,00000000200,a2f,recvmsg
0,48253495200,48253495400,00000000200,a2f,recvmsg
0,48253490100,48253500400,00000010300,a17,select
0,48253503500,48253503700,00000000200,a2f,recvmsg
0,48253508900,48253509000,00000000100,a2f,recvmsg
0,48253509300,48253509500,00000000200,a2f,recvmsg
0,48253504300,48253514100,00000009800,a17,select
0,48253517200,48253517400,00000000200,a2f,recvmsg
0,48253522500,48253522600,00000000100,a2f,recvmsg
0,48253523000,48253523200,00000000200,a2f,recvmsg
0,48253523800,48253523900,00000000100,a08,lseek
0,48253517900,48253529600,00000011700,a17,select
0,48253532700,48253532900,00000000200,a2f,recvmsg
0,48253538300,48253538500,00000000200,a2f,recvmsg
0,48253538800,48253539000,00000000200,a2f,recvmsg
0,48253533500,48253545800,00000012300,a17,select
0,48253549100,48253549100,00000000000,a2f,recvmsg
0,48253554500,48253554600,00000000100,a2f,recvmsg
0,48253554900,48253555100,00000000200,a2f,recvmsg
0,48253549700,48253560200,00000010500,a17,select
0,48253563100,48253563300,00000000200,a2f,recvmsg
0,48253568600,48253568700,00000000100,a2f,recvmsg
0,48253569100,48253569300,00000000200,a2f,recvmsg
0,48253563900,48253574000,00000010100,a17,select
0,48253577100,48253577300,00000000200,a2f,recvmsg
0,48253582400,48253582600,00000000200,a2f,recvmsg
0,48253583000,48253583200,00000000200,a2f,recvmsg
0,48253577700,48253587800,00000010100,a17,select
0,48253590800,48253590900,00000000100,a2f,recvmsg
0,48253596600,48253596700,00000000100,a2f,recvmsg
0,48253597100,48253597300,00000000200,a2f,recvmsg
0,48253591500,48253602100,00000010600,a17,select
0,48253605200,48253605300,00000000100,a2f,recvmsg
0,48253610500,48253610700,00000000200,a2f,recvmsg
0,48253611100,48253611200,00000000100,a2f,recvmsg
0,48253605900,48253616400,00000010500,a17,select
0,48253619400,48253619600,00000000200,a2f,recvmsg
0,48253624700,48253624900,00000000200,a2f,recvmsg
0,48253625200,48253625400,00000000200,a2f,recvmsg
0,48253620200,48253630100,00000009900,a17,select
0,48253633100,48253633300,00000000200,a2f,recvmsg
0,48253638400,48253638500,00000000100,a2f,recvmsg
0,48253638900,48253639100,00000000200,a2f,recvmsg
0,48253633800,48253643800,00000010000,a17,select
0,48253646900,48253647100,00000000200,a2f,recvmsg
0,48253652200,48253652300,00000000100,a2f,recvmsg
0,48253652700,48253652900,00000000200,a2f,recvmsg
0,48253647600,48253657600,00000010000,a17,select
0,48253660700,48253660900,00000000200,a2f,recvmsg
0,48253665900,48253666100,00000000200,a2f,recvmsg
0,48253666500,48253666700,00000000200,a2f,recvmsg
0,48253661400,48253671300,00000009900,a17,select
0,48253674400,48253674500,00000000100,a2f,recvmsg
0,48253679700,48253679900,00000000200,a2f,recvmsg
0,48253680200,48253680300,00000000100,a2f,recvmsg
0,48253675000,48253685100,00000010100,a17,select
0,48253688100,48253688300,00000000200,a2f,recvmsg
0,48253693400,48253693500,00000000100,a2f,recvmsg
0,48253693900,48253694100,00000000200,a2f,recvmsg
0,48253688900,48253699300,00000010400,a17,select
0,48253354100,48294205300,00040851200,60e,page_fault
0,48294212900,48294213500,00000000600,a00,read
0,48294371900,48294372500,00000000600,a00,read
0,48294480800,48294481500,00000000700,a00,read
0,48294512300,48294513000,00000000700,a0c,brk
0,48294620900,48294621600,00000000700,a00,read
0,48294860600,48294861100,00000000500,a00,read
0,48294872900,48294873300,00000000400,a00,read
0,48294917200,48294917600,00000000400,a00,read
0,48294937300,48294938000,00000000700,a00,read
0,48295147200,48295147700,00000000500,a00,read
0,48295176900,48295177800,00000000900,a00,read
0,48295274800,48295275500,00000000700,a00,read
0,48295299500,48295300700,00000001200,a0c,brk
0,48295345400,48295345800,00000000400,a00,read
0,48295422200,48295423000,00000000800,a00,read
0,48295576100,48295576600,00000000500,a00,read
0,48295688700,48295689200,00000000500,a00,read
0,48295784600,48295785100,00000000500,a00,read
0,48295796900,48295797400,00000000500,a00,read
0,48295879100,48295879500,00000000400,a00,read
0,48295903700,48295904000,00000000300,a00,read
0,48295926300,48295926700,00000000400,a00,read
0,48296028200,48296029300,00000001100,a0c,brk
0,48296031100,48296032000,00000000900,a00,read
0,48296231100,48296231500,00000000400,a00,read
0,48296313900,48296314500,00000000600,a00,read
0,48296378700,48296379300,00000000600,a00,read
0,48296507000,48296507400,00000000400,a00,read
0,48296539700,48296540300,00000000600,a00,read
0,48296558100,48296559400,00000001300,a02,open
0,48296668600,48296669100,00000000500,a00,read
0,48296739200,48296739600,00000000400,a00,read
0,48296791700,48296792800,00000001100,a0c,brk
0,48296798800,48296799400,00000000600,a00,read
0,48296906100,48296906800,00000000700,a00,read
0,48297055500,48297056400,00000000900,a00,read
0,48297186300,48297186900,00000000600,a00,read
0,48297245200,48297245800,00000000600,a00,read
0,48297301100,48297301800,00000000700,a00,read
0,48297371300,48297372100,00000000800,a00,read
0,48297424500,48297425200,00000000700,a00,read
0,48297512600,48297513400,00000000800,a0c,brk
0,48297544400,48297548300,00000003900,a0c,brk
0,48297562400,48297563100,00000000700,a00,read
0,48297677700,48297678500,00000000800,a00,read
0,48297837000,48297837700,00000000700,a00,read
0,48297964500,48297965200,00000000700,a00,read
0,48298110300,48298111000,00000000700,a00,read
0,48298228800,48298229600,00000000800,a00,read
0,48298391000,48298391600,00000000600,a00,read
0,48298396600,48298397400,00000000800,a0c,brk
0,48298512300,48298513000,00000000700,a00,read
0,48298631100,48298631800,00000000700,a00,read
0,48298772900,48298773700,00000000800,a00,read
0,48298904600,48298905300,00000000700,a00,read
0,48298998000,48298998700,00000000700,a00,read
0,48299111600,48299112300,00000000700,a00,read
0,48299235800,48299236500,00000000700,a00,read
0,48299347700,48299348300,00000000600,a0c,brk
0,48299371200,48299371900,00000000700,a00,read
0,48299540800,48299541400,00000000600,a00,read
0,48299690800,48299691600,00000000800,a00,read
0,48299801800,48299802600,00000000800,a00,read
0,48299971000,48299971800,00000000800,a00,read
0,48300048200,48300048900,00000000700,a00,read
0,48300130400,48300131100,00000000700,a00,read
0,48300198000,48300198600,00000000600,a0c,brk
0,48300212200,48300213100,00000000900,a00,read
0,48300285300,48300286000,00000000700,a00,read
0,48300386600,48300387500,00000000900,a00,read
0,48300489600,48300490300,00000000700,a00,read
0,48300580500,48300581100,00000000600,a00,read
0,48300661200,48300661800,00000000600,a00,read
0,48300762200,48300763000,00000000800,a00,read
0,48300843600,48300843900,00000000300,a0c,brk
0,48300846400,48300847100,00000000700,a00,read
0,48300953300,48300954000,00000000700,a00,read
0,48301045600,48301046300,00000000700,a00,read
0,48301165400,48301166100,00000000700,a00,read
0,48301279000,48301279500,00000000500,a00,read
0,48301381900,48301382500,00000000600,a00,read
0,48301482100,48301482300,00000000200,a0c,brk
0,48301837000,48301840400,00000003400,a57,unlink
0,48301841200,48301865600,00000024400,a02,open
0,48301866800,48301867500,00000000700,a48,fcntl
0,48309922300,48309937600,00000015300,a01,write
0,48309955400,48309957800,00000002400,a01,write
0,48309973800,48309975800,00000002000,a01,write
0,48236630900,48310137100,00073506200,a3d,wait4
0,48310158300,48310161200,00000002900,a00,read
0,48310163300,48310163600,00000000300,a00,read
0,48253688900,48310195200,00056506300,a17,select
0,48310216200,48310216500,00000000300,a2f,recvmsg
0,48310232800,48310233000,00000000200,a2f,recvmsg
0,48310233800,48310234000,00000000200,a2f,recvmsg
0,48310220100,48310240900,00000020800,a17,select
0,48310244800,48310245000,00000000200,a2f,recvmsg
0,48310250800,48310250900,00000000100,a2f,recvmsg
0,48310251300,48310251500,00000000200,a2f,recvmsg
0,48310245600,48310256700,00000011100,a17,select
0,48310260200,48310260300,00000000100,a2f,recvmsg
0,48310265600,48310265800,00000000200,a2f,recvmsg
0,48310266100,48310266300,00000000200,a2f,recvmsg
0,48310260900,48310271900,00000011000,a17,select
0,48310275500,48310275700,00000000200,a2f,recvmsg
0,48310281000,48310281200,00000000200,a2f,recvmsg
0,48310281400,48310281600,00000000200,a2f,recvmsg
0,48310276300,48310287200,00000010900,a17,select
0,48310291200,48310291400,00000000200,a2f,recvmsg
0,48310296500,48310296700,00000000200,a2f,recvmsg
0,48310297000,48310297200,00000000200,a2f,recvmsg
0,48310292000,48310301600,00000009600,a17,select
0,48310304600,48310304800,00000000200,a2f,recvmsg
0,48310310800,48310311000,00000000200,a2f,recvmsg
0,48310311300,48310311500,00000000200,a2f,recvmsg
0,48310312800,48310313000,00000000200,a08,lseek
0,48310322700,48310322800,00000000100,a08,lseek
0,48310305400,48310327200,00000021800,a17,select
0,48310330700,48310330800,00000000100,a2f,recvmsg
0,48310336300,48310336500,00000000200,a2f,recvmsg
0,48310336800,48310337000,00000000200,a2f,recvmsg
0,48310331500,48310343900,00000012400,a17,select
0,48310347400,48310347500,00000000100,a2f,recvmsg
0,48310353600,48310353800,00000000200,a2f,recvmsg
0,48310354200,48310354400,00000000200,a2f,recvmsg
0,48310348000,48310359500,00000011500,a17,select
0,48310362600,48310362800,00000000200,a2f,recvmsg
0,48310368200,48310368300,00000000100,a2f,recvmsg
0,48310368600,48310368800,00000000200,a2f,recvmsg
0,48310363300,48310374200,00000010900,a17,select
0,48310377200,48310377400,00000000200,a2f,recvmsg
0,48310382700,48310382900,00000000200,a2f,recvmsg
0,48310383200,48310383400,00000000200,a2f,recvmsg
0,48310377900,48310388600,00000010700,a17,select
0,48310391800,48310391900,00000000100,a2f,recvmsg
0,48310398100,48310398300,00000000200,a2f,recvmsg
0,48310398700,48310398900,00000000200,a2f,recvmsg
0,48310392500,48310404400,00000011900,a17,select
0,48310407500,48310407700,00000000200,a2f,recvmsg
0,48310413800,48310413900,00000000100,a2f,recvmsg
0,48310414200,48310414400,00000000200,a2f,recvmsg
0,48310408300,48310419600,00000011300,a17,select
0,48310423000,48310423200,00000000200,a2f,recvmsg
0,48310428400,48310428600,00000000200,a2f,recvmsg
0,48310428900,48310429100,00000000200,a2f,recvmsg
0,48310423700,48310433700,00000010000,a17,select
0,48310436700,48310436900,00000000200,a2f,recvmsg
0,48310442000,48310442200,00000000200,a2f,recvmsg
0,48310442500,48310442700,00000000200,a2f,recvmsg
0,48310437400,48310448800,00000011400,a17,select
0,48310452200,48310452300,00000000100,a2f,recvmsg
0,48310457600,48310457800,00000000200,a2f,recvmsg
0,48310458000,48310458200,00000000200,a2f,recvmsg
0,48310452900,48310463600,00000010700,a17,select
0,48310466800,48310467000,00000000200,a2f,recvmsg
0,48310472300,48310472500,00000000200,a2f,recvmsg
0,48310472800,48310473000,00000000200,a2f,recvmsg
0,48310467500,48310478100,00000010600,a17,select
0,48310481300,48310481500,00000000200,a2f,recvmsg
0,48310486900,48310487000,00000000100,a2f,recvmsg
0,48310487400,48310487600,00000000200,a2f,recvmsg
0,48310482100,48310492700,00000010600,a17,select
0,48310495900,48310496000,00000000100,a2f,recvmsg
0,48310501600,48310501700,00000000100,a2f,recvmsg
0,48310502100,48310502300,00000000200,a2f,recvmsg
0,48310496600,48310507700,00000011100,a17,select
0,48310511000,48310511100,00000000100,a2f,recvmsg
0,48310516500,48310516700,00000000200,a2f,recvmsg
0,48310517000,48310517100,00000000100,a2f,recvmsg
0,48310511700,48310522500,00000010800,a17,select
0,48310525700,48310525900,00000000200,a2f,recvmsg
0,48310531100,48310531300,00000000200,a2f,recvmsg
0,48310531700,48310531900,00000000200,a2f,recvmsg
0,48310526400,48310536700,00000010300,a17,select
0,48310539800,48310539900,00000000100,a2f,recvmsg
0,48310546000,48310546200,00000000200,a2f,recvmsg
0,48310546600,48310546700,00000000100,a2f,recvmsg
0,48310540500,48310551300,00000010800,a17,select
0,48310554600,48310554800,00000000200,a2f,recvmsg
0,48310560000,48310560200,00000000200,a2f,recvmsg
0,48310560500,48310560600,00000000100,a2f,recvmsg
0,48310555300,48310567400,00000012100,a17,select
0,48310570500,48310570600,00000000100,a2f,recvmsg
0,48310575900,48310576100,00000000200,a2f,recvmsg
0,48310576400,48310576600,00000000200,a2f,recvmsg
0,48310571200,48310581100,00000009900,a17,select
0,48310584200,48310584400,00000000200,a2f,recvmsg
0,48310589500,48310589600,00000000100,a2f,recvmsg
0,48310590000,48310590200,00000000200,a2f,recvmsg
0,48310585000,48310594700,00000009700,a17,select
0,48310597700,48310597900,00000000200,a2f,recvmsg
0,48310603000,48310603200,00000000200,a2f,recvmsg
0,48310603600,48310603700,00000000100,a2f,recvmsg
0,48310598500,48310608100,00000009600,a17,select
0,48310611300,48310611500,00000000200,a2f,recvmsg
0,48310616700,48310616900,00000000200,a2f,recvmsg
0,48310617200,48310617400,00000000200,a2f,recvmsg
0,48310612000,48310622300,00000010300,a17,select
0,48310625200,48310625400,00000000200,a2f,recvmsg
0,48310630800,48310630800,00000000000,a2f,recvmsg
0,48310631200,48310631400,00000000200,a2f,recvmsg
0,48310626000,48310636100,00000010100,a17,select
0,48310639000,48310639200,00000000200,a2f,recvmsg
0,48310644600,48310644800,00000000200,a2f,recvmsg
0,48310645100,48310645300,00000000200,a2f,recvmsg
0,48310639800,48310650600,00000010800,a17,select
0,48310653700,48310653900,00000000200,a2f,recvmsg
0,48310659300,48310659400,00000000100,a2f,recvmsg
0,48310659700,48310659900,00000000200,a2f,recvmsg
0,48310654500,48310665100,00000010600,a17,select
0,48310668400,48310668500,00000000100,a2f,recvmsg
0,48310673600,48310673800,00000000200,a2f,recvmsg
0,48310674100,48310674300,00000000200,a2f,recvmsg
0,48310669000,48310680300,00000011300,a17,select
0,48310683700,48310683900,00000000200,a2f,recvmsg
0,48310689000,48310689200,00000000200,a2f,recvmsg
0,48310689500,48310689700,00000000200,a2f,recvmsg
0,48310684400,48310695200,00000010800,a17,select
0,48310698200,48310698400,00000000200,a2f,recvmsg
0,48310703400,48310703600,00000000200,a2f,recvmsg
0,48310703900,48310704100,00000000200,a2f,recvmsg
0,48310699000,48310709600,00000010600,a17,select
0,48310712800,48310713000,00000000200,a2f,recvmsg
0,48310718200,48310718300,00000000100,a2f,recvmsg
0,48310718600,48310718800,00000000200,a2f,recvmsg
0,48310713600,48310726300,00000012700,a17,select
0,48310729600,48310729700,00000000100,a2f,recvmsg
0,48310735100,48310735200,00000000100,a2f,recvmsg
0,48310735500,48310735700,00000000200,a2f,recvmsg
0,48310730300,48310740700,00000010400,a17,select
0,48310743700,48310743800,00000000100,a2f,recvmsg
0,48310749100,48310749300,00000000200,a2f,recvmsg
0,48310749600,48310749800,00000000200,a2f,recvmsg
0,48310744500,48310754700,00000010200,a17,select
0,48310758000,48310758100,00000000100,a2f,recvmsg
0,48310763400,48310763500,00000000100,a2f,recvmsg
0,48310763800,48310764000,00000000200,a2f,recvmsg
0,48310758700,48310769900,00000011200,a17,select
0,48310773200,48310773300,00000000100,a2f,recvmsg
0,48310778500,48310778700,00000000200,a2f,recvmsg
0,48310779000,48310779100,00000000100,a2f,recvmsg
0,48310773800,48310784700,00000010900,a17,select
0,48310787900,48310788000,00000000100,a2f,recvmsg
0,48310793300,48310793500,00000000200,a2f,recvmsg
0,48310793800,48310794000,00000000200,a2f,recvmsg
0,48310788500,48310799800,00000011300,a17,select
0,48310803100,48310803300,00000000200,a2f,recvmsg
0,48310808500,48310808700,00000000200,a2f,recvmsg
0,48310809000,48310809200,00000000200,a2f,recvmsg
0,48310803800,48310814400,00000010600,a17,select
0,48310817500,48310817700,00000000200,a2f,recvmsg
0,48310822900,48310823100,00000000200,a2f,recvmsg
0,48310823400,48310823600,00000000200,a2f,recvmsg
0,48310818300,48310828600,00000010300,a17,select
0,48310831800,48310832000,00000000200,a2f,recvmsg
0,48310837300,48310837400,00000000100,a2f,recvmsg
0,48310837800,48310837900,00000000100,a2f,recvmsg
0,48310832500,48310842700,00000010200,a17,select
0,48310845700,48310845800,00000000100,a2f,recvmsg
0,48310851100,48310851200,00000000100,a2f,recvmsg
0,48310851500,48310851700,00000000200,a2f,recvmsg
0,48310846400,48310857000,00000010600,a17,select
0,48310860200,48310860400,00000000200,a2f,recvmsg
0,48310865600,48310865800,00000000200,a2f,recvmsg
0,48310866200,48310866400,00000000200,a2f,recvmsg
0,48310867600,48310867900,00000000300,a08,lseek
0,48310870600,48310871600,00000001000,a00,read
0,48310875200,48310875300,00000000100,a08,lseek
0,48310860900,48310880000,00000019100,a17,select
0,48310883300,48310883500,00000000200,a2f,recvmsg
0,48310889000,48310889200,00000000200,a2f,recvmsg
0,48310889400,48310889600,00000000200,a2f,recvmsg
0,48310884100,48310917100,00000033000,a17,select
0,48310920400,48310920600,00000000200,a2f,recvmsg
0,48310926100,48310926300,00000000200,a2f,recvmsg
0,48310926700,48310926800,00000000100,a2f,recvmsg
0,48310930900,48310931600,00000000700,a00,read
0,48310937100,48310937200,00000000100,a08,lseek
0,48310921300,48310942300,00000021000,a17,select
0,48310945600,48310945800,00000000200,a2f,recvmsg
0,48310951100,48310951300,00000000200,a2f,recvmsg
0,48310951700,48310951900,00000000200,a2f,recvmsg
0,48310946300,48310956400,00000010100,a17,select
0,48310959500,48310959600,00000000100,a2f,recvmsg
0,48310964800,48310965000,00000000200,a2f,recvmsg
0,48310965200,48310965400,00000000200,a2f,recvmsg
0,48310960200,48310969800,00000009600,a17,select
0,48310972700,48310972800,00000000100,a2f,recvmsg
0,48310977900,48310978100,00000000200,a2f,recvmsg
0,48310978500,48310978600,00000000100,a2f,recvmsg
0,48310973400,48310983000,00000009600,a17,select
0,48310986000,48310986100,00000000100,a2f,recvmsg
0,48310991400,48310991600,00000000200,a2f,recvmsg
0,48310991800,48310992000,00000000200,a2f,recvmsg
0,48310986600,48310996500,00000009900,a17,select
0,48310999500,48310999600,00000000100,a2f,recvmsg
0,48311004800,48311004900,00000000100,a2f,recvmsg
0,48311005200,48311005400,00000000200,a2f,recvmsg
0,48311000200,48311009800,00000009600,a17,select
0,48311012800,48311012900,00000000100,a2f,recvmsg
0,48311018100,48311018300,00000000200,a2f,recvmsg
0,48311018500,48311018700,00000000200,a2f,recvmsg
0,48311013500,48311023100,00000009600,a17,select
0,48311026000,48311026200,00000000200,a2f,recvmsg
0,48311031300,48311031500,00000000200,a2f,recvmsg
0,48311031700,48311031900,00000000200,a2f,recvmsg
0,48311026700,48311037000,00000010300,a17,select
0,48311040000,48311040200,00000000200,a2f,recvmsg
0,48311045400,48311045500,00000000100,a2f,recvmsg
0,48311045900,48311046100,00000000200,a2f,recvmsg
0,48311040800,48311050600,00000009800,a17,select
0,48311053600,48311053700,00000000100,a2f,recvmsg
0,48311058800,48311058900,00000000100,a2f,recvmsg
0,48311059300,48311059500,00000000200,a2f,recvmsg
0,48311060100,48311060200,00000000100,a08,lseek
0,48311054300,48311066100,00000011800,a17,select
0,48311069200,48311069400,00000000200,a2f,recvmsg
0,48311074600,48311074800,00000000200,a2f,recvmsg
0,48311075100,48311075300,00000000200,a2f,recvmsg
0,48311069800,48311082000,00000012200,a17,select
0,48311085200,48311085300,00000000100,a2f,recvmsg
0,48311090600,48311090700,00000000100,a2f,recvmsg
0,48311091000,48311091200,00000000200,a2f,recvmsg
0,48311085900,48311096300,00000010400,a17,select
0,48311099200,48311099400,00000000200,a2f,recvmsg
0,48311104500,48311104700,00000000200,a2f,recvmsg
0,48311105000,48311105200,00000000200,a2f,recvmsg
0,48311100000,48311110000,00000010000,a17,select
0,48311113100,48311113300,00000000200,a2f,recvmsg
0,48311118500,48311118700,00000000200,a2f,recvmsg
0,48311119000,48311119100,00000000100,a2f,recvmsg
0,48311113700,48311123800,00000010100,a17,select
0,48311126800,48311127000,00000000200,a2f,recvmsg
0,48311132300,48311132400,00000000100,a2f,recvmsg
0,48311132700,48311132900,00000000200,a2f,recvmsg
0,48311127500,48311137500,00000010000,a17,select
0,48311140500,48311140700,00000000200,a2f,recvmsg
0,48311146000,48311146100,00000000100,a2f,recvmsg
0,48311146500,48311146700,00000000200,a2f,recvmsg
0,48311141300,48311152100,00000010800,a17,select
0,48311155200,48311155200,00000000000,a2f,recvmsg
0,48311160500,48311160600,00000000100,a2f,recvmsg
0,48311160900,48311161100,00000000200,a2f,recvmsg
0,48311155800,48311165800,00000010000,a17,select
0,48311168900,48311169100,00000000200,a2f,recvmsg
0,48311174200,48311174300,00000000100,a2f,recvmsg
0,48311174700,48311174900,00000000200,a2f,recvmsg
0,48311169700,48311179600,00000009900,a17,select
0,48311182500,48311182700,00000000200,a2f,recvmsg
0,48311187800,48311188000,00000000200,a2f,recvmsg
0,48311188300,48311188500,00000000200,a2f,recvmsg
0,48311183300,48311193200,00000009900,a17,select
0,48311196200,48311196300,00000000100,a2f,recvmsg
0,48311201600,48311201800,00000000200,a2f,recvmsg
0,48311202200,48311202300,00000000100,a2f,recvmsg
0,48311196900,48311206900,00000010000,a17,select
0,48311209900,48311210100,00000000200,a2f,recvmsg
0,48311215300,48311215400,00000000100,a2f,recvmsg
0,48311215800,48311216000,00000000200,a2f,recvmsg
0,48311210600,48311220600,00000010000,a17,select
0,48311223600,48311223800,00000000200,a2f,recvmsg
0,48311229000,48311229200,00000000200,a2f,recvmsg
0,48311229400,48311229600,00000000200,a2f,recvmsg
0,48311224400,48311234900,00000010500,a17,select
0,48311237900,48311238000,00000000100,a2f,recvmsg
0,48311243100,48311243300,00000000200,a2f,recvmsg
0,48311243700,48311243800,00000000100,a2f,recvmsg
0,48311238600,48311248400,00000009800,a17,select
0,48311251500,48311251700,00000000200,a2f,recvmsg
0,48311256800,48311257000,00000000200,a2f,recvmsg
0,48311257300,48311257500,00000000200,a2f,recvmsg
0,48311252100,48311262100,00000010000,a17,select
0,48311265200,48311265400,00000000200,a2f,recvmsg
0,48311270400,48311270600,00000000200,a2f,recvmsg
0,48311271000,48311271100,00000000100,a2f,recvmsg
0,48311265900,48311275700,00000009800,a17,select
0,48311278700,48311278900,00000000200,a2f,recvmsg
0,48311284100,48311284300,00000000200,a2f,recvmsg
0,48311284600,48311284700,00000000100,a2f,recvmsg
0,48311279500,48311295000,00000015500,a17,select
0,48311298000,48311298200,00000000200,a2f,recvmsg
0,48311303400,48311303500,00000000100,a2f,recvmsg
0,48311303900,48311304100,00000000200,a2f,recvmsg
0,48311298900,48311309000,00000010100,a17,select
0,48311312000,48311312200,00000000200,a2f,recvmsg
0,48311317200,48311317400,00000000200,a2f,recvmsg
0,48311317800,48311317900,00000000100,a2f,recvmsg
0,48311312800,48311322600,00000009800,a17,select
0,48311325600,48311325700,00000000100,a2f,recvmsg
0,48311330700,48311330900,00000000200,a2f,recvmsg
0,48311331200,48311331400,00000000200,a2f,recvmsg
0,48311326200,48311336300,00000010100,a17,select
0,48311339300,48311339500,00000000200,a2f,recvmsg
0,48311344500,48311344700,00000000200,a2f,recvmsg
0,48311345000,48311345200,00000000200,a2f,recvmsg
0,48311340000,48311349900,00000009900,a17,select
0,48311353000,48311353200,00000000200,a2f,recvmsg
0,48311358400,48311358500,00000000100,a2f,recvmsg
0,48311358800,48311359000,00000000200,a2f,recvmsg
0,48311403100,48311406700,00000003600,a14,writev
0,48311353800,48311410400,00000056600,a17,select
0,48311412800,48311414000,00000001200,a2f,recvmsg
0,48311499100,48311502900,00000003800,a14,writev
0,48311503600,48311506600,00000003000,a14,writev
0,48311584600,48311586500,00000001900,a14,writev
0,48311642900,48311644900,00000002000,a14,writev
0,48311645100,48311646600,00000001500,a14,writev
0,48311699400,48311701000,00000001600,a14,writev
0,48311701200,48311702700,00000001500,a14,writev
0,48311755600,48311757200,00000001600,a14,writev
0,48311757400,48311759000,00000001600,a14,writev
0,48311811800,48311813600,00000001800,a14,writev
0,48311813800,48311815600,00000001800,a14,writev
0,48311819600,48311820200,00000000600,a2f,recvmsg
0,48311868100,48311869700,00000001600,a14,writev
0,48311912100,48311914200,00000002100,a14,writev
0,48311956300,48311958100,00000001800,a14,writev
0,48312001000,48312002600,00000001600,a14,writev
0,48312045500,48312047600,00000002100,a14,writev
0,48312090400,48312092000,00000001600,a14,writev
0,48312117900,48312119700,00000001800,a2f,recvmsg
0,48312144600,48312146500,00000001900,a14,writev
0,48312163600,48312165900,00000002300,a14,writev
0,48312180600,48312182600,00000002000,a14,writev
0,48312196500,48312198600,00000002100,a14,writev
0,48312212100,48312213700,00000001600,a14,writev
0,48312227200,48312229100,00000001900,a14,writev
0,48312234000,48312234300,00000000300,a2f,recvmsg
0,48312234900,48312235200,00000000300,a14,writev
0,48312253100,48312254800,00000001700,a14,writev
0,48312255100,48312256800,00000001700,a14,writev
0,48312257300,48312257500,00000000200,a2f,recvmsg
0,48311402500,48312265800,00000863300,a07,poll
0,48312270500,48312276700,00000006200,a2f,recvmsg
0,48312288500,48312288700,00000000200,a2f,recvmsg
0,48312316300,48312320700,00000004400,a07,poll
0,48312326800,48312333000,00000006200,a2f,recvmsg
0,48312345100,48312345300,00000000200,a2f,recvmsg
0,48312367400,48312371800,00000004400,a07,poll
0,48312378000,48312383800,00000005800,a2f,recvmsg
0,48312397300,48312397500,00000000200,a2f,recvmsg
0,48312258200,48312426700,00000168500,a17,select
0,48312441800,48312443400,00000001600,a14,writev
0,48312443800,48312444000,00000000200,a2f,recvmsg
0,48312461900,48312462800,00000000900,a14,writev
0,48312463100,48312463200,00000000100,a2f,recvmsg
0,48312475200,48312476000,00000000800,a14,writev
0,48312476300,48312476500,00000000200,a2f,recvmsg
0,48312421100,48312480700,00000059600,a07,poll
0,48312481300,48312482300,00000001000,a2f,recvmsg
0,48312486900,48312487600,00000000700,a2d,recvfrom
0,48312488600,48312488800,00000000200,a2f,recvmsg
0,48312489400,48312489500,00000000100,a2f,recvmsg
0,48312530200,48312530500,00000000300,a2f,recvmsg
0,48312532500,48312532700,00000000200,a2f,recvmsg
0,48312534900,48312537000,00000002100,a07,poll
0,48312537500,48312538500,00000001000,a2f,recvmsg
0,48312543500,48312544100,00000000600,a2d,recvfrom
0,48312545000,48312545200,00000000200,a2f,recvmsg
0,48312545800,48312546000,00000000200,a2f,recvmsg
0,48312574400,48312574500,00000000100,a2f,recvmsg
0,48312576400,48312576500,00000000100,a2f,recvmsg
0,48312579500,48312581700,00000002200,a07,poll
0,48312582200,48312583300,00000001100,a2f,recvmsg
0,48312588700,48312589300,00000000600,a2d,recvfrom
0,48312590300,48312590500,00000000200,a2f,recvmsg
0,48312591200,48312591400,00000000200,a2f,recvmsg
0,48312620500,48312620800,00000000300,a2f,recvmsg
0,48312622600,48312622800,00000000200,a2f,recvmsg
0,48312633100,48312633300,00000000200,a2f,recvmsg
0,48312633800,48312634000,00000000200,a2f,recvmsg
0,48312477100,48312667500,00000190400,a17,select
0,48312677500,48312679500,00000002000,a14,writev
0,48312681400,48312681500,00000000100,a2f,recvmsg
0,48312689300,48312689500,00000000200,a2f,recvmsg
0,48312690000,48312690200,00000000200,a2f,recvmsg
0,48313141200,48313145200,00000004000,a09,mmap
0,48313299600,48313304600,00000005000,a02,open
0,48313312200,48313314400,00000002200,a00,read
0,48313365100,48313366000,00000000900,a00,read
0,48313414500,48313415300,00000000800,a00,read
0,48313461000,48313461700,00000000700,a00,read
0,48313508700,48313509300,00000000600,a00,read
0,48313555000,48313555700,00000000700,a00,read
0,48313599700,48313600400,00000000700,a00,read
0,48313644900,48313645800,00000000900,a00,read
0,48313693200,48313693800,00000000600,a00,read
0,48313742700,48313743300,00000000600,a00,read
0,48313790800,48313791500,00000000700,a00,read
0,48313818300,48313820100,00000001800,a02,open
0,48313823200,48313824100,00000000900,a00,read
0,48313895500,48313896400,00000000900,a00,read
0,48313978600,48313979500,00000000900,a00,read
0,48314050600,48314051300,00000000700,a00,read
0,48314127700,48314128400,00000000700,a00,read
0,48314205800,48314206500,00000000700,a00,read
0,48314282300,48314283000,00000000700,a00,read
0,48314366100,48314366700,00000000600,a00,read
0,48314433300,48314434000,00000000700,a00,read
0,48314490800,48314491500,00000000700,a00,read
0,48312682800,48314575200,00001892400,a17,select
0,48314588100,48314588400,00000000300,a2f,recvmsg
0,48314599700,48314599900,00000000200,a2f,recvmsg
0,48314600500,48314600600,00000000100,a2f,recvmsg
0,48314590300,48314606000,00000015700,a17,select
0,48314610200,48314610400,00000000200,a2f,recvmsg
0,48314616200,48314616300,00000000100,a2f,recvmsg
0,48314616800,48314617000,00000000200,a2f,recvmsg
0,48314621900,48314626700,00000004800,a06,lstat
0,48314627500,48314628900,00000001400,a06,lstat
0,48314646100,48314657400,00000011300,a01,write
0,48314611100,48314666000,00000054900,a17,select
0,48314671900,48314672300,00000000400,a2f,recvmsg
0,48314679800,48314680000,00000000200,a2f,recvmsg
0,48314680500,48314680700,00000000200,a2f,recvmsg
0,48314682200,48314990700,00000308500,a38,clone
0,48315464800,48315464900,00000000100,a0c,brk
0,48315474700,48315477400,00000002700,a15,access
0,48315478000,48315479000,00000001000,a09,mmap
0,48315482600,48315483400,00000000800,a15,access
0,48315489300,48315490500,00000001200,a09,mmap
0,48315494200,48315494700,00000000500,a15,access
0,48315501500,48315502400,00000000900,a00,read
0,48315503900,48315505300,00000001400,a09,mmap
0,48315510000,48315511900,00000001900,a09,mmap
0,48315523000,48315523600,00000000600,a15,access
0,48315526900,48315527500,00000000600,a00,read
0,48315528200,48315529000,00000000800,a09,mmap
0,48315530900,48315532200,00000001300,a09,mmap
0,48315540400,48315541000,00000000600,a15,access
0,48315543800,48315544300,00000000500,a00,read
0,48315545000,48315545900,00000000900,a09,mmap
0,48315547400,48315549700,00000002300,a09,mmap
0,48315553900,48315557200,00000003300,a09,mmap
0,48315570000,48315570700,00000000700,a15,access
0,48315573300,48315573900,00000000600,a00,read
0,48315574600,48315576300,00000001700,a09,mmap
0,48315578900,48315580600,00000001700,a09,mmap
0,48315588700,48315589500,00000000800,a15,access
0,48315592600,48315593300,00000000700,a00,read
0,48315593900,48315595500,00000001600,a09,mmap
0,48315598800,48315601200,00000002400,a09,mmap
0,48315609700,48315610300,00000000600,a15,access
0,48315612600,48315613200,00000000600,a00,read
0,48315613700,48315614700,00000001000,a09,mmap
0,48315616100,48315617400,00000001300,a09,mmap
0,48315620000,48315621300,00000001300,a09,mmap
0,48315627500,48315628200,00000000700,a15,access
0,48315630400,48315630900,00000000500,a00,read
0,48315631500,48315632700,00000001200,a09,mmap
0,48315634900,48315636500,00000001600,a09,mmap
0,48315654400,48315654700,00000000300,a09,mmap
0,48315655900,48315656200,00000000300,a09,mmap
0,48315833100,48315833200,00000000100,a0c,brk
0,48315833300,48315834100,00000000800,a0c,brk
0,48315870000,48315871000,00000001000,a00,read
0,48315883800,48315885100,00000001300,a00,read
0,48315926000,48315926900,00000000900,a00,read
0,48316050600,48316051300,00000000700,a00,read
0,48316122700,48316123100,00000000400,a00,read
0,48316208900,48316209500,00000000600,a00,read
0,48316339700,48316340700,00000001000,a00,read
0,48316469300,48316469900,00000000600,a00,read
0,48316625700,48316626400,00000000700,a00,read
0,48316777000,48316777700,00000000700,a00,read
0,48316814800,48316816100,00000001300,a0c,brk
0,48316931700,48316932400,00000000700,a00,read
0,48317080600,48317081300,00000000700,a00,read
0,48317236300,48317237000,00000000700,a00,read
0,48317396500,48317397100,00000000600,a00,read
0,48317507400,48317508200,00000000800,a00,read
0,48317538500,48317539100,00000000600,a0c,brk
0,48317647100,48317647700,00000000600,a00,read
0,48317899300,48317900200,00000000900,a00,read
0,48317912500,48317913000,00000000500,a00,read
0,48317956900,48317957200,00000000300,a00,read
0,48317978100,48317978800,00000000700,a00,read
0,48318185900,48318186400,00000000500,a00,read
0,48318215300,48318216100,00000000800,a00,read
0,48318313200,48318314100,00000000900,a00,read
0,48318384100,48318384500,00000000400,a00,read
0,48318460600,48318461400,00000000800,a00,read
0,48318613300,48318613800,00000000500,a00,read
0,48318724600,48318725200,00000000600,a00,read
0,48318819500,48318819900,00000000400,a00,read
0,48318831800,48318832300,00000000500,a00,read
0,48318913700,48318914100,00000000400,a00,read
0,48318938000,48318938300,00000000300,a00,read
0,48318960300,48318960800,00000000500,a00,read
0,48319062100,48319063100,00000001000,a0c,brk
0,48319064900,48319065800,00000000900,a00,read
0,48319268000,48319268300,00000000300,a00,read
0,48319350900,48319351500,00000000600,a00,read
0,48319415500,48319416200,00000000700,a00,read
0,48319543300,48319543700,00000000400,a00,read
0,48319577200,48319577800,00000000600,a00,read
0,48319592200,48319593700,00000001500,a02,open
0,48319703600,48319704100,00000000500,a00,read
0,48319775300,48319775700,00000000400,a00,read
0,48319828300,48319829400,00000001100,a0c,brk
0,48319836600,48319837300,00000000700,a00,read
0,48319945200,48319945800,00000000600,a00,read
0,48320099400,48320100300,00000000900,a00,read
0,48320236100,48320236800,00000000700,a00,read
0,48320296800,48320297600,00000000800,a00,read
0,48320354700,48320355400,00000000700,a00,read
0,48320427300,48320428000,00000000700,a00,read
0,48320482500,48320483200,00000000700,a00,read
0,48320574400,48320575200,00000000800,a0c,brk
0,48320605900,48320609400,00000003500,a0c,brk
0,48320624100,48320624900,00000000800,a00,read
0,48320743200,48320744000,00000000800,a00,read
0,48320902200,48320902900,00000000700,a00,read
0,48321019700,48321020300,00000000600,a00,read
0,48321167200,48321168000,00000000800,a00,read
0,48321285200,48321285900,00000000700,a00,read
0,48321447500,48321448100,00000000600,a00,read
0,48321453200,48321453900,00000000700,a0c,brk
0,48321568900,48321569400,00000000500,a00,read
0,48321687600,48321688300,00000000700,a00,read
0,48321829300,48321830000,00000000700,a00,read
0,48321970800,48321971800,00000001000,a00,read
0,48322066400,48322067100,00000000700,a00,read
0,48322179100,48322180000,00000000900,a00,read
0,48322304000,48322304600,00000000600,a00,read
0,48322416100,48322416700,00000000600,a0c,brk
0,48322439400,48322440100,00000000700,a00,read
0,48322609100,48322609800,00000000700,a00,read
0,48322759900,48322760400,00000000500,a00,read
0,48322870600,48322871400,00000000800,a00,read
0,48323040600,48323041500,00000000900,a00,read
0,48323119200,48323120000,00000000800,a00,read
0,48323202100,48323202900,00000000800,a00,read
0,48323269200,48323269900,00000000700,a0c,brk
0,48323283500,48323284200,00000000700,a00,read
0,48323356500,48323357600,00000001100,a00,read
0,48323458400,48323459100,00000000700,a00,read
0,48323561100,48323561800,00000000700,a00,read
0,48323651800,48323652400,00000000600,a00,read
0,48323733000,48323733500,00000000500,a00,read
0,48323834500,48323835200,00000000700,a00,read
0,48323915600,48323915900,00000000300,a0c,brk
0,48323918500,48323919100,00000000600,a00,read
0,48324025500,48324026100,00000000600,a00,read
0,48324118600,48324119200,00000000600,a00,read
0,48324239300,48324240100,00000000800,a00,read
0,48324353200,48324353900,00000000700,a00,read
0,48324456700,48324457200,00000000500,a00,read
0,48324556700,48324557200,00000000500,a0c,brk
0,48324914400,48324917900,00000003500,a57,unlink
0,48324942700,48324943300,00000000600,a48,fcntl
0,48324990200,48325005000,00000014800,a01,write
0,48325023000,48325025400,00000002400,a01,write
0,48325041600,48325043900,00000002300,a01,write
0,48315013800,48329902800,00014889000,a3d,wait4
0,48329921000,48329924300,00000003300,a00,read
0,48329926400,48329926800,00000000400,a00,read
0,48314673300,48329956400,00015283100,a17,select
0,48329978300,48329978500,00000000200,a2f,recvmsg
0,48329992800,48329993000,00000000200,a2f,recvmsg
0,48329993900,48329994100,00000000200,a2f,recvmsg
0,48329982100,48330001400,00000019300,a17,select
0,48330005300,48330005500,00000000200,a2f,recvmsg
0,48330011200,48330011400,00000000200,a2f,recvmsg
0,48330011800,48330012000,00000000200,a2f,recvmsg
0,48330006300,48330017300,00000011000,a17,select
0,48330020800,48330020900,00000000100,a2f,recvmsg
0,48330026200,48330026400,00000000200,a2f,recvmsg
0,48330026700,48330026900,00000000200,a2f,recvmsg
0,48330021500,48330031700,00000010200,a17,select
0,48330035500,48330035600,00000000100,a2f,recvmsg
0,48330040800,48330041000,00000000200,a2f,recvmsg
0,48330041200,48330041400,00000000200,a2f,recvmsg
0,48330036200,48330047000,00000010800,a17,select
0,48330051000,48330051200,00000000200,a2f,recvmsg
0,48330056400,48330056500,00000000100,a2f,recvmsg
0,48330056800,48330057000,00000000200,a2f,recvmsg
0,48330051800,48330061300,00000009500,a17,select
0,48330064400,48330064600,00000000200,a2f,recvmsg
0,48330071000,48330071200,00000000200,a2f,recvmsg
0,48330071600,48330071700,00000000100,a2f,recvmsg
0,48330073400,48330073500,00000000100,a08,lseek
0,48330082800,48330082900,00000000100,a08,lseek
0,48330065200,48330087100,00000021900,a17,select
0,48330090700,48330090900,00000000200,a2f,recvmsg
0,48330096600,48330096800,00000000200,a2f,recvmsg
0,48330097100,48330097300,00000000200,a2f,recvmsg
0,48330091500,48330104200,00000012700,a17,select
0,48330107600,48330107700,00000000100,a2f,recvmsg
0,48330113200,48330113300,00000000100,a2f,recvmsg
0,48330113600,48330113800,00000000200,a2f,recvmsg
0,48330108200,48330118800,00000010600,a17,select
0,48330122000,48330122200,00000000200,a2f,recvmsg
0,48330127500,48330127600,00000000100,a2f,recvmsg
0,48330128000,48330128200,00000000200,a2f,recvmsg
0,48330122800,48330133400,00000010600,a17,select
0,48330136400,48330136600,00000000200,a2f,recvmsg
0,48330142000,48330142100,00000000100,a2f,recvmsg
0,48330142500,48330142700,00000000200,a2f,recvmsg
0,48330137200,48330148800,00000011600,a17,select
0,48330152000,48330152100,00000000100,a2f,recvmsg
0,48330157600,48330157700,00000000100,a2f,recvmsg
0,48330158100,48330158300,00000000200,a2f,recvmsg
0,48330152700,48330163700,00000011000,a17,select
0,48330167000,48330167200,00000000200,a2f,recvmsg
0,48330172400,48330172600,00000000200,a2f,recvmsg
0,48330172900,48330173100,00000000200,a2f,recvmsg
0,48330167800,48330178200,00000010400,a17,select
0,48330181500,48330181700,00000000200,a2f,recvmsg
0,48330186900,48330187100,00000000200,a2f,recvmsg
0,48330187500,48330187600,00000000100,a2f,recvmsg
0,48330182200,48330192200,00000010000,a17,select
0,48330195200,48330195400,00000000200,a2f,recvmsg
0,48330200700,48330200800,00000000100,a2f,recvmsg
0,48330201100,48330201300,00000000200,a2f,recvmsg
0,48330196000,48330207800,00000011800,a17,select
0,48330211200,48330211400,00000000200,a2f,recvmsg
0,48330216800,48330217000,00000000200,a2f,recvmsg
0,48330217300,48330217500,00000000200,a2f,recvmsg
0,48330212000,48330222700,00000010700,a17,select
0,48330225900,48330226100,00000000200,a2f,recvmsg
0,48330231400,48330231600,00000000200,a2f,recvmsg
0,48330231900,48330232100,00000000200,a2f,recvmsg
0,48330226700,48330237100,00000010400,a17,select
0,48330240500,48330240700,00000000200,a2f,recvmsg
0,48330245900,48330246100,00000000200,a2f,recvmsg
0,48330246400,48330246500,00000000100,a2f,recvmsg
0,48330241200,48330251700,00000010500,a17,select
0,48330254800,48330255000,00000000200,a2f,recvmsg
0,48330260300,48330260500,00000000200,a2f,recvmsg
0,48330260800,48330261000,00000000200,a2f,recvmsg
0,48330255600,48330266000,00000010400,a17,select
0,48330269100,48330269200,00000000100,a2f,recvmsg
0,48330274600,48330274700,00000000100,a2f,recvmsg
0,48330275000,48330275200,00000000200,a2f,recvmsg
0,48330269700,48330281500,00000011800,a17,select
0,48330284600,48330284800,00000000200,a2f,recvmsg
0,48330290100,48330290300,00000000200,a2f,recvmsg
0,48330290600,48330290800,00000000200,a2f,recvmsg
0,48330285400,48330295700,00000010300,a17,select
0,48330298700,48330298900,00000000200,a2f,recvmsg
0,48330304100,48330304200,00000000100,a2f,recvmsg
0,48330304600,48330304800,00000000200,a2f,recvmsg
0,48330299500,48330309200,00000009700,a17,select
0,48330312500,48330312600,00000000100,a2f,recvmsg
0,48330317700,48330317900,00000000200,a2f,recvmsg
0,48330318300,48330318500,00000000200,a2f,recvmsg
0,48330313100,48330325100,00000012000,a17,select
0,48330328300,48330328500,00000000200,a2f,recvmsg
0,48330333800,48330333900,00000000100,a2f,recvmsg
0,48330334300,48330334500,00000000200,a2f,recvmsg
0,48330329100,48330338900,00000009800,a17,select
0,48330342100,48330342200,00000000100,a2f,recvmsg
0,48330347400,48330347600,00000000200,a2f,recvmsg
0,48330347900,48330348100,00000000200,a2f,recvmsg
0,48330342800,48330352600,00000009800,a17,select
0,48330355500,48330355700,00000000200,a2f,recvmsg
0,48330360800,48330361000,00000000200,a2f,recvmsg
0,48330361400,48330361500,00000000100,a2f,recvmsg
0,48330356300,48330366000,00000009700,a17,select
0,48330369100,48330369300,00000000200,a2f,recvmsg
0,48330374400,48330374600,00000000200,a2f,recvmsg
0,48330374900,48330375100,00000000200,a2f,recvmsg
0,48330369800,48330380100,00000010300,a17,select
0,48330383200,48330383300,00000000100,a2f,recvmsg
0,48330388700,48330388800,00000000100,a2f,recvmsg
0,48330389100,48330389300,00000000200,a2f,recvmsg
0,48330383900,48330393900,00000010000,a17,select
0,48330396900,48330397100,00000000200,a2f,recvmsg
0,48330402300,48330402500,00000000200,a2f,recvmsg
0,48330402800,48330403000,00000000200,a2f,recvmsg
0,48330397700,48330409200,00000011500,a17,select
0,48330412300,48330412500,00000000200,a2f,recvmsg
0,48330417800,48330418000,00000000200,a2f,recvmsg
0,48330418300,48330418500,00000000200,a2f,recvmsg
0,48330413100,48330423700,00000010600,a17,select
0,48330426900,48330427000,00000000100,a2f,recvmsg
0,48330432200,48330432400,00000000200,a2f,recvmsg
0,48330432600,48330432800,00000000200,a2f,recvmsg
0,48330427600,48330438500,00000010900,a17,select
0,48330441900,48330442100,00000000200,a2f,recvmsg
0,48330447300,48330447500,00000000200,a2f,recvmsg
0,48330447800,48330447900,00000000100,a2f,recvmsg
0,48330442600,48330454300,00000011700,a17,select
0,48330457300,48330457400,00000000100,a2f,recvmsg
0,48330462700,48330462900,00000000200,a2f,recvmsg
0,48330463100,48330463300,00000000200,a2f,recvmsg
0,48330458000,48330468700,00000010700,a17,select
0,48330472100,48330472300,00000000200,a2f,recvmsg
0,48330477500,48330477700,00000000200,a2f,recvmsg
0,48330478000,48330478200,00000000200,a2f,recvmsg
0,48330472800,48330485600,00000012800,a17,select
0,48330488700,48330488900,00000000200,a2f,recvmsg
0,48330494100,48330494300,00000000200,a2f,recvmsg
0,48330494600,48330494800,00000000200,a2f,recvmsg
0,48330489500,48330499600,00000010100,a17,select
0,48330502700,48330502900,00000000200,a2f,recvmsg
0,48330508000,48330508200,00000000200,a2f,recvmsg
0,48330508500,48330508600,00000000100,a2f,recvmsg
0,48330503400,48330513700,00000010300,a17,select
0,48330516900,48330517000,00000000100,a2f,recvmsg
0,48330522300,48330522500,00000000200,a2f,recvmsg
0,48330522800,48330523000,00000000200,a2f,recvmsg
0,48330517600,48330529000,00000011400,a17,select
0,48330532100,48330532300,00000000200,a2f,recvmsg
0,48330537600,48330537800,00000000200,a2f,recvmsg
0,48330538100,48330538300,00000000200,a2f,recvmsg
0,48330532900,48330543700,00000010800,a17,select
0,48330546800,48330547000,00000000200,a2f,recvmsg
0,48330552300,48330552500,00000000200,a2f,recvmsg
0,48330552800,48330553000,00000000200,a2f,recvmsg
0,48330547600,48330558700,00000011100,a17,select
0,48330561900,48330562100,00000000200,a2f,recvmsg
0,48330567400,48330567500,00000000100,a2f,recvmsg
0,48330567900,48330568000,00000000100,a2f,recvmsg
0,48330562700,48330573200,00000010500,a17,select
0,48330576400,48330576600,00000000200,a2f,recvmsg
0,48330581800,48330582000,00000000200,a2f,recvmsg
0,48330582300,48330582500,00000000200,a2f,recvmsg
0,48330577100,48330588400,00000011300,a17,select
0,48330591500,48330591600,00000000100,a2f,recvmsg
0,48330596900,48330597100,00000000200,a2f,recvmsg
0,48330597400,48330597600,00000000200,a2f,recvmsg
0,48330592200,48330602200,00000010000,a17,select
0,48330605300,48330605500,00000000200,a2f,recvmsg
0,48330610600,48330610800,00000000200,a2f,recvmsg
0,48330611100,48330611200,00000000100,a2f,recvmsg
0,48330606000,48330616500,00000010500,a17,select
0,48330619600,48330619800,00000000200,a2f,recvmsg
0,48330625000,48330625200,00000000200,a2f,recvmsg
0,48330625500,48330625700,00000000200,a2f,recvmsg
0,48330627000,48330627100,00000000100,a08,lseek
0,48330629800,48330630700,00000000900,a00,read
0,48330634300,48330634400,00000000100,a08,lseek
0,48330620400,48330639100,00000018700,a17,select
0,48330642400,48330642500,00000000100,a2f,recvmsg
0,48330648000,48330648200,00000000200,a2f,recvmsg
0,48330648600,48330648800,00000000200,a2f,recvmsg
0,48330643200,48330677700,00000034500,a17,select
0,48330681100,48330681300,00000000200,a2f,recvmsg
0,48330686900,48330687100,00000000200,a2f,recvmsg
0,48330687400,48330687500,00000000100,a2f,recvmsg
0,48330691500,48330692300,00000000800,a00,read
0,48330697900,48330698000,00000000100,a08,lseek
0,48330681800,48330703100,00000021300,a17,select
0,48330706500,48330706700,00000000200,a2f,recvmsg
0,48330712100,48330712300,00000000200,a2f,recvmsg
0,48330712700,48330712900,00000000200,a2f,recvmsg
0,48330707300,48330717400,00000010100,a17,select
0,48330720400,48330720600,00000000200,a2f,recvmsg
0,48330725700,48330725900,00000000200,a2f,recvmsg
0,48330726300,48330726400,00000000100,a2f,recvmsg
0,48330721200,48330730900,00000009700,a17,select
0,48330733700,48330733900,00000000200,a2f,recvmsg
0,48330739000,48330739100,00000000100,a2f,recvmsg
0,48330739500,48330739700,00000000200,a2f,recvmsg
0,48330734500,48330744000,00000009500,a17,select
0,48330746900,48330747100,00000000200,a2f,recvmsg
0,48330752100,48330752300,00000000200,a2f,recvmsg
0,48330752700,48330752800,00000000100,a2f,recvmsg
0,48330747700,48330757300,00000009600,a17,select
0,48330760200,48330760400,00000000200,a2f,recvmsg
0,48330765500,48330765600,00000000100,a2f,recvmsg
0,48330766000,48330766200,00000000200,a2f,recvmsg
0,48330760900,48330770600,00000009700,a17,select
0,48330773500,48330773700,00000000200,a2f,recvmsg
0,48330778700,48330778900,00000000200,a2f,recvmsg
0,48330779200,48330779400,00000000200,a2f,recvmsg
0,48330774200,48330783900,00000009700,a17,select
0,48330786700,48330786900,00000000200,a2f,recvmsg
0,48330791900,48330792100,00000000200,a2f,recvmsg
0,48330792400,48330792600,00000000200,a2f,recvmsg
0,48330787400,48330797600,00000010200,a17,select
0,48330800800,48330801000,00000000200,a2f,recvmsg
0,48330806000,48330806200,00000000200,a2f,recvmsg
0,48330806600,48330806700,00000000100,a2f,recvmsg
0,48330801400,48330811500,00000010100,a17,select
0,48330814500,48330814600,00000000100,a2f,recvmsg
0,48330819700,48330819900,00000000200,a2f,recvmsg
0,48330820200,48330820300,00000000100,a2f,recvmsg
0,48330821000,48330821100,00000000100,a08,lseek
0,48330815100,48330827200,00000012100,a17,select
0,48330830300,48330830500,00000000200,a2f,recvmsg
0,48330835800,48330836000,00000000200,a2f,recvmsg
0,48330836300,48330836500,00000000200,a2f,recvmsg
0,48330831100,48330843400,00000012300,a17,select
0,48330846700,48330846800,00000000100,a2f,recvmsg
0,48330852200,48330852400,00000000200,a2f,recvmsg
0,48330852600,48330852800,00000000200,a2f,recvmsg
0,48330847300,48330858000,00000010700,a17,select
0,48330860900,48330861000,00000000100,a2f,recvmsg
0,48330866600,48330866700,00000000100,a2f,recvmsg
0,48330867100,48330867300,00000000200,a2f,recvmsg
0,48330861600,48330872100,00000010500,a17,select
0,48330875200,48330875300,00000000100,a2f,recvmsg
0,48330880500,48330880600,00000000100,a2f,recvmsg
0,48330881000,48330881100,00000000100,a2f,recvmsg
0,48330875800,48330885800,00000010000,a17,select
0,48330888700,48330888800,00000000100,a2f,recvmsg
0,48330894100,48330894200,00000000100,a2f,recvmsg
0,48330894500,48330894700,00000000200,a2f,recvmsg
0,48330889400,48330899400,00000010000,a17,select
0,48330902400,48330902500,00000000100,a2f,recvmsg
0,48330907600,48330907800,00000000200,a2f,recvmsg
0,48330908200,48330908300,00000000100,a2f,recvmsg
0,48330903100,48330913500,00000010400,a17,select
0,48330916600,48330916800,00000000200,a2f,recvmsg
0,48330921900,48330922100,00000000200,a2f,recvmsg
0,48330922400,48330922600,00000000200,a2f,recvmsg
0,48330917200,48330927300,00000010100,a17,select
0,48330930200,48330930400,00000000200,a2f,recvmsg
0,48330935600,48330935700,00000000100,a2f,recvmsg
0,48330936100,48330936200,00000000100,a2f,recvmsg
0,48330930900,48330940900,00000010000,a17,select
0,48330943800,48330944000,00000000200,a2f,recvmsg
0,48330949200,48330949400,00000000200,a2f,recvmsg
0,48330949600,48330949800,00000000200,a2f,recvmsg
0,48330944500,48330954600,00000010100,a17,select
0,48330957500,48330957700,00000000200,a2f,recvmsg
0,48330963700,48330963900,00000000200,a2f,recvmsg
0,48330964200,48330964400,00000000200,a2f,recvmsg
0,48330958300,48330969100,00000010800,a17,select
0,48330972200,48330972200,00000000000,a2f,recvmsg
0,48330977800,48330977900,00000000100,a2f,recvmsg
0,48330978200,48330978400,00000000200,a2f,recvmsg
0,48330972800,48330983100,00000010300,a17,select
0,48330986100,48330986300,00000000200,a2f,recvmsg
0,48330991400,48330991600,00000000200,a2f,recvmsg
0,48330991900,48330992100,00000000200,a2f,recvmsg
0,48330986800,48330997500,00000010700,a17,select
0,48331000600,48331000700,00000000100,a2f,recvmsg
0,48331006100,48331006300,00000000200,a2f,recvmsg
0,48331006500,48331006700,00000000200,a2f,recvmsg
0,48331001200,48331011400,00000010200,a17,select
0,48331014400,48331014500,00000000100,a2f,recvmsg
0,48331019800,48331020000,00000000200,a2f,recvmsg
0,48331020300,48331020500,00000000200,a2f,recvmsg
0,48331015100,48331025200,00000010100,a17,select
0,48331028200,48331028300,00000000100,a2f,recvmsg
0,48331033500,48331033700,00000000200,a2f,recvmsg
0,48331034100,48331034200,00000000100,a2f,recvmsg
0,48331028900,48331038900,00000010000,a17,select
0,48331042000,48331042100,00000000100,a2f,recvmsg
0,48331047300,48331047400,00000000100,a2f,recvmsg
0,48331047800,48331048000,00000000200,a2f,recvmsg
0,48331042600,48331058100,00000015500,a17,select
0,48331061300,48331061400,00000000100,a2f,recvmsg
0,48331066800,48331067000,00000000200,a2f,recvmsg
0,48331067200,48331067400,00000000200,a2f,recvmsg
0,48331062000,48331072500,00000010500,a17,select
0,48331075400,48331075600,00000000200,a2f,recvmsg
0,48331081100,48331081300,00000000200,a2f,recvmsg
0,48331081600,48331081800,00000000200,a2f,recvmsg
0,48331076200,48331086500,00000010300,a17,select
0,48331089500,48331089700,00000000200,a2f,recvmsg
0,48331094800,48331095000,00000000200,a2f,recvmsg
0,48331095300,48331095500,00000000200,a2f,recvmsg
0,48331090100,48331100400,00000010300,a17,select
0,48331103300,48331103400,00000000100,a2f,recvmsg
0,48331108600,48331108700,00000000100,a2f,recvmsg
0,48331109000,48331109200,00000000200,a2f,recvmsg
0,48331104000,48331114200,00000010200,a17,select
0,48331117100,48331117300,00000000200,a2f,recvmsg
0,48331122500,48331122600,00000000100,a2f,recvmsg
0,48331123000,48331123200,00000000200,a2f,recvmsg
0,48331166500,48331170300,00000003800,a14,writev
0,48331117900,48331174300,00000056400,a17,select
0,48331176700,48331178000,00000001300,a2f,recvmsg
0,48331263400,48331267000,00000003600,a14,writev
0,48331267500,48331270700,00000003200,a14,writev
0,48331347000,48331349000,00000002000,a14,writev
0,48331349200,48331350900,00000001700,a14,writev
0,48331407300,48331409100,00000001800,a14,writev
0,48331409200,48331410900,00000001700,a14,writev
0,48331465100,48331466600,00000001500,a14,writev
0,48331466900,48331468300,00000001400,a14,writev
0,48331522900,48331524400,00000001500,a14,writev
0,48331524600,48331526400,00000001800,a14,writev
0,48331580500,48331582200,00000001700,a14,writev
0,48331582400,48331584600,00000002200,a14,writev
0,48331588900,48331589600,00000000700,a2f,recvmsg
0,48331637300,48331639100,00000001800,a14,writev
0,48331682800,48331684400,00000001600,a14,writev
0,48331727800,48331729600,00000001800,a14,writev
0,48331772300,48331774000,00000001700,a14,writev
0,48331817700,48331819300,00000001600,a14,writev
0,48331862100,48331863500,00000001400,a14,writev
0,48331888600,48331890600,00000002000,a2f,recvmsg
0,48331915000,48331916900,00000001900,a14,writev
0,48331933800,48331935400,00000001600,a14,writev
0,48331950700,48331952600,00000001900,a14,writev
0,48331965900,48331967600,00000001700,a14,writev
0,48331980800,48331982900,00000002100,a14,writev
0,48331996000,48331997500,00000001500,a14,writev
0,48332002000,48332002200,00000000200,a2f,recvmsg
0,48332002900,48332003200,00000000300,a14,writev
0,48332021400,48332023000,00000001600,a14,writev
0,48332023300,48332024600,00000001300,a14,writev
0,48332025000,48332025200,00000000200,a2f,recvmsg
0,48331166000,48332033500,00000867500,a07,poll
0,48332038900,48332045100,00000006200,a2f,recvmsg
0,48332057100,48332057200,00000000100,a2f,recvmsg
0,48332085100,48332089800,00000004700,a07,poll
0,48332096200,48332102500,00000006300,a2f,recvmsg
0,48332114600,48332114800,00000000200,a2f,recvmsg
0,48332136900,48332141200,00000004300,a07,poll
0,48332147200,48332153400,00000006200,a2f,recvmsg
0,48332165700,48332165900,00000000200,a2f,recvmsg
0,48332026000,48332194200,00000168200,a17,select
0,48332208800,48332210100,00000001300,a14,writev
0,48332210600,48332210800,00000000200,a2f,recvmsg
0,48332229400,48332230300,00000000900,a14,writev
0,48332230600,48332230800,00000000200,a2f,recvmsg
0,48332242700,48332243500,00000000800,a14,writev
0,48332243800,48332244000,00000000200,a2f,recvmsg
0,48332189000,48332248200,00000059200,a07,poll
0,48332248900,48332249800,00000000900,a2f,recvmsg
0,48332254700,48332255600,00000000900,a2d,recvfrom
0,48332256500,48332256600,00000000100,a2f,recvmsg
0,48332257300,48332257500,00000000200,a2f,recvmsg
0,48332297900,48332298200,00000000300,a2f,recvmsg
0,48332300300,48332300400,00000000100,a2f,recvmsg
0,48332302600,48332304700,00000002100,a07,poll
0,48332305200,48332306300,00000001100,a2f,recvmsg
0,48332311500,48332312000,00000000500,a2d,recvfrom
0,48332312900,48332313000,00000000100,a2f,recvmsg
0,48332313700,48332313900,00000000200,a2f,recvmsg
0,48332342400,48332342700,00000000300,a2f,recvmsg
0,48332344500,48332344700,00000000200,a2f,recvmsg
0,48332347700,48332349800,00000002100,a07,poll
0,48332350400,48332351400,00000001000,a2f,recvmsg
0,48332356600,48332357200,00000000600,a2d,recvfrom
0,48332358200,48332358400,00000000200,a2f,recvmsg
0,48332359100,48332359200,00000000100,a2f,recvmsg
0,48332387900,48332388100,00000000200,a2f,recvmsg
0,48332389900,48332390100,00000000200,a2f,recvmsg
0,48332400800,48332401000,00000000200,a2f,recvmsg
0,48332401500,48332401700,00000000200,a2f,recvmsg
0,48332244500,48332433700,00000189200,a17,select
0,48332443400,48332445800,00000002400,a14,writev
0,48332447600,48332447800,00000000200,a2f,recvmsg
0,48332455700,48332455900,00000000200,a2f,recvmsg
0,48332456300,48332456500,00000000200,a2f,recvmsg
0,48333058500,48333064100,00000005600,a07,poll
0,48333075700,48333081600,00000005900,a2e,sendmsg
0,48182097300,48333085000,00150987700,ae8,epoll_wait
0,48333097500,48333099200,00000001700,a2f,recvmsg
0,48333113600,48333113900,00000000300,a2f,recvmsg
0,48333172000,48333176100,00000004100,a2e,sendmsg
0,48333058500,48333186000,00000127500,a07,poll
0,48333204200,48333205300,00000001100,a2f,recvmsg
0,48333280700,48333282800,00000002100,a07,poll
0,48333280700,48333427600,00000146900,a07,poll
0,48333430800,48333432400,00000001600,aca,futex
0,48333434600,48333435700,00000001100,aca,futex
0,48333437200,48333438000,00000000800,aca,futex
0,48333441200,48333444300,00000003100,a2e,sendmsg
0,48333447100,48333447300,00000000200,a00,read
0,48333181800,48333467100,00000285300,ae8,epoll_wait
0,48333470900,48333472400,00000001500,a2f,recvmsg
0,48333491700,48333492000,00000000300,a2f,recvmsg
0,48333520100,48333521200,00000001100,a2e,sendmsg
0,48333538400,48333540800,00000002400,a2f,recvmsg
0,48333546700,48333547400,00000000700,a2f,recvmsg
0,48333559900,48333562100,00000002200,a2e,sendmsg
0,48333524000,48333563800,00000039800,ae8,epoll_wait
0,48333566500,48333567100,00000000600,a2f,recvmsg
0,48333574300,48333574600,00000000300,a2f,recvmsg
0,48333605700,48333607300,00000001600,a2e,sendmsg
0,48333545700,48333612800,00000067100,a07,poll
0,48333620400,48333620900,00000000500,a2f,recvmsg
0,48333672300,48333674000,00000001700,a07,poll
0,48333672300,48333782400,00000110100,a07,poll
0,48333784100,48333785100,00000001000,aca,futex
0,48333787300,48333788200,00000000900,aca,futex
0,48333789600,48333790300,00000000700,aca,futex
0,48333792700,48333795100,00000002400,a2e,sendmsg
0,48333797500,48333797800,00000000300,a00,read
0,48333610900,48333816000,00000205100,ae8,epoll_wait
0,48333819500,48333821100,00000001600,a2f,recvmsg
0,48333839200,48333839400,00000000200,a2f,recvmsg
0,48333863800,48333864900,00000001100,a2e,sendmsg
0,48312831700,48312831800,00000000100,a2f,recvmsg
0,48312837200,48312837400,00000000200,a2f,recvmsg
0,48312837700,48312837800,00000000100,a2f,recvmsg
0,48312832300,48312842600,00000010300,a17,select
0,48312845600,48312845800,00000000200,a2f,recvmsg
0,48312851000,48312851000,00000000000,a2f,recvmsg
0,48312851400,48312851600,00000000200,a2f,recvmsg
0,48312846300,48312856300,00000010000,a17,select
0,48312859200,48312859400,00000000200,a2f,recvmsg
0,48312864500,48312864700,00000000200,a2f,recvmsg
0,48312865000,48312865200,00000000200,a2f,recvmsg
0,48312860000,48312869900,00000009900,a17,select
0,48312872900,48312873100,00000000200,a2f,recvmsg
0,48312878200,48312878400,00000000200,a2f,recvmsg
0,48312878800,48312878900,00000000100,a2f,recvmsg
0,48312873700,48312889100,00000015400,a17,select
0,48312892400,48312892600,00000000200,a2f,recvmsg
0,48312897900,48312898100,00000000200,a2f,recvmsg
0,48312898400,48312898500,00000000100,a2f,recvmsg
0,48312893100,48312903500,00000010400,a17,select
0,48312906400,48312906600,00000000200,a2f,recvmsg
0,48312911800,48312911800,00000000000,a2f,recvmsg
0,48312912200,48312912400,00000000200,a2f,recvmsg
0,48312907200,48312917100,00000009900,a17,select
0,48312920100,48312920300,00000000200,a2f,recvmsg
0,48312925400,48312925600,00000000200,a2f,recvmsg
0,48312925900,48312926100,00000000200,a2f,recvmsg
0,48312920800,48312930900,00000010100,a17,select
0,48312933900,48312934100,00000000200,a2f,recvmsg
0,48312939100,48312939300,00000000200,a2f,recvmsg
0,48312939700,48312939900,00000000200,a2f,recvmsg
0,48312934600,48312944700,00000010100,a17,select
0,48312947900,48312948000,00000000100,a2f,recvmsg
0,48312953200,48312953400,00000000200,a2f,recvmsg
0,48312953700,48312953800,00000000100,a2f,recvmsg
0,48312997600,48313001300,00000003700,a14,writev
0,48312948600,48313004900,00000056300,a17,select
0,48313007200,48313008700,00000001500,a2f,recvmsg
0,48313093900,48313098500,00000004600,a14,writev
0,48313099000,48313102700,00000003700,a14,writev
0,48313181900,48313184100,00000002200,a14,writev
0,48313239500,48313241200,00000001700,a14,writev
0,48313241500,48313243000,00000001500,a14,writev
0,48313297000,48313298800,00000001800,a14,writev
0,48313299000,48313300500,00000001500,a14,writev
0,48313354600,48313356400,00000001800,a14,writev
0,48313356500,48313358000,00000001500,a14,writev
0,48313418300,48313420200,00000001900,a14,writev
0,48313420400,48313422100,00000001700,a14,writev
0,48313427100,48313427900,00000000800,a2f,recvmsg
0,48313474900,48313476600,00000001700,a14,writev
0,48313519700,48313521300,00000001600,a14,writev
0,48313563600,48313565200,00000001600,a14,writev
0,48313606400,48313608100,00000001700,a14,writev
0,48313650600,48313652000,00000001400,a14,writev
0,48313693000,48313694600,00000001600,a14,writev
0,48313719600,48313721600,00000002000,a2f,recvmsg
0,48313747300,48313749500,00000002200,a14,writev
0,48313766200,48313767800,00000001600,a14,writev
0,48313783800,48313785300,00000001500,a14,writev
0,48313799400,48313801200,00000001800,a14,writev
0,48313815100,48313816600,00000001500,a14,writev
0,48313830400,48313832200,00000001800,a14,writev
0,48313837000,48313837200,00000000200,a2f,recvmsg
0,48313837900,48313838200,00000000300,a14,writev
0,48313859900,48313861500,00000001600,a14,writev
0,48313861800,48313863000,00000001200,a14,writev
0,48313863500,48313863700,00000000200,a2f,recvmsg
0,48312997100,48313871800,00000874700,a07,poll
0,48313877500,48313883800,00000006300,a2f,recvmsg
0,48313895400,48313895600,00000000200,a2f,recvmsg
0,48313921900,48313926600,00000004700,a07,poll
0,48313933100,48313939400,00000006300,a2f,recvmsg
0,48313951500,48313951700,00000000200,a2f,recvmsg
0,48313974400,48313978800,00000004400,a07,poll
0,48313984500,48313990600,00000006100,a2f,recvmsg
0,48314003400,48314003600,00000000200,a2f,recvmsg
0,48313864500,48314031900,00000167400,a17,select
0,48314046700,48314048000,00000001300,a14,writev
0,48314048500,48314048700,00000000200,a2f,recvmsg
0,48314062300,48314063200,00000000900,a14,writev
0,48314063600,48314063800,00000000200,a2f,recvmsg
0,48314076000,48314076900,00000000900,a14,writev
0,48314077200,48314077400,00000000200,a2f,recvmsg
0,48314026100,48314081500,00000055400,a07,poll
0,48314082200,48314083200,00000001000,a2f,recvmsg
0,48314087800,48314088600,00000000800,a2d,recvfrom
0,48314089600,48314089800,00000000200,a2f,recvmsg
0,48314090400,48314090600,00000000200,a2f,recvmsg
0,48314131600,48314131700,00000000100,a2f,recvmsg
0,48314134000,48314134200,00000000200,a2f,recvmsg
0,48314136600,48314138500,00000001900,a07,poll
0,48314139000,48314140000,00000001000,a2f,recvmsg
0,48314145100,48314145800,00000000700,a2d,recvfrom
0,48314146700,48314146800,00000000100,a2f,recvmsg
0,48314147500,48314147600,00000000100,a2f,recvmsg
0,48314175900,48314176200,00000000300,a2f,recvmsg
0,48314178000,48314178200,00000000200,a2f,recvmsg
0,48314181100,48314183200,00000002100,a07,poll
0,48314183900,48314185100,00000001200,a2f,recvmsg
0,48314190400,48314190900,00000000500,a2d,recvfrom
0,48314191900,48314192100,00000000200,a2f,recvmsg
0,48314192700,48314192900,00000000200,a2f,recvmsg
0,48314222100,48314222300,00000000200,a2f,recvmsg
0,48314224000,48314224100,00000000100,a2f,recvmsg
0,48314234800,48314235000,00000000200,a2f,recvmsg
0,48314235600,48314235800,00000000200,a2f,recvmsg
0,48314077900,48314269200,00000191300,a17,select
0,48314279500,48314281900,00000002400,a14,writev
0,48314283700,48314283900,00000000200,a2f,recvmsg
0,48314291900,48314292100,00000000200,a2f,recvmsg
0,48314292600,48314292800,00000000200,a2f,recvmsg
0,48314722100,48314726300,00000004200,a09,mmap
0,48315084100,48315088900,00000004800,a02,open
0,48315097200,48315099400,00000002200,a00,read
0,48315151900,48315152700,00000000800,a00,read
0,48315201300,48315202100,00000000800,a00,read
0,48315248300,48315248900,00000000600,a00,read
0,48315295900,48315296500,00000000600,a00,read
0,48315342200,48315342900,00000000700,a00,read
0,48315387300,48315387900,00000000600,a00,read
0,48315433100,48315433900,00000000800,a00,read
0,48315481900,48315482700,00000000800,a00,read
0,48315531900,48315532500,00000000600,a00,read
0,48315580200,48315580900,00000000700,a00,read
0,48315607500,48315609000,00000001500,a02,open
0,48315612100,48315613200,00000001100,a00,read
0,48315668600,48315669300,00000000700,a00,read
0,48315751900,48315752600,00000000700,a00,read
0,48315824200,48315824900,00000000700,a00,read
0,48315900500,48315901200,00000000700,a00,read
0,48315978400,48315979100,00000000700,a00,read
0,48316054700,48316055500,00000000800,a00,read
0,48316138600,48316139300,00000000700,a00,read
0,48316205800,48316206500,00000000700,a00,read
0,48316263200,48316263800,00000000600,a00,read
0,48314285200,48316350100,00002064900,a17,select
0,48316364500,48316364800,00000000300,a2f,recvmsg
0,48316331100,48321380000,00005048900,a07,poll
0,48321392700,48321397100,00000004400,a2e,sendmsg
0,48321406200,48321407100,00000000900,a2e,sendmsg
0,48321416700,48321416900,00000000200,a00,read
0,48321430700,48321430900,00000000200,a2f,recvmsg
0,48321431400,48321431600,00000000200,a2f,recvmsg
0,48316367400,48321439100,00005071700,a17,select
0,48321445800,48321446000,00000000200,a2f,recvmsg
0,48321453000,48321453200,00000000200,a2f,recvmsg
0,48321453600,48321453700,00000000100,a2f,recvmsg
0,48321460000,48321465900,00000005900,a06,lstat
0,48321466800,48321468200,00000001400,a06,lstat
0,48321490300,48321504700,00000014400,a01,write
0,48321447000,48321514200,00000067200,a17,select
0,48321520500,48321520700,00000000200,a2f,recvmsg
0,48321528300,48321528500,00000000200,a2f,recvmsg
0,48321529100,48321529300,00000000200,a2f,recvmsg
0,48321530700,48321871000,00000340300,a38,clone
0,48322653500,48322653600,00000000100,a0c,brk
0,48322663500,48322666400,00000002900,a15,access
0,48322667000,48322667900,00000000900,a09,mmap
0,48322672100,48322672800,00000000700,a15,access
0,48322679000,48322679800,00000000800,a09,mmap
0,48322683800,48322684300,00000000500,a15,access
0,48322691500,48322692500,00000001000,a00,read
0,48322694000,48322695500,00000001500,a09,mmap
0,48322711600,48322712100,00000000500,a15,access
0,48322715300,48322715800,00000000500,a00,read
0,48322716600,48322717400,00000000800,a09,mmap
0,48322719700,48322721000,00000001300,a09,mmap
0,48322729100,48322729500,00000000400,a15,access
0,48322732200,48322732900,00000000700,a00,read
0,48322733500,48322734300,00000000800,a09,mmap
0,48322735800,48322737900,00000002100,a09,mmap
0,48322742100,48322745200,00000003100,a09,mmap
0,48322747400,48322748500,00000001100,a09,mmap
0,48322758200,48322758700,00000000500,a15,access
0,48322761400,48322761900,00000000500,a00,read
0,48322762600,48322764100,00000001500,a09,mmap
0,48322766800,48322768400,00000001600,a09,mmap
0,48322776400,48322776900,00000000500,a15,access
0,48322779800,48322780400,00000000600,a00,read
0,48322781000,48322782400,00000001400,a09,mmap
0,48322786000,48322788200,00000002200,a09,mmap
0,48322796400,48322797000,00000000600,a15,access
0,48322799300,48322799700,00000000400,a00,read
0,48322800200,48322801300,00000001100,a09,mmap
0,48322802600,48322803900,00000001300,a09,mmap
0,48322806600,48322807700,00000001100,a09,mmap
0,48322813900,48322814500,00000000600,a15,access
0,48322817000,48322817500,00000000500,a00,read
0,48322818100,48322819400,00000001300,a09,mmap
0,48322836500,48322837100,00000000600,a09,mmap
0,48322842300,48322842700,00000000400,a09,mmap
0,48323021200,48323021400,00000000200,a0c,brk
0,48323021500,48323022300,00000000800,a0c,brk
0,48323054900,48323055900,00000001000,a00,read
0,48323067700,48323069100,00000001400,a00,read
0,48323107800,48323109000,00000001200,a00,read
0,48323230700,48323231400,00000000700,a00,read
0,48323302300,48323302800,00000000500,a00,read
0,48323388000,48323388600,00000000600,a00,read
0,48323518800,48323519700,00000000900,a00,read
0,48323647300,48323648000,00000000700,a00,read
0,48323802600,48323803400,00000000800,a00,read
0,48323953700,48323954400,00000000700,a00,read
0,48323991300,48323992600,00000001300,a0c,brk
0,48324107400,48324108200,00000000800,a00,read
0,48324256000,48324256700,00000000700,a00,read
0,48324411900,48324412600,00000000700,a00,read
0,48324571500,48324572200,00000000700,a00,read
0,48324680400,48324681200,00000000800,a00,read
0,48324711600,48324712200,00000000600,a0c,brk
0,48324821600,48324822400,00000000800,a00,read
0,48325060500,48325061100,00000000600,a00,read
0,48325072800,48325073300,00000000500,a00,read
0,48325116500,48325116900,00000000400,a00,read
0,48325136400,48325137100,00000000700,a00,read
0,48325342300,48325342700,00000000400,a00,read
0,48325371100,48325389500,00000018400,60e,page_fault
0,48325405900,48325406800,00000000900,a00,read
0,48325505100,48325505800,00000000700,a00,read
0,48325529800,48325531200,00000001400,a0c,brk
0,48325576200,48325576600,00000000400,a00,read
0,48325656500,48325657200,00000000700,a00,read
0,48325809700,48325810100,00000000400,a00,read
0,48325921000,48325921600,00000000600,a00,read
0,48326015200,48326015800,00000000600,a00,read
0,48326027500,48326027900,00000000400,a00,read
0,48326111000,48326111300,00000000300,a00,read
0,48326135000,48326135400,00000000400,a00,read
0,48326157400,48326158000,00000000600,a00,read
0,48326259400,48326260600,00000001200,a0c,brk
0,48326262400,48326263400,00000001000,a00,read
0,48326465600,48326466000,00000000400,a00,read
0,48326548700,48326549300,00000000600,a00,read
0,48326613900,48326614600,00000000700,a00,read
0,48326742500,48326742900,00000000400,a00,read
0,48326774700,48326775300,00000000600,a00,read
0,48326792400,48326793800,00000001400,a02,open
0,48326908600,48326909100,00000000500,a00,read
0,48326980300,48326981000,00000000700,a00,read
0,48327033200,48327034400,00000001200,a0c,brk
0,48327042100,48327042700,00000000600,a00,read
0,48327150400,48327150900,00000000500,a00,read
0,48327300600,48327301600,00000001000,a00,read
0,48327432700,48327433400,00000000700,a00,read
0,48327491200,48327492000,00000000800,a00,read
0,48327548200,48327549000,00000000800,a00,read
0,48327619600,48327620200,00000000600,a00,read
0,48327672700,48327673300,00000000600,a00,read
0,48327795600,48327799200,00000003600,a0c,brk
0,48327813300,48327814100,00000000800,a00,read
0,48327929200,48327930000,00000000800,a00,read
0,48328089700,48328090400,00000000700,a00,read
0,48328208300,48328208900,00000000600,a00,read
0,48328356200,48328356900,00000000700,a00,read
0,48328476600,48328477200,00000000600,a00,read
0,48328641000,48328641700,00000000700,a00,read
0,48328646700,48328647600,00000000900,a0c,brk
0,48328764600,48328765300,00000000700,a00,read
0,48328884300,48328885000,00000000700,a00,read
0,48329026700,48329027500,00000000800,a00,read
0,48329159500,48329160100,00000000600,a00,read
0,48329253300,48329253900,00000000600,a00,read
0,48329366400,48329367000,00000000600,a00,read
0,48329503500,48329504200,00000000700,a00,read
0,48329617700,48329618500,00000000800,a0c,brk
0,48329641400,48329642100,00000000700,a00,read
0,48329812700,48329813400,00000000700,a00,read
0,48329965000,48329965800,00000000800,a00,read
0,48330076600,48330077400,00000000800,a00,read
0,48330247800,48330248800,00000001000,a00,read
0,48330325400,48330326100,00000000700,a00,read
0,48330408000,48330408700,00000000700,a00,read
0,48330476300,48330476900,00000000600,a0c,brk
0,48330490600,48330491300,00000000700,a00,read
0,48330564700,48330565400,00000000700,a00,read
0,48330667900,48330668600,00000000700,a00,read
0,48330772400,48330773000,00000000600,a00,read
0,48330863700,48330864500,00000000800,a00,read
0,48330946100,48330946700,00000000600,a00,read
0,48331050800,48331051400,00000000600,a00,read
0,48331133100,48331133500,00000000400,a0c,brk
0,48331136000,48331136600,00000000600,a00,read
0,48331245700,48331246400,00000000700,a00,read
0,48331339800,48331340300,00000000500,a00,read
0,48331461400,48331462000,00000000600,a00,read
0,48331577100,48331577600,00000000500,a00,read
0,48331682600,48331683400,00000000800,a00,read
0,48331784200,48331784500,00000000300,a0c,brk
0,48332144200,48332148100,00000003900,a57,unlink
0,48332171600,48332172100,00000000500,a48,fcntl
0,48332219700,48332234800,00000015100,a01,write
0,48332253000,48332255600,00000002600,a01,write
0,48332271900,48332274100,00000002200,a01,write
0,48321893800,48337388000,00015494200,a3d,wait4
0,48337411200,48337414200,00000003000,a00,read
0,48337416300,48337416700,00000000400,a00,read
0,48321521900,48337446900,00015925000,a17,select
0,48337467500,48337467800,00000000300,a2f,recvmsg
0,48337484200,48337484400,00000000200,a2f,recvmsg
0,48337485300,48337485500,00000000200,a2f,recvmsg
0,48337471200,48337491900,00000020700,a17,select
0,48337495900,48337496000,00000000100,a2f,recvmsg
0,48337501900,48337502100,00000000200,a2f,recvmsg
0,48337502500,48337502700,00000000200,a2f,recvmsg
0,48337496800,48337507200,00000010400,a17,select
0,48337510500,48337510700,00000000200,a2f,recvmsg
0,48337516100,48337516300,00000000200,a2f,recvmsg
0,48337516600,48337516800,00000000200,a2f,recvmsg
0,48337511200,48337522500,00000011300,a17,select
0,48337526000,48337526100,00000000100,a2f,recvmsg
0,48337531300,48337531400,00000000100,a2f,recvmsg
0,48337531800,48337532000,00000000200,a2f,recvmsg
0,48337526600,48337537600,00000011000,a17,select
0,48337541300,48337541500,00000000200,a2f,recvmsg
0,48337546600,48337546800,00000000200,a2f,recvmsg
0,48337547100,48337547200,00000000100,a2f,recvmsg
0,48337542000,48337552300,00000010300,a17,select
0,48337555300,48337555500,00000000200,a2f,recvmsg
0,48337561600,48337561700,00000000100,a2f,recvmsg
0,48337562100,48337562300,00000000200,a2f,recvmsg
0,48337562900,48337563100,00000000200,a08,lseek
0,48337572800,48337572900,00000000100,a08,lseek
0,48337556100,48337577200,00000021100,a17,select
0,48337580600,48337580800,00000000200,a2f,recvmsg
0,48337587100,48337587200,00000000100,a2f,recvmsg
0,48337587600,48337587700,00000000100,a2f,recvmsg
0,48337581400,48337593800,00000012400,a17,select
0,48337596900,48337597100,00000000200,a2f,recvmsg
0,48337602500,48337602700,00000000200,a2f,recvmsg
0,48337603100,48337603200,00000000100,a2f,recvmsg
0,48337597700,48337608300,00000010600,a17,select
0,48337611400,48337611600,00000000200,a2f,recvmsg
0,48337616700,48337616900,00000000200,a2f,recvmsg
0,48337617200,48337617400,00000000200,a2f,recvmsg
0,48337612100,48337622700,00000010600,a17,select
0,48337625600,48337625700,00000000100,a2f,recvmsg
0,48337631000,48337631200,00000000200,a2f,recvmsg
0,48337631600,48337631800,00000000200,a2f,recvmsg
0,48337626300,48337637000,00000010700,a17,select
0,48337640300,48337640400,00000000100,a2f,recvmsg
0,48337645800,48337645900,00000000100,a2f,recvmsg
0,48337646200,48337646400,00000000200,a2f,recvmsg
0,48337641000,48337651800,00000010800,a17,select
0,48337654900,48337655100,00000000200,a2f,recvmsg
0,48337660400,48337660600,00000000200,a2f,recvmsg
0,48337661000,48337661100,00000000100,a2f,recvmsg
0,48337655600,48337667100,00000011500,a17,select
0,48337670400,48337670600,00000000200,a2f,recvmsg
0,48337676000,48337676200,00000000200,a2f,recvmsg
0,48337676500,48337676700,00000000200,a2f,recvmsg
0,48337671100,48337682200,00000011100,a17,select
0,48337685200,48337685400,00000000200,a2f,recvmsg
0,48337690500,48337690700,00000000200,a2f,recvmsg
0,48337691100,48337691300,00000000200,a2f,recvmsg
0,48337685900,48337697300,00000011400,a17,select
0,48337700700,48337700900,00000000200,a2f,recvmsg
0,48337706000,48337706200,00000000200,a2f,recvmsg
0,48337706500,48337706700,00000000200,a2f,recvmsg
0,48337701400,48337712100,00000010700,a17,select
0,48337715200,48337715400,00000000200,a2f,recvmsg
0,48337720600,48337720800,00000000200,a2f,recvmsg
0,48337721100,48337721300,00000000200,a2f,recvmsg
0,48337716000,48337726400,00000010400,a17,select
0,48337729600,48337729700,00000000100,a2f,recvmsg
0,48337735200,48337735300,00000000100,a2f,recvmsg
0,48337735600,48337735900,00000000300,a2f,recvmsg
0,48337730200,48337741100,00000010900,a17,select
0,48337744200,48337744400,00000000200,a2f,recvmsg
0,48337749600,48337749800,00000000200,a2f,recvmsg
0,48337750200,48337750300,00000000100,a2f,recvmsg
0,48337744900,48337755300,00000010400,a17,select
0,48337758300,48337758500,00000000200,a2f,recvmsg
0,48337763800,48337764000,00000000200,a2f,recvmsg
0,48337764300,48337764500,00000000200,a2f,recvmsg
0,48337759000,48337769700,00000010700,a17,select
0,48337772800,48337772900,00000000100,a2f,recvmsg
0,48337779300,48337779500,00000000200,a2f,recvmsg
0,48337779900,48337780000,00000000100,a2f,recvmsg
0,48337773400,48337785000,00000011600,a17,select
0,48337788200,48337788400,00000000200,a2f,recvmsg
0,48337793600,48337793700,00000000100,a2f,recvmsg
0,48337794100,48337794200,00000000100,a2f,recvmsg
0,48337788900,48337798700,00000009800,a17,select
0,48337801900,48337802100,00000000200,a2f,recvmsg
0,48337807300,48337807500,00000000200,a2f,recvmsg
0,48337807700,48337807900,00000000200,a2f,recvmsg
0,48337802700,48337814800,00000012100,a17,select
0,48337817900,48337818100,00000000200,a2f,recvmsg
0,48337823300,48337823500,00000000200,a2f,recvmsg
0,48337823800,48337824000,00000000200,a2f,recvmsg
0,48337818700,48337828400,00000009700,a17,select
0,48337831500,48337831700,00000000200,a2f,recvmsg
0,48337836700,48337836800,00000000100,a2f,recvmsg
0,48337837200,48337837400,00000000200,a2f,recvmsg
0,48337832200,48337841800,00000009600,a17,select
0,48337844800,48337845000,00000000200,a2f,recvmsg
0,48337850300,48337850400,00000000100,a2f,recvmsg
0,48337850800,48337851000,00000000200,a2f,recvmsg
0,48337845500,48337855300,00000009800,a17,select
0,48337858400,48337858600,00000000200,a2f,recvmsg
0,48337863800,48337863900,00000000100,a2f,recvmsg
0,48337864300,48337864500,00000000200,a2f,recvmsg
0,48337859100,48337869500,00000010400,a17,select
0,48337872400,48337872600,00000000200,a2f,recvmsg
0,48337877800,48337878000,00000000200,a2f,recvmsg
0,48337878300,48337878500,00000000200,a2f,recvmsg
0,48337873100,48337883100,00000010000,a17,select
0,48337886100,48337886300,00000000200,a2f,recvmsg
0,48337891500,48337891600,00000000100,a2f,recvmsg
0,48337892000,48337892200,00000000200,a2f,recvmsg
0,48337886900,48337898300,00000011400,a17,select
0,48337901400,48337901500,00000000100,a2f,recvmsg
0,48337906700,48337906900,00000000200,a2f,recvmsg
0,48337907300,48337907400,00000000100,a2f,recvmsg
0,48337902100,48337912700,00000010600,a17,select
0,48337915800,48337915900,00000000100,a2f,recvmsg
0,48337921100,48337921300,00000000200,a2f,recvmsg
0,48337921600,48337921700,00000000100,a2f,recvmsg
0,48337916500,48337927500,00000011000,a17,select
0,48337931000,48337931000,00000000000,a2f,recvmsg
0,48337936200,48337936400,00000000200,a2f,recvmsg
0,48337936700,48337936800,00000000100,a2f,recvmsg
0,48337931600,48337942400,00000010800,a17,select
0,48337945400,48337945500,00000000100,a2f,recvmsg
0,48337950600,48337950800,00000000200,a2f,recvmsg
0,48337951100,48337951300,00000000200,a2f,recvmsg
0,48337946100,48337956900,00000010800,a17,select
0,48337960100,48337960300,00000000200,a2f,recvmsg
0,48337965400,48337965600,00000000200,a2f,recvmsg
0,48337965900,48337966100,00000000200,a2f,recvmsg
0,48337960800,48337973300,00000012500,a17,select
0,48337976600,48337976700,00000000100,a2f,recvmsg
0,48337983600,48337983700,00000000100,a2f,recvmsg
0,48337984100,48337984200,00000000100,a2f,recvmsg
0,48337977300,48337989200,00000011900,a17,select
0,48337992100,48337992300,00000000200,a2f,recvmsg
0,48337997500,48337997600,00000000100,a2f,recvmsg
0,48337998000,48337998200,00000000200,a2f,recvmsg
0,48337992800,48338003200,00000010400,a17,select
0,48338006400,48338006600,00000000200,a2f,recvmsg
0,48338011700,48338011900,00000000200,a2f,recvmsg
0,48338012300,48338012500,00000000200,a2f,recvmsg
0,48338007100,48338018400,00000011300,a17,select
0,48338021700,48338021900,00000000200,a2f,recvmsg
0,48338027100,48338027300,00000000200,a2f,recvmsg
0,48338027700,48338027800,00000000100,a2f,recvmsg
0,48338022400,48338033200,00000010800,a17,select
0,48338036300,48338036500,00000000200,a2f,recvmsg
0,48338041700,48338041900,00000000200,a2f,recvmsg
0,48338042300,48338042400,00000000100,a2f,recvmsg
0,48338037100,48338048200,00000011100,a17,select
0,48338051500,48338051600,00000000100,a2f,recvmsg
0,48338057000,48338057200,00000000200,a2f,recvmsg
0,48338057500,48338057700,00000000200,a2f,recvmsg
0,48338052200,48338063200,00000011000,a17,select
0,48338066400,48338066500,00000000100,a2f,recvmsg
0,48338071800,48338072000,00000000200,a2f,recvmsg
0,48338072400,48338072600,00000000200,a2f,recvmsg
0,48338067100,48338077600,00000010500,a17,select
0,48338080800,48338081000,00000000200,a2f,recvmsg
0,48338086200,48338086400,00000000200,a2f,recvmsg
0,48338086700,48338086800,00000000100,a2f,recvmsg
0,48338081500,48338091600,00000010100,a17,select
0,48338094500,48338094700,00000000200,a2f,recvmsg
0,48338099900,48338100100,00000000200,a2f,recvmsg
0,48338100300,48338100500,00000000200,a2f,recvmsg
0,48338095300,48338105800,00000010500,a17,select
0,48338109000,48338109100,00000000100,a2f,recvmsg
0,48338114300,48338114500,00000000200,a2f,recvmsg
0,48338114900,48338115000,00000000100,a2f,recvmsg
0,48338116300,48338116500,00000000200,a08,lseek
0,48338119300,48338120300,00000001000,a00,read
0,48338123900,48338124000,00000000100,a08,lseek
0,48338109600,48338128700,00000019100,a17,select
0,48338132100,48338132300,00000000200,a2f,recvmsg
0,48338137800,48338138000,00000000200,a2f,recvmsg
0,48338138300,48338138500,00000000200,a2f,recvmsg
0,48338132800,48338167000,00000034200,a17,select
0,48338170400,48338170600,00000000200,a2f,recvmsg
0,48338176200,48338176400,00000000200,a2f,recvmsg
0,48338176700,48338176900,00000000200,a2f,recvmsg
0,48338180900,48338181800,00000000900,a00,read
0,48338187400,48338187500,00000000100,a08,lseek
0,48338171200,48338192400,00000021200,a17,select
0,48338195700,48338195800,00000000100,a2f,recvmsg
0,48338201200,48338201300,00000000100,a2f,recvmsg
0,48338201700,48338201900,00000000200,a2f,recvmsg
0,48338196500,48338206400,00000009900,a17,select
0,48338209500,48338209600,00000000100,a2f,recvmsg
0,48338214700,48338214900,00000000200,a2f,recvmsg
0,48338215200,48338215400,00000000200,a2f,recvmsg
0,48338210200,48338219800,00000009600,a17,select
0,48338222700,48338222900,00000000200,a2f,recvmsg
0,48338228000,48338228200,00000000200,a2f,recvmsg
0,48338228500,48338228700,00000000200,a2f,recvmsg
0,48338223500,48338233100,00000009600,a17,select
0,48338236000,48338236200,00000000200,a2f,recvmsg
0,48338241300,48338241400,00000000100,a2f,recvmsg
0,48338241800,48338242000,00000000200,a2f,recvmsg
0,48338236800,48338246400,00000009600,a17,select
0,48338249300,48338249500,00000000200,a2f,recvmsg
0,48338254600,48338254800,00000000200,a2f,recvmsg
0,48338255100,48338255300,00000000200,a2f,recvmsg
0,48338250100,48338259700,00000009600,a17,select
0,48338262900,48338263000,00000000100,a2f,recvmsg
0,48338268100,48338268300,00000000200,a2f,recvmsg
0,48338268600,48338268800,00000000200,a2f,recvmsg
0,48338263500,48338273100,00000009600,a17,select
0,48338276000,48338276200,00000000200,a2f,recvmsg
0,48338281200,48338281400,00000000200,a2f,recvmsg
0,48338281800,48338281900,00000000100,a2f,recvmsg
0,48338276700,48338286900,00000010200,a17,select
0,48338290100,48338290200,00000000100,a2f,recvmsg
0,48338295400,48338295600,00000000200,a2f,recvmsg
0,48338295900,48338296100,00000000200,a2f,recvmsg
0,48338290800,48338300600,00000009800,a17,select
0,48338303600,48338303700,00000000100,a2f,recvmsg
0,48338308800,48338309000,00000000200,a2f,recvmsg
0,48338309200,48338309400,00000000200,a2f,recvmsg
0,48338310000,48338310200,00000000200,a08,lseek
0,48338304300,48338316100,00000011800,a17,select
0,48338319200,48338319300,00000000100,a2f,recvmsg
0,48338324600,48338324800,00000000200,a2f,recvmsg
0,48338325200,48338325300,00000000100,a2f,recvmsg
0,48338319900,48338332100,00000012200,a17,select
0,48338335300,48338335400,00000000100,a2f,recvmsg
0,48338340600,48338340800,00000000200,a2f,recvmsg
0,48338341100,48338341300,00000000200,a2f,recvmsg
0,48338335900,48338346300,00000010400,a17,select
0,48338349100,48338349300,00000000200,a2f,recvmsg
0,48338354500,48338354700,00000000200,a2f,recvmsg
0,48338355000,48338355100,00000000100,a2f,recvmsg
0,48338349900,48338359900,00000010000,a17,select
0,48338362800,48338362900,00000000100,a2f,recvmsg
0,48338368000,48338368200,00000000200,a2f,recvmsg
0,48338368500,48338368700,00000000200,a2f,recvmsg
0,48338363500,48338373400,00000009900,a17,select
0,48338376400,48338376600,00000000200,a2f,recvmsg
0,48338381700,48338381900,00000000200,a2f,recvmsg
0,48338382200,48338382400,00000000200,a2f,recvmsg
0,48338377100,48338387000,00000009900,a17,select
0,48338390000,48338390200,00000000200,a2f,recvmsg
0,48338395200,48338395400,00000000200,a2f,recvmsg
0,48338395800,48338395900,00000000100,a2f,recvmsg
0,48338390800,48338401100,00000010300,a17,select
0,48338404100,48338404200,00000000100,a2f,recvmsg
0,48338409400,48338409600,00000000200,a2f,recvmsg
0,48338409800,48338410000,00000000200,a2f,recvmsg
0,48338404800,48338414700,00000009900,a17,select
0,48338417700,48338417900,00000000200,a2f,recvmsg
0,48338423100,48338423300,00000000200,a2f,recvmsg
0,48338423600,48338423800,00000000200,a2f,recvmsg
0,48338418500,48338428600,00000010100,a17,select
0,48338431500,48338431700,00000000200,a2f,recvmsg
0,48338436900,48338437000,00000000100,a2f,recvmsg
0,48338437400,48338437600,00000000200,a2f,recvmsg
0,48338432300,48338442200,00000009900,a17,select
0,48338445200,48338445400,00000000200,a2f,recvmsg
0,48338450500,48338450700,00000000200,a2f,recvmsg
0,48338451100,48338451300,00000000200,a2f,recvmsg
0,48338445900,48338455900,00000010000,a17,select
0,48338458900,48338459100,00000000200,a2f,recvmsg
0,48338464200,48338464400,00000000200,a2f,recvmsg
0,48338464700,48338464900,00000000200,a2f,recvmsg
0,48338459500,48338469600,00000010100,a17,select
0,48338472600,48338472700,00000000100,a2f,recvmsg
0,48338478000,48338478200,00000000200,a2f,recvmsg
0,48338478400,48338478600,00000000200,a2f,recvmsg
0,48338473300,48338483900,00000010600,a17,select
0,48338487000,48338487100,00000000100,a2f,recvmsg
0,48338492600,48338492700,00000000100,a2f,recvmsg
0,48338493100,48338493300,00000000200,a2f,recvmsg
0,48338487700,48338497900,00000010200,a17,select
0,48338500900,48338501000,00000000100,a2f,recvmsg
0,48338506200,48338506400,00000000200,a2f,recvmsg
0,48338506700,48338506800,00000000100,a2f,recvmsg
0,48338501600,48338511600,00000010000,a17,select
0,48338514500,48338514700,00000000200,a2f,recvmsg
0,48338519800,48338520000,00000000200,a2f,recvmsg
0,48338520300,48338520500,00000000200,a2f,recvmsg
0,48338515300,48338525100,00000009800,a17,select
0,48338528100,48338528300,00000000200,a2f,recvmsg
0,48338533400,48338533500,00000000100,a2f,recvmsg
0,48338533900,48338534100,00000000200,a2f,recvmsg
0,48338528900,48338544400,00000015500,a17,select
0,48338547400,48338547600,00000000200,a2f,recvmsg
0,48338553000,48338553200,00000000200,a2f,recvmsg
0,48338553500,48338553700,00000000200,a2f,recvmsg
0,48338548300,48338558600,00000010300,a17,select
0,48338561600,48338561800,00000000200,a2f,recvmsg
0,48338567000,48338567200,00000000200,a2f,recvmsg
0,48338567500,48338567600,00000000100,a2f,recvmsg
0,48338562400,48338572300,00000009900,a17,select
0,48338575300,48338575500,00000000200,a2f,recvmsg
0,48338580800,48338580900,00000000100,a2f,recvmsg
0,48338581400,48338581500,00000000100,a2f,recvmsg
0,48338576200,48338586500,00000010300,a17,select
0,48338589400,48338589600,00000000200,a2f,recvmsg
0,48338594700,48338594900,00000000200,a2f,recvmsg
0,48338595200,48338595400,00000000200,a2f,recvmsg
0,48338590200,48338600200,00000010000,a17,select
0,48338603200,48338603300,00000000100,a2f,recvmsg
0,48338608500,48338608700,00000000200,a2f,recvmsg
0,48338609000,48338609200,00000000200,a2f,recvmsg
0,48338653600,48338657300,00000003700,a14,writev
0,48338603800,48338661000,00000057200,a17,select
0,48338663400,48338664600,00000001200,a2f,recvmsg
0,48338749400,48338752900,00000003500,a14,writev
0,48338753500,48338756300,00000002800,a14,writev
0,48338834900,48338836800,00000001900,a14,writev
0,48338892900,48338895000,00000002100,a14,writev
0,48338895200,48338896800,00000001600,a14,writev
0,48338950800,48338952500,00000001700,a14,writev
0,48338952700,48338954500,00000001800,a14,writev
0,48339010300,48339012200,00000001900,a14,writev
0,48339012400,48339014100,00000001700,a14,writev
0,48339068900,48339070700,00000001800,a14,writev
0,48339070900,48339072800,00000001900,a14,writev
0,48339077500,48339078300,00000000800,a2f,recvmsg
0,48339126400,48339128400,00000002000,a14,writev
0,48339171700,48339173600,00000001900,a14,writev
0,48339216900,48339218500,00000001600,a14,writev
0,48339261000,48339262500,00000001500,a14,writev
0,48339304400,48339306300,00000001900,a14,writev
0,48339349700,48339351200,00000001500,a14,writev
0,48339377400,48339379500,00000002100,a2f,recvmsg
0,48339403600,48339405500,00000001900,a14,writev
0,48339423400,48339425000,00000001600,a14,writev
0,48339440700,48339442300,00000001600,a14,writev
0,48339456500,48339458400,00000001900,a14,writev
0,48339471900,48339473600,00000001700,a14,writev
0,48339487000,48339488800,00000001800,a14,writev
0,48339493600,48339493800,00000000200,a2f,recvmsg
0,48339494500,48339494800,00000000300,a14,writev
0,48339513200,48339514800,00000001600,a14,writev
0,48339515100,48339516500,00000001400,a14,writev
0,48339517000,48339517200,00000000200,a2f,recvmsg
0,48338653100,48339526900,00000873800,a07,poll
0,48339531800,48339538400,00000006600,a2f,recvmsg
0,48339549900,48339550100,00000000200,a2f,recvmsg
0,48339577100,48339581500,00000004400,a07,poll
0,48339587500,48339594100,00000006600,a2f,recvmsg
0,48339606500,48339606700,00000000200,a2f,recvmsg
0,48339628500,48339632800,00000004300,a07,poll
0,48339639000,48339644900,00000005900,a2f,recvmsg
0,48339657400,48339657600,00000000200,a2f,recvmsg
0,48339517900,48339687400,00000169500,a17,select
0,48339702100,48339703500,00000001400,a14,writev
0,48339704000,48339704200,00000000200,a2f,recvmsg
0,48339717900,48339718800,00000000900,a14,writev
0,48339719100,48339719200,00000000100,a2f,recvmsg
0,48339731200,48339732100,00000000900,a14,writev
0,48339732300,48339732500,00000000200,a2f,recvmsg
0,48339680400,48339736700,00000056300,a07,poll
0,48339737300,48339738300,00000001000,a2f,recvmsg
0,48339743400,48339744200,00000000800,a2d,recvfrom
0,48339745200,48339745400,00000000200,a2f,recvmsg
0,48339746000,48339746100,00000000100,a2f,recvmsg
0,48339786500,48339786800,00000000300,a2f,recvmsg
0,48339788900,48339789100,00000000200,a2f,recvmsg
0,48339791200,48339793200,00000002000,a07,poll
0,48339793800,48339794900,00000001100,a2f,recvmsg
0,48339799500,48339800300,00000000800,a2d,recvfrom
0,48339801000,48339801200,00000000200,a2f,recvmsg
0,48339801900,48339802000,00000000100,a2f,recvmsg
0,48339831000,48339831300,00000000300,a2f,recvmsg
0,48339833200,48339833400,00000000200,a2f,recvmsg
0,48339836400,48339838600,00000002200,a07,poll
0,48339839200,48339840300,00000001100,a2f,recvmsg
0,48339845500,48339846100,00000000600,a2d,recvfrom
0,48339847100,48339847200,00000000100,a2f,recvmsg
0,48339847900,48339848100,00000000200,a2f,recvmsg
0,48339876800,48339877100,00000000300,a2f,recvmsg
0,48339878800,48339879000,00000000200,a2f,recvmsg
0,48339889700,48339889900,00000000200,a2f,recvmsg
0,48339890400,48339890600,00000000200,a2f,recvmsg
0,48339733000,48339923100,00000190100,a17,select
0,48339933300,48339935800,00000002500,a14,writev
0,48339937800,48339938000,00000000200,a2f,recvmsg
0,48339945800,48339946000,00000000200,a2f,recvmsg
0,48339946500,48339946800,00000000300,a2f,recvmsg
0,48340497300,48340504200,00000006900,a02,open
0,48340515100,48340517700,00000002600,a00,read
0,48340568900,48340569800,00000000900,a00,read
0,48340618300,48340619200,00000000900,a00,read
0,48340664400,48340665100,00000000700,a00,read
0,48340711900,48340712600,00000000700,a00,read
0,48340758100,48340758700,00000000600,a00,read
0,48340802000,48340802900,00000000900,a00,read
0,48340847700,48340848400,00000000700,a00,read
0,48340895800,48340896600,00000000800,a00,read
0,48340945200,48340945900,00000000700,a00,read
0,48340993300,48340993900,00000000600,a00,read
0,48341021100,48341023200,00000002100,a02,open
0,48341026400,48341027400,00000001000,a00,read
0,48341081200,48341082000,00000000800,a00,read
0,48341163800,48341164700,00000000900,a00,read
0,48341235200,48341236000,00000000800,a00,read
0,48341312300,48341312900,00000000600,a00,read
0,48341407900,48341408700,00000000800,a00,read
0,48341484700,48341485400,00000000700,a00,read
0,48341568300,48341569100,00000000800,a00,read
0,48341634000,48341634600,00000000600,a00,read
0,48341691300,48341692000,00000000700,a00,read
0,48339939300,48341775000,00001835700,a17,select
0,48341787200,48341787500,00000000300,a2f,recvmsg
0,48341799000,48341799200,00000000200,a2f,recvmsg
0,48341799800,48341799900,00000000100,a2f,recvmsg
0,48341789000,48341805100,00000016100,a17,select
0,48341809300,48341809500,00000000200,a2f,recvmsg
0,48341815200,48341815400,00000000200,a2f,recvmsg
0,48341815800,48341816000,00000000200,a2f,recvmsg
0,48341821100,48341826900,00000005800,a06,lstat
0,48341827700,48341828800,00000001100,a06,lstat
0,48341847600,48341860800,00000013200,a01,write
0,48341810300,48341869500,00000059200,a17,select
0,48341875200,48341875400,00000000200,a2f,recvmsg
0,48341882900,48341883000,00000000100,a2f,recvmsg
0,48341883600,48341883800,00000000200,a2f,recvmsg
0,48341885200,48342195100,00000309900,a38,clone
0,48341881100,48349846900,00007965800,a07,poll
0,48349985800,48349986700,00000000900,a2f,recvmsg
0,48349988900,48349989100,00000000200,a00,read
0,48350037900,48353478700,00003440800,a07,poll
0,48353484000,48353488200,00000004200,a2e,sendmsg
0,48353491000,48353491200,00000000200,a00,read
0,48341876400,48356731400,00014855000,a17,select
0,48356752000,48356752300,00000000300,a2f,recvmsg
0,48356755200,48361379600,00004624400,a17,select
0,48361382900,48361384700,00000001800,a14,writev
0,48361385000,48361385200,00000000200,a2f,recvmsg
0,48361385800,48361394400,00000008600,a17,select
0,48361396900,48361398500,00000001600,a14,writev
0,48361398800,48361399000,00000000200,a2f,recvmsg
0,48361399500,48361407500,00000008000,a17,select
0,48361410400,48361411900,00000001500,a14,writev
0,48361412200,48361412300,00000000100,a2f,recvmsg
0,48361412900,48361420700,00000007800,a17,select
0,48361423800,48361425300,00000001500,a14,writev
0,48361425500,48361425700,00000000200,a2f,recvmsg
0,48361426300,48361433900,00000007600,a17,select
0,48361436200,48361437800,00000001600,a14,writev
0,48361438000,48361438100,00000000100,a2f,recvmsg
0,48361438700,48361459300,00000020600,a17,select
0,48361461800,48361463200,00000001400,a14,writev
0,48361463400,48361463600,00000000200,a2f,recvmsg
0,48361464100,48361474000,00000009900,a17,select
0,48361476400,48361477900,00000001500,a14,writev
0,48361478200,48361478300,00000000100,a2f,recvmsg
0,48361478900,48361486900,00000008000,a17,select
0,48361489100,48361490700,00000001600,a14,writev
0,48361490900,48361491000,00000000100,a2f,recvmsg
0,48361491500,48361499700,00000008200,a17,select
0,48361502000,48361503400,00000001400,a14,writev
0,48361503600,48361503800,00000000200,a2f,recvmsg
0,48361504300,48361512600,00000008300,a17,select
0,48361515000,48361516400,00000001400,a14,writev
0,48361516600,48361516800,00000000200,a2f,recvmsg
0,48361517400,48361525600,00000008200,a17,select
0,48361528000,48361529500,00000001500,a14,writev
0,48361529800,48361529900,00000000100,a2f,recvmsg
0,48361530500,48361538800,00000008300,a17,select
0,48361541300,48361542700,00000001400,a14,writev
0,48361542900,48361543100,00000000200,a2f,recvmsg
0,48361543700,48361551500,00000007800,a17,select
0,48361553700,48361555200,00000001500,a14,writev
0,48361555400,48361555600,00000000200,a2f,recvmsg
0,48361556100,48361565400,00000009300,a17,select
0,48361567900,48361569400,00000001500,a14,writev
0,48361569700,48361569900,00000000200,a2f,recvmsg
0,48361570400,48361578800,00000008400,a17,select
0,48361581200,48361582700,00000001500,a14,writev
0,48361582900,48361583100,00000000200,a2f,recvmsg
0,48361583600,48361591700,00000008100,a17,select
0,48361594200,48361595600,00000001400,a14,writev
0,48361595800,48361596000,00000000200,a2f,recvmsg
0,48361596500,48361604600,00000008100,a17,select
0,48361607100,48361608700,00000001600,a14,writev
0,48361608800,48361609000,00000000200,a2f,recvmsg
0,48361609500,48361617600,00000008100,a17,select
0,48361619900,48361621300,00000001400,a14,writev
0,48361621600,48361621800,00000000200,a2f,recvmsg
0,48361622200,48361630500,00000008300,a17,select
0,48361632800,48361634300,00000001500,a14,writev
0,48361634500,48361634700,00000000200,a2f,recvmsg
0,48361635200,48361643300,00000008100,a17,select
0,48361645700,48361647100,00000001400,a14,writev
0,48361647400,48361647600,00000000200,a2f,recvmsg
0,48361648100,48361655600,00000007500,a17,select
0,48361658100,48361659500,00000001400,a14,writev
0,48361659800,48361659900,00000000100,a2f,recvmsg
0,48361660400,48361670000,00000009600,a17,select
0,48361672300,48361673600,00000001300,a14,writev
0,48361673900,48361674100,00000000200,a2f,recvmsg
0,48361674600,48361682500,00000007900,a17,select
0,48361684900,48361686600,00000001700,a14,writev
0,48361686700,48361686900,00000000200,a2f,recvmsg
0,48361687400,48361695100,00000007700,a17,select
0,48361697400,48361698800,00000001400,a14,writev
0,48361699100,48361699200,00000000100,a2f,recvmsg
0,48361699800,48361708400,00000008600,a17,select
0,48361710800,48361712200,00000001400,a14,writev
0,48361712500,48361712600,00000000100,a2f,recvmsg
0,48361713200,48361721100,00000007900,a17,select
0,48361723400,48361724900,00000001500,a14,writev
0,48361725200,48361725400,00000000200,a2f,recvmsg
0,48361725900,48361733700,00000007800,a17,select
0,48361736000,48361737500,00000001500,a14,writev
0,48361737700,48361737900,00000000200,a2f,recvmsg
0,48361738300,48361746600,00000008300,a17,select
0,48361749000,48361750300,00000001300,a14,writev
0,48361750600,48361750800,00000000200,a2f,recvmsg
0,48361751300,48361759500,00000008200,a17,select
0,48361761900,48361763400,00000001500,a14,writev
0,48361763600,48361763800,00000000200,a2f,recvmsg
0,48361764300,48361773000,00000008700,a17,select
0,48361775600,48361777000,00000001400,a14,writev
0,48361777200,48361777400,00000000200,a2f,recvmsg
0,48361777900,48361786400,00000008500,a17,select
0,48361788700,48361790200,00000001500,a14,writev
0,48361790400,48361790600,00000000200,a2f,recvmsg
0,48361791100,48361799500,00000008400,a17,select
0,48361802000,48361803500,00000001500,a14,writev
0,48361803700,48361803900,00000000200,a2f,recvmsg
0,48361804400,48361814800,00000010400,a17,select
0,48361817200,48361818600,00000001400,a14,writev
0,48361818800,48361819000,00000000200,a2f,recvmsg
0,48361819500,48361827500,00000008000,a17,select
0,48361829700,48361831100,00000001400,a14,writev
0,48361831400,48361831600,00000000200,a2f,recvmsg
0,48361832100,48361840100,00000008000,a17,select
0,48361842500,48361844100,00000001600,a14,writev
0,48361844300,48361844400,00000000100,a2f,recvmsg
0,48361844900,48361853900,00000009000,a17,select
0,48361856200,48361857700,00000001500,a14,writev
0,48361857800,48361858000,00000000200,a2f,recvmsg
0,48361858500,48361866900,00000008400,a17,select
0,48361869300,48361870800,00000001500,a14,writev
0,48361871000,48361871100,00000000100,a2f,recvmsg
0,48361871700,48361880400,00000008700,a17,select
0,48361882800,48361884300,00000001500,a14,writev
0,48361884600,48361884700,00000000100,a2f,recvmsg
0,48361885300,48361893800,00000008500,a17,select
0,48361896100,48361897600,00000001500,a14,writev
0,48361897800,48361898000,00000000200,a2f,recvmsg
0,48361898500,48361906900,00000008400,a17,select
0,48361909200,48361910700,00000001500,a14,writev
0,48361910900,48361911000,00000000100,a2f,recvmsg
0,48361911500,48361919300,00000007800,a17,select
0,48361921600,48361923100,00000001500,a14,writev
0,48361923400,48361923500,00000000100,a2f,recvmsg
0,48361924100,48361932400,00000008300,a17,select
0,48361934800,48361936200,00000001400,a14,writev
0,48361936500,48361936600,00000000100,a2f,recvmsg
0,48361937200,48361955400,00000018200,a17,select
0,48361957800,48361959200,00000001400,a14,writev
0,48361959500,48361959600,00000000100,a2f,recvmsg
0,48361960200,48361992100,00000031900,a17,select
0,48361994500,48361996000,00000001500,a14,writev
0,48361996300,48361996400,00000000100,a2f,recvmsg
0,48361996900,48362015700,00000018800,a17,select
0,48362018100,48362019400,00000001300,a14,writev
0,48362019700,48362019900,00000000200,a2f,recvmsg
0,48362020400,48362028200,00000007800,a17,select
0,48362030500,48362031900,00000001400,a14,writev
0,48362032200,48362032300,00000000100,a2f,recvmsg
0,48362032800,48362040400,00000007600,a17,select
0,48362042600,48362044200,00000001600,a14,writev
0,48362044500,48362044700,00000000200,a2f,recvmsg
0,48362045200,48362052800,00000007600,a17,select
0,48362055100,48362056500,00000001400,a14,writev
0,48362056700,48362056900,00000000200,a2f,recvmsg
0,48362057300,48362065100,00000007800,a17,select
0,48362067500,48362068800,00000001300,a14,writev
0,48362069100,48362069300,00000000200,a2f,recvmsg
0,48362069800,48362077400,00000007600,a17,select
0,48362079700,48362081200,00000001500,a14,writev
0,48362081500,48362081600,00000000100,a2f,recvmsg
0,48362082100,48362089600,00000007500,a17,select
0,48362091900,48362093400,00000001500,a14,writev
0,48362093700,48362093800,00000000100,a2f,recvmsg
0,48362094400,48362102700,00000008300,a17,select
0,48362105100,48362106600,00000001500,a14,writev
0,48362106700,48362106900,00000000200,a2f,recvmsg
0,48362107400,48362115100,00000007700,a17,select
0,48362117400,48362118900,00000001500,a14,writev
0,48362119200,48362119300,00000000100,a2f,recvmsg
0,48362119900,48362129300,00000009400,a17,select
0,48362131500,48362133100,00000001600,a14,writev
0,48362133200,48362133400,00000000200,a2f,recvmsg
0,48362133900,48362144100,00000010200,a17,select
0,48362146600,48362148200,00000001600,a14,writev
0,48362148400,48362148500,00000000100,a2f,recvmsg
0,48362149100,48362157300,00000008200,a17,select
0,48362159600,48362161100,00000001500,a14,writev
0,48362161400,48362161600,00000000200,a2f,recvmsg
0,48362162000,48362170000,00000008000,a17,select
0,48362172300,48362173700,00000001400,a14,writev
0,48362173900,48362174100,00000000200,a2f,recvmsg
0,48362174600,48362182400,00000007800,a17,select
0,48362184600,48362186100,00000001500,a14,writev
0,48362186400,48362186500,00000000100,a2f,recvmsg
0,48362187000,48362195000,00000008000,a17,select
0,48362197300,48362198800,00000001500,a14,writev
0,48362199100,48362199300,00000000200,a2f,recvmsg
0,48362199700,48362208200,00000008500,a17,select
0,48362210600,48362212000,00000001400,a14,writev
0,48362212200,48362212400,00000000200,a2f,recvmsg
0,48362212900,48362221100,00000008200,a17,select
0,48362223400,48362224800,00000001400,a14,writev
0,48362225000,48362225200,00000000200,a2f,recvmsg
0,48362225700,48362233600,00000007900,a17,select
0,48362235800,48362237500,00000001700,a14,writev
0,48362237700,48362237900,00000000200,a2f,recvmsg
0,48362238400,48362246300,00000007900,a17,select
0,48362248700,48362250100,00000001400,a14,writev
0,48362250400,48362250600,00000000200,a2f,recvmsg
0,48362251000,48362258900,00000007900,a17,select
0,48362261200,48362262600,00000001400,a14,writev
0,48362262800,48362263000,00000000200,a2f,recvmsg
0,48362263500,48362271700,00000008200,a17,select
0,48362273900,48362275500,00000001600,a14,writev
0,48362275700,48362275800,00000000100,a2f,recvmsg
0,48362276300,48362284800,00000008500,a17,select
0,48362287300,48362288800,00000001500,a14,writev
0,48362289000,48362289100,00000000100,a2f,recvmsg
0,48362289700,48362297500,00000007800,a17,select
0,48362299900,48362301300,00000001400,a14,writev
0,48362301600,48362301700,00000000100,a2f,recvmsg
0,48362302300,48362310000,00000007700,a17,select
0,48362312300,48362313800,00000001500,a14,writev
0,48362314100,48362314200,00000000100,a2f,recvmsg
0,48362314800,48362322600,00000007800,a17,select
0,48362325000,48362326400,00000001400,a14,writev
0,48362326700,48362326900,00000000200,a2f,recvmsg
0,48362327300,48362340600,00000013300,a17,select
0,48362343000,48362344400,00000001400,a14,writev
0,48362344700,48362344800,00000000100,a2f,recvmsg
0,48362345400,48362353500,00000008100,a17,select
0,48362355700,48362357400,00000001700,a14,writev
0,48362357600,48362357700,00000000100,a2f,recvmsg
0,48362358300,48362366200,00000007900,a17,select
0,48362368600,48362370000,00000001400,a14,writev
0,48362370200,48362370400,00000000200,a2f,recvmsg
0,48362370800,48362379000,00000008200,a17,select
0,48362381200,48362382600,00000001400,a14,writev
0,48362382900,48362383100,00000000200,a2f,recvmsg
0,48362383600,48362391600,00000008000,a17,select
0,48362393800,48362395400,00000001600,a14,writev
0,48362395600,48362395800,00000000200,a2f,recvmsg
0,48362396300,48362449800,00000053500,a17,select
0,48362451000,48362452200,00000001200,a2f,recvmsg
0,48362542000,48362545000,00000003000,a14,writev
0,48362545500,48362548200,00000002700,a14,writev
0,48362629600,48362631600,00000002000,a14,writev
0,48362631900,48362633700,00000001800,a14,writev
0,48362694600,48362696400,00000001800,a14,writev
0,48362696700,48362698200,00000001500,a14,writev
0,48362755700,48362757700,00000002000,a14,writev
0,48362757900,48362759600,00000001700,a14,writev
0,48362817300,48362819100,00000001800,a14,writev
0,48362819300,48362820900,00000001600,a14,writev
0,48362879200,48362881000,00000001800,a14,writev
0,48362881300,48362883700,00000002400,a14,writev
0,48362888200,48362889000,00000000800,a2f,recvmsg
0,48362938100,48362939800,00000001700,a14,writev
0,48362983800,48362985400,00000001600,a14,writev
0,48363028100,48363030000,00000001900,a14,writev
0,48363072300,48363074100,00000001800,a14,writev
0,48363116400,48363118300,00000001900,a14,writev
0,48363160900,48363162600,00000001700,a14,writev
0,48363163700,48363164000,00000000300,a14,writev
0,48363188800,48363190600,00000001800,a2f,recvmsg
0,48363213400,48363215300,00000001900,a14,writev
0,48363231700,48363233300,00000001600,a14,writev
0,48363248100,48363249900,00000001800,a14,writev
0,48363264000,48363265900,00000001900,a14,writev
0,48363278500,48363279900,00000001400,a14,writev
0,48363292200,48363293700,00000001500,a14,writev
0,48363297300,48363299100,00000001800,a14,writev
0,48363299300,48363299500,00000000200,a2f,recvmsg
0,48363300000,48363300400,00000000400,a14,writev
0,48363300700,48363300900,00000000200,a14,writev
0,48363320100,48363321500,00000001400,a14,writev
0,48363322000,48363322200,00000000200,a2f,recvmsg
0,48363333200,48363334800,00000001600,a14,writev
0,48363337100,48363337300,00000000200,a2f,recvmsg
0,48353497200,48363344700,00009847500,a07,poll
0,48363349200,48363355600,00000006400,a2f,recvmsg
0,48363367000,48363367200,00000000200,a2f,recvmsg
0,48363392600,48363397000,00000004400,a07,poll
0,48363402400,48363409500,00000007100,a2f,recvmsg
0,48363422900,48363423100,00000000200,a2f,recvmsg
0,48363445400,48363450100,00000004700,a07,poll
0,48363456100,48363462700,00000006600,a2f,recvmsg
0,48363476300,48363476500,00000000200,a2f,recvmsg
0,48363337800,48363506100,00000168300,a17,select
0,48363521500,48363522900,00000001400,a14,writev
0,48363523500,48363523700,00000000200,a2f,recvmsg
0,48363537300,48363538200,00000000900,a14,writev
0,48363538600,48363538800,00000000200,a2f,recvmsg
0,48363550500,48363551400,00000000900,a14,writev
0,48363551700,48363551900,00000000200,a2f,recvmsg
0,48363500700,48363556200,00000055500,a07,poll
0,48363556800,48363557900,00000001100,a2f,recvmsg
0,48363563100,48363564000,00000000900,a2d,recvfrom
0,48363565100,48363565300,00000000200,a2f,recvmsg
0,48363565800,48363566000,00000000200,a2f,recvmsg
0,48363607600,48363607700,00000000100,a2f,recvmsg
0,48363610400,48363610600,00000000200,a2f,recvmsg
0,48363612900,48363615100,00000002200,a07,poll
0,48363615700,48363617200,00000001500,a2f,recvmsg
0,48363623000,48363623700,00000000700,a2d,recvfrom
0,48363624500,48363624700,00000000200,a2f,recvmsg
0,48363625400,48363625500,00000000100,a2f,recvmsg
0,48363655500,48363655700,00000000200,a2f,recvmsg
0,48363658200,48363658400,00000000200,a2f,recvmsg
0,48363661500,48363663900,00000002400,a07,poll
0,48363664600,48363665800,00000001200,a2f,recvmsg
0,48363672800,48363673300,00000000500,a2d,recvfrom
0,48363674400,48363674600,00000000200,a2f,recvmsg
0,48363675300,48363675500,00000000200,a2f,recvmsg
0,48363707300,48363707600,00000000300,a2f,recvmsg
0,48363709600,48363709800,00000000200,a2f,recvmsg
0,48363713300,48364050700,00000337400,a07,poll
0,48364061600,48364066600,00000005000,a2e,sendmsg
0,48364076900,48364078300,00000001400,aca,futex
0,48333867600,48364085700,00030218100,ae8,epoll_wait
0,48364098000,48364099700,00000001700,a2f,recvmsg
0,48364114400,48364114600,00000000200,a2f,recvmsg
0,48364171900,48364176100,00000004200,a2e,sendmsg
0,48364081800,48364185500,00000103700,a07,poll
0,48364202400,48364203700,00000001300,a2f,recvmsg
0,48364278400,48364280700,00000002300,a07,poll
0,48364278400,48364425500,00000147100,a07,poll
0,48364427400,48364429000,00000001600,aca,futex
0,48364431300,48364432300,00000001000,aca,futex
0,48364433800,48364434500,00000000700,aca,futex
0,48364437900,48364441400,00000003500,a2e,sendmsg
0,48364444000,48364444200,00000000200,a00,read
0,48364462000,48364464100,00000002100,a07,poll
0,48364470900,48364472000,00000001100,a2e,sendmsg
0,48364475600,48364475800,00000000200,a00,read
0,48364181700,48364481300,00000299600,ae8,epoll_wait
0,48364485500,48364487000,00000001500,a2f,recvmsg
0,48364507100,48364507300,00000000200,a2f,recvmsg
0,48364508400,48364508900,00000000500,a2f,recvmsg
0,48364514800,48364515000,00000000200,a2f,recvmsg
0,48364542900,48364545500,00000002600,a2e,sendmsg
0,48364574900,48364576300,00000001400,a2e,sendmsg
0,48364479300,48364581800,00000102500,a07,poll
0,48364589600,48364590200,00000000600,a2f,recvmsg
0,48364721700,48364724000,00000002300,a07,poll
0,48364731400,48364732200,00000000800,a2f,recvmsg
0,48364781500,48364783100,00000001600,a07,poll
0,48364781500,48364889300,00000107800,a07,poll
0,48364890900,48364892000,00000001100,aca,futex
0,48364894100,48364895000,00000000900,aca,futex
0,48364896400,48364897300,00000000900,aca,futex
0,48364899700,48364902500,00000002800,a2e,sendmsg
0,48364905100,48364905300,00000000200,a00,read
0,48364579800,48364923700,00000343900,ae8,epoll_wait
0,48364927300,48364928700,00000001400,a2f,recvmsg
0,48364946600,48364946900,00000000300,a2f,recvmsg
0,48364972500,48364974700,00000002200,a2e,sendmsg
0,48364922000,48364980400,00000058400,a07,poll
0,48364981000,48364981300,00000000300,a00,read
0,48364988800,48364989400,00000000600,a2f,recvmsg
0,48365100200,48365102800,00000002600,a07,poll
0,48365440000,48365446900,00000006900,a02,open
0,48365457700,48365460100,00000002400,a00,read
0,48365515900,48365516700,00000000800,a00,read
0,48365568800,48365569700,00000000900,a00,read
0,48365620900,48365621600,00000000700,a00,read
0,48365674000,48365674800,00000000800,a00,read
0,48365724700,48365725400,00000000700,a00,read
0,48365772600,48365773500,00000000900,a00,read
0,48365823100,48365823900,00000000800,a00,read
0,48365876700,48365877600,00000000900,a00,read
0,48365928100,48365928800,00000000700,a00,read
0,48365977900,48365978700,00000000800,a00,read
0,48366006400,48366008000,00000001600,a02,open
0,48366011000,48366011900,00000000900,a00,read
0,48366068200,48366069200,00000001000,a00,read
0,48366154700,48366155500,00000000800,a00,read
0,48366228600,48366229400,00000000800,a00,read
0,48366307900,48366308600,00000000700,a00,read
0,48366388200,48366389000,00000000800,a00,read
0,48366466400,48366467100,00000000700,a00,read
0,48366552200,48366552900,00000000700,a00,read
0,48366619300,48366620000,00000000700,a00,read
0,48366677600,48366678300,00000000700,a00,read
0,48363552400,48366771100,00003218700,a17,select
0,48366789600,48366789800,00000000200,a2f,recvmsg
0,48366804800,48366805000,00000000200,a2f,recvmsg
0,48366805600,48366805800,00000000200,a2f,recvmsg
0,48366793000,48366811300,00000018300,a17,select
0,48366815800,48366816000,00000000200,a2f,recvmsg
0,48366821900,48366822100,00000000200,a2f,recvmsg
0,48366822500,48366822700,00000000200,a2f,recvmsg
0,48366828000,48366834200,00000006200,a06,lstat
0,48366835100,48366836000,00000000900,a06,lstat
0,48366858000,48366871800,00000013800,a01,write
0,48366816700,48366880700,00000064000,a17,select
0,48366886800,48366887000,00000000200,a2f,recvmsg
0,48366894600,48366894800,00000000200,a2f,recvmsg
0,48366895300,48366895500,00000000200,a2f,recvmsg
0,48366896900,48367209200,00000312300,a38,clone
0,48367686400,48367686600,00000000200,a0c,brk
0,48367696300,48367699200,00000002900,a15,access
0,48367700000,48367700800,00000000800,a09,mmap
0,48367704700,48367705500,00000000800,a15,access
0,48367711400,48367712300,00000000900,a09,mmap
0,48367716200,48367716700,00000000500,a15,access
0,48367724000,48367724900,00000000900,a00,read
0,48367726600,48367728000,00000001400,a09,mmap
0,48367732100,48367734400,00000002300,a09,mmap
0,48367745300,48367746000,00000000700,a15,access
0,48367749300,48367749900,00000000600,a00,read
0,48367750800,48367751600,00000000800,a09,mmap
0,48367754400,48367755700,00000001300,a09,mmap
0,48367763900,48367764500,00000000600,a15,access
0,48367767400,48367768200,00000000800,a00,read
0,48367768900,48367769800,00000000900,a09,mmap
0,48367771400,48367773400,00000002000,a09,mmap
0,48367778100,48367781400,00000003300,a09,mmap
0,48367783500,48367784600,00000001100,a09,mmap
0,48367794500,48367795200,00000000700,a15,access
0,48367798000,48367798600,00000000600,a00,read
0,48367799300,48367801000,00000001700,a09,mmap
0,48367803900,48367805400,00000001500,a09,mmap
0,48367813900,48367814400,00000000500,a15,access
0,48367817600,48367818100,00000000500,a00,read
0,48367818900,48367820400,00000001500,a09,mmap
0,48367824400,48367826700,00000002300,a09,mmap
0,48367835500,48367836200,00000000700,a15,access
0,48367838900,48367839600,00000000700,a00,read
0,48367840200,48367841200,00000001000,a09,mmap
0,48367842700,48367844100,00000001400,a09,mmap
0,48367847000,48367848400,00000001400,a09,mmap
0,48367854600,48367855200,00000000600,a15,access
0,48367857600,48367858000,00000000400,a00,read
0,48367858700,48367860200,00000001500,a09,mmap
0,48367862600,48367864100,00000001500,a09,mmap
0,48367878800,48367879500,00000000700,a09,mmap
0,48367883600,48367884100,00000000500,a09,mmap
0,48368071800,48368071900,00000000100,a0c,brk
0,48368072000,48368072800,00000000800,a0c,brk
0,48368101000,48368102200,00000001200,a00,read
0,48368116400,48368117900,00000001500,a00,read
0,48368154600,48368155500,00000000900,a00,read
0,48368277800,48368278600,00000000800,a00,read
0,48368349500,48368350000,00000000500,a00,read
0,48368435700,48368436400,00000000700,a00,read
0,48368568000,48368568800,00000000800,a00,read
0,48368697700,48368698400,00000000700,a00,read
0,48368854500,48368855300,00000000800,a00,read
0,48369006200,48369007000,00000000800,a00,read
0,48369043600,48369044900,00000001300,a0c,brk
0,48369160800,48369161400,00000000600,a00,read
0,48369309900,48369310700,00000000800,a00,read
0,48369491800,48369492600,00000000800,a00,read
0,48369655600,48369656300,00000000700,a00,read
0,48369764600,48369765300,00000000700,a00,read
0,48369796300,48369797300,00000001000,a0c,brk
0,48369905500,48369906200,00000000700,a00,read
0,48370148100,48370148800,00000000700,a00,read
0,48370160900,48370161300,00000000400,a00,read
0,48370204800,48370205100,00000000300,a00,read
0,48370224800,48370225500,00000000700,a00,read
0,48370435600,48370436000,00000000400,a00,read
0,48370465900,48370466700,00000000800,a00,read
0,48370564300,48370565100,00000000800,a00,read
0,48370589300,48370590400,00000001100,a0c,brk
0,48370635700,48370636100,00000000400,a00,read
0,48370712400,48370713300,00000000900,a00,read
0,48370867800,48370868300,00000000500,a00,read
0,48370980500,48370981300,00000000800,a00,read
0,48371076500,48371077000,00000000500,a00,read
0,48371088800,48371089300,00000000500,a00,read
0,48371173300,48371173600,00000000300,a00,read
0,48371197200,48371197500,00000000300,a00,read
0,48371219200,48371219800,00000000600,a00,read
0,48371321300,48371322400,00000001100,a0c,brk
0,48371324300,48371325500,00000001200,a00,read
0,48371526300,48371526700,00000000400,a00,read
0,48371610400,48371611000,00000000600,a00,read
0,48371675800,48371676500,00000000700,a00,read
0,48371804700,48371805100,00000000400,a00,read
0,48371837700,48371838300,00000000600,a00,read
0,48371855200,48371856500,00000001300,a02,open
0,48371971300,48371971800,00000000500,a00,read
0,48372043600,48372043600,00000000000,a00,read
0,48372096100,48372097100,00000001000,a0c,brk
0,48372103500,48372104200,00000000700,a00,read
0,48372210900,48372211500,00000000600,a00,read
0,48372361200,48372362200,00000001000,a00,read
0,48372493700,48372494300,00000000600,a00,read
0,48372551800,48372552600,00000000800,a00,read
0,48372608100,48372608800,00000000700,a00,read
0,48372678900,48372679700,00000000800,a00,read
0,48372732500,48372733100,00000000600,a00,read
0,48372821300,48372822100,00000000800,a0c,brk
0,48372854400,48372857600,00000003200,a0c,brk
0,48372872100,48372872900,00000000800,a00,read
0,48372988200,48372989200,00000001000,a00,read
0,48373147900,48373148500,00000000600,a00,read
0,48373266200,48373266900,00000000700,a00,read
0,48373420500,48373421100,00000000600,a00,read
0,48373538900,48373539500,00000000600,a00,read
0,48373701700,48373702300,00000000600,a00,read
0,48373707300,48373708000,00000000700,a0c,brk
0,48373823000,48373823800,00000000800,a00,read
0,48373942200,48373943000,00000000800,a00,read
0,48374085000,48374085800,00000000800,a00,read
0,48374217100,48374217700,00000000600,a00,read
0,48374311900,48374312500,00000000600,a00,read
0,48374425000,48374425700,00000000700,a00,read
0,48374549300,48374549900,00000000600,a00,read
0,48374661400,48374662100,00000000700,a0c,brk
0,48374684800,48374685400,00000000600,a00,read
0,48374854700,48374855400,00000000700,a00,read
0,48375006300,48375007000,00000000700,a00,read
0,48375117600,48375118200,00000000600,a00,read
0,48375287000,48375287900,00000000900,a00,read
0,48375364200,48375364800,00000000600,a00,read
0,48375446600,48375447300,00000000700,a00,read
0,48375514400,48375515000,00000000600,a0c,brk
0,48375528300,48375529000,00000000700,a00,read
0,48375601400,48375602100,00000000700,a00,read
0,48375703100,48375703800,00000000700,a00,read
0,48375807400,48375808000,00000000600,a00,read
0,48375897400,48375898000,00000000600,a00,read
0,48375978600,48375979300,00000000700,a00,read
0,48376080400,48376081100,00000000700,a00,read
0,48376162000,48376162400,00000000400,a0c,brk
0,48376164700,48376165500,00000000800,a00,read
0,48376272200,48376272900,00000000700,a00,read
0,48376365700,48376366300,00000000600,a00,read
0,48376486100,48376486800,00000000700,a00,read
0,48376600300,48376601100,00000000800,a00,read
0,48376704300,48376704800,00000000500,a00,read
0,48376805000,48376805400,00000000400,a0c,brk
0,48377161500,48377164800,00000003300,a57,unlink
0,48377189300,48377189800,00000000500,a48,fcntl
0,48377236300,48377251100,00000014800,a01,write
0,48377269300,48377271800,00000002500,a01,write
0,48377287700,48377290200,00000002500,a01,write
0,48367232600,48377471000,00010238400,a3d,wait4
0,48377489300,48377492700,00000003400,a00,read
0,48377494900,48377495300,00000000400,a00,read
0,48366888000,48377526600,00010638600,a17,select
0,48377547600,48377547900,00000000300,a2f,recvmsg
0,48377562400,48377562600,00000000200,a2f,recvmsg
0,48377563400,48377563600,00000000200,a2f,recvmsg
0,48377551400,48377570300,00000018900,a17,select
0,48377574100,48377574300,00000000200,a2f,recvmsg
0,48377580200,48377580400,00000000200,a2f,recvmsg
0,48377580800,48377581000,00000000200,a2f,recvmsg
0,48377575000,48377586400,00000011400,a17,select
0,48377589900,48377590100,00000000200,a2f,recvmsg
0,48377595400,48377595500,00000000100,a2f,recvmsg
0,48377595800,48377596000,00000000200,a2f,recvmsg
0,48377590700,48377601700,00000011000,a17,select
0,48377605300,48377605500,00000000200,a2f,recvmsg
0,48377610800,48377610900,00000000100,a2f,recvmsg
0,48377611300,48377611500,00000000200,a2f,recvmsg
0,48377606100,48377617000,00000010900,a17,select
0,48377620600,48377620800,00000000200,a2f,recvmsg
0,48377625900,48377626100,00000000200,a2f,recvmsg
0,48377626500,48377626700,00000000200,a2f,recvmsg
0,48377621400,48377631600,00000010200,a17,select
0,48377635100,48377635300,00000000200,a2f,recvmsg
0,48377640500,48377640700,00000000200,a2f,recvmsg
0,48377641000,48377641100,00000000100,a2f,recvmsg
0,48377642000,48377642200,00000000200,a08,lseek
0,48377654200,48377654300,00000000100,a08,lseek
0,48377635800,48377658700,00000022900,a17,select
0,48377662200,48377662400,00000000200,a2f,recvmsg
0,48377667800,48377668000,00000000200,a2f,recvmsg
0,48377668400,48377668600,00000000200,a2f,recvmsg
0,48377663000,48377675700,00000012700,a17,select
0,48377679200,48377679400,00000000200,a2f,recvmsg
0,48377684700,48377684900,00000000200,a2f,recvmsg
0,48377685300,48377685400,00000000100,a2f,recvmsg
0,48377680000,48377690400,00000010400,a17,select
0,48377693500,48377693700,00000000200,a2f,recvmsg
0,48377698900,48377699100,00000000200,a2f,recvmsg
0,48377699400,48377699600,00000000200,a2f,recvmsg
0,48377694200,48377705000,00000010800,a17,select
0,48377708100,48377708300,00000000200,a2f,recvmsg
0,48377713700,48377713900,00000000200,a2f,recvmsg
0,48377714200,48377714400,00000000200,a2f,recvmsg
0,48377708900,48377720600,00000011700,a17,select
0,48377724000,48377724100,00000000100,a2f,recvmsg
0,48377729500,48377729600,00000000100,a2f,recvmsg
0,48377730000,48377730300,00000000300,a2f,recvmsg
0,48377724600,48377736000,00000011400,a17,select
0,48377739100,48377739300,00000000200,a2f,recvmsg
0,48377744600,48377744800,00000000200,a2f,recvmsg
0,48377745100,48377745300,00000000200,a2f,recvmsg
0,48377739800,48377750500,00000010700,a17,select
0,48377753800,48377753900,00000000100,a2f,recvmsg
0,48377759300,48377759400,00000000100,a2f,recvmsg
0,48377759800,48377760000,00000000200,a2f,recvmsg
0,48377754500,48377764700,00000010200,a17,select
0,48377767700,48377767900,00000000200,a2f,recvmsg
0,48377774100,48377774200,00000000100,a2f,recvmsg
0,48377774600,48377774800,00000000200,a2f,recvmsg
0,48377768400,48377781200,00000012800,a17,select
0,48377784600,48377784800,00000000200,a2f,recvmsg
0,48377790000,48377790200,00000000200,a2f,recvmsg
0,48377790500,48377790700,00000000200,a2f,recvmsg
0,48377785400,48377795900,00000010500,a17,select
0,48377799200,48377799400,00000000200,a2f,recvmsg
0,48377804600,48377804800,00000000200,a2f,recvmsg
0,48377805100,48377805300,00000000200,a2f,recvmsg
0,48377800000,48377810400,00000010400,a17,select
0,48377813600,48377813800,00000000200,a2f,recvmsg
0,48377819100,48377819300,00000000200,a2f,recvmsg
0,48377819600,48377819700,00000000100,a2f,recvmsg
0,48377814300,48377824900,00000010600,a17,select
0,48377827900,48377828000,00000000100,a2f,recvmsg
0,48377833400,48377833500,00000000100,a2f,recvmsg
0,48377833900,48377834100,00000000200,a2f,recvmsg
0,48377828600,48377839100,00000010500,a17,select
0,48377842200,48377842400,00000000200,a2f,recvmsg
0,48377847500,48377847700,00000000200,a2f,recvmsg
0,48377848100,48377848100,00000000000,a2f,recvmsg
0,48377842900,48377853400,00000010500,a17,select
0,48377856500,48377856700,00000000200,a2f,recvmsg
0,48377861900,48377862000,00000000100,a2f,recvmsg
0,48377862400,48377862600,00000000200,a2f,recvmsg
0,48377857300,48377867600,00000010300,a17,select
0,48377870700,48377870800,00000000100,a2f,recvmsg
0,48377876000,48377876200,00000000200,a2f,recvmsg
0,48377876600,48377876600,00000000000,a2f,recvmsg
0,48377871300,48377881200,00000009900,a17,select
0,48377884300,48377884500,00000000200,a2f,recvmsg
0,48377889700,48377889900,00000000200,a2f,recvmsg
0,48377890100,48377890300,00000000200,a2f,recvmsg
0,48377885100,48377897200,00000012100,a17,select
0,48377900400,48377900600,00000000200,a2f,recvmsg
0,48377905800,48377906000,00000000200,a2f,recvmsg
0,48377906300,48377906500,00000000200,a2f,recvmsg
0,48377901200,48377910900,00000009700,a17,select
0,48377914100,48377914300,00000000200,a2f,recvmsg
0,48377919400,48377919500,00000000100,a2f,recvmsg
0,48377919900,48377920100,00000000200,a2f,recvmsg
0,48377914800,48377924500,00000009700,a17,select
0,48377927500,48377927600,00000000100,a2f,recvmsg
0,48377932900,48377933100,00000000200,a2f,recvmsg
0,48377933400,48377933600,00000000200,a2f,recvmsg
0,48377928100,48377938000,00000009900,a17,select
0,48377941100,48377941200,00000000100,a2f,recvmsg
0,48377946500,48377946700,00000000200,a2f,recvmsg
0,48377947000,48377947100,00000000100,a2f,recvmsg
0,48377941800,48377952100,00000010300,a17,select
0,48377955100,48377955300,00000000200,a2f,recvmsg
0,48377960400,48377960600,00000000200,a2f,recvmsg
0,48377960900,48377961100,00000000200,a2f,recvmsg
0,48377955900,48377965900,00000010000,a17,select
0,48377968800,48377969000,00000000200,a2f,recvmsg
0,48377974300,48377974400,00000000100,a2f,recvmsg
0,48377974800,48377975000,00000000200,a2f,recvmsg
0,48377969600,48377980200,00000010600,a17,select
0,48377983300,48377983400,00000000100,a2f,recvmsg
0,48377988700,48377988800,00000000100,a2f,recvmsg
0,48377989200,48377989400,00000000200,a2f,recvmsg
0,48377984000,48377994600,00000010600,a17,select
0,48377997900,48377998100,00000000200,a2f,recvmsg
0,48378003200,48378003300,00000000100,a2f,recvmsg
0,48378003700,48378003900,00000000200,a2f,recvmsg
0,48377998600,48378010500,00000011900,a17,select
0,48378013900,48378014100,00000000200,a2f,recvmsg
0,48378019300,48378019500,00000000200,a2f,recvmsg
0,48378019800,48378020000,00000000200,a2f,recvmsg
0,48378014700,48378025500,00000010800,a17,select
0,48378028500,48378028600,00000000100,a2f,recvmsg
0,48378033800,48378033900,00000000100,a2f,recvmsg
0,48378034300,48378034400,00000000100,a2f,recvmsg
0,48378029200,48378040000,00000010800,a17,select
0,48378043000,48378043200,00000000200,a2f,recvmsg
0,48378048400,48378048600,00000000200,a2f,recvmsg
0,48378048900,48378049100,00000000200,a2f,recvmsg
0,48378043800,48378056400,00000012600,a17,select
0,48378059600,48378059800,00000000200,a2f,recvmsg
0,48378064900,48378065100,00000000200,a2f,recvmsg
0,48378065500,48378065600,00000000100,a2f,recvmsg
0,48378060400,48378070500,00000010100,a17,select
0,48378073500,48378073700,00000000200,a2f,recvmsg
0,48378079100,48378079200,00000000100,a2f,recvmsg
0,48378079600,48378079800,00000000200,a2f,recvmsg
0,48378074200,48378084900,00000010700,a17,select
0,48378088000,48378088200,00000000200,a2f,recvmsg
0,48378093300,48378093500,00000000200,a2f,recvmsg
0,48378093900,48378094000,00000000100,a2f,recvmsg
0,48378088800,48378100000,00000011200,a17,select
0,48378103100,48378103300,00000000200,a2f,recvmsg
0,48378108500,48378108700,00000000200,a2f,recvmsg
0,48378109000,48378109200,00000000200,a2f,recvmsg
0,48378103900,48378114700,00000010800,a17,select
0,48378117900,48378118000,00000000100,a2f,recvmsg
0,48378123300,48378123400,00000000100,a2f,recvmsg
0,48378123700,48378123900,00000000200,a2f,recvmsg
0,48378118600,48378129600,00000011000,a17,select
0,48378132900,48378133100,00000000200,a2f,recvmsg
0,48378138300,48378138500,00000000200,a2f,recvmsg
0,48378138800,48378138900,00000000100,a2f,recvmsg
0,48378133600,48378144200,00000010600,a17,select
0,48378147400,48378147600,00000000200,a2f,recvmsg
0,48378152800,48378153000,00000000200,a2f,recvmsg
0,48378153300,48378153500,00000000200,a2f,recvmsg
0,48378148200,48378159600,00000011400,a17,select
0,48378162700,48378162800,00000000100,a2f,recvmsg
0,48378168100,48378168200,00000000100,a2f,recvmsg
0,48378168600,48378168800,00000000200,a2f,recvmsg
0,48378163400,48378173400,00000010000,a17,select
0,48378176500,48378176700,00000000200,a2f,recvmsg
0,48378181800,48378182000,00000000200,a2f,recvmsg
0,48378182300,48378182500,00000000200,a2f,recvmsg
0,48378177200,48378187800,00000010600,a17,select
0,48378190900,48378191100,00000000200,a2f,recvmsg
0,48378196300,48378196500,00000000200,a2f,recvmsg
0,48378196800,48378197000,00000000200,a2f,recvmsg
0,48378198300,48378198400,00000000100,a08,lseek
0,48378201000,48378201900,00000000900,a00,read
0,48378205600,48378205700,00000000100,a08,lseek
0,48378191700,48378210600,00000018900,a17,select
0,48378213800,48378214000,00000000200,a2f,recvmsg
0,48378219400,48378219600,00000000200,a2f,recvmsg
0,48378220000,48378220100,00000000100,a2f,recvmsg
0,48378214700,48378248500,00000033800,a17,select
0,48378251900,48378252100,00000000200,a2f,recvmsg
0,48378257600,48378257700,00000000100,a2f,recvmsg
0,48378258100,48378258300,00000000200,a2f,recvmsg
0,48378262600,48378263500,00000000900,a00,read
0,48378269000,48378269200,00000000200,a08,lseek
0,48378252700,48378274300,00000021600,a17,select
0,48378277700,48378277900,00000000200,a2f,recvmsg
0,48378283200,48378283400,00000000200,a2f,recvmsg
0,48378283700,48378283900,00000000200,a2f,recvmsg
0,48378278500,48378288500,00000010000,a17,select
0,48378291500,48378291600,00000000100,a2f,recvmsg
0,48378296700,48378296900,00000000200,a2f,recvmsg
0,48378297200,48378297400,00000000200,a2f,recvmsg
0,48378292200,48378301800,00000009600,a17,select
0,48378304700,48378304900,00000000200,a2f,recvmsg
0,48378309900,48378310100,00000000200,a2f,recvmsg
0,48378310500,48378310700,00000000200,a2f,recvmsg
0,48378305400,48378315100,00000009700,a17,select
0,48378318100,48378318200,00000000100,a2f,recvmsg
0,48378323300,48378323500,00000000200,a2f,recvmsg
0,48378323800,48378324000,00000000200,a2f,recvmsg
0,48378318800,48378328400,00000009600,a17,select
0,48378331400,48378331500,00000000100,a2f,recvmsg
0,48378336500,48378336600,00000000100,a2f,recvmsg
0,48378337000,48378337200,00000000200,a2f,recvmsg
0,48378332100,48378341600,00000009500,a17,select
0,48378344600,48378344800,00000000200,a2f,recvmsg
0,48378349800,48378349900,00000000100,a2f,recvmsg
0,48378350300,48378350500,00000000200,a2f,recvmsg
0,48378345300,48378354800,00000009500,a17,select
0,48378357800,48378358000,00000000200,a2f,recvmsg
0,48378363000,48378363200,00000000200,a2f,recvmsg
0,48378363500,48378363700,00000000200,a2f,recvmsg
0,48378358600,48378368700,00000010100,a17,select
0,48378371800,48378371900,00000000100,a2f,recvmsg
0,48378377000,48378377200,00000000200,a2f,recvmsg
0,48378377500,48378377700,00000000200,a2f,recvmsg
0,48378372500,48378382200,00000009700,a17,select
0,48378385400,48378385600,00000000200,a2f,recvmsg
0,48378390600,48378390800,00000000200,a2f,recvmsg
0,48378391200,48378391300,00000000100,a2f,recvmsg
0,48378391900,48378392000,00000000100,a08,lseek
0,48378386100,48378398100,00000012000,a17,select
0,48378401200,48378401300,00000000100,a2f,recvmsg
0,48378406700,48378406900,00000000200,a2f,recvmsg
0,48378407200,48378407400,00000000200,a2f,recvmsg
0,48378402000,48378414300,00000012300,a17,select
0,48378417500,48378417700,00000000200,a2f,recvmsg
0,48378422800,48378423000,00000000200,a2f,recvmsg
0,48378423300,48378423500,00000000200,a2f,recvmsg
0,48378418200,48378428600,00000010400,a17,select
0,48378431500,48378431700,00000000200,a2f,recvmsg
0,48378436900,48378437100,00000000200,a2f,recvmsg
0,48378437400,48378437600,00000000200,a2f,recvmsg
0,48378432300,48378442400,00000010100,a17,select
0,48378445300,48378445500,00000000200,a2f,recvmsg
0,48378450500,48378450700,00000000200,a2f,recvmsg
0,48378451100,48378451200,00000000100,a2f,recvmsg
0,48378446100,48378456000,00000009900,a17,select
0,48378459000,48378459200,00000000200,a2f,recvmsg
0,48378464200,48378464400,00000000200,a2f,recvmsg
0,48378464800,48378465000,00000000200,a2f,recvmsg
0,48378459700,48378469600,00000009900,a17,select
0,48378472700,48378472800,00000000100,a2f,recvmsg
0,48378477900,48378478100,00000000200,a2f,recvmsg
0,48378478500,48378478600,00000000100,a2f,recvmsg
0,48378473300,48378483800,00000010500,a17,select
0,48378487000,48378487100,00000000100,a2f,recvmsg
0,48378492200,48378492300,00000000100,a2f,recvmsg
0,48378492700,48378492900,00000000200,a2f,recvmsg
0,48378487700,48378497700,00000010000,a17,select
0,48378500600,48378500800,00000000200,a2f,recvmsg
0,48378505800,48378506000,00000000200,a2f,recvmsg
0,48378506300,48378506500,00000000200,a2f,recvmsg
0,48378501300,48378511200,00000009900,a17,select
0,48378514200,48378514300,00000000100,a2f,recvmsg
0,48378519500,48378519700,00000000200,a2f,recvmsg
0,48378520000,48378520200,00000000200,a2f,recvmsg
0,48378514900,48378524900,00000010000,a17,select
0,48378527900,48378528100,00000000200,a2f,recvmsg
0,48378533200,48378533400,00000000200,a2f,recvmsg
0,48378533800,48378534000,00000000200,a2f,recvmsg
0,48378528600,48378538600,00000010000,a17,select
0,48378541700,48378541900,00000000200,a2f,recvmsg
0,48378547100,48378547200,00000000100,a2f,recvmsg
0,48378547500,48378547700,00000000200,a2f,recvmsg
0,48378542500,48378552500,00000010000,a17,select
0,48378555500,48378555700,00000000200,a2f,recvmsg
0,48378560900,48378561000,00000000100,a2f,recvmsg
0,48378561400,48378561500,00000000100,a2f,recvmsg
0,48378556300,48378566900,00000010600,a17,select
0,48378570000,48378570100,00000000100,a2f,recvmsg
0,48378575300,48378575500,00000000200,a2f,recvmsg
0,48378575800,48378576000,00000000200,a2f,recvmsg
0,48378570700,48378580900,00000010200,a17,select
0,48378583800,48378584000,00000000200,a2f,recvmsg
0,48378589300,48378589400,00000000100,a2f,recvmsg
0,48378589800,48378590000,00000000200,a2f,recvmsg
0,48378584600,48378594700,00000010100,a17,select
0,48378597600,48378597700,00000000100,a2f,recvmsg
0,48378602800,48378603000,00000000200,a2f,recvmsg
0,48378603300,48378603500,00000000200,a2f,recvmsg
0,48378598400,48378608200,00000009800,a17,select
0,48378611300,48378611400,00000000100,a2f,recvmsg
0,48378616500,48378616700,00000000200,a2f,recvmsg
0,48378617100,48378617200,00000000100,a2f,recvmsg
0,48378611900,48378629900,00000018000,a17,select
0,48378633000,48378633200,00000000200,a2f,recvmsg
0,48378638600,48378638700,00000000100,a2f,recvmsg
0,48378639100,48378639300,00000000200,a2f,recvmsg
0,48378633900,48378644300,00000010400,a17,select
0,48378647400,48378647600,00000000200,a2f,recvmsg
0,48378652700,48378652800,00000000100,a2f,recvmsg
0,48378653200,48378653400,00000000200,a2f,recvmsg
0,48378648100,48378658100,00000010000,a17,select
0,48378661100,48378661300,00000000200,a2f,recvmsg
0,48378666500,48378666600,00000000100,a2f,recvmsg
0,48378667000,48378667100,00000000100,a2f,recvmsg
0,48378661800,48378672100,00000010300,a17,select
0,48378675000,48378675200,00000000200,a2f,recvmsg
0,48378680300,48378680500,00000000200,a2f,recvmsg
0,48378680800,48378681000,00000000200,a2f,recvmsg
0,48378675800,48378685900,00000010100,a17,select
0,48378688900,48378689100,00000000200,a2f,recvmsg
0,48378694200,48378694400,00000000200,a2f,recvmsg
0,48378694800,48378694900,00000000100,a2f,recvmsg
0,48378739100,48378742700,00000003600,a14,writev
0,48378689700,48378746400,00000056700,a17,select
0,48378748700,48378750000,00000001300,a2f,recvmsg
0,48378835500,48378839800,00000004300,a14,writev
0,48378840100,48378844200,00000004100,a14,writev
0,48378922600,48378924700,00000002100,a14,writev
0,48378979700,48378982400,00000002700,a14,writev
0,48379040000,48379041800,00000001800,a14,writev
0,48379042000,48379043700,00000001700,a14,writev
0,48379097400,48379099100,00000001700,a14,writev
0,48379099300,48379100900,00000001600,a14,writev
0,48379154800,48379156500,00000001700,a14,writev
0,48379156800,48379158400,00000001600,a14,writev
0,48379161800,48379162500,00000000700,a2f,recvmsg
0,48379209700,48379211700,00000002000,a14,writev
0,48379254400,48379256100,00000001700,a14,writev
0,48379298000,48379299700,00000001700,a14,writev
0,48379342200,48379343700,00000001500,a14,writev
0,48379384900,48379386500,00000001600,a14,writev
0,48379428900,48379430500,00000001600,a14,writev
0,48379455200,48379457100,00000001900,a2f,recvmsg
0,48379482800,48379485200,00000002400,a14,writev
0,48379501600,48379503200,00000001600,a14,writev
0,48379517700,48379519400,00000001700,a14,writev
0,48379532600,48379534400,00000001800,a14,writev
0,48379546900,48379548600,00000001700,a14,writev
0,48379561000,48379563800,00000002800,a14,writev
0,48379568200,48379568400,00000000200,a2f,recvmsg
0,48379569100,48379569400,00000000300,a14,writev
0,48379569700,48379570100,00000000400,a14,writev
0,48379588800,48379590400,00000001600,a14,writev
0,48379590600,48379591900,00000001300,a14,writev
0,48379592300,48379592500,00000000200,a2f,recvmsg
0,48378738500,48379600700,00000862200,a07,poll
0,48379605600,48379612000,00000006400,a2f,recvmsg
0,48379624300,48379624500,00000000200,a2f,recvmsg
0,48379651200,48379656000,00000004800,a07,poll
0,48379661600,48379668300,00000006700,a2f,recvmsg
0,48379680600,48379680800,00000000200,a2f,recvmsg
0,48379703700,48379708100,00000004400,a07,poll
0,48379713900,48379719600,00000005700,a2f,recvmsg
0,48379732200,48379732400,00000000200,a2f,recvmsg
0,48379593300,48379761200,00000167900,a17,select
0,48379776600,48379778000,00000001400,a14,writev
0,48379778500,48379778600,00000000100,a2f,recvmsg
0,48379792400,48379793500,00000001100,a14,writev
0,48379793700,48379793900,00000000200,a2f,recvmsg
0,48379805700,48379806700,00000001000,a14,writev
0,48379807000,48379807100,00000000100,a2f,recvmsg
0,48379755400,48379813500,00000058100,a07,poll
0,48379814200,48379815200,00000001000,a2f,recvmsg
0,48379819700,48379822800,00000003100,a2d,recvfrom
0,48379824000,48379824100,00000000100,a2f,recvmsg
0,48379824800,48379824900,00000000100,a2f,recvmsg
0,48379865800,48379866000,00000000200,a2f,recvmsg
0,48379868300,48379868500,00000000200,a2f,recvmsg
0,48379870800,48379873200,00000002400,a07,poll
0,48379873600,48379874700,00000001100,a2f,recvmsg
0,48379879500,48379880200,00000000700,a2d,recvfrom
0,48379881100,48379881100,00000000000,a2f,recvmsg
0,48379881900,48379882000,00000000100,a2f,recvmsg
0,48379910900,48379911100,00000000200,a2f,recvmsg
0,48379913000,48379913200,00000000200,a2f,recvmsg
0,48379916000,48379918300,00000002300,a07,poll
0,48379919000,48379920400,00000001400,a2f,recvmsg
0,48379925600,48379926200,00000000600,a2d,recvfrom
0,48379927100,48379927300,00000000200,a2f,recvmsg
0,48379928000,48379928200,00000000200,a2f,recvmsg
0,48379957100,48379957200,00000000100,a2f,recvmsg
0,48379959000,48379959200,00000000200,a2f,recvmsg
0,48379970000,48379970200,00000000200,a2f,recvmsg
0,48379970700,48379970900,00000000200,a2f,recvmsg
0,48379807600,48380005000,00000197400,a17,select
0,48380015200,48380017500,00000002300,a14,writev
0,48380019300,48380019400,00000000100,a2f,recvmsg
0,48380027200,48380027400,00000000200,a2f,recvmsg
0,48380027900,48380028100,00000000200,a2f,recvmsg
1,48319415000,48319415500,00000000500,a00,read
1,48319528400,48319529200,00000000800,a00,read
1,48319622900,48319623400,00000000500,a00,read
1,48319635900,48319636400,00000000500,a00,read
1,48323724000,48323724800,00000000800,a00,read
1,48323750500,48323750900,00000000400,a00,read
1,48323773900,48323774500,00000000600,a00,read
1,48323878000,48323879300,00000001300,a0c,brk
1,48323882100,48323883100,00000001000,a00,read
1,48324084300,48324084800,00000000500,a00,read
1,48324168100,48324168700,00000000600,a00,read
1,48324232300,48324233100,00000000800,a00,read
1,48324361500,48324361900,00000000400,a00,read
1,48324394400,48324395000,00000000600,a00,read
1,48324411600,48324413200,00000001600,a02,open
1,48324525800,48324526400,00000000600,a00,read
1,48324597700,48324598100,00000000400,a00,read
1,48324652200,48324653400,00000001200,a0c,brk
1,48324660000,48324660800,00000000800,a00,read
1,48324768900,48324769600,00000000700,a00,read
1,48324921100,48324922100,00000001000,a00,read
1,48179858800,48325089400,00145230600,a4a,fsync
1,48325147200,48325151800,00000004600,a09,mmap
1,48206717400,48325228600,00118511200,a07,poll
1,48325232700,48325234200,00000001500,aca,futex
1,48325238200,48325239100,00000000900,aca,futex
1,48325241100,48325242000,00000000900,aca,futex
1,48325262500,48325262800,00000000300,a00,read
1,48188746600,48325271400,00136524800,ae8,epoll_wait
1,48325299600,48325299900,00000000300,a2f,recvmsg
1,48325319300,48325324100,00000004800,a2e,sendmsg
1,48325267800,48325382600,00000114800,a07,poll
1,48325384300,48325385300,00000001000,aca,futex
1,48325387000,48325387800,00000000800,aca,futex
1,48325389200,48325390200,00000001000,aca,futex
1,48325392800,48325394900,00000002100,a2e,sendmsg
1,48325327400,48325402400,00000075000,ae8,epoll_wait
1,48325405100,48325406300,00000001200,a2f,recvmsg
1,48325414300,48325414400,00000000100,a2f,recvmsg
1,48325437000,48325437900,00000000900,a2e,sendmsg
1,48325599900,48325609600,00000009700,a01,write
1,48325457700,48325644300,00000186600,a07,poll
1,48325707300,48325707600,00000000300,a00,read
1,48325748400,48325761100,00000012700,a01,write
1,48325776800,48325778200,00000001400,aca,futex
1,48325440100,48325791300,00000351200,ae8,epoll_wait
1,48325795500,48325797500,00000002000,a2f,recvmsg
1,48325806900,48325807200,00000000300,a2f,recvmsg
1,48325820100,48325823100,00000003000,a2e,sendmsg
1,48325782900,48325824900,00000042000,a07,poll
1,48325825600,48325826000,00000000400,a00,read
1,48325834700,48325835600,00000000900,a2f,recvmsg
1,48325952900,48325954600,00000001700,a00,read
1,48326024100,48326024800,00000000700,a00,read
1,48326081600,48326082400,00000000800,a00,read
1,48326152000,48326152800,00000000800,a00,read
1,48326205600,48326206300,00000000700,a00,read
1,48326324900,48326327800,00000002900,a0c,brk
1,48326367300,48326371100,00000003800,a0c,brk
1,48326393600,48326394600,00000001000,a00,read
1,48326513600,48326514400,00000000800,a00,read
1,48326674600,48326675400,00000000800,a00,read
1,48326792800,48326793500,00000000700,a00,read
1,48326938800,48326939500,00000000700,a00,read
1,48327056100,48327056700,00000000600,a00,read
1,48327219500,48327220100,00000000600,a00,read
1,48327225000,48327226000,00000001000,a0c,brk
1,48327341200,48327341900,00000000700,a00,read
1,48327460100,48327460700,00000000600,a00,read
1,48327602000,48327602800,00000000800,a00,read
1,48327741500,48327742200,00000000700,a00,read
1,48327835200,48327836000,00000000800,a00,read
1,48327947900,48327948600,00000000700,a00,read
1,48328072300,48328072900,00000000600,a00,read
1,48328185600,48328186400,00000000800,a0c,brk
1,48328209400,48328210100,00000000700,a00,read
1,48328379800,48328380400,00000000600,a00,read
1,48328530300,48328531000,00000000700,a00,read
1,48328641000,48328641700,00000000700,a00,read
1,48328812400,48328813400,00000001000,a00,read
1,48328890100,48328890800,00000000700,a00,read
1,48328972200,48328973000,00000000800,a00,read
1,48329039900,48329040500,00000000600,a0c,brk
1,48329054100,48329054700,00000000600,a00,read
1,48329127400,48329128100,00000000700,a00,read
1,48329229100,48329229900,00000000800,a00,read
1,48329332300,48329333000,00000000700,a00,read
1,48329422600,48329423300,00000000700,a00,read
1,48329503700,48329504400,00000000700,a00,read
1,48329605900,48329606600,00000000700,a00,read
1,48329687400,48329687700,00000000300,a0c,brk
1,48329690400,48329691100,00000000700,a00,read
1,48329797800,48329798400,00000000600,a00,read
1,48329890800,48329891500,00000000700,a00,read
1,48330009800,48330010400,00000000600,a00,read
1,48330123700,48330124400,00000000700,a00,read
1,48330229600,48330230300,00000000700,a00,read
1,48330330000,48330330300,00000000300,a0c,brk
1,48330694100,48330696700,00000002600,a57,unlink
1,48330718200,48330718600,00000000400,a48,fcntl
1,48330768200,48330779500,00000011300,a01,write
1,48330797600,48330800600,00000003000,a01,write
1,48330817100,48330819600,00000002500,a01,write
1,48118123300,48330989000,00212865700,a3d,wait4
1,48331010400,48331012000,00000001600,a00,read
1,48331014100,48331014500,00000000400,a00,read
1,48331025000,48331033000,00000008000,a14,writev
1,48331037500,48335706600,00004669100,a07,poll
1,48335711100,48335711300,00000000200,a2f,recvmsg
1,48335712300,48335712400,00000000100,a2f,recvmsg
1,48335714600,48335716500,00000001900,a14,writev
1,48335716900,48335726100,00000009200,a07,poll
1,48335727500,48335727700,00000000200,a2f,recvmsg
1,48335728000,48335728200,00000000200,a2f,recvmsg
1,48335729400,48335731200,00000001800,a14,writev
1,48335731400,48335739200,00000007800,a07,poll
1,48335740600,48335740700,00000000100,a2f,recvmsg
1,48335741000,48335741200,00000000200,a2f,recvmsg
1,48335742800,48335744400,00000001600,a14,writev
1,48335744700,48335752600,00000007900,a07,poll
1,48335753900,48335754000,00000000100,a2f,recvmsg
1,48335754300,48335754500,00000000200,a2f,recvmsg
1,48335756000,48335757700,00000001700,a14,writev
1,48335758000,48335766200,00000008200,a07,poll
1,48335767400,48335767600,00000000200,a2f,recvmsg
1,48335767900,48335768100,00000000200,a2f,recvmsg
1,48335769200,48335770700,00000001500,a14,writev
1,48335771000,48335778500,00000007500,a07,poll
1,48335779800,48335779900,00000000100,a2f,recvmsg
1,48335780300,48335780500,00000000200,a2f,recvmsg
1,48335781000,48335781300,00000000300,a08,lseek
1,48335790200,48335790300,00000000100,a08,lseek
1,48335791300,48335793000,00000001700,a14,writev
1,48335793400,48335801100,00000007700,a07,poll
1,48335802400,48335802600,00000000200,a2f,recvmsg
1,48335803000,48335803100,00000000100,a2f,recvmsg
1,48335806800,48335808500,00000001700,a14,writev
1,48335809500,48335816400,00000006900,a07,poll
1,48335817800,48335818000,00000000200,a2f,recvmsg
1,48335818300,48335818500,00000000200,a2f,recvmsg
1,48335820000,48335821600,00000001600,a14,writev
1,48335822000,48335829200,00000007200,a07,poll
1,48335830400,48335830600,00000000200,a2f,recvmsg
1,48335830900,48335831100,00000000200,a2f,recvmsg
1,48335833000,48335834800,00000001800,a14,writev
1,48335835100,48335842300,00000007200,a07,poll
1,48335843600,48335843700,00000000100,a2f,recvmsg
1,48335844100,48335844300,00000000200,a2f,recvmsg
1,48335846000,48335847700,00000001700,a14,writev
1,48335848000,48335855400,00000007400,a07,poll
1,48335857600,48335857800,00000000200,a2f,recvmsg
1,48335858200,48335858400,00000000200,a2f,recvmsg
1,48335860200,48335861800,00000001600,a14,writev
1,48335862200,48335869500,00000007300,a07,poll
1,48335870800,48335871000,00000000200,a2f,recvmsg
1,48335871300,48335871500,00000000200,a2f,recvmsg
1,48335873100,48335874800,00000001700,a14,writev
1,48335875200,48335882800,00000007600,a07,poll
1,48335884000,48335884200,00000000200,a2f,recvmsg
1,48335884500,48335884700,00000000200,a2f,recvmsg
1,48335885900,48335887500,00000001600,a14,writev
1,48335887800,48335895200,00000007400,a07,poll
1,48335897500,48335897700,00000000200,a2f,recvmsg
1,48335898000,48335898200,00000000200,a2f,recvmsg
1,48335901800,48335903400,00000001600,a14,writev
1,48335903700,48335911200,00000007500,a07,poll
1,48335912400,48335912600,00000000200,a2f,recvmsg
1,48335912900,48335913100,00000000200,a2f,recvmsg
1,48335914900,48335916500,00000001600,a14,writev
1,48335916900,48335924400,00000007500,a07,poll
1,48335925600,48335925800,00000000200,a2f,recvmsg
1,48335926100,48335926300,00000000200,a2f,recvmsg
1,48335928600,48335930300,00000001700,a14,writev
1,48335930600,48335938100,00000007500,a07,poll
1,48335939300,48335939500,00000000200,a2f,recvmsg
1,48335939800,48335940000,00000000200,a2f,recvmsg
1,48335941600,48335943200,00000001600,a14,writev
1,48335943500,48335951000,00000007500,a07,poll
1,48335952200,48335952400,00000000200,a2f,recvmsg
1,48335952700,48335952900,00000000200,a2f,recvmsg
1,48335954400,48335956000,00000001600,a14,writev
1,48335956500,48335963700,00000007200,a07,poll
1,48335965000,48335965100,00000000100,a2f,recvmsg
1,48335965500,48335965700,00000000200,a2f,recvmsg
1,48335967400,48335969000,00000001600,a14,writev
1,48335969300,48335976700,00000007400,a07,poll
1,48335978100,48335978300,00000000200,a2f,recvmsg
1,48335978500,48335978700,00000000200,a2f,recvmsg
1,48335980200,48335981900,00000001700,a14,writev
1,48335982300,48335989700,00000007400,a07,poll
1,48335990900,48335991100,00000000200,a2f,recvmsg
1,48335991400,48335991600,00000000200,a2f,recvmsg
1,48335992700,48335994300,00000001600,a14,writev
1,48335994600,48336002200,00000007600,a07,poll
1,48336003500,48336003700,00000000200,a2f,recvmsg
1,48336004000,48336004200,00000000200,a2f,recvmsg
1,48336007900,48336009500,00000001600,a14,writev
1,48336009900,48336017300,00000007400,a07,poll
1,48336018500,48336018700,00000000200,a2f,recvmsg
1,48336019000,48336019200,00000000200,a2f,recvmsg
1,48336020300,48336022000,00000001700,a14,writev
1,48336022200,48336029700,00000007500,a07,poll
1,48336031000,48336031200,00000000200,a2f,recvmsg
1,48336031500,48336031600,00000000100,a2f,recvmsg
1,48336032800,48336034400,00000001600,a14,writev
1,48336034800,48336042000,00000007200,a07,poll
1,48336043200,48336043300,00000000100,a2f,recvmsg
1,48336043600,48336043800,00000000200,a2f,recvmsg
1,48336044900,48336046500,00000001600,a14,writev
1,48336046800,48336054300,00000007500,a07,poll
1,48336055600,48336055700,00000000100,a2f,recvmsg
1,48336056000,48336056200,00000000200,a2f,recvmsg
1,48336057700,48336059300,00000001600,a14,writev
1,48336059600,48336067000,00000007400,a07,poll
1,48336068300,48336068500,00000000200,a2f,recvmsg
1,48336068800,48336069000,00000000200,a2f,recvmsg
1,48336070200,48336071700,00000001500,a14,writev
1,48336072100,48336079400,00000007300,a07,poll
1,48336080800,48336080900,00000000100,a2f,recvmsg
1,48336081200,48336081400,00000000200,a2f,recvmsg
1,48336084000,48336085600,00000001600,a14,writev
1,48336085900,48336093300,00000007400,a07,poll
1,48336094500,48336094700,00000000200,a2f,recvmsg
1,48336095000,48336095200,00000000200,a2f,recvmsg
1,48336096900,48336098400,00000001500,a14,writev
1,48336098800,48336106200,00000007400,a07,poll
1,48336107500,48336107700,00000000200,a2f,recvmsg
1,48336108000,48336108200,00000000200,a2f,recvmsg
1,48336110600,48336112200,00000001600,a14,writev
1,48336112500,48336120100,00000007600,a07,poll
1,48336121300,48336121500,00000000200,a2f,recvmsg
1,48336121800,48336122000,00000000200,a2f,recvmsg
1,48336123900,48336125400,00000001500,a14,writev
1,48336125800,48336133200,00000007400,a07,poll
1,48336134400,48336134600,00000000200,a2f,recvmsg
1,48336134900,48336135100,00000000200,a2f,recvmsg
1,48336137000,48336138600,00000001600,a14,writev
1,48336138900,48336146400,00000007500,a07,poll
1,48336147600,48336147800,00000000200,a2f,recvmsg
1,48336148100,48336148300,00000000200,a2f,recvmsg
1,48336152000,48336153500,00000001500,a14,writev
1,48336153900,48336161400,00000007500,a07,poll
1,48336162700,48336162800,00000000100,a2f,recvmsg
1,48336163200,48336163400,00000000200,a2f,recvmsg
1,48336164800,48336166400,00000001600,a14,writev
1,48336166800,48336174100,00000007300,a07,poll
1,48336175600,48336175700,00000000100,a2f,recvmsg
1,48336175900,48336176100,00000000200,a2f,recvmsg
1,48336177700,48336179200,00000001500,a14,writev
1,48336179600,48336187000,00000007400,a07,poll
1,48336188200,48336188400,00000000200,a2f,recvmsg
1,48336188700,48336188900,00000000200,a2f,recvmsg
1,48336191200,48336193000,00000001800,a14,writev
1,48336193200,48336200600,00000007400,a07,poll
1,48336201900,48336202000,00000000100,a2f,recvmsg
1,48336202300,48336202500,00000000200,a2f,recvmsg
1,48336205200,48336206700,00000001500,a14,writev
1,48336207100,48336214600,00000007500,a07,poll
1,48336216000,48336216200,00000000200,a2f,recvmsg
1,48336216500,48336216700,00000000200,a2f,recvmsg
1,48336219000,48336220600,00000001600,a14,writev
1,48336220900,48336228400,00000007500,a07,poll
1,48336229700,48336229900,00000000200,a2f,recvmsg
1,48336230200,48336230400,00000000200,a2f,recvmsg
1,48336232300,48336233900,00000001600,a14,writev
1,48336234300,48336241700,00000007400,a07,poll
1,48336243000,48336243200,00000000200,a2f,recvmsg
1,48336243500,48336243700,00000000200,a2f,recvmsg
1,48336245200,48336246800,00000001600,a14,writev
1,48336247200,48336254500,00000007300,a07,poll
1,48336255800,48336256000,00000000200,a2f,recvmsg
1,48336256300,48336256500,00000000200,a2f,recvmsg
1,48336257700,48336259400,00000001700,a14,writev
1,48336259600,48336267100,00000007500,a07,poll
1,48336268500,48336268600,00000000100,a2f,recvmsg
1,48336269000,48336269000,00000000000,a2f,recvmsg
1,48336271000,48336272700,00000001700,a14,writev
1,48336272900,48336280300,00000007400,a07,poll
1,48336281600,48336281700,00000000100,a2f,recvmsg
1,48336282100,48336282300,00000000200,a2f,recvmsg
1,48336283400,48336283500,00000000100,a08,lseek
1,48336286100,48336288900,00000002800,a00,read
1,48336292700,48336292800,00000000100,a08,lseek
1,48336294000,48336295700,00000001700,a14,writev
1,48336296200,48336303400,00000007200,a07,poll
1,48336305100,48336305200,00000000100,a2f,recvmsg
1,48336305600,48336305800,00000000200,a2f,recvmsg
1,48336329200,48336330900,00000001700,a14,writev
1,48336331300,48336338600,00000007300,a07,poll
1,48336340000,48336340200,00000000200,a2f,recvmsg
1,48336340600,48336340800,00000000200,a2f,recvmsg
1,48336344600,48336345300,00000000700,a00,read
1,48336350800,48336350900,00000000100,a08,lseek
1,48336352500,48336354100,00000001600,a14,writev
1,48336354500,48336361900,00000007400,a07,poll
1,48336363200,48336363400,00000000200,a2f,recvmsg
1,48336363800,48336364000,00000000200,a2f,recvmsg
1,48336365200,48336366800,00000001600,a14,writev
1,48336367100,48336374500,00000007400,a07,poll
1,48336375700,48336375900,00000000200,a2f,recvmsg
1,48336376200,48336376400,00000000200,a2f,recvmsg
1,48336377500,48336379200,00000001700,a14,writev
1,48336379400,48336386800,00000007400,a07,poll
1,48336388100,48336388300,00000000200,a2f,recvmsg
1,48336388600,48336388700,00000000100,a2f,recvmsg
1,48336389900,48336391500,00000001600,a14,writev
1,48336391800,48336399100,00000007300,a07,poll
1,48336400400,48336400500,00000000100,a2f,recvmsg
1,48336400900,48336401100,00000000200,a2f,recvmsg
1,48336402200,48336403800,00000001600,a14,writev
1,48336404100,48336411500,00000007400,a07,poll
1,48336412900,48336413100,00000000200,a2f,recvmsg
1,48336413400,48336413500,00000000100,a2f,recvmsg
1,48336414700,48336416400,00000001700,a14,writev
1,48336416700,48336423900,00000007200,a07,poll
1,48336425200,48336425400,00000000200,a2f,recvmsg
1,48336425700,48336425900,00000000200,a2f,recvmsg
1,48336427000,48336428600,00000001600,a14,writev
1,48336428900,48336436200,00000007300,a07,poll
1,48336437500,48336437700,00000000200,a2f,recvmsg
1,48336438100,48336438100,00000000000,a2f,recvmsg
1,48336440000,48336441700,00000001700,a14,writev
1,48336441900,48336449600,00000007700,a07,poll
1,48336451000,48336451200,00000000200,a2f,recvmsg
1,48336451400,48336451600,00000000200,a2f,recvmsg
1,48336453000,48336454500,00000001500,a14,writev
1,48336454800,48336462200,00000007400,a07,poll
1,48336463500,48336463700,00000000200,a2f,recvmsg
1,48336464000,48336464200,00000000200,a2f,recvmsg
1,48336464700,48336464800,00000000100,a08,lseek
1,48336467400,48336469100,00000001700,a14,writev
1,48336469400,48336476800,00000007400,a07,poll
1,48336478200,48336478400,00000000200,a2f,recvmsg
1,48336478700,48336478900,00000000200,a2f,recvmsg
1,48336482300,48336484000,00000001700,a14,writev
1,48336484400,48336491900,00000007500,a07,poll
1,48336493200,48336493300,00000000100,a2f,recvmsg
1,48336493700,48336493900,00000000200,a2f,recvmsg
1,48336495600,48336497200,00000001600,a14,writev
1,48336497600,48336504800,00000007200,a07,poll
1,48336506200,48336506400,00000000200,a2f,recvmsg
1,48336506600,48336506800,00000000200,a2f,recvmsg
1,48336508300,48336509900,00000001600,a14,writev
1,48336510200,48336517500,00000007300,a07,poll
1,48336518800,48336519000,00000000200,a2f,recvmsg
1,48336519300,48336519500,00000000200,a2f,recvmsg
1,48336520900,48336522500,00000001600,a14,writev
1,48336522900,48336530100,00000007200,a07,poll
1,48336531400,48336531600,00000000200,a2f,recvmsg
1,48336531900,48336532100,00000000200,a2f,recvmsg
1,48336533500,48336535000,00000001500,a14,writev
1,48336535400,48336542600,00000007200,a07,poll
1,48336544000,48336544200,00000000200,a2f,recvmsg
1,48336544500,48336544600,00000000100,a2f,recvmsg
1,48336546500,48336548200,00000001700,a14,writev
1,48336548500,48336555800,00000007300,a07,poll
1,48336557100,48336557300,00000000200,a2f,recvmsg
1,48336557600,48336557800,00000000200,a2f,recvmsg
1,48336559200,48336560700,00000001500,a14,writev
1,48336561100,48336568400,00000007300,a07,poll
1,48336569700,48336569900,00000000200,a2f,recvmsg
1,48336570200,48336570400,00000000200,a2f,recvmsg
1,48336571700,48336573300,00000001600,a14,writev
1,48336573700,48336580900,00000007200,a07,poll
1,48336582300,48336582500,00000000200,a2f,recvmsg
1,48336582700,48336582900,00000000200,a2f,recvmsg
1,48336584400,48336586000,00000001600,a14,writev
1,48336586300,48336593600,00000007300,a07,poll
1,48336594900,48336595100,00000000200,a2f,recvmsg
1,48336595400,48336595600,00000000200,a2f,recvmsg
1,48336597000,48336598600,00000001600,a14,writev
1,48336599000,48336606300,00000007300,a07,poll
1,48336607600,48336607800,00000000200,a2f,recvmsg
1,48336608100,48336608300,00000000200,a2f,recvmsg
1,48336609800,48336611300,00000001500,a14,writev
1,48336611700,48336619000,00000007300,a07,poll
1,48336620400,48336620500,00000000100,a2f,recvmsg
1,48336620800,48336621000,00000000200,a2f,recvmsg
1,48336623100,48336624700,00000001600,a14,writev
1,48336625100,48336632300,00000007200,a07,poll
1,48336633700,48336633800,00000000100,a2f,recvmsg
1,48336634100,48336634300,00000000200,a2f,recvmsg
1,48336635700,48336637300,00000001600,a14,writev
1,48336637600,48336645000,00000007400,a07,poll
1,48336646400,48336646500,00000000100,a2f,recvmsg
1,48336646900,48336647100,00000000200,a2f,recvmsg
1,48336648400,48336650100,00000001700,a14,writev
1,48336650600,48336657900,00000007300,a07,poll
1,48336659200,48336659300,00000000100,a2f,recvmsg
1,48336659700,48336659900,00000000200,a2f,recvmsg
1,48336661200,48336662800,00000001600,a14,writev
1,48336663100,48336670500,00000007400,a07,poll
1,48336671800,48336671900,00000000100,a2f,recvmsg
1,48336672200,48336672400,00000000200,a2f,recvmsg
1,48336679500,48336681200,00000001700,a14,writev
1,48336681500,48336688900,00000007400,a07,poll
1,48336690300,48336690400,00000000100,a2f,recvmsg
1,48336690800,48336690900,00000000100,a2f,recvmsg
1,48336692600,48336694200,00000001600,a14,writev
1,48336694600,48336701800,00000007200,a07,poll
1,48336703100,48336703300,00000000200,a2f,recvmsg
1,48336703600,48336703800,00000000200,a2f,recvmsg
1,48336705200,48336706900,00000001700,a14,writev
1,48336707200,48336714500,00000007300,a07,poll
1,48336715800,48336716000,00000000200,a2f,recvmsg
1,48336716300,48336716500,00000000200,a2f,recvmsg
1,48336718100,48336719600,00000001500,a14,writev
1,48336720000,48336727300,00000007300,a07,poll
1,48336728700,48336728800,00000000100,a2f,recvmsg
1,48336729000,48336729200,00000000200,a2f,recvmsg
1,48336730700,48336732400,00000001700,a14,writev
1,48336732700,48336740200,00000007500,a07,poll
1,48336741400,48336741600,00000000200,a2f,recvmsg
1,48336741900,48336742100,00000000200,a2f,recvmsg
1,48336784100,48336788400,00000004300,a14,writev
1,48336788900,48336887000,00000098100,a07,poll
1,48336788900,48336890900,00000102000,a07,poll
1,48336903600,48336903800,00000000200,a2f,recvmsg
1,48336908300,48336908500,00000000200,a2f,recvmsg
1,48336908700,48336908900,00000000200,a2f,recvmsg
1,48336913200,48336913400,00000000200,a2f,recvmsg
1,48336913500,48336913700,00000000200,a2f,recvmsg
1,48336918400,48336919200,00000000800,a00,read
1,48336929500,48336929700,00000000200,a2f,recvmsg
1,48336958200,48336963300,00000005100,a07,poll
1,48336966100,48336966300,00000000200,a2f,recvmsg
1,48336967000,48336967200,00000000200,a2f,recvmsg
1,48336967400,48336967500,00000000100,a2f,recvmsg
1,48336968300,48336968500,00000000200,a2f,recvmsg
1,48336968700,48336968900,00000000200,a2f,recvmsg
1,48336972400,48337019200,00000046800,a07,poll
1,48337019400,48337020500,00000001100,a2f,recvmsg
1,48336972400,48337021600,00000049200,a07,poll
1,48337023300,48337023400,00000000100,a2f,recvmsg
1,48337024000,48337024200,00000000200,a2f,recvmsg
1,48337024400,48337024500,00000000100,a2f,recvmsg
1,48337025100,48337025200,00000000100,a2f,recvmsg
1,48337025400,48337025500,00000000100,a2f,recvmsg
1,48337027300,48337075800,00000048500,a07,poll
1,48337076000,48337077200,00000001200,a2f,recvmsg
1,48337027300,48337078400,00000051100,a07,poll
1,48337081000,48337081100,00000000100,a2f,recvmsg
1,48337081700,48337081800,00000000100,a2f,recvmsg
1,48337082000,48337082200,00000000200,a2f,recvmsg
1,48337082600,48337082800,00000000200,a2f,recvmsg
1,48337083000,48337083200,00000000200,a2f,recvmsg
1,48337084900,48337133300,00000048400,a07,poll
1,48337133500,48337134600,00000001100,a2f,recvmsg
1,48337084900,48337135700,00000050800,a07,poll
1,48337137300,48337137500,00000000200,a2f,recvmsg
1,48337138000,48337138200,00000000200,a2f,recvmsg
1,48337138400,48337138500,00000000100,a2f,recvmsg
1,48337139100,48337139200,00000000100,a2f,recvmsg
1,48337139300,48337139500,00000000200,a2f,recvmsg
1,48337141300,48337191000,00000049700,a07,poll
1,48337191200,48337192400,00000001200,a2f,recvmsg
1,48337141300,48337193600,00000052300,a07,poll
1,48337195300,48337195500,00000000200,a2f,recvmsg
1,48337196000,48337196200,00000000200,a2f,recvmsg
1,48337196300,48337196500,00000000200,a2f,recvmsg
1,48337197000,48337197200,00000000200,a2f,recvmsg
1,48337197300,48337197500,00000000200,a2f,recvmsg
1,48337199900,48337247400,00000047500,a07,poll
1,48337248800,48337291800,00000043000,a07,poll
1,48337293100,48337335100,00000042000,a07,poll
1,48337337300,48337379300,00000042000,a07,poll
1,48337380500,48337422700,00000042200,a07,poll
1,48337424100,48337467400,00000043300,a07,poll
1,48337468800,48337521400,00000052600,a07,poll
1,48337522700,48337540500,00000017800,a07,poll
1,48337541900,48337556000,00000014100,a07,poll
1,48337557200,48337570700,00000013500,a07,poll
1,48325776800,48337578900,00011802100,aca,futex
1,48337571900,48337586800,00000014900,a07,poll
1,48337588100,48337599900,00000011800,a07,poll
1,48337601500,48337605800,00000004300,a07,poll
1,48337608300,48337608500,00000000200,a2f,recvmsg
1,48337609000,48337609200,00000000200,a2f,recvmsg
1,48337630700,48337632300,00000001600,a07,poll
1,48337632700,48337634100,00000001400,a2f,recvmsg
1,48337638400,48337642000,00000003600,a2d,recvfrom
1,48337630700,48337643500,00000012800,a07,poll
1,48337646500,48337646500,00000000000,a2f,recvmsg
1,48337647600,48337647700,00000000100,a2f,recvmsg
1,48337647900,48337648100,00000000200,a2f,recvmsg
1,48337649000,48337649100,00000000100,a2f,recvmsg
1,48337649300,48337649500,00000000200,a2f,recvmsg
1,48337655700,48337656000,00000000300,a2f,recvmsg
1,48337656500,48337656700,00000000200,a2f,recvmsg
1,48337713000,48337713200,00000000200,a2f,recvmsg
1,48337715400,48337715600,00000000200,a2f,recvmsg
1,48337718300,48337721500,00000003200,a07,poll
1,48337724000,48337724200,00000000200,a2f,recvmsg
1,48337724600,48337724800,00000000200,a2f,recvmsg
1,48338212400,48338216900,00000004500,a09,mmap
1,48338374500,48338379500,00000005000,a02,open
1,48338387200,48338389400,00000002200,a00,read
1,48338442000,48338442800,00000000800,a00,read
1,48338491800,48338492600,00000000800,a00,read
1,48338539600,48338540300,00000000700,a00,read
1,48338587800,48338588600,00000000800,a00,read
1,48338634500,48338635200,00000000700,a00,read
1,48338678900,48338679600,00000000700,a00,read
1,48338724700,48338725400,00000000700,a00,read
1,48338773200,48338773900,00000000700,a00,read
1,48338822200,48338822900,00000000700,a00,read
1,48338870200,48338870900,00000000700,a00,read
1,48338897400,48338899000,00000001600,a02,open
1,48338902400,48338903400,00000001000,a00,read
1,48338959400,48338960300,00000000900,a00,read
1,48339043300,48339044000,00000000700,a00,read
1,48339115300,48339116100,00000000800,a00,read
1,48339192500,48339193200,00000000700,a00,read
1,48339271300,48339272000,00000000700,a00,read
1,48339348100,48339348900,00000000800,a00,read
1,48339431800,48339432500,00000000700,a00,read
1,48339498400,48339499000,00000000600,a00,read
1,48339555800,48339556500,00000000700,a00,read
1,48339625500,48339633400,00000007900,a14,writev
1,48339634600,48339656900,00000022300,a07,poll
1,48339660900,48339661100,00000000200,a2f,recvmsg
1,48339661800,48339662000,00000000200,a2f,recvmsg
1,48339663000,48339665000,00000002000,a14,writev
1,48339665400,48339673500,00000008100,a07,poll
1,48339675100,48339675200,00000000100,a2f,recvmsg
1,48339675600,48339675700,00000000100,a2f,recvmsg
1,48339680600,48339686000,00000005400,a06,lstat
1,48339686800,48339688100,00000001300,a06,lstat
1,48339688800,48339719900,00000031100,a02,open
1,48339724300,48339735100,00000010800,a01,write
1,48339737600,48339740500,00000002900,a14,writev
1,48339741500,48339750200,00000008700,a07,poll
1,48339752700,48339752900,00000000200,a2f,recvmsg
1,48339753500,48339753600,00000000100,a2f,recvmsg
1,48339755500,48340063400,00000307900,a38,clone
1,48340536400,48340536500,00000000100,a0c,brk
1,48340546800,48340549400,00000002600,a15,access
1,48340555400,48340556100,00000000700,a15,access
1,48340562400,48340563300,00000000900,a09,mmap
1,48340566800,48340567300,00000000500,a15,access
1,48340574700,48340575700,00000001000,a00,read
1,48340577200,48340578900,00000001700,a09,mmap
1,48340582800,48340585000,00000002200,a09,mmap
1,48340596800,48340597300,00000000500,a15,access
1,48340600900,48340601400,00000000500,a00,read
1,48340602200,48340603000,00000000800,a09,mmap
1,48340605100,48340606400,00000001300,a09,mmap
1,48340614600,48340615200,00000000600,a15,access
1,48340617900,48340618400,00000000500,a00,read
1,48340619000,48340619900,00000000900,a09,mmap
1,48340621400,48340623500,00000002100,a09,mmap
1,48340627700,48340631000,00000003300,a09,mmap
1,48340633100,48340634100,00000001000,a09,mmap
1,48340642900,48340643800,00000000900,a15,access
1,48340646400,48340646900,00000000500,a00,read
1,48340647600,48340649100,00000001500,a09,mmap
1,48340652200,48340653800,00000001600,a09,mmap
1,48340661900,48340662600,00000000700,a15,access
1,48340665800,48340666500,00000000700,a00,read
1,48340667200,48340668600,00000001400,a09,mmap
1,48340683300,48340684000,00000000700,a15,access
1,48340687100,48340687600,00000000500,a00,read
1,48340688100,48340689200,00000001100,a09,mmap
1,48340690400,48340691900,00000001500,a09,mmap
1,48340694600,48340695900,00000001300,a09,mmap
1,48340702400,48340702900,00000000500,a15,access
1,48340705400,48340705900,00000000500,a00,read
1,48340707600,48340709000,00000001400,a09,mmap
1,48340711100,48340712700,00000001600,a09,mmap
1,48340727000,48340727500,00000000500,a09,mmap
1,48340731500,48340731800,00000000300,a09,mmap
1,48340732900,48340733100,00000000200,a09,mmap
1,48340781200,48340788700,00000007500,60e,page_fault
1,48337583100,48340792100,00003209000,aca,futex
1,48340958100,48340958200,00000000100,a0c,brk
1,48340958300,48340959500,00000001200,a0c,brk
1,48340995400,48340996700,00000001300,a00,read
1,48341007900,48341009300,00000001400,a00,read
1,48341042900,48341043800,00000000900,a00,read
1,48341165300,48341166200,00000000900,a00,read
1,48341237900,48341238400,00000000500,a00,read
1,48341323500,48341324300,00000000800,a00,read
1,48341454800,48341455700,00000000900,a00,read
1,48341584800,48341585400,00000000600,a00,read
1,48341741600,48341742300,00000000700,a00,read
1,48341891900,48341892600,00000000700,a00,read
1,48341929200,48341930700,00000001500,a0c,brk
1,48342045500,48342046300,00000000800,a00,read
1,48342194500,48342195100,00000000600,a00,read
1,48342353300,48342354100,00000000800,a00,read
1,48342512800,48342513500,00000000700,a00,read
1,48342622300,48342623000,00000000700,a00,read
1,48342653500,48342654100,00000000600,a0c,brk
1,48342762000,48342762900,00000000900,a00,read
1,48343005400,48343006200,00000000800,a00,read
1,48343019300,48343019700,00000000400,a00,read
1,48343063400,48343063900,00000000500,a00,read
1,48343083700,48343084400,00000000700,a00,read
1,48343289800,48343290300,00000000500,a00,read
1,48343319300,48343320100,00000000800,a00,read
1,48343416600,48343417300,00000000700,a00,read
1,48343441400,48343442600,00000001200,a0c,brk
1,48343487200,48343487700,00000000500,a00,read
1,48343563300,48343564100,00000000800,a00,read
1,48343729200,48343729800,00000000600,a00,read
1,48343844800,48343845500,00000000700,a00,read
1,48343939500,48343940100,00000000600,a00,read
1,48343952300,48343952800,00000000500,a00,read
1,48344033900,48344034300,00000000400,a00,read
1,48344057900,48344058300,00000000400,a00,read
1,48344080300,48344080900,00000000600,a00,read
1,48344181900,48344183100,00000001200,a0c,brk
1,48344184400,48344185500,00000001100,a00,read
1,48344385800,48344386100,00000000300,a00,read
1,48344469700,48344470300,00000000600,a00,read
1,48344533400,48344534000,00000000600,a00,read
1,48344662100,48344662500,00000000400,a00,read
1,48344694600,48344695200,00000000600,a00,read
1,48344712400,48344713600,00000001200,a02,open
1,48344825000,48344825900,00000000900,a00,read
1,48344896600,48344896900,00000000300,a00,read
1,48344957100,48344957800,00000000700,a00,read
1,48345065400,48345066000,00000000600,a00,read
1,48345216700,48345217700,00000001000,a00,read
1,48345346900,48345347500,00000000600,a00,read
1,48345405400,48345406100,00000000700,a00,read
1,48345462300,48345463000,00000000700,a00,read
1,48345532600,48345533400,00000000800,a00,read
1,48345585900,48345586600,00000000700,a00,read
1,48345674000,48345674700,00000000700,a0c,brk
1,48345704500,48345708500,00000004000,a0c,brk
1,48345722400,48345723200,00000000800,a00,read
1,48345837400,48345838200,00000000800,a00,read
1,48345995200,48345996000,00000000800,a00,read
1,48346113100,48346113900,00000000800,a00,read
1,48346259000,48346259600,00000000600,a00,read
1,48346376300,48346377000,00000000700,a00,read
1,48346538500,48346539200,00000000700,a00,read
1,48346544200,48346545000,00000000800,a0c,brk
1,48346659700,48346660400,00000000700,a00,read
1,48346777300,48346778000,00000000700,a00,read
1,48346920000,48346920800,00000000800,a00,read
1,48347051300,48347051900,00000000600,a00,read
1,48347143900,48347144600,00000000700,a00,read
1,48347255600,48347256300,00000000700,a00,read
1,48347378800,48347379500,00000000700,a00,read
1,48347490400,48347491000,00000000600,a0c,brk
1,48347513700,48347514400,00000000700,a00,read
1,48347682900,48347683600,00000000700,a00,read
1,48347840000,48347840700,00000000700,a00,read
1,48347950600,48347951300,00000000700,a00,read
1,48348117700,48348118600,00000000900,a00,read
1,48348195700,48348196400,00000000700,a00,read
1,48348277800,48348278600,00000000800,a00,read
1,48348345300,48348346000,00000000700,a0c,brk
1,48348359400,48348360000,00000000600,a00,read
1,48348432200,48348432900,00000000700,a00,read
1,48348534900,48348535500,00000000600,a00,read
1,48348637500,48348638200,00000000700,a00,read
1,48348727300,48348727900,00000000600,a00,read
1,48348807900,48348808600,00000000700,a00,read
1,48348908600,48348909300,00000000700,a00,read
1,48348992500,48348993200,00000000700,a00,read
1,48349100800,48349101500,00000000700,a00,read
1,48349193600,48349194300,00000000700,a00,read
1,48349312700,48349313300,00000000600,a00,read
1,48349426000,48349426500,00000000500,a00,read
1,48349529100,48349529700,00000000600,a00,read
1,48349628700,48349629100,00000000400,a0c,brk
1,48339741500,48349858700,00010117200,a07,poll
1,48349861400,48349862300,00000000900,a00,read
1,48349960400,48349964400,00000004000,a09,mmap
1,48349971200,48349972300,00000001100,a09,mmap
1,48350371900,48361562900,00011191000,a07,poll
1,48350371900,48361566400,00011194500,a07,poll
1,48361580600,48361580800,00000000200,a2f,recvmsg
1,48361584900,48361585100,00000000200,a2f,recvmsg
1,48361585400,48361585500,00000000100,a2f,recvmsg
1,48361589700,48361589900,00000000200,a2f,recvmsg
1,48361590100,48361590300,00000000200,a2f,recvmsg
1,48361604000,48361604200,00000000200,a2f,recvmsg
1,48361636300,48361641600,00000005300,a07,poll
1,48361644400,48361644500,00000000100,a2f,recvmsg
1,48361645400,48361645400,00000000000,a2f,recvmsg
1,48361645700,48361645800,00000000100,a2f,recvmsg
1,48361646800,48361647000,00000000200,a2f,recvmsg
1,48361647200,48361647300,00000000100,a2f,recvmsg
1,48361638300,48361650500,00000012200,a14,writev
1,48361651800,48361696300,00000044500,a07,poll
1,48361696500,48361697800,00000001300,a2f,recvmsg
1,48361651800,48361699000,00000047200,a07,poll
1,48361701800,48361702000,00000000200,a2f,recvmsg
1,48361702400,48361702600,00000000200,a2f,recvmsg
1,48361702700,48361702900,00000000200,a2f,recvmsg
1,48361703500,48361703700,00000000200,a2f,recvmsg
1,48361703800,48361704000,00000000200,a2f,recvmsg
1,48361705800,48361754000,00000048200,a07,poll
1,48361754200,48361755500,00000001300,a2f,recvmsg
1,48361705800,48361756700,00000050900,a07,poll
1,48361758300,48361758500,00000000200,a2f,recvmsg
1,48361759000,48361759200,00000000200,a2f,recvmsg
1,48361759400,48361759500,00000000100,a2f,recvmsg
1,48361760000,48361760200,00000000200,a2f,recvmsg
1,48361760400,48361760500,00000000100,a2f,recvmsg
1,48361762300,48361812000,00000049700,a07,poll
1,48361812200,48361813300,00000001100,a2f,recvmsg
1,48361762300,48361814400,00000052100,a07,poll
1,48361816000,48361816200,00000000200,a2f,recvmsg
1,48361816600,48361816800,00000000200,a2f,recvmsg
1,48361816900,48361817100,00000000200,a2f,recvmsg
1,48361817600,48361817800,00000000200,a2f,recvmsg
1,48361818000,48361818200,00000000200,a2f,recvmsg
1,48361819900,48361867200,00000047300,a07,poll
1,48361867400,48361868500,00000001100,a2f,recvmsg
1,48361819900,48361869500,00000049600,a07,poll
1,48361871100,48361871300,00000000200,a2f,recvmsg
1,48361871700,48361871900,00000000200,a2f,recvmsg
1,48361872100,48361872300,00000000200,a2f,recvmsg
1,48361872800,48361873000,00000000200,a2f,recvmsg
1,48361873200,48361873400,00000000200,a2f,recvmsg
1,48361875000,48361923300,00000048300,a07,poll
1,48361924500,48361968300,00000043800,a07,poll
1,48361969400,48362011200,00000041800,a07,poll
1,48362013200,48362054700,00000041500,a07,poll
1,48362056000,48362098000,00000042000,a07,poll
1,48362099200,48362142000,00000042800,a07,poll
1,48362143100,48362194600,00000051500,a07,poll
1,48362196000,48362213100,00000017100,a07,poll
1,48362214400,48362229400,00000015000,a07,poll
1,48362230600,48362245400,00000014800,a07,poll
1,48362246600,48362259700,00000013100,a07,poll
1,48362261400,48362273700,00000012300,a07,poll
1,48362274900,48362299300,00000024400,a07,poll
1,48362299500,48362301300,00000001800,a2f,recvmsg
1,48362303000,48362304700,00000001700,a2d,recvfrom
1,48362308500,48362308700,00000000200,a2f,recvmsg
1,48362309100,48362309300,00000000200,a2f,recvmsg
1,48362365400,48362365600,00000000200,a2f,recvmsg
1,48362367900,48362368100,00000000200,a2f,recvmsg
1,48362370800,48362707400,00000336600,a07,poll
1,48362710300,48362710500,00000000200,a2f,recvmsg
1,48362711300,48362711500,00000000200,a2f,recvmsg
1,48362711700,48362711900,00000000200,a2f,recvmsg
1,48362712800,48362713000,00000000200,a2f,recvmsg
1,48362713200,48362713300,00000000100,a2f,recvmsg
1,48325613700,48363676700,00038063000,a4a,fsync
1,48363749000,48363755800,00000006800,a09,mmap
1,48362713600,48363818300,00001104700,a07,poll
1,48363820800,48363822100,00000001300,aca,futex
1,48363825200,48363826200,00000001000,aca,futex
1,48363828100,48363828900,00000000800,aca,futex
1,48363841700,48363841900,00000000200,a00,read
1,48325911700,48363848700,00037937000,ae8,epoll_wait
1,48363866600,48363866800,00000000200,a2f,recvmsg
1,48363845700,48363936900,00000091200,a07,poll
1,48363938500,48363939400,00000000900,aca,futex
1,48363941100,48363942000,00000000900,aca,futex
1,48363943300,48363944100,00000000800,aca,futex
1,48363946500,48363948300,00000001800,a2e,sendmsg
1,48363885500,48363955600,00000070100,ae8,epoll_wait
1,48363958200,48363959400,00000001200,a2f,recvmsg
1,48363967000,48363967200,00000000200,a2f,recvmsg
1,48363988200,48363989200,00000001000,a2e,sendmsg
1,48364145800,48364155900,00000010100,a01,write
1,48364008500,48364348200,00000339700,a07,poll
1,48364372300,48364372600,00000000300,aca,futex
1,48364379100,48364382400,00000003300,aca,futex
1,48364429800,48364431500,00000001700,aca,futex
1,48364439200,48364440600,00000001400,aca,futex
1,48364451700,48364512800,00000061100,a07,poll
1,48364527200,48364527600,00000000400,aca,futex
1,48364528300,48364528500,00000000200,aca,futex
1,48363991300,48364533200,00000541900,ae8,epoll_wait
1,48364538900,48364540900,00000002000,a2f,recvmsg
1,48364550800,48364551000,00000000200,a2f,recvmsg
1,48364564700,48364568200,00000003500,a2e,sendmsg
1,48364530400,48364570100,00000039700,a07,poll
1,48364571100,48364571500,00000000400,a00,read
1,48364580900,48364581700,00000000800,a2f,recvmsg
1,48364748500,48364749200,00000000700,a2f,recvmsg
1,48364749400,48364749600,00000000200,a2f,recvmsg
1,48364754300,48364755100,00000000800,a00,read
1,48364763900,48364764100,00000000200,a2f,recvmsg
1,48364798600,48364801500,00000002900,a14,writev
1,48364797900,48364803200,00000005300,a07,poll
1,48364805700,48364805900,00000000200,a2f,recvmsg
1,48364806700,48364806900,00000000200,a2f,recvmsg
1,48364807000,48364807200,00000000200,a2f,recvmsg
1,48364808200,48364808400,00000000200,a2f,recvmsg
1,48364808600,48364808800,00000000200,a2f,recvmsg
1,48364813200,48364860300,00000047100,a07,poll
1,48364860500,48364861600,00000001100,a2f,recvmsg
1,48364813200,48364862700,00000049500,a07,poll
1,48364864600,48364864700,00000000100,a2f,recvmsg
1,48364865300,48364865400,00000000100,a2f,recvmsg
1,48364865600,48364865800,00000000200,a2f,recvmsg
1,48364866200,48364866400,00000000200,a2f,recvmsg
1,48364866600,48364866800,00000000200,a2f,recvmsg
1,48364868600,48364917700,00000049100,a07,poll
1,48364917900,48364919100,00000001200,a2f,recvmsg
1,48364868600,48364920200,00000051600,a07,poll
1,48364921800,48364922000,00000000200,a2f,recvmsg
1,48364922500,48364922700,00000000200,a2f,recvmsg
1,48364922800,48364922900,00000000100,a2f,recvmsg
1,48364923500,48364923600,00000000100,a2f,recvmsg
1,48364923800,48364924000,00000000200,a2f,recvmsg
1,48364925600,48364977400,00000051800,a07,poll
1,48364977600,48364978700,00000001100,a2f,recvmsg
1,48364925600,48364979800,00000054200,a07,poll
1,48364981400,48364981500,00000000100,a2f,recvmsg
1,48364982000,48364982100,00000000100,a2f,recvmsg
1,48364982300,48364982500,00000000200,a2f,recvmsg
1,48364983000,48364983200,00000000200,a2f,recvmsg
1,48364983400,48364983500,00000000100,a2f,recvmsg
1,48364985200,48365035900,00000050700,a07,poll
1,48365036100,48365038300,00000002200,a2f,recvmsg
1,48364985200,48365039400,00000054200,a07,poll
1,48365041100,48365041300,00000000200,a2f,recvmsg
1,48365041800,48365042000,00000000200,a2f,recvmsg
1,48365042200,48365042400,00000000200,a2f,recvmsg
1,48365042800,48365043000,00000000200,a2f,recvmsg
1,48365043100,48365043300,00000000200,a2f,recvmsg
1,48365045000,48365093600,00000048600,a07,poll
1,48365094900,48365138700,00000043800,a07,poll
1,48365140000,48365183700,00000043700,a07,poll
1,48365185900,48365227700,00000041800,a07,poll
1,48365229000,48365271500,00000042500,a07,poll
1,48365272800,48365316400,00000043600,a07,poll
1,48365317700,48365370800,00000053100,a07,poll
1,48365372000,48365390200,00000018200,a07,poll
1,48365391300,48365407500,00000016200,a07,poll
1,48365409200,48365423600,00000014400,a07,poll
1,48365424800,48365438700,00000013900,a07,poll
1,48365440000,48365453900,00000013900,a07,poll
1,48365455300,48365480000,00000024700,a07,poll
1,48365480200,48365481800,00000001600,a2f,recvmsg
1,48365485200,48365486800,00000001600,a2d,recvfrom
1,48365490800,48365491000,00000000200,a2f,recvmsg
1,48365491400,48365491600,00000000200,a2f,recvmsg
1,48365547600,48365547900,00000000300,a2f,recvmsg
1,48365549900,48365550000,00000000100,a2f,recvmsg
1,48365552300,48365901700,00000349400,a07,poll
1,48365904700,48365904800,00000000100,a2f,recvmsg
1,48365905600,48365905800,00000000200,a2f,recvmsg
1,48365906000,48365906200,00000000200,a2f,recvmsg
1,48365907000,48365907100,00000000100,a2f,recvmsg
1,48365907300,48365907400,00000000100,a2f,recvmsg
1,48368641300,48368641400,00000000100,a0c,brk
1,48368651100,48368653700,00000002600,a15,access
1,48368654400,48368655300,00000000900,a09,mmap
1,48368659900,48368661900,00000002000,a15,access
1,48368669100,48368670100,00000001000,a09,mmap
1,48368673800,48368674300,00000000500,a15,access
1,48368681500,48368682600,00000001100,a00,read
1,48368684200,48368686000,00000001800,a09,mmap
1,48368689700,48368691800,00000002100,a09,mmap
1,48368704000,48368704700,00000000700,a15,access
1,48368708000,48368708700,00000000700,a00,read
1,48368709400,48368710200,00000000800,a09,mmap
1,48368712800,48368714100,00000001300,a09,mmap
1,48368722400,48368723000,00000000600,a15,access
1,48368725900,48368726400,00000000500,a00,read
1,48368727000,48368728000,00000001000,a09,mmap
1,48368729600,48368731700,00000002100,a09,mmap
1,48368736200,48368739500,00000003300,a09,mmap
1,48368741700,48368742700,00000001000,a09,mmap
1,48368751500,48368752200,00000000700,a15,access
1,48368754900,48368755500,00000000600,a00,read
1,48368756200,48368757800,00000001600,a09,mmap
1,48368760600,48368762400,00000001800,a09,mmap
1,48368770500,48368771200,00000000700,a15,access
1,48368774200,48368774700,00000000500,a00,read
1,48368780300,48368782700,00000002400,a09,mmap
1,48368791200,48368791700,00000000500,a15,access
1,48368794300,48368795000,00000000700,a00,read
1,48368795400,48368796500,00000001100,a09,mmap
1,48368797700,48368799100,00000001400,a09,mmap
1,48368802000,48368803300,00000001300,a09,mmap
1,48368809500,48368810100,00000000600,a15,access
1,48368812300,48368812800,00000000500,a00,read
1,48368813500,48368814800,00000001300,a09,mmap
1,48368817200,48368818800,00000001600,a09,mmap
1,48368832900,48368833400,00000000500,a09,mmap
1,48368837100,48368837500,00000000400,a09,mmap
1,48368838700,48368838900,00000000200,a09,mmap
1,48369019100,48369019200,00000000100,a0c,brk
1,48369019300,48369020100,00000000800,a0c,brk
1,48369054000,48369055100,00000001100,a00,read
1,48369066700,48369068000,00000001300,a00,read
1,48369102700,48369103600,00000000900,a00,read
1,48369225000,48369225800,00000000800,a00,read
1,48369297800,48369298400,00000000600,a00,read
1,48369383200,48369383900,00000000700,a00,read
1,48369514000,48369514900,00000000900,a00,read
1,48369642400,48369643100,00000000700,a00,read
1,48369798300,48369799100,00000000800,a00,read
1,48369948800,48369949600,00000000800,a00,read
1,48369986400,48369987700,00000001300,a0c,brk
1,48370102700,48370103400,00000000700,a00,read
1,48370251200,48370251800,00000000600,a00,read
1,48370406800,48370407600,00000000800,a00,read
1,48370566800,48370567600,00000000800,a00,read
1,48370676200,48370676900,00000000700,a00,read
1,48370707300,48370707900,00000000600,a0c,brk
1,48370816200,48370816900,00000000700,a00,read
1,48371059100,48371059900,00000000800,a00,read
1,48371071300,48371071600,00000000300,a00,read
1,48371115100,48371115400,00000000300,a00,read
1,48371135000,48371135800,00000000800,a00,read
1,48371365900,48371366600,00000000700,a00,read
1,48371396900,48371397800,00000000900,a00,read
1,48371494800,48371495400,00000000600,a00,read
1,48371565300,48371565800,00000000500,a00,read
1,48371643500,48371644300,00000000800,a00,read
1,48371796700,48371797100,00000000400,a00,read
1,48371909200,48371909800,00000000600,a00,read
1,48372003900,48372004300,00000000400,a00,read
1,48372016200,48372016700,00000000500,a00,read
1,48372096500,48372097000,00000000500,a00,read
1,48372120400,48372120800,00000000400,a00,read
1,48372143100,48372143700,00000000600,a00,read
1,48372245600,48372246700,00000001100,a0c,brk
1,48372247800,48372248700,00000000900,a00,read
1,48372451000,48372451400,00000000400,a00,read
1,48372533900,48372534400,00000000500,a00,read
1,48372598000,48372598600,00000000600,a00,read
1,48372727300,48372727800,00000000500,a00,read
1,48372759800,48372760400,00000000600,a00,read
1,48372776700,48372778000,00000001300,a02,open
1,48372889600,48372890000,00000000400,a00,read
1,48372960400,48372960800,00000000400,a00,read
1,48373013100,48373014200,00000001100,a0c,brk
1,48373021800,48373022500,00000000700,a00,read
1,48373129600,48373130300,00000000700,a00,read
1,48373280300,48373281200,00000000900,a00,read
1,48373410800,48373411600,00000000800,a00,read
1,48373468800,48373469400,00000000600,a00,read
1,48373525100,48373525800,00000000700,a00,read
1,48373595300,48373596000,00000000700,a00,read
1,48373648400,48373649100,00000000700,a00,read
1,48373736600,48373737200,00000000600,a0c,brk
1,48373768900,48373772900,00000004000,a0c,brk
1,48373786800,48373787700,00000000900,a00,read
1,48373901700,48373902500,00000000800,a00,read
1,48374061200,48374061900,00000000700,a00,read
1,48374179200,48374180000,00000000800,a00,read
1,48374325000,48374325700,00000000700,a00,read
1,48374441900,48374442600,00000000700,a00,read
1,48374604400,48374605000,00000000600,a00,read
1,48374609800,48374610500,00000000700,a0c,brk
1,48374726400,48374727000,00000000600,a00,read
1,48374844200,48374844900,00000000700,a00,read
1,48374986100,48374986800,00000000700,a00,read
1,48375117700,48375118300,00000000600,a00,read
1,48375210900,48375211500,00000000600,a00,read
1,48375323200,48375323800,00000000600,a00,read
1,48364160500,48375563300,00011402800,a4a,fsync
1,48375625400,48375630200,00000004800,a09,mmap
1,48365907800,48375707800,00009800000,a07,poll
1,48375712000,48375713900,00000001900,aca,futex
1,48375718100,48375718900,00000000800,aca,futex
1,48375721000,48375722000,00000001000,aca,futex
1,48375742400,48375742600,00000000200,a00,read
1,48364651200,48375751200,00011100000,ae8,epoll_wait
1,48375779900,48375780100,00000000200,a2f,recvmsg
1,48375799300,48375804200,00000004900,a2e,sendmsg
1,48375747500,48375863100,00000115600,a07,poll
1,48375864800,48375865700,00000000900,aca,futex
1,48375867400,48375868300,00000000900,aca,futex
1,48375869600,48375870400,00000000800,aca,futex
1,48375872800,48375875000,00000002200,a2e,sendmsg
1,48375807500,48375882600,00000075100,ae8,epoll_wait
1,48375885200,48375886300,00000001100,a2f,recvmsg
1,48375894500,48375894700,00000000200,a2f,recvmsg
1,48375917200,48375918200,00000001000,a2e,sendmsg
1,48376077300,48376086700,00000009400,a01,write
1,48375938100,48379335900,00003397800,a07,poll
1,48379438200,48379440800,00000002600,a01,write
1,48375920300,48379454600,00003534300,ae8,epoll_wait
1,48379459400,48379461500,00000002100,a2f,recvmsg
1,48379470800,48379471000,00000000200,a2f,recvmsg
1,48379484800,48379488000,00000003200,a2e,sendmsg
1,48379443800,48379489900,00000046100,a07,poll
1,48379490500,48379491000,00000000500,a00,read
1,48379499600,48379500300,00000000700,a2f,recvmsg
1,48379708900,48379710900,00000002000,a00,read
1,48379827500,48379830200,00000002700,a0c,brk
1,48379852500,48379853300,00000000800,a00,read
1,48380024100,48380024900,00000000800,a00,read
1,48380175900,48380176400,00000000500,a00,read
1,48380286200,48380286900,00000000700,a00,read
1,48380476000,48380477000,00000001000,a00,read
1,48380554200,48380554800,00000000600,a00,read
1,48380635900,48380636800,00000000900,a00,read
1,48380703500,48380704300,00000000800,a0c,brk
1,48380718500,48380719200,00000000700,a00,read
1,48380791300,48380791900,00000000600,a00,read
1,48380891800,48380892400,00000000600,a00,read
1,48380995000,48380995700,00000000700,a00,read
1,48381085100,48381085700,00000000600,a00,read
1,48381165400,48381166000,00000000600,a00,read
1,48381269100,48381269800,00000000700,a00,read
1,48381350200,48381350600,00000000400,a0c,brk
1,48381353100,48381353800,00000000700,a00,read
1,48381459400,48381460200,00000000800,a00,read
1,48381552800,48381553500,00000000700,a00,read
1,48381671600,48381672300,00000000700,a00,read
1,48381784500,48381785200,00000000700,a00,read
1,48381889800,48381890300,00000000500,a00,read
1,48381990900,48381991300,00000000400,a0c,brk
1,48382356500,48382359200,00000002700,a57,unlink
1,48382378700,48382379200,00000000500,a48,fcntl
1,48382431000,48382441000,00000010000,a01,write
1,48382458800,48382461400,00000002600,a01,write
1,48382477900,48382480200,00000002300,a01,write
1,48340086400,48382647000,00042560600,a3d,wait4
1,48382663300,48382664700,00000001400,a00,read
1,48382666700,48382667000,00000000300,a00,read
1,48382675700,48382682200,00000006500,a14,writev
1,48382684400,48387109200,00004424800,a07,poll
1,48382684400,48387112700,00004428300,a07,poll
1,48387126500,48387126700,00000000200,a2f,recvmsg
1,48387131000,48387131200,00000000200,a2f,recvmsg
1,48387131400,48387131600,00000000200,a2f,recvmsg
1,48387136400,48387136600,00000000200,a2f,recvmsg
1,48387136800,48387137000,00000000200,a2f,recvmsg
1,48387151000,48387151300,00000000300,a2f,recvmsg
1,48387184500,48387187100,00000002600,a07,poll
1,48387189800,48387190000,00000000200,a2f,recvmsg
1,48387190800,48387190900,00000000100,a2f,recvmsg
1,48387191100,48387191300,00000000200,a2f,recvmsg
1,48387192200,48387192300,00000000100,a2f,recvmsg
1,48387192500,48387192700,00000000200,a2f,recvmsg
1,48387195600,48387244900,00000049300,a07,poll
1,48387245100,48387246200,00000001100,a2f,recvmsg
1,48387195600,48387247400,00000051800,a07,poll
1,48387249000,48387249200,00000000200,a2f,recvmsg
1,48387249700,48387249800,00000000100,a2f,recvmsg
1,48387250000,48387250100,00000000100,a2f,recvmsg
1,48387250700,48387250800,00000000100,a2f,recvmsg
1,48387251000,48387251200,00000000200,a2f,recvmsg
1,48387252900,48387301800,00000048900,a07,poll
1,48387302100,48387303100,00000001000,a2f,recvmsg
1,48387252900,48387304300,00000051400,a07,poll
1,48387305800,48387306000,00000000200,a2f,recvmsg
1,48387306500,48387306700,00000000200,a2f,recvmsg
1,48387306800,48387306900,00000000100,a2f,recvmsg
1,48387307500,48387307700,00000000200,a2f,recvmsg
1,48387307800,48387308000,00000000200,a2f,recvmsg
1,48387309700,48387329500,00000019800,a07,poll
1,48387334000,48387334300,00000000300,a2f,recvmsg
1,48387335000,48387335200,00000000200,a2f,recvmsg
1,48387338300,48387340300,00000002000,a14,writev
1,48387340700,48387350200,00000009500,a07,poll
1,48387351600,48387351800,00000000200,a2f,recvmsg
1,48387352200,48387352300,00000000100,a2f,recvmsg
1,48387354200,48387355800,00000001600,a14,writev
1,48387356100,48387358100,00000002000,a07,poll
1,48387358200,48387359300,00000001100,a2f,recvmsg
1,48387356100,48387360300,00000004200,a07,poll
1,48387362000,48387362200,00000000200,a2f,recvmsg
1,48387362700,48387362900,00000000200,a2f,recvmsg
1,48387363100,48387363200,00000000100,a2f,recvmsg
1,48387356100,48387363800,00000007700,a07,poll
1,48387363800,48387363800,00000000000,a2f,recvmsg
1,48387364000,48387364200,00000000200,a2f,recvmsg
1,48387365000,48387365200,00000000200,a2f,recvmsg
1,48387365600,48387365700,00000000100,a2f,recvmsg
1,48387367400,48387368900,00000001500,a14,writev
1,48387369300,48387377100,00000007800,a07,poll
1,48387378400,48387378600,00000000200,a2f,recvmsg
1,48387378900,48387379000,00000000100,a2f,recvmsg
1,48387380600,48387382100,00000001500,a14,writev
1,48387382500,48387390400,00000007900,a07,poll
1,48387391800,48387392000,00000000200,a2f,recvmsg
1,48387392300,48387392400,00000000100,a2f,recvmsg
1,48387393500,48387395200,00000001700,a14,writev
1,48387395500,48387403000,00000007500,a07,poll
1,48387404200,48387404400,00000000200,a2f,recvmsg
1,48387404900,48387405100,00000000200,a2f,recvmsg
1,48387406400,48387406600,00000000200,a08,lseek
1,48387395500,48387415300,00000019800,a07,poll
1,48387395500,48387417300,00000021800,a07,poll
1,48387417900,48387418000,00000000100,a08,lseek
1,48387419000,48387419100,00000000100,a2f,recvmsg
1,48387419700,48387419800,00000000100,a2f,recvmsg
1,48387420000,48387420200,00000000200,a2f,recvmsg
1,48387419000,48387420700,00000001700,a14,writev
1,48387420700,48387420800,00000000100,a2f,recvmsg
1,48387421000,48387421200,00000000200,a2f,recvmsg
1,48387421000,48387422800,00000001800,a2f,recvmsg
1,48387424000,48387428400,00000004400,a07,poll
1,48387429800,48387430000,00000000200,a2f,recvmsg
1,48387430300,48387430400,00000000100,a2f,recvmsg
1,48387433800,48387435400,00000001600,a14,writev
1,48387435800,48387443200,00000007400,a07,poll
1,48387444400,48387444600,00000000200,a2f,recvmsg
1,48387444900,48387445100,00000000200,a2f,recvmsg
1,48387446700,48387448200,00000001500,a14,writev
1,48387448600,48387455900,00000007300,a07,poll
1,48387457100,48387457300,00000000200,a2f,recvmsg
1,48387457600,48387457800,00000000200,a2f,recvmsg
1,48387459500,48387461000,00000001500,a14,writev
1,48387461700,48387468500,00000006800,a07,poll
1,48387470000,48387470200,00000000200,a2f,recvmsg
1,48387470400,48387470600,00000000200,a2f,recvmsg
1,48387461700,48387471700,00000010000,a07,poll
1,48387472300,48387474000,00000001700,a14,writev
1,48387474300,48387481600,00000007300,a07,poll
1,48387483000,48387483200,00000000200,a2f,recvmsg
1,48387483500,48387483600,00000000100,a2f,recvmsg
1,48387485500,48387487100,00000001600,a14,writev
1,48387487400,48387494800,00000007400,a07,poll
1,48387496200,48387496400,00000000200,a2f,recvmsg
1,48387496700,48387496800,00000000100,a2f,recvmsg
1,48387498600,48387500200,00000001600,a14,writev
1,48387500500,48387507900,00000007400,a07,poll
1,48387509200,48387509400,00000000200,a2f,recvmsg
1,48387509700,48387509900,00000000200,a2f,recvmsg
1,48387511300,48387512800,00000001500,a14,writev
1,48387513200,48387515700,00000002500,a07,poll
1,48387516800,48387520400,00000003600,a07,poll
1,48387521700,48387521900,00000000200,a2f,recvmsg
1,48387522200,48387522400,00000000200,a2f,recvmsg
1,48387525300,48387526800,00000001500,a14,writev
1,48387527200,48387534700,00000007500,a07,poll
1,48387536000,48387536200,00000000200,a2f,recvmsg
1,48387536500,48387536700,00000000200,a2f,recvmsg
1,48387538500,48387540200,00000001700,a14,writev
1,48387542400,48387547900,00000005500,a07,poll
1,48387549200,48387549400,00000000200,a2f,recvmsg
1,48387549700,48387549900,00000000200,a2f,recvmsg
1,48387551600,48387553100,00000001500,a14,writev
1,48387553500,48387559700,00000006200,a07,poll
1,48387553500,48387560800,00000007300,a07,poll
1,48387562100,48387562300,00000000200,a2f,recvmsg
1,48387562600,48387562800,00000000200,a2f,recvmsg
1,48387564400,48387565900,00000001500,a14,writev
1,48387566300,48387573800,00000007500,a07,poll
1,48387575100,48387575300,00000000200,a2f,recvmsg
1,48387575600,48387575800,00000000200,a2f,recvmsg
1,48387577400,48387578900,00000001500,a14,writev
1,48387579300,48387586500,00000007200,a07,poll
1,48387587800,48387588000,00000000200,a2f,recvmsg
1,48387588200,48387588400,00000000200,a2f,recvmsg
1,48387590200,48387591800,00000001600,a14,writev
1,48387592100,48387599400,00000007300,a07,poll
1,48387600800,48387601000,00000000200,a2f,recvmsg
1,48387601300,48387601400,00000000100,a2f,recvmsg
1,48387602800,48387602900,00000000100,a07,poll
1,48387603100,48387604700,00000001600,a14,writev
1,48387605100,48387612400,00000007300,a07,poll
1,48387613600,48387613800,00000000200,a2f,recvmsg
1,48387614100,48387614300,00000000200,a2f,recvmsg
1,48387615400,48387616900,00000001500,a14,writev
1,48387617300,48387624700,00000007400,a07,poll
1,48387626000,48387626100,00000000100,a2f,recvmsg
1,48387626400,48387626600,00000000200,a2f,recvmsg
1,48387629800,48387631400,00000001600,a14,writev
1,48387631700,48387638900,00000007200,a07,poll
1,48387640200,48387640400,00000000200,a2f,recvmsg
1,48387640700,48387640900,00000000200,a2f,recvmsg
1,48387642000,48387643600,00000001600,a14,writev
1,48387643900,48387644200,00000000300,a07,poll
1,48387645600,48387651800,00000006200,a07,poll
1,48387653000,48387653200,00000000200,a2f,recvmsg
1,48387653500,48387653700,00000000200,a2f,recvmsg
1,48387654800,48387656400,00000001600,a14,writev
1,48387656700,48387664000,00000007300,a07,poll
1,48387666300,48387666500,00000000200,a2f,recvmsg
1,48387666800,48387667000,00000000200,a2f,recvmsg
1,48387668100,48387669700,00000001600,a14,writev
1,48387670100,48387677400,00000007300,a07,poll
1,48387678800,48387679000,00000000200,a2f,recvmsg
1,48387679200,48387679400,00000000200,a2f,recvmsg
1,48387681000,48387682500,00000001500,a14,writev
1,48387682800,48387690200,00000007400,a07,poll
1,48387691500,48387691700,00000000200,a2f,recvmsg
1,48387692000,48387692200,00000000200,a2f,recvmsg
1,48387693500,48387695000,00000001500,a14,writev
1,48387695300,48387702600,00000007300,a07,poll
1,48387695300,48387704000,00000008700,a07,poll
1,48387703900,48387704100,00000000200,a2f,recvmsg
1,48387704400,48387704600,00000000200,a2f,recvmsg
1,48387706400,48387707900,00000001500,a14,writev
1,48387708300,48387715500,00000007200,a07,poll
1,48387716800,48387717000,00000000200,a2f,recvmsg
1,48387717200,48387717400,00000000200,a2f,recvmsg
1,48387719300,48387720900,00000001600,a14,writev
1,48387721100,48387728600,00000007500,a07,poll
1,48387729900,48387730100,00000000200,a2f,recvmsg
1,48387730400,48387730500,00000000100,a2f,recvmsg
1,48387732700,48387734400,00000001700,a14,writev
1,48387734700,48387742100,00000007400,a07,poll
1,48387743500,48387743600,00000000100,a2f,recvmsg
1,48387743900,48387744100,00000000200,a2f,recvmsg
1,48387746100,48387747700,00000001600,a14,writev
1,48387748000,48387755400,00000007400,a07,poll
1,48387756700,48387756900,00000000200,a2f,recvmsg
1,48387757100,48387757300,00000000200,a2f,recvmsg
1,48387748000,48387758400,00000010400,a07,poll
1,48387759300,48387760900,00000001600,a14,writev
1,48387761200,48387768600,00000007400,a07,poll
1,48387770000,48387770200,00000000200,a2f,recvmsg
1,48387770400,48387770600,00000000200,a2f,recvmsg
1,48387774600,48387776100,00000001500,a14,writev
1,48387776500,48387777100,00000000600,a07,poll
1,48387778200,48387783800,00000005600,a07,poll
1,48387785200,48387785300,00000000100,a2f,recvmsg
1,48387785600,48387785700,00000000100,a2f,recvmsg
1,48387787400,48387788900,00000001500,a14,writev
1,48387789200,48387793000,00000003800,a07,poll
1,48387795300,48387796400,00000001100,a07,poll
1,48387797700,48387797900,00000000200,a2f,recvmsg
1,48387798200,48387798400,00000000200,a2f,recvmsg
1,48387799800,48387801400,00000001600,a14,writev
1,48387801800,48387809100,00000007300,a07,poll
1,48387801800,48387809300,00000007500,a07,poll
1,48387810600,48387810800,00000000200,a2f,recvmsg
1,48387811100,48387811300,00000000200,a2f,recvmsg
1,48387813700,48387815200,00000001500,a14,writev
1,48387815500,48387822900,00000007400,a07,poll
1,48387815500,48387823700,00000008200,a07,poll
1,48387824200,48387824300,00000000100,a2f,recvmsg
1,48387824700,48387824900,00000000200,a2f,recvmsg
1,48387826800,48387828300,00000001500,a14,writev
1,48387828600,48387836000,00000007400,a07,poll
1,48387837300,48387837500,00000000200,a2f,recvmsg
1,48387828600,48387837800,00000009200,a07,poll
1,48387837800,48387838000,00000000200,a2f,recvmsg
1,48387840200,48387841800,00000001600,a14,writev
1,48387842100,48387849600,00000007500,a07,poll
1,48387850900,48387851100,00000000200,a2f,recvmsg
1,48387851400,48387851600,00000000200,a2f,recvmsg
1,48387853500,48387855100,00000001600,a14,writev
1,48387855400,48387862900,00000007500,a07,poll
1,48387855400,48387863100,00000007700,a07,poll
1,48387864400,48387864600,00000000200,a2f,recvmsg
1,48387864400,48387864900,00000000500,a2f,recvmsg
1,48387864900,48387865100,00000000200,a2f,recvmsg
1,48387866100,48387867800,00000001700,a2d,recvfrom
1,48387866600,48387868200,00000001600,a14,writev
1,48387871600,48387871800,00000000200,a2f,recvmsg
1,48387872400,48387872500,00000000100,a2f,recvmsg
1,48387868600,48387875800,00000007200,a07,poll
1,48387877100,48387877300,00000000200,a2f,recvmsg
1,48387877600,48387877800,00000000200,a2f,recvmsg
1,48387879100,48387880600,00000001500,a14,writev
1,48387881000,48387888400,00000007400,a07,poll
1,48387889700,48387889900,00000000200,a2f,recvmsg
1,48387890100,48387890300,00000000200,a2f,recvmsg
1,48387892100,48387893800,00000001700,a14,writev
1,48387894000,48387901500,00000007500,a07,poll
1,48387902800,48387903000,00000000200,a2f,recvmsg
1,48387903300,48387903400,00000000100,a2f,recvmsg
1,48387904600,48387904700,00000000100,a08,lseek
1,48387907200,48387910200,00000003000,a00,read
1,48387913900,48387914000,00000000100,a08,lseek
1,48387915100,48387916700,00000001600,a14,writev
1,48387917100,48387924300,00000007200,a07,poll
1,48387925900,48387926100,00000000200,a2f,recvmsg
1,48387926300,48387926500,00000000200,a2f,recvmsg
1,48387927500,48387927800,00000000300,a2f,recvmsg
1,48387930100,48387930300,00000000200,a2f,recvmsg
1,48387951800,48387953500,00000001700,a14,writev
1,48387953900,48387961200,00000007300,a07,poll
1,48387962700,48387962800,00000000100,a2f,recvmsg
1,48387963200,48387963400,00000000200,a2f,recvmsg
1,48387967400,48387968200,00000000800,a00,read
1,48387973700,48387973800,00000000100,a08,lseek
1,48387975300,48387977100,00000001800,a14,writev
1,48387977400,48387984700,00000007300,a07,poll
1,48387986100,48387986300,00000000200,a2f,recvmsg
1,48387986600,48387986800,00000000200,a2f,recvmsg
1,48387988000,48387989500,00000001500,a14,writev
1,48387989800,48387997100,00000007300,a07,poll
1,48387998400,48387998500,00000000100,a2f,recvmsg
1,48387998800,48387999000,00000000200,a2f,recvmsg
1,48388000200,48388001700,00000001500,a14,writev
1,48388002100,48388009500,00000007400,a07,poll
1,48388010800,48388011000,00000000200,a2f,recvmsg
1,48388011300,48388011500,00000000200,a2f,recvmsg
1,48388012600,48388014100,00000001500,a14,writev
1,48388014400,48388021700,00000007300,a07,poll
1,48388023100,48388023300,00000000200,a2f,recvmsg
1,48388023600,48388023800,00000000200,a2f,recvmsg
1,48388025000,48388026500,00000001500,a14,writev
1,48388026900,48388034100,00000007200,a07,poll
1,48388035300,48388035500,00000000200,a2f,recvmsg
1,48388035800,48388036000,00000000200,a2f,recvmsg
1,48388037100,48388038700,00000001600,a14,writev
1,48388039000,48388046400,00000007400,a07,poll
1,48388047700,48388047800,00000000100,a2f,recvmsg
1,48388048100,48388048300,00000000200,a2f,recvmsg
1,48388049500,48388051000,00000001500,a14,writev
1,48388051400,48388058700,00000007300,a07,poll
1,48388060000,48388060100,00000000100,a2f,recvmsg
1,48388060400,48388060600,00000000200,a2f,recvmsg
1,48388062400,48388064000,00000001600,a14,writev
1,48388064300,48388071700,00000007400,a07,poll
1,48388073000,48388073100,00000000100,a2f,recvmsg
1,48388073500,48388073600,00000000100,a2f,recvmsg
1,48388074900,48388076400,00000001500,a14,writev
1,48388076700,48388084100,00000007400,a07,poll
1,48388085400,48388085600,00000000200,a2f,recvmsg
1,48388085800,48388086000,00000000200,a2f,recvmsg
1,48388086600,48388086700,00000000100,a08,lseek
1,48388089100,48388090600,00000001500,a14,writev
1,48388091000,48388098200,00000007200,a07,poll
1,48388099500,48388099700,00000000200,a2f,recvmsg
1,48388100000,48388100200,00000000200,a2f,recvmsg
1,48388103700,48388105400,00000001700,a14,writev
1,48388105700,48388113400,00000007700,a07,poll
1,48388114700,48388114900,00000000200,a2f,recvmsg
1,48388115200,48388115400,00000000200,a2f,recvmsg
1,48388117100,48388118600,00000001500,a14,writev
1,48388119000,48388126400,00000007400,a07,poll
1,48388127700,48388127900,00000000200,a2f,recvmsg
1,48388128200,48388128400,00000000200,a2f,recvmsg
1,48388129800,48388131400,00000001600,a14,writev
1,48388131800,48388138900,00000007100,a07,poll
1,48388140200,48388140400,00000000200,a2f,recvmsg
1,48388140700,48388140900,00000000200,a2f,recvmsg
1,48388142300,48388143800,00000001500,a14,writev
1,48388144100,48388151300,00000007200,a07,poll
1,48388152600,48388152800,00000000200,a2f,recvmsg
1,48388153100,48388153300,00000000200,a2f,recvmsg
1,48388154800,48388156300,00000001500,a14,writev
1,48388156700,48388164000,00000007300,a07,poll
1,48388165400,48388165600,00000000200,a2f,recvmsg
1,48388165800,48388166000,00000000200,a2f,recvmsg
1,48388167900,48388169600,00000001700,a14,writev
1,48388169900,48388177200,00000007300,a07,poll
1,48388178800,48388178900,00000000100,a2f,recvmsg
1,48388179200,48388179400,00000000200,a2f,recvmsg
1,48388180800,48388182500,00000001700,a14,writev
1,48388182700,48388190000,00000007300,a07,poll
1,48388191300,48388191500,00000000200,a2f,recvmsg
1,48388191800,48388192000,00000000200,a2f,recvmsg
1,48388193400,48388194900,00000001500,a14,writev
1,48388195300,48388202700,00000007400,a07,poll
1,48388204000,48388204100,00000000100,a2f,recvmsg
1,48388204400,48388204600,00000000200,a2f,recvmsg
1,48388206000,48388207600,00000001600,a14,writev
1,48388207900,48388215300,00000007400,a07,poll
1,48388216700,48388216900,00000000200,a2f,recvmsg
1,48388217100,48388217300,00000000200,a2f,recvmsg
1,48388218800,48388220300,00000001500,a14,writev
1,48388220600,48388228100,00000007500,a07,poll
1,48388229300,48388229500,00000000200,a2f,recvmsg
1,48388229800,48388230000,00000000200,a2f,recvmsg
1,48388231300,48388233000,00000001700,a14,writev
1,48388233300,48388240700,00000007400,a07,poll
1,48388241900,48388242100,00000000200,a2f,recvmsg
1,48388242400,48388242600,00000000200,a2f,recvmsg
1,48388244600,48388246100,00000001500,a14,writev
1,48388246400,48388254000,00000007600,a07,poll
1,48388255300,48388255400,00000000100,a2f,recvmsg
1,48388255800,48388255900,00000000100,a2f,recvmsg
1,48388257300,48388258800,00000001500,a14,writev
1,48388259200,48388266500,00000007300,a07,poll
1,48388267900,48388268100,00000000200,a2f,recvmsg
1,48388268300,48388268500,00000000200,a2f,recvmsg
1,48388269900,48388271400,00000001500,a14,writev
1,48388271700,48388279100,00000007400,a07,poll
1,48388280400,48388280600,00000000200,a2f,recvmsg
1,48388280900,48388281100,00000000200,a2f,recvmsg
1,48388282500,48388284000,00000001500,a14,writev
1,48388282200,48388284100,00000001900,a07,poll
1,48388287000,48388287100,00000000100,a2f,recvmsg
1,48388288000,48388288100,00000000100,a2f,recvmsg
1,48388288300,48388288500,00000000200,a2f,recvmsg
1,48388289300,48388289500,00000000200,a2f,recvmsg
1,48388289700,48388289900,00000000200,a2f,recvmsg
1,48388290200,48388291600,00000001400,a07,poll
1,48388292900,48388293000,00000000100,a2f,recvmsg
1,48388293300,48388293500,00000000200,a2f,recvmsg
1,48388300400,48388302000,00000001600,a14,writev
1,48388302400,48388309700,00000007300,a07,poll
1,48388310900,48388311100,00000000200,a2f,recvmsg
1,48388311400,48388311600,00000000200,a2f,recvmsg
1,48388313200,48388314800,00000001600,a14,writev
1,48388315100,48388322600,00000007500,a07,poll
1,48388323800,48388324000,00000000200,a2f,recvmsg
1,48388324300,48388324500,00000000200,a2f,recvmsg
1,48388326000,48388327500,00000001500,a14,writev
1,48388327800,48388335200,00000007400,a07,poll
1,48388336500,48388336600,00000000100,a2f,recvmsg
1,48388336900,48388337100,00000000200,a2f,recvmsg
1,48388338700,48388340400,00000001700,a14,writev
1,48388340600,48388347900,00000007300,a07,poll
1,48388349200,48388349300,00000000100,a2f,recvmsg
1,48388349700,48388349800,00000000100,a2f,recvmsg
1,48388351400,48388352900,00000001500,a14,writev
1,48388353200,48388360600,00000007400,a07,poll
1,48388361800,48388362000,00000000200,a2f,recvmsg
1,48388362300,48388362500,00000000200,a2f,recvmsg
1,48388406600,48388411000,00000004400,a14,writev
1,48388411700,48388514500,00000102800,a07,poll
1,48388411700,48388517900,00000106200,a07,poll
1,48388530700,48388530900,00000000200,a2f,recvmsg
1,48388535300,48388535500,00000000200,a2f,recvmsg
1,48388535800,48388535900,00000000100,a2f,recvmsg
1,48388540000,48388540200,00000000200,a2f,recvmsg
1,48388540400,48388540500,00000000100,a2f,recvmsg
1,48388554900,48388555100,00000000200,a2f,recvmsg
1,48388586700,48388597000,00000010300,a07,poll
1,48388597300,48388598600,00000001300,a2f,recvmsg
1,48388586700,48388600100,00000013400,a07,poll
1,48388603600,48388603800,00000000200,a2f,recvmsg
1,48388604600,48388604700,00000000100,a2f,recvmsg
1,48388604900,48388605100,00000000200,a2f,recvmsg
1,48388606100,48388606300,00000000200,a2f,recvmsg
1,48388606400,48388606500,00000000100,a2f,recvmsg
1,48388608700,48388661700,00000053000,a07,poll
1,48388661900,48388663100,00000001200,a2f,recvmsg
1,48388608700,48388664200,00000055500,a07,poll
1,48388666100,48388666300,00000000200,a2f,recvmsg
1,48388667000,48388667200,00000000200,a2f,recvmsg
1,48388667300,48388667500,00000000200,a2f,recvmsg
1,48388668000,48388668200,00000000200,a2f,recvmsg
1,48388668400,48388668500,00000000100,a2f,recvmsg
1,48388670300,48388722900,00000052600,a07,poll
1,48388723100,48388724200,00000001100,a2f,recvmsg
1,48388670300,48388725400,00000055100,a07,poll
1,48388727100,48388727300,00000000200,a2f,recvmsg
1,48388727800,48388728000,00000000200,a2f,recvmsg
1,48388728100,48388728300,00000000200,a2f,recvmsg
1,48388728800,48388729000,00000000200,a2f,recvmsg
1,48388729200,48388729300,00000000100,a2f,recvmsg
1,48388731200,48388784300,00000053100,a07,poll
1,48388784600,48388785700,00000001100,a2f,recvmsg
1,48388731200,48388786900,00000055700,a07,poll
1,48388788600,48388788800,00000000200,a2f,recvmsg
1,48388789200,48388789400,00000000200,a2f,recvmsg
1,48388789600,48388789700,00000000100,a2f,recvmsg
1,48388790300,48388790400,00000000100,a2f,recvmsg
1,48388790600,48388790700,00000000100,a2f,recvmsg
1,48388792500,48388846200,00000053700,a07,poll
1,48388792500,48388849000,00000056500,a07,poll
1,48388850700,48388850900,00000000200,a2f,recvmsg
1,48388851400,48388851500,00000000100,a2f,recvmsg
1,48388851700,48388851900,00000000200,a2f,recvmsg
1,48388852400,48388852600,00000000200,a2f,recvmsg
1,48388852800,48388852900,00000000100,a2f,recvmsg
1,48388855000,48388905000,00000050000,a07,poll
1,48388906600,48388950500,00000043900,a07,poll
1,48388951800,48388995200,00000043400,a07,poll
1,48388997100,48389039300,00000042200,a07,poll
1,48389040600,48389083500,00000042900,a07,poll
1,48389084800,48389127800,00000043000,a07,poll
1,48389129100,48389180500,00000051400,a07,poll
1,48389181700,48389198500,00000016800,a07,poll
1,48389199800,48389215000,00000015200,a07,poll
1,48389216700,48389231100,00000014400,a07,poll
1,48389232400,48389245100,00000012700,a07,poll
1,48389246400,48389258900,00000012500,a07,poll
1,48389260000,48389264300,00000004300,a07,poll
1,48389266800,48389266900,00000000100,a2f,recvmsg
1,48389267600,48389267700,00000000100,a2f,recvmsg
1,48389289600,48389291200,00000001600,a07,poll
1,48389291600,48389293000,00000001400,a2f,recvmsg
1,48389294300,48389295600,00000001300,a2d,recvfrom
1,48389289600,48389300500,00000010900,a07,poll
1,48389303300,48389303500,00000000200,a2f,recvmsg
1,48389304400,48389304600,00000000200,a2f,recvmsg
1,48389304800,48389304900,00000000100,a2f,recvmsg
1,48389305800,48389305900,00000000100,a2f,recvmsg
1,48389306100,48389306300,00000000200,a2f,recvmsg
1,48389309500,48389309700,00000000200,a2f,recvmsg
1,48389310300,48389310500,00000000200,a2f,recvmsg
1,48389367300,48389367600,00000000300,a2f,recvmsg
1,48389370000,48389370200,00000000200,a2f,recvmsg
1,48389372800,48389376200,00000003400,a07,poll
1,48389378400,48389378600,00000000200,a2f,recvmsg
1,48389379200,48389379400,00000000200,a2f,recvmsg
1,48389835400,48389840100,00000004700,a09,mmap
1,48390005000,48390010300,00000005300,a01,write
1,48379567100,48390342400,00010775300,ae8,epoll_wait
1,48390352600,48390354500,00000001900,a2f,recvmsg
1,48390377700,48390377900,00000000200,a2f,recvmsg
1,48390401200,48390405300,00000004100,a2e,sendmsg
1,48390412600,48390413400,00000000800,a2e,sendmsg
1,48390075900,48390420300,00000344400,a07,poll
1,48390422300,48390423300,00000001000,a00,read
1,48390439900,48390440900,00000001000,a2f,recvmsg
1,48390521600,48390522400,00000000800,a2f,recvmsg
1,48390525000,48390525100,00000000100,a00,read
1,48390575200,48390579700,00000004500,a07,poll
1,48391067000,48391069300,00000002300,a2f,recvmsg
1,48391079000,48391079300,00000000300,a2f,recvmsg
1,48376091100,48400894000,00024802900,a4a,fsync
1,48400955900,48400961500,00000005600,a09,mmap
1,48391079900,48401038600,00009958700,a07,poll
1,48401043600,48401045400,00000001800,aca,futex
1,48401049400,48401050200,00000000800,aca,futex
1,48401052500,48401053400,00000000900,aca,futex
1,48401073700,48401073900,00000000200,a00,read
1,48390415500,48401082600,00010667100,ae8,epoll_wait
1,48401110500,48401110700,00000000200,a2f,recvmsg
1,48401078700,48401190400,00000111700,a07,poll
1,48401192000,48401193000,00000001000,aca,futex
1,48401194700,48401195600,00000000900,aca,futex
1,48401196800,48401197600,00000000800,aca,futex
1,48401200000,48401201800,00000001800,a2e,sendmsg
1,48401136800,48401209100,00000072300,ae8,epoll_wait
1,48401211600,48401212700,00000001100,a2f,recvmsg
1,48401220600,48401220800,00000000200,a2f,recvmsg
1,48401242000,48401243100,00000001100,a2e,sendmsg
1,48401403900,48401413100,00000009200,a01,write
1,48401262200,48403808300,00002546100,a07,poll
1,48403836400,48403839200,00000002800,aca,futex
1,48403865300,48403865600,00000000300,a00,read
1,48403866600,48403866900,00000000300,aca,futex
1,48403910100,48403912000,00000001900,a01,write
1,48401245200,48403934700,00002689500,ae8,epoll_wait
1,48403939800,48403942000,00000002200,a2f,recvmsg
1,48403951500,48403951700,00000000200,a2f,recvmsg
1,48403965200,48403968400,00000003200,a2e,sendmsg
1,48403930600,48403970100,00000039500,a07,poll
1,48403970900,48403971200,00000000300,a00,read
1,48403979600,48403980300,00000000700,a2f,recvmsg
1,48404038300,48404809500,00000771200,a07,poll
1,48404038300,48404812800,00000774500,a07,poll
1,48404825700,48404826000,00000000300,a2f,recvmsg
1,48404831200,48404831300,00000000100,a2f,recvmsg
1,48404831700,48404831800,00000000100,a2f,recvmsg
1,48404837200,48404837400,00000000200,a2f,recvmsg
1,48404837600,48404837700,00000000100,a2f,recvmsg
1,48404852400,48404852600,00000000200,a2f,recvmsg
1,48404886400,48404891300,00000004900,a07,poll
1,48404893800,48404894000,00000000200,a2f,recvmsg
1,48404894900,48404895100,00000000200,a2f,recvmsg
1,48404895200,48404895400,00000000200,a2f,recvmsg
1,48404896500,48404896600,00000000100,a2f,recvmsg
1,48404896800,48404897000,00000000200,a2f,recvmsg
1,48404888400,48404900000,00000011600,a14,writev
1,48404901200,48404964600,00000063400,a07,poll
1,48404968000,48404968100,00000000100,a2f,recvmsg
1,48404968700,48404968900,00000000200,a2f,recvmsg
1,48404969100,48404969200,00000000100,a2f,recvmsg
1,48404969800,48404970000,00000000200,a2f,recvmsg
1,48404970200,48404970400,00000000200,a2f,recvmsg
1,48404970600,48404972000,00000001400,a07,poll
1,48404973500,48405007100,00000033600,a07,poll
1,48405007200,48405008400,00000001200,a2f,recvmsg
1,48404973500,48405009500,00000036000,a07,poll
1,48405011800,48405012000,00000000200,a2f,recvmsg
1,48405012500,48405012700,00000000200,a2f,recvmsg
1,48405012900,48405013000,00000000100,a2f,recvmsg
1,48405013600,48405013800,00000000200,a2f,recvmsg
1,48405014000,48405014100,00000000100,a2f,recvmsg
1,48405016100,48405072100,00000056000,a07,poll
1,48405073900,48405074200,00000000300,a2f,recvmsg
1,48405074700,48405074900,00000000200,a2f,recvmsg
1,48405075100,48405075300,00000000200,a2f,recvmsg
1,48405075700,48405075900,00000000200,a2f,recvmsg
1,48405076100,48405076300,00000000200,a2f,recvmsg
1,48405076500,48405077800,00000001300,a07,poll
1,48405079200,48405121800,00000042600,a07,poll
1,48405122000,48405123100,00000001100,a2f,recvmsg
1,48405079200,48405124300,00000045100,a07,poll
1,48405126000,48405126200,00000000200,a2f,recvmsg
1,48405126700,48405126800,00000000100,a2f,recvmsg
1,48405126900,48405127100,00000000200,a2f,recvmsg
1,48405127600,48405127800,00000000200,a2f,recvmsg
1,48405128000,48405128200,00000000200,a2f,recvmsg
1,48405129900,48405176900,00000047000,a07,poll
1,48405178200,48405221300,00000043100,a07,poll
1,48405222400,48405264900,00000042500,a07,poll
1,48405267200,48405309000,00000041800,a07,poll
1,48405310200,48405351700,00000041500,a07,poll
1,48405352900,48405395700,00000042800,a07,poll
1,48405396800,48405450400,00000053600,a07,poll
1,48405451600,48405468500,00000016900,a07,poll
1,48405470200,48405484500,00000014300,a07,poll
1,48405485900,48405499600,00000013700,a07,poll
1,48405500900,48405513700,00000012800,a07,poll
1,48405514900,48405529000,00000014100,a07,poll
1,48405530300,48405555600,00000025300,a07,poll
1,48405555900,48405557300,00000001400,a2f,recvmsg
1,48405559000,48405560500,00000001500,a2d,recvfrom
1,48405564600,48405564800,00000000200,a2f,recvmsg
1,48405565300,48405565500,00000000200,a2f,recvmsg
1,48405622800,48405623000,00000000200,a2f,recvmsg
1,48405625400,48405625600,00000000200,a2f,recvmsg
1,48405628300,48405983500,00000355200,a07,poll
1,48405986500,48405986700,00000000200,a2f,recvmsg
1,48405987500,48405987600,00000000100,a2f,recvmsg
1,48405987800,48405988000,00000000200,a2f,recvmsg
1,48405988800,48405989000,00000000200,a2f,recvmsg
1,48405989200,48405989400,00000000200,a2f,recvmsg
1,48405989600,48406936700,00000947100,a07,poll
1,48405989600,48406939900,00000950300,a07,poll
1,48406952900,48406953200,00000000300,a2f,recvmsg
1,48406957000,48406957200,00000000200,a2f,recvmsg
1,48406957400,48406957600,00000000200,a2f,recvmsg
1,48406961200,48406961400,00000000200,a2f,recvmsg
1,48406961500,48406961700,00000000200,a2f,recvmsg
1,48406966000,48406966400,00000000400,a00,read
1,48406976600,48406976800,00000000200,a2f,recvmsg
1,48407011000,48407012100,00000001100,a2f,recvmsg
1,48407010600,48407013600,00000003000,a07,poll
1,48407016300,48407016500,00000000200,a2f,recvmsg
1,48407017400,48407017400,00000000000,a2f,recvmsg
1,48407017600,48407017800,00000000200,a2f,recvmsg
1,48407018700,48407018900,00000000200,a2f,recvmsg
1,48407019100,48407019300,00000000200,a2f,recvmsg
1,48407021400,48407068700,00000047300,a07,poll
1,48407069000,48407070100,00000001100,a2f,recvmsg
1,48407021400,48407071100,00000049700,a07,poll
1,48407072800,48407073000,00000000200,a2f,recvmsg
1,48407073500,48407073700,00000000200,a2f,recvmsg
1,48407073800,48407074000,00000000200,a2f,recvmsg
1,48407074500,48407074600,00000000100,a2f,recvmsg
1,48407074800,48407075000,00000000200,a2f,recvmsg
1,48407076700,48407126900,00000050200,a07,poll
1,48407127100,48407128100,00000001000,a2f,recvmsg
1,48407076700,48407129300,00000052600,a07,poll
1,48407131800,48407131900,00000000100,a2f,recvmsg
1,48407132500,48407132600,00000000100,a2f,recvmsg
1,48407132800,48407133000,00000000200,a2f,recvmsg
1,48407133400,48407133600,00000000200,a2f,recvmsg
1,48407133800,48407134000,00000000200,a2f,recvmsg
1,48407135600,48407184500,00000048900,a07,poll
1,48407184700,48407185900,00000001200,a2f,recvmsg
1,48407135600,48407187000,00000051400,a07,poll
1,48407188700,48407188900,00000000200,a2f,recvmsg
1,48407189400,48407189600,00000000200,a2f,recvmsg
1,48407189700,48407189900,00000000200,a2f,recvmsg
1,48407190300,48407190500,00000000200,a2f,recvmsg
1,48407190700,48407190900,00000000200,a2f,recvmsg
1,48404047300,48408051500,00004004200,ae8,epoll_wait
1,48408063100,48408065100,00000002000,a2f,recvmsg
1,48408089300,48408089600,00000000300,a2f,recvmsg
1,48408113000,48408117100,00000004100,a2e,sendmsg
1,48408124200,48408125400,00000001200,a2e,sendmsg
1,48407192600,48408132700,00000940100,a07,poll
1,48408134600,48408135400,00000000800,a00,read
1,48408152900,48408154100,00000001200,a2f,recvmsg
1,48408233900,48408234800,00000000900,a2f,recvmsg
1,48408237200,48408237400,00000000200,a00,read
1,48408287900,48408292300,00000004400,a07,poll
1,48408780000,48408781700,00000001700,a2f,recvmsg
1,48408791100,48408791300,00000000200,a2f,recvmsg
1,48415852200,48415852300,00000000100,a0c,brk
1,48415861900,48415864900,00000003000,a15,access
1,48415865600,48415866500,00000000900,a09,mmap
1,48415871500,48415873600,00000002100,a15,access
1,48415881300,48415882400,00000001100,a09,mmap
1,48415886200,48415886700,00000000500,a15,access
1,48415894200,48415895300,00000001100,a00,read
1,48415896800,48415898400,00000001600,a09,mmap
1,48415902400,48415904700,00000002300,a09,mmap
1,48415916500,48415917100,00000000600,a15,access
1,48415920800,48415921400,00000000600,a00,read
1,48415922200,48415923000,00000000800,a09,mmap
1,48415925400,48415926700,00000001300,a09,mmap
1,48415934700,48415935300,00000000600,a15,access
1,48415937900,48415938600,00000000700,a00,read
1,48415939300,48415940100,00000000800,a09,mmap
1,48415941700,48415944100,00000002400,a09,mmap
1,48415948300,48415951600,00000003300,a09,mmap
1,48415953900,48415955000,00000001100,a09,mmap
1,48415963800,48415964500,00000000700,a15,access
1,48415967000,48415967700,00000000700,a00,read
1,48415968400,48415970100,00000001700,a09,mmap
1,48415972800,48415974400,00000001600,a09,mmap
1,48415982700,48415983200,00000000500,a15,access
1,48415986000,48415986600,00000000600,a00,read
1,48415992700,48415994900,00000002200,a09,mmap
1,48416003300,48416003900,00000000600,a15,access
1,48416006300,48416006800,00000000500,a00,read
1,48416007300,48416008200,00000000900,a09,mmap
1,48416009500,48416010800,00000001300,a09,mmap
1,48416013500,48416014700,00000001200,a09,mmap
1,48416021000,48416021600,00000000600,a15,access
1,48416023800,48416024300,00000000500,a00,read
1,48416025000,48416026100,00000001100,a09,mmap
1,48416028300,48416030100,00000001800,a09,mmap
1,48416043500,48416044100,00000000600,a09,mmap
1,48416047800,48416048100,00000000300,a09,mmap
1,48416049100,48416049400,00000000300,a09,mmap
1,48416228100,48416228200,00000000100,a0c,brk
1,48416228300,48416229000,00000000700,a0c,brk
1,48416263100,48416269600,00000006500,a00,read
1,48416281800,48416283400,00000001600,a00,read
1,48416317600,48416318700,00000001100,a00,read
1,48416439600,48416440400,00000000800,a00,read
1,48416512000,48416512500,00000000500,a00,read
1,48416597700,48416598400,00000000700,a00,read
1,48416729200,48416730100,00000000900,a00,read
1,48416861900,48416862600,00000000700,a00,read
1,48417022400,48417023000,00000000600,a00,read
1,48417176700,48417177400,00000000700,a00,read
1,48417334700,48417335500,00000000800,a00,read
1,48417486900,48417487600,00000000700,a00,read
1,48417645700,48417646400,00000000700,a00,read
1,48417809400,48417810300,00000000900,a00,read
1,48417920300,48417921200,00000000900,a00,read
1,48417952300,48417953000,00000000700,a0c,brk
1,48418065100,48418065800,00000000700,a00,read
1,48418310800,48418311300,00000000500,a00,read
1,48418323500,48418324000,00000000500,a00,read
1,48418368500,48418368900,00000000400,a00,read
1,48418388700,48418389400,00000000700,a00,read
1,48418596800,48418597400,00000000600,a00,read
1,48418627200,48418628100,00000000900,a00,read
1,48418725000,48418725700,00000000700,a00,read
1,48418749500,48418750700,00000001200,a0c,brk
1,48418795900,48418796400,00000000500,a00,read
1,48418874700,48418875800,00000001100,a00,read
0,48380025600,48366992000,-0013033600,a07,poll
0,48367123000,48367123800,00000000800,a2f,recvmsg
0,48367127000,48367127200,00000000200,a00,read
0,48367179800,48367415300,00000235500,a07,poll
0,48367415800,48367441400,00000025600,aca,futex
0,48367446800,48367450800,00000004000,a2e,sendmsg
0,48367453300,48367453500,00000000200,a00,read
0,48380020600,48372707900,-0007312700,a17,select
0,48372729500,48372729900,00000000400,a2f,recvmsg
0,48372732700,48377381700,00004649000,a17,select
0,48377384800,48377386600,00000001800,a14,writev
0,48377386900,48377387000,00000000100,a2f,recvmsg
0,48377387700,48377395900,00000008200,a17,select
0,48377398500,48377400100,00000001600,a14,writev
0,48377400400,48377400500,00000000100,a2f,recvmsg
0,48377401000,48377409000,00000008000,a17,select
0,48377411900,48377413400,00000001500,a14,writev
0,48377413700,48377413800,00000000100,a2f,recvmsg
0,48377414300,48377422300,00000008000,a17,select
0,48377425600,48377427000,00000001400,a14,writev
0,48377427300,48377427400,00000000100,a2f,recvmsg
0,48377427900,48377435300,00000007400,a17,select
0,48377437800,48377439300,00000001500,a14,writev
0,48377439500,48377439700,00000000200,a2f,recvmsg
0,48377440300,48377457700,00000017400,a17,select
0,48377460200,48377461800,00000001600,a14,writev
0,48377462000,48377462200,00000000200,a2f,recvmsg
0,48377462700,48377473100,00000010400,a17,select
0,48377475600,48377477200,00000001600,a14,writev
0,48377477400,48377477600,00000000200,a2f,recvmsg
0,48377478100,48377486300,00000008200,a17,select
0,48377488500,48377490000,00000001500,a14,writev
0,48377490200,48377490400,00000000200,a2f,recvmsg
0,48377490900,48377499500,00000008600,a17,select
0,48377501600,48377503200,00000001600,a14,writev
0,48377503400,48377503500,00000000100,a2f,recvmsg
0,48377504000,48377512400,00000008400,a17,select
0,48377514900,48377516300,00000001400,a14,writev
0,48377516500,48377516700,00000000200,a2f,recvmsg
0,48377517100,48377526400,00000009300,a17,select
0,48377528800,48377530200,00000001400,a14,writev
0,48377530500,48377530700,00000000200,a2f,recvmsg
0,48377531200,48377539500,00000008300,a17,select
0,48377542000,48377543400,00000001400,a14,writev
0,48377543700,48377543900,00000000200,a2f,recvmsg
0,48377544400,48377552200,00000007800,a17,select
0,48377554500,48377556000,00000001500,a14,writev
0,48377556300,48377556400,00000000100,a2f,recvmsg
0,48377556900,48377568100,00000011200,a17,select
0,48377570600,48377571900,00000001300,a14,writev
0,48377572200,48377572400,00000000200,a2f,recvmsg
0,48377572900,48377581200,00000008300,a17,select
0,48377583600,48377585200,00000001600,a14,writev
0,48377585400,48377585600,00000000200,a2f,recvmsg
0,48377586100,48377594900,00000008800,a17,select
0,48377597400,48377598800,00000001400,a14,writev
0,48377599100,48377599200,00000000100,a2f,recvmsg
0,48377599800,48377607900,00000008100,a17,select
0,48377610200,48377611800,00000001600,a14,writev
0,48377612000,48377612100,00000000100,a2f,recvmsg
0,48377612700,48377620800,00000008100,a17,select
0,48377623100,48377624500,00000001400,a14,writev
0,48377624700,48377624900,00000000200,a2f,recvmsg
0,48377625300,48377633600,00000008300,a17,select
0,48377636000,48377637500,00000001500,a14,writev
0,48377637800,48377637900,00000000100,a2f,recvmsg
0,48377638400,48377646500,00000008100,a17,select
0,48377649000,48377650400,00000001400,a14,writev
0,48377650700,48377650800,00000000100,a2f,recvmsg
0,48377651400,48377659000,00000007600,a17,select
0,48377661400,48377663000,00000001600,a14,writev
0,48377663200,48377663300,00000000100,a2f,recvmsg
0,48377663900,48377674200,00000010300,a17,select
0,48377676500,48377678100,00000001600,a14,writev
0,48377678300,48377678400,00000000100,a2f,recvmsg
0,48377678900,48377686600,00000007700,a17,select
0,48377689000,48377690500,00000001500,a14,writev
0,48377690700,48377690900,00000000200,a2f,recvmsg
0,48377691500,48377699100,00000007600,a17,select
0,48377701300,48377702800,00000001500,a14,writev
0,48377703000,48377703100,00000000100,a2f,recvmsg
0,48377703600,48377711200,00000007600,a17,select
0,48377713500,48377715000,00000001500,a14,writev
0,48377715200,48377715400,00000000200,a2f,recvmsg
0,48377715900,48377723900,00000008000,a17,select
0,48377726300,48377727700,00000001400,a14,writev
0,48377728000,48377728200,00000000200,a2f,recvmsg
0,48377728700,48377736400,00000007700,a17,select
0,48377738800,48377740200,00000001400,a14,writev
0,48377740500,48377740600,00000000100,a2f,recvmsg
0,48377741100,48377750300,00000009200,a17,select
0,48377752600,48377754100,00000001500,a14,writev
0,48377754300,48377754400,00000000100,a2f,recvmsg
0,48377754900,48377763200,00000008300,a17,select
0,48377765600,48377767000,00000001400,a14,writev
0,48377767300,48377767400,00000000100,a2f,recvmsg
0,48377767900,48377776900,00000009000,a17,select
0,48377779400,48377780900,00000001500,a14,writev
0,48377781100,48377781300,00000000200,a2f,recvmsg
0,48377781800,48377790200,00000008400,a17,select
0,48377792500,48377794000,00000001500,a14,writev
0,48377794200,48377794300,00000000100,a2f,recvmsg
0,48377794900,48377803300,00000008400,a17,select
0,48377805700,48377807200,00000001500,a14,writev
0,48377807400,48377807500,00000000100,a2f,recvmsg
0,48377808000,48377818200,00000010200,a17,select
0,48377820700,48377822200,00000001500,a14,writev
0,48377822400,48377822600,00000000200,a2f,recvmsg
0,48377823000,48377831200,00000008200,a17,select
0,48377833500,48377834900,00000001400,a14,writev
0,48377835200,48377835400,00000000200,a2f,recvmsg
0,48377835900,48377843800,00000007900,a17,select
0,48377846300,48377847700,00000001400,a14,writev
0,48377848000,48377848100,00000000100,a2f,recvmsg
0,48377848700,48377857500,00000008800,a17,select
0,48377859900,48377861300,00000001400,a14,writev
0,48377861600,48377861700,00000000100,a2f,recvmsg
0,48377862300,48377871400,00000009100,a17,select
0,48377873900,48377875400,00000001500,a14,writev
0,48377875700,48377875800,00000000100,a2f,recvmsg
0,48377876300,48377885300,00000009000,a17,select
0,48377887700,48377889200,00000001500,a14,writev
0,48377889400,48377889500,00000000100,a2f,recvmsg
0,48377890100,48377898700,00000008600,a17,select
0,48377901000,48377902500,00000001500,a14,writev
0,48377902700,48377902800,00000000100,a2f,recvmsg
0,48377903400,48377911500,00000008100,a17,select
0,48377913900,48377915400,00000001500,a14,writev
0,48377915600,48377915800,00000000200,a2f,recvmsg
0,48377916300,48377924000,00000007700,a17,select
0,48377926400,48377927900,00000001500,a14,writev
0,48377928100,48377928300,00000000200,a2f,recvmsg
0,48377928800,48377937300,00000008500,a17,select
0,48377939700,48377941100,00000001400,a14,writev
0,48377941300,48377941500,00000000200,a2f,recvmsg
0,48377942000,48377960400,00000018400,a17,select
0,48377962800,48377964300,00000001500,a14,writev
0,48377964500,48377964700,00000000200,a2f,recvmsg
0,48377965200,48377995600,00000030400,a17,select
0,48377998000,48377999400,00000001400,a14,writev
0,48377999600,48377999800,00000000200,a2f,recvmsg
0,48378000300,48378018700,00000018400,a17,select
0,48378021200,48378022600,00000001400,a14,writev
0,48378022900,48378023000,00000000100,a2f,recvmsg
0,48378023600,48378031500,00000007900,a17,select
0,48378033800,48378035300,00000001500,a14,writev
0,48378035500,48378035600,00000000100,a2f,recvmsg
0,48378036200,48378043800,00000007600,a17,select
0,48378046100,48378047600,00000001500,a14,writev
0,48378047800,48378048000,00000000200,a2f,recvmsg
0,48378048500,48378056200,00000007700,a17,select
0,48378058400,48378059900,00000001500,a14,writev
0,48378060100,48378060200,00000000100,a2f,recvmsg
0,48378060700,48378068400,00000007700,a17,select
0,48378070900,48378072300,00000001400,a14,writev
0,48378072600,48378072700,00000000100,a2f,recvmsg
0,48378073300,48378081100,00000007800,a17,select
0,48378083300,48378084800,00000001500,a14,writev
0,48378084900,48378085100,00000000200,a2f,recvmsg
0,48378085600,48378093200,00000007600,a17,select
0,48378095500,48378097000,00000001500,a14,writev
0,48378097200,48378097400,00000000200,a2f,recvmsg
0,48378098000,48378106300,00000008300,a17,select
0,48378108900,48378110400,00000001500,a14,writev
0,48378110700,48378110900,00000000200,a2f,recvmsg
0,48378111400,48378119100,00000007700,a17,select
0,48378121400,48378122900,00000001500,a14,writev
0,48378123200,48378123300,00000000100,a2f,recvmsg
0,48378123900,48378133800,00000009900,a17,select
0,48378136100,48378137600,00000001500,a14,writev
0,48378137800,48378138000,00000000200,a2f,recvmsg
0,48378138400,48378148700,00000010300,a17,select
0,48378151200,48378152700,00000001500,a14,writev
0,48378152900,48378153100,00000000200,a2f,recvmsg
0,48378153600,48378161900,00000008300,a17,select
0,48378164200,48378165700,00000001500,a14,writev
0,48378165900,48378166100,00000000200,a2f,recvmsg
0,48378166600,48378174500,00000007900,a17,select
0,48378176800,48378178200,00000001400,a14,writev
0,48378178500,48378178600,00000000100,a2f,recvmsg
0,48378179200,48378187200,00000008000,a17,select
0,48378189400,48378190900,00000001500,a14,writev
0,48378191200,48378191300,00000000100,a2f,recvmsg
0,48378191800,48378199700,00000007900,a17,select
0,48378202000,48378203500,00000001500,a14,writev
0,48378203700,48378203900,00000000200,a2f,recvmsg
0,48378204400,48378212800,00000008400,a17,select
0,48378215100,48378216600,00000001500,a14,writev
0,48378216800,48378217000,00000000200,a2f,recvmsg
0,48378217500,48378225500,00000008000,a17,select
0,48378227700,48378229200,00000001500,a14,writev
0,48378229400,48378229500,00000000100,a2f,recvmsg
0,48378230100,48378238000,00000007900,a17,select
0,48378240300,48378241700,00000001400,a14,writev
0,48378242000,48378242200,00000000200,a2f,recvmsg
0,48378242600,48378250600,00000008000,a17,select
0,48378252900,48378254400,00000001500,a14,writev
0,48378254600,48378254800,00000000200,a2f,recvmsg
0,48378255300,48378263300,00000008000,a17,select
0,48378265600,48378267100,00000001500,a14,writev
0,48378267300,48378267400,00000000100,a2f,recvmsg
0,48378267900,48378276000,00000008100,a17,select
0,48378278400,48378279800,00000001400,a14,writev
0,48378280100,48378280200,00000000100,a2f,recvmsg
0,48378280700,48378289400,00000008700,a17,select
0,48378291800,48378293200,00000001400,a14,writev
0,48378293400,48378293600,00000000200,a2f,recvmsg
0,48378294000,48378301900,00000007900,a17,select
0,48378304200,48378305700,00000001500,a14,writev
0,48378306000,48378306200,00000000200,a2f,recvmsg
0,48378306700,48378314800,00000008100,a17,select
0,48378317200,48378318600,00000001400,a14,writev
0,48378318800,48378319000,00000000200,a2f,recvmsg
0,48378319600,48378327400,00000007800,a17,select
0,48378329800,48378331300,00000001500,a14,writev
0,48378331500,48378331700,00000000200,a2f,recvmsg
0,48378332100,48378345800,00000013700,a17,select
0,48378348300,48378349700,00000001400,a14,writev
0,48378349900,48378350100,00000000200,a2f,recvmsg
0,48378350600,48378358800,00000008200,a17,select
0,48378361100,48378362500,00000001400,a14,writev
0,48378362800,48378363000,00000000200,a2f,recvmsg
0,48378363500,48378371600,00000008100,a17,select
0,48378373800,48378375300,00000001500,a14,writev
0,48378375600,48378375700,00000000100,a2f,recvmsg
0,48378376200,48378384300,00000008100,a17,select
0,48378386700,48378388100,00000001400,a14,writev
0,48378388400,48378388500,00000000100,a2f,recvmsg
0,48378389000,48378397100,00000008100,a17,select
0,48378399500,48378400900,00000001400,a14,writev
0,48378401100,48378401300,00000000200,a2f,recvmsg
0,48378401800,48378453100,00000051300,a17,select
0,48378454200,48378455500,00000001300,a2f,recvmsg
0,48378540300,48378543500,00000003200,a14,writev
0,48378544000,48378546700,00000002700,a14,writev
0,48378621900,48378623500,00000001600,a14,writev
0,48378678100,48378679800,00000001700,a14,writev
0,48378680000,48378681600,00000001600,a14,writev
0,48378734500,48378736600,00000002100,a14,writev
0,48378736800,48378738300,00000001500,a14,writev
0,48378792300,48378794000,00000001700,a14,writev
0,48378794200,48378795700,00000001500,a14,writev
0,48378850100,48378851900,00000001800,a14,writev
0,48378852100,48378853600,00000001500,a14,writev
0,48378857000,48378857800,00000000800,a2f,recvmsg
0,48378906500,48378908200,00000001700,a14,writev
0,48378950800,48378952700,00000001900,a14,writev
0,48378994500,48378996000,00000001500,a14,writev
0,48379038500,48379040100,00000001600,a14,writev
0,48379081700,48379083500,00000001800,a14,writev
0,48379126500,48379128200,00000001700,a14,writev
0,48379153000,48379155100,00000002100,a2f,recvmsg
0,48379180000,48379182200,00000002200,a14,writev
0,48379199700,48379201400,00000001700,a14,writev
0,48379215200,48379216800,00000001600,a14,writev
0,48379229600,48379231500,00000001900,a14,writev
0,48379258600,48379260700,00000002100,a14,writev
0,48379264800,48379266500,00000001700,a14,writev
0,48379266700,48379266900,00000000200,a2f,recvmsg
0,48379267500,48379267900,00000000400,a14,writev
0,48379268300,48379268600,00000000300,a14,writev
0,48379287600,48379289000,00000001400,a14,writev
0,48379289400,48379289500,00000000100,a2f,recvmsg
0,48379301200,48379303100,00000001900,a14,writev
0,48379305700,48379305800,00000000100,a2f,recvmsg
0,48367459200,48379312500,00011853300,a07,poll
0,48379317100,48379323700,00000006600,a2f,recvmsg
0,48379335700,48379335900,00000000200,a2f,recvmsg
0,48379361800,48379366500,00000004700,a07,poll
0,48379371700,48379377800,00000006100,a2f,recvmsg
0,48379390300,48379390500,00000000200,a2f,recvmsg
0,48379413100,48379417800,00000004700,a07,poll
0,48379424100,48379430400,00000006300,a2f,recvmsg
0,48379444200,48379444500,00000000300,a2f,recvmsg
0,48379306400,48379473300,00000166900,a17,select
0,48379489000,48379490500,00000001500,a14,writev
0,48379490900,48379491100,00000000200,a2f,recvmsg
0,48379504700,48379505800,00000001100,a14,writev
0,48379506100,48379506200,00000000100,a2f,recvmsg
0,48379518000,48379519000,00000001000,a14,writev
0,48379519300,48379519400,00000000100,a2f,recvmsg
0,48379468400,48379523600,00000055200,a07,poll
0,48379524200,48379525300,00000001100,a2f,recvmsg
0,48379530600,48379531500,00000000900,a2d,recvfrom
0,48379532500,48379532700,00000000200,a2f,recvmsg
0,48379533200,48379533400,00000000200,a2f,recvmsg
0,48379574500,48379574800,00000000300,a2f,recvmsg
0,48379577300,48379577400,00000000100,a2f,recvmsg
0,48379580000,48379582100,00000002100,a07,poll
0,48379582700,48379584100,00000001400,a2f,recvmsg
0,48379589800,48379590600,00000000800,a2d,recvfrom
0,48379591400,48379591600,00000000200,a2f,recvmsg
0,48379592300,48379592400,00000000100,a2f,recvmsg
0,48379622600,48379622900,00000000300,a2f,recvmsg
0,48379625200,48379625300,00000000100,a2f,recvmsg
0,48379628700,48379631100,00000002400,a07,poll
0,48379631900,48379633100,00000001200,a2f,recvmsg
0,48379639700,48379640300,00000000600,a2d,recvfrom
0,48379641400,48379641500,00000000100,a2f,recvmsg
0,48379642300,48379642500,00000000200,a2f,recvmsg
0,48379674000,48379674200,00000000200,a2f,recvmsg
0,48379676000,48379676100,00000000100,a2f,recvmsg
0,48379519900,48381304500,00001784600,a17,select
0,48381314200,48381317100,00000002900,a14,writev
0,48381317500,48381317700,00000000200,a2f,recvmsg
0,48381319200,48381329900,00000010700,a17,select
0,48381332600,48381334200,00000001600,a14,writev
0,48381334500,48381334600,00000000100,a2f,recvmsg
0,48381335200,48381405600,00000070400,a17,select
0,48381409200,48381410900,00000001700,a14,writev
0,48381411200,48381411300,00000000100,a2f,recvmsg
0,48401516800,48401520200,00000003400,a57,unlink
0,48401540700,48401541300,00000000600,a48,fcntl
0,48401593900,48401606800,00000012900,a01,write
0,48401624900,48401627400,00000002500,a01,write
0,48401643800,48401646100,00000002300,a01,write
0,48367232600,48401824100,00034591500,a3d,wait4
0,48401842700,48401844400,00000001700,a00,read
0,48401846300,48401846700,00000000400,a00,read
0,48381411900,48401874800,00020462900,a17,select
0,48401894800,48401895100,00000000300,a2f,recvmsg
0,48401863400,48401903000,00000039600,a07,poll
0,48401906300,48401906500,00000000200,a2f,recvmsg
0,48401907300,48401907500,00000000200,a2f,recvmsg
0,48401898400,48401916000,00000017600,a17,select
0,48401920200,48401920300,00000000100,a2f,recvmsg
0,48401912900,48401924200,00000011300,a07,poll
0,48401925400,48401925600,00000000200,a2f,recvmsg
0,48401926000,48401926100,00000000100,a2f,recvmsg
0,48401921000,48401931900,00000010900,a17,select
0,48401935700,48401935800,00000000100,a2f,recvmsg
0,48401929300,48401939400,00000010100,a07,poll
0,48401940600,48401940800,00000000200,a2f,recvmsg
0,48401941200,48401941300,00000000100,a2f,recvmsg
0,48401936500,48401947400,00000010900,a17,select
0,48401951400,48401951600,00000000200,a2f,recvmsg
0,48401945000,48401955100,00000010100,a07,poll
0,48401956400,48401956500,00000000100,a2f,recvmsg
0,48401956800,48401957000,00000000200,a2f,recvmsg
0,48401952200,48401963100,00000010900,a17,select
0,48401967400,48401967600,00000000200,a2f,recvmsg
0,48401960600,48401971100,00000010500,a07,poll
0,48401972300,48401972400,00000000100,a2f,recvmsg
0,48401972800,48401973000,00000000200,a2f,recvmsg
0,48401968100,48401978500,00000010400,a17,select
0,48401982000,48401982200,00000000200,a2f,recvmsg
0,48401976000,48401985700,00000009700,a07,poll
0,48401986900,48401987100,00000000200,a2f,recvmsg
0,48401987400,48401987600,00000000200,a2f,recvmsg
0,48401988400,48401988600,00000000200,a08,lseek
0,48401998900,48401999000,00000000100,a08,lseek
0,48401982800,48402004100,00000021300,a17,select
0,48402008100,48402008300,00000000200,a2f,recvmsg
0,48402001400,48402012000,00000010600,a07,poll
0,48402013400,48402013500,00000000100,a2f,recvmsg
0,48402013900,48402014100,00000000200,a2f,recvmsg
0,48402008900,48402021700,00000012800,a17,select
0,48402025500,48402025600,00000000100,a2f,recvmsg
0,48402019100,48402029200,00000010100,a07,poll
0,48402030600,48402030700,00000000100,a2f,recvmsg
0,48402031100,48402031300,00000000200,a2f,recvmsg
0,48402026300,48402036700,00000010400,a17,select
0,48402040100,48402040300,00000000200,a2f,recvmsg
0,48402034200,48402043900,00000009700,a07,poll
0,48402045200,48402045300,00000000100,a2f,recvmsg
0,48402045700,48402045800,00000000100,a2f,recvmsg
0,48402040900,48402052700,00000011800,a17,select
0,48402056200,48402056400,00000000200,a2f,recvmsg
0,48402049900,48402060000,00000010100,a07,poll
0,48402061200,48402061400,00000000200,a2f,recvmsg
0,48402061800,48402062000,00000000200,a2f,recvmsg
0,48402057000,48402067800,00000010800,a17,select
0,48402071600,48402071700,00000000100,a2f,recvmsg
0,48402065100,48402075400,00000010300,a07,poll
0,48402076700,48402076900,00000000200,a2f,recvmsg
0,48402077300,48402077400,00000000100,a2f,recvmsg
0,48402072300,48402084500,00000012200,a17,select
0,48402088200,48402088400,00000000200,a2f,recvmsg
0,48402081800,48402092000,00000010200,a07,poll
0,48402093300,48402093400,00000000100,a2f,recvmsg
0,48402093800,48402094000,00000000200,a2f,recvmsg
0,48402089000,48402099600,00000010600,a17,select
0,48402103500,48402103700,00000000200,a2f,recvmsg
0,48402097100,48402107200,00000010100,a07,poll
0,48402108500,48402108600,00000000100,a2f,recvmsg
0,48402109000,48402109200,00000000200,a2f,recvmsg
0,48402104300,48402114400,00000010100,a17,select
0,48402117900,48402118000,00000000100,a2f,recvmsg
0,48402111900,48402121500,00000009600,a07,poll
0,48402122700,48402122900,00000000200,a2f,recvmsg
0,48402123300,48402123500,00000000200,a2f,recvmsg
0,48402118600,48402130300,00000011700,a17,select
0,48402134100,48402134300,00000000200,a2f,recvmsg
0,48402127600,48402137900,00000010300,a07,poll
0,48402139100,48402139300,00000000200,a2f,recvmsg
0,48402139700,48402139800,00000000100,a2f,recvmsg
0,48402134900,48402145700,00000010800,a17,select
0,48402149300,48402149500,00000000200,a2f,recvmsg
0,48402143000,48402153000,00000010000,a07,poll
0,48402154300,48402154500,00000000200,a2f,recvmsg
0,48402154900,48402155000,00000000100,a2f,recvmsg
0,48402150000,48402160700,00000010700,a17,select
0,48402164300,48402164400,00000000100,a2f,recvmsg
0,48402158000,48402167900,00000009900,a07,poll
0,48402169300,48402169400,00000000100,a2f,recvmsg
0,48402169700,48402169900,00000000200,a2f,recvmsg
0,48402165000,48402175600,00000010600,a17,select
0,48402179200,48402179400,00000000200,a2f,recvmsg
0,48402173000,48402182900,00000009900,a07,poll
0,48402184200,48402184400,00000000200,a2f,recvmsg
0,48402184700,48402184800,00000000100,a2f,recvmsg
0,48402180000,48402190400,00000010400,a17,select
0,48402193900,48402194000,00000000100,a2f,recvmsg
0,48402187900,48402197600,00000009700,a07,poll
0,48402198800,48402199000,00000000200,a2f,recvmsg
0,48402199300,48402199500,00000000200,a2f,recvmsg
0,48402194600,48402205200,00000010600,a17,select
0,48402208800,48402209000,00000000200,a2f,recvmsg
0,48402202600,48402212600,00000010000,a07,poll
0,48402213800,48402214000,00000000200,a2f,recvmsg
0,48402214400,48402214600,00000000200,a2f,recvmsg
0,48402209500,48402220100,00000010600,a17,select
0,48402223600,48402223700,00000000100,a2f,recvmsg
0,48402217500,48402227500,00000010000,a07,poll
0,48402229700,48402229900,00000000200,a2f,recvmsg
0,48402230100,48402230300,00000000200,a2f,recvmsg
0,48402224400,48402235800,00000011400,a17,select
0,48402239400,48402239600,00000000200,a2f,recvmsg
0,48402233100,48402243000,00000009900,a07,poll
0,48402244200,48402244400,00000000200,a2f,recvmsg
0,48402244700,48402244900,00000000200,a2f,recvmsg
0,48402240100,48402252000,00000011900,a17,select
0,48402255400,48402255600,00000000200,a2f,recvmsg
0,48402249400,48402259100,00000009700,a07,poll
0,48402260400,48402260500,00000000100,a2f,recvmsg
0,48402260900,48402261100,00000000200,a2f,recvmsg
0,48402256200,48402266100,00000009900,a17,select
0,48402269600,48402269700,00000000100,a2f,recvmsg
0,48402263500,48402273200,00000009700,a07,poll
0,48402274400,48402274500,00000000100,a2f,recvmsg
0,48402274900,48402275100,00000000200,a2f,recvmsg
0,48402270200,48402280000,00000009800,a17,select
0,48402283400,48402283500,00000000100,a2f,recvmsg
0,48402277600,48402287000,00000009400,a07,poll
0,48402288300,48402288500,00000000200,a2f,recvmsg
0,48402288900,48402289000,00000000100,a2f,recvmsg
0,48402284100,48402294000,00000009900,a17,select
0,48402297400,48402297500,00000000100,a2f,recvmsg
0,48402291400,48402301000,00000009600,a07,poll
0,48402302300,48402302400,00000000100,a2f,recvmsg
0,48402302800,48402303000,00000000200,a2f,recvmsg
0,48402298100,48402308400,00000010300,a17,select
0,48402312100,48402312300,00000000200,a2f,recvmsg
0,48402305800,48402315700,00000009900,a07,poll
0,48402317000,48402317200,00000000200,a2f,recvmsg
0,48402317500,48402317700,00000000200,a2f,recvmsg
0,48402312800,48402323000,00000010200,a17,select
0,48402326500,48402326700,00000000200,a2f,recvmsg
0,48402320400,48402330100,00000009700,a07,poll
0,48402331300,48402331500,00000000200,a2f,recvmsg
0,48402331800,48402332000,00000000200,a2f,recvmsg
0,48402327100,48402337900,00000010800,a17,select
0,48402341500,48402341700,00000000200,a2f,recvmsg
0,48402335100,48402345200,00000010100,a07,poll
0,48402346400,48402346600,00000000200,a2f,recvmsg
0,48402346900,48402347100,00000000200,a2f,recvmsg
0,48402342200,48402353900,00000011700,a17,select
0,48402357400,48402357600,00000000200,a2f,recvmsg
0,48402351300,48402361200,00000009900,a07,poll
0,48402362400,48402362600,00000000200,a2f,recvmsg
0,48402363000,48402363100,00000000100,a2f,recvmsg
0,48402358200,48402369200,00000011000,a17,select
0,48402373000,48402373200,00000000200,a2f,recvmsg
0,48402366700,48402376800,00000010100,a07,poll
0,48402378100,48402378300,00000000200,a2f,recvmsg
0,48402378500,48402378700,00000000200,a2f,recvmsg
0,48402373800,48402384800,00000011000,a17,select
0,48402388300,48402388400,00000000100,a2f,recvmsg
0,48402382200,48402391900,00000009700,a07,poll
0,48402393100,48402393300,00000000200,a2f,recvmsg
0,48402393600,48402393800,00000000200,a2f,recvmsg
0,48402389000,48402399800,00000010800,a17,select
0,48402403500,48402403700,00000000200,a2f,recvmsg
0,48402397200,48402407300,00000010100,a07,poll
0,48402408600,48402408700,00000000100,a2f,recvmsg
0,48402409100,48402409200,00000000100,a2f,recvmsg
0,48402404200,48402418200,00000014000,a17,select
0,48402422000,48402422100,00000000100,a2f,recvmsg
0,48402415500,48402425800,00000010300,a07,poll
0,48402427000,48402427200,00000000200,a2f,recvmsg
0,48402427600,48402427700,00000000100,a2f,recvmsg
0,48402422700,48402433900,00000011200,a17,select
0,48402437400,48402437600,00000000200,a2f,recvmsg
0,48402431400,48402441100,00000009700,a07,poll
0,48402442400,48402442500,00000000100,a2f,recvmsg
0,48402442900,48402443000,00000000100,a2f,recvmsg
0,48402438200,48402448500,00000010300,a17,select
0,48402452100,48402452300,00000000200,a2f,recvmsg
0,48402445800,48402455800,00000010000,a07,poll
0,48402457000,48402457200,00000000200,a2f,recvmsg
0,48402457600,48402457800,00000000200,a2f,recvmsg
0,48402452800,48402464100,00000011300,a17,select
0,48402467800,48402467900,00000000100,a2f,recvmsg
0,48402461500,48402471400,00000009900,a07,poll
0,48402473500,48402473700,00000000200,a2f,recvmsg
0,48402474100,48402474300,00000000200,a2f,recvmsg
0,48402468500,48402480900,00000012400,a17,select
0,48402484600,48402484700,00000000100,a2f,recvmsg
0,48402478200,48402488300,00000010100,a07,poll
0,48402489500,48402489700,00000000200,a2f,recvmsg
0,48402490100,48402490300,00000000200,a2f,recvmsg
0,48402485300,48402496500,00000011200,a17,select
0,48402500200,48402500400,00000000200,a2f,recvmsg
0,48402493900,48402503900,00000010000,a07,poll
0,48402505200,48402505400,00000000200,a2f,recvmsg
0,48402505700,48402505800,00000000100,a2f,recvmsg
0,48402500900,48402511600,00000010700,a17,select
0,48402515100,48402515300,00000000200,a2f,recvmsg
0,48402509000,48402518900,00000009900,a07,poll
0,48402520100,48402520300,00000000200,a2f,recvmsg
0,48402520700,48402520800,00000000100,a2f,recvmsg
0,48402515900,48402526500,00000010600,a17,select
0,48402530000,48402530200,00000000200,a2f,recvmsg
0,48402523800,48402533700,00000009900,a07,poll
0,48402534900,48402535100,00000000200,a2f,recvmsg
0,48402535500,48402535700,00000000200,a2f,recvmsg
0,48402530600,48402540900,00000010300,a17,select
0,48402544400,48402544600,00000000200,a2f,recvmsg
0,48402538300,48402548000,00000009700,a07,poll
0,48402549300,48402549400,00000000100,a2f,recvmsg
0,48402549800,48402549900,00000000100,a2f,recvmsg
0,48402545100,48402555700,00000010600,a17,select
0,48402559200,48402559400,00000000200,a2f,recvmsg
0,48402553100,48402563000,00000009900,a07,poll
0,48402564300,48402564500,00000000200,a2f,recvmsg
0,48402564800,48402565000,00000000200,a2f,recvmsg
0,48402566300,48402566500,00000000200,a08,lseek
0,48402569200,48402570200,00000001000,a00,read
0,48402573800,48402573900,00000000100,a08,lseek
0,48402560000,48402579300,00000019300,a17,select
0,48402583200,48402583400,00000000200,a2f,recvmsg
0,48402576300,48402587100,00000010800,a07,poll
0,48402588400,48402588600,00000000200,a2f,recvmsg
0,48402588900,48402589100,00000000200,a2f,recvmsg
0,48402584000,48402617900,00000033900,a17,select
0,48402621800,48402622000,00000000200,a2f,recvmsg
0,48402615200,48402625600,00000010400,a07,poll
0,48402627000,48402627100,00000000100,a2f,recvmsg
0,48402627400,48402627600,00000000200,a2f,recvmsg
0,48402631800,48402632600,00000000800,a00,read
0,48402638100,48402638300,00000000200,a08,lseek
0,48402622600,48402644000,00000021400,a17,select
0,48402647700,48402647900,00000000200,a2f,recvmsg
0,48402641200,48402651500,00000010300,a07,poll
0,48402652800,48402653000,00000000200,a2f,recvmsg
0,48402653300,48402653500,00000000200,a2f,recvmsg
0,48402648500,48402658500,00000010000,a17,select
0,48402661900,48402662100,00000000200,a2f,recvmsg
0,48402656000,48402665600,00000009600,a07,poll
0,48402666900,48402667000,00000000100,a2f,recvmsg
0,48402667300,48402667500,00000000200,a2f,recvmsg
0,48402662700,48402672400,00000009700,a17,select
0,48402675800,48402675900,00000000100,a2f,recvmsg
0,48402670000,48402679400,00000009400,a07,poll
0,48402680600,48402680800,00000000200,a2f,recvmsg
0,48402681100,48402681300,00000000200,a2f,recvmsg
0,48402676500,48402686100,00000009600,a17,select
0,48402689500,48402689700,00000000200,a2f,recvmsg
0,48402683800,48402693200,00000009400,a07,poll
0,48402694400,48402694600,00000000200,a2f,recvmsg
0,48402694900,48402695100,00000000200,a2f,recvmsg
0,48402690200,48402700000,00000009800,a17,select
0,48402703400,48402703600,00000000200,a2f,recvmsg
0,48402697500,48402707100,00000009600,a07,poll
0,48402708400,48402708500,00000000100,a2f,recvmsg
0,48402708900,48402709000,00000000100,a2f,recvmsg
0,48402704100,48402713900,00000009800,a17,select
0,48402717400,48402717600,00000000200,a2f,recvmsg
0,48402711400,48402721100,00000009700,a07,poll
0,48402722200,48402722400,00000000200,a2f,recvmsg
0,48402722800,48402723000,00000000200,a2f,recvmsg
0,48402718200,48402727900,00000009700,a17,select
0,48402731200,48402731400,00000000200,a2f,recvmsg
0,48402725400,48402734800,00000009400,a07,poll
0,48402736000,48402736200,00000000200,a2f,recvmsg
0,48402736500,48402736700,00000000200,a2f,recvmsg
0,48402731900,48402742300,00000010400,a17,select
0,48402745800,48402746000,00000000200,a2f,recvmsg
0,48402739800,48402749400,00000009600,a07,poll
0,48402750700,48402750800,00000000100,a2f,recvmsg
0,48402751100,48402751300,00000000200,a2f,recvmsg
0,48402746600,48402756400,00000009800,a17,select
0,48402759800,48402760000,00000000200,a2f,recvmsg
0,48402753900,48402763400,00000009500,a07,poll
0,48402764600,48402764800,00000000200,a2f,recvmsg
0,48402765100,48402765300,00000000200,a2f,recvmsg
0,48402765900,48402766000,00000000100,a08,lseek
0,48402760400,48402772600,00000012200,a17,select
0,48402776100,48402776300,00000000200,a2f,recvmsg
0,48402770000,48402779800,00000009800,a07,poll
0,48402781100,48402781200,00000000100,a2f,recvmsg
0,48402781600,48402781700,00000000100,a2f,recvmsg
0,48402776900,48402788900,00000012000,a17,select
0,48402792600,48402792800,00000000200,a2f,recvmsg
0,48402786500,48402796300,00000009800,a07,poll
0,48402797600,48402797800,00000000200,a2f,recvmsg
0,48402798100,48402798200,00000000100,a2f,recvmsg
0,48402793400,48402803900,00000010500,a17,select
0,48402807300,48402807500,00000000200,a2f,recvmsg
0,48402801500,48402811000,00000009500,a07,poll
0,48402812100,48402812300,00000000200,a2f,recvmsg
0,48402812700,48402812900,00000000200,a2f,recvmsg
0,48402808000,48402818300,00000010300,a17,select
0,48402821600,48402821700,00000000100,a2f,recvmsg
0,48402815700,48402825200,00000009500,a07,poll
0,48402826600,48402826700,00000000100,a2f,recvmsg
0,48402827100,48402827300,00000000200,a2f,recvmsg
0,48402822300,48402832500,00000010200,a17,select
0,48402835900,48402836100,00000000200,a2f,recvmsg
0,48402830100,48402839500,00000009400,a07,poll
0,48402840700,48402840900,00000000200,a2f,recvmsg
0,48402841300,48402841500,00000000200,a2f,recvmsg
0,48402836600,48402847100,00000010500,a17,select
0,48402850500,48402850700,00000000200,a2f,recvmsg
0,48402844500,48402854200,00000009700,a07,poll
0,48402855300,48402855500,00000000200,a2f,recvmsg
0,48402855900,48402856100,00000000200,a2f,recvmsg
0,48402851200,48402861800,00000010600,a17,select
0,48402865200,48402865300,00000000100,a2f,recvmsg
0,48402859300,48402868800,00000009500,a07,poll
0,48402870100,48402870200,00000000100,a2f,recvmsg
0,48402870500,48402870700,00000000200,a2f,recvmsg
0,48402865900,48402876000,00000010100,a17,select
0,48402879500,48402879600,00000000100,a2f,recvmsg
0,48402873500,48402883100,00000009600,a07,poll
0,48402884300,48402884400,00000000100,a2f,recvmsg
0,48402884800,48402885000,00000000200,a2f,recvmsg
0,48402880100,48402890200,00000010100,a17,select
0,48402893600,48402893800,00000000200,a2f,recvmsg
0,48402887600,48402897200,00000009600,a07,poll
0,48402898500,48402898600,00000000100,a2f,recvmsg
0,48402898900,48402899100,00000000200,a2f,recvmsg
0,48402894300,48402904400,00000010100,a17,select
0,48402907800,48402908000,00000000200,a2f,recvmsg
0,48402901900,48402911500,00000009600,a07,poll
0,48402913000,48402913200,00000000200,a2f,recvmsg
0,48402913600,48402913700,00000000100,a2f,recvmsg
0,48402908500,48402918900,00000010400,a17,select
0,48402922400,48402922500,00000000100,a2f,recvmsg
0,48402916400,48402926000,00000009600,a07,poll
0,48402927300,48402927400,00000000100,a2f,recvmsg
0,48402927700,48402927900,00000000200,a2f,recvmsg
0,48402923100,48402933400,00000010300,a17,select
0,48402936900,48402937000,00000000100,a2f,recvmsg
0,48402930900,48402940700,00000009800,a07,poll
0,48402941900,48402942100,00000000200,a2f,recvmsg
0,48402942400,48402942600,00000000200,a2f,recvmsg
0,48402937600,48402948300,00000010700,a17,select
0,48402951900,48402952000,00000000100,a2f,recvmsg
0,48402945900,48402955600,00000009700,a07,poll
0,48402956800,48402957000,00000000200,a2f,recvmsg
0,48402957300,48402957500,00000000200,a2f,recvmsg
0,48402952500,48402962700,00000010200,a17,select
0,48402966100,48402966300,00000000200,a2f,recvmsg
0,48402960200,48402969900,00000009700,a07,poll
0,48402971100,48402971300,00000000200,a2f,recvmsg
0,48402971600,48402971800,00000000200,a2f,recvmsg
0,48402966900,48402977000,00000010100,a17,select
0,48402980500,48402980600,00000000100,a2f,recvmsg
0,48402974600,48402984100,00000009500,a07,poll
0,48402985300,48402985500,00000000200,a2f,recvmsg
0,48402985900,48402986100,00000000200,a2f,recvmsg
0,48402981100,48402991300,00000010200,a17,select
0,48402994700,48402994900,00000000200,a2f,recvmsg
0,48402988700,48402998300,00000009600,a07,poll
0,48402999600,48402999700,00000000100,a2f,recvmsg
0,48403000000,48403000200,00000000200,a2f,recvmsg
0,48402995500,48403011000,00000015500,a17,select
0,48403014400,48403014600,00000000200,a2f,recvmsg
0,48403008300,48403018200,00000009900,a07,poll
0,48403019400,48403019600,00000000200,a2f,recvmsg
0,48403019900,48403020100,00000000200,a2f,recvmsg
0,48403015100,48403025500,00000010400,a17,select
0,48403028900,48403029100,00000000200,a2f,recvmsg
0,48403023000,48403032500,00000009500,a07,poll
0,48403033800,48403033900,00000000100,a2f,recvmsg
0,48403034200,48403034400,00000000200,a2f,recvmsg
0,48403029700,48403039600,00000009900,a17,select
0,48403043000,48403043200,00000000200,a2f,recvmsg
0,48403037200,48403046700,00000009500,a07,poll
0,48403047900,48403048100,00000000200,a2f,recvmsg
0,48403048500,48403048600,00000000100,a2f,recvmsg
0,48403043700,48403054300,00000010600,a17,select
0,48403057700,48403057900,00000000200,a2f,recvmsg
0,48403051800,48403061300,00000009500,a07,poll
0,48403062500,48403062700,00000000200,a2f,recvmsg
0,48403063100,48403063300,00000000200,a2f,recvmsg
0,48403058500,48403068600,00000010100,a17,select
0,48403071900,48403072100,00000000200,a2f,recvmsg
0,48403066100,48403075600,00000009500,a07,poll
0,48403077000,48403077200,00000000200,a2f,recvmsg
0,48403077500,48403077600,00000000100,a2f,recvmsg
0,48403118500,48403122200,00000003700,a14,writev
0,48403072700,48403126900,00000054200,a17,select
0,48403129200,48403130400,00000001200,a2f,recvmsg
0,48403214800,48403218800,00000004000,a14,writev
0,48403219300,48403223000,00000003700,a14,writev
0,48403298600,48403300500,00000001900,a14,writev
0,48403355100,48403357000,00000001900,a14,writev
0,48403357200,48403359400,00000002200,a14,writev
0,48403413200,48403414800,00000001600,a14,writev
0,48403415100,48403416800,00000001700,a14,writev
0,48403470900,48403472700,00000001800,a14,writev
0,48403472900,48403474500,00000001600,a14,writev
0,48403526400,48403528000,00000001600,a14,writev
0,48403528200,48403529800,00000001600,a14,writev
0,48403533700,48403534500,00000000800,a2f,recvmsg
0,48403582400,48403584100,00000001700,a14,writev
0,48403627200,48403628800,00000001600,a14,writev
0,48403670500,48403672100,00000001600,a14,writev
0,48403714000,48403715600,00000001600,a14,writev
0,48403756800,48403758800,00000002000,a14,writev
0,48403801200,48403802900,00000001700,a14,writev
0,48403827400,48403829400,00000002000,a2f,recvmsg
0,48403853400,48403855500,00000002100,a14,writev
0,48403871900,48403873900,00000002000,a14,writev
0,48403888600,48403890200,00000001600,a14,writev
0,48403904700,48403906100,00000001400,a14,writev
0,48403919000,48403920600,00000001600,a14,writev
0,48403933000,48403934400,00000001400,a14,writev
0,48403939000,48403939200,00000000200,a2f,recvmsg
0,48403939900,48403940200,00000000300,a14,writev
0,48403940600,48403940900,00000000300,a14,writev
0,48403958600,48403960100,00000001500,a14,writev
0,48403960400,48403961900,00000001500,a14,writev
0,48403962400,48403962600,00000000200,a2f,recvmsg
0,48403122900,48403970300,00000847400,a07,poll
0,48403975100,48403981700,00000006600,a2f,recvmsg
0,48403993200,48403993300,00000000100,a2f,recvmsg
0,48404017800,48404021900,00000004100,a07,poll
0,48404026900,48404033400,00000006500,a2f,recvmsg
0,48404045900,48404046100,00000000200,a2f,recvmsg
0,48404067400,48404072000,00000004600,a07,poll
0,48404077300,48404083600,00000006300,a2f,recvmsg
0,48404095900,48404096100,00000000200,a2f,recvmsg
0,48403963300,48404122700,00000159400,a17,select
0,48404137000,48404138300,00000001300,a14,writev
0,48404138800,48404139000,00000000200,a2f,recvmsg
0,48404152700,48404153500,00000000800,a14,writev
0,48404153900,48404154000,00000000100,a2f,recvmsg
0,48404166000,48404166800,00000000800,a14,writev
0,48404167100,48404167200,00000000100,a2f,recvmsg
0,48404117500,48404171300,00000053800,a07,poll
0,48404172000,48404173100,00000001100,a2f,recvmsg
0,48404177600,48404178300,00000000700,a2d,recvfrom
0,48404179300,48404179400,00000000100,a2f,recvmsg
0,48404180000,48404180200,00000000200,a2f,recvmsg
0,48404220800,48404221000,00000000200,a2f,recvmsg
0,48404223200,48404223300,00000000100,a2f,recvmsg
0,48404225400,48404227500,00000002100,a07,poll
0,48404228000,48404229100,00000001100,a2f,recvmsg
0,48404233900,48404234600,00000000700,a2d,recvfrom
0,48404235300,48404235500,00000000200,a2f,recvmsg
0,48404236200,48404236300,00000000100,a2f,recvmsg
0,48404264900,48404265100,00000000200,a2f,recvmsg
0,48404267000,48404267200,00000000200,a2f,recvmsg
0,48404270300,48404272400,00000002100,a07,poll
0,48404272800,48404274000,00000001200,a2f,recvmsg
0,48404279000,48404279600,00000000600,a2d,recvfrom
0,48404280500,48404280700,00000000200,a2f,recvmsg
0,48404281400,48404281600,00000000200,a2f,recvmsg
0,48404309900,48404310200,00000000300,a2f,recvmsg
0,48404311900,48404312000,00000000100,a2f,recvmsg
0,48404315200,48404318400,00000003200,a07,poll
0,48404321500,48404321700,00000000200,a2f,recvmsg
0,48404322300,48404322500,00000000200,a2f,recvmsg
0,48404167800,48404355000,00000187200,a17,select
0,48404365400,48404367600,00000002200,a14,writev
0,48404369800,48404370000,00000000200,a2f,recvmsg
0,48404350600,48404375200,00000024600,a07,poll
0,48404377100,48404377200,00000000100,a2f,recvmsg
0,48404377700,48404377900,00000000200,a2f,recvmsg
0,48404967200,48404973000,00000005800,a07,poll
0,48404985600,48404991100,00000005500,a2e,sendmsg
0,48364978000,48404994500,00040016500,ae8,epoll_wait
0,48405006700,48405008600,00000001900,a2f,recvmsg
0,48405022300,48405022600,00000000300,a2f,recvmsg
0,48405080100,48405083900,00000003800,a2e,sendmsg
0,48404967200,48405093700,00000126500,a07,poll
0,48405111100,48405112400,00000001300,a2f,recvmsg
0,48405187200,48405189700,00000002500,a07,poll
0,48405187200,48405333100,00000145900,a07,poll
0,48405336600,48405338500,00000001900,aca,futex
0,48405340700,48405341800,00000001100,aca,futex
0,48405343300,48405344100,00000000800,aca,futex
0,48405358300,48405361600,00000003300,a2e,sendmsg
0,48405364800,48405365000,00000000200,a00,read
0,48405089700,48405388700,00000299000,ae8,epoll_wait
0,48405394000,48405395600,00000001600,a2f,recvmsg
0,48405414900,48405415200,00000000300,a2f,recvmsg
0,48405449300,48405450700,00000001400,a2e,sendmsg
0,48405470700,48405472700,00000002000,a2f,recvmsg
0,48405478300,48405479100,00000000800,a2f,recvmsg
0,48405492200,48405494800,00000002600,a2e,sendmsg
0,48405454000,48405496500,00000042500,ae8,epoll_wait
0,48405499400,48405500000,00000000600,a2f,recvmsg
0,48405507800,48405508000,00000000200,a2f,recvmsg
0,48405540400,48405542100,00000001700,a2e,sendmsg
0,48405477200,48405547700,00000070500,a07,poll
0,48405557000,48405557600,00000000600,a2f,recvmsg
0,48405611700,48405613400,00000001700,a07,poll
0,48405611700,48405724200,00000112500,a07,poll
0,48405726000,48405727100,00000001100,aca,futex
0,48405729200,48405730100,00000000900,aca,futex
0,48405731600,48405732300,00000000700,aca,futex
0,48405735000,48405737600,00000002600,a2e,sendmsg
0,48405740200,48405740500,00000000300,a00,read
0,48405545800,48405758900,00000213100,ae8,epoll_wait
0,48405762600,48405763900,00000001300,a2f,recvmsg
0,48405781900,48405782200,00000000300,a2f,recvmsg
0,48405808000,48405809200,00000001200,a2e,sendmsg
0,48406003500,48406007000,00000003500,a01,write
0,48406012600,48406013200,00000000600,a2f,recvmsg
0,48406015300,48406015500,00000000200,a00,read
0,48406016900,48406017700,00000000800,a2f,recvmsg
0,48406028200,48406028900,00000000700,aca,futex
0,48406038700,48406038900,00000000200,aca,futex
0,48406040400,48406046100,00000005700,aca,futex
0,48406091500,48406094700,00000003200,aca,futex
0,48406101000,48406103700,00000002700,aca,futex
0,48406171500,48406173100,00000001600,a01,write
0,48406180800,48406183600,00000002800,a2e,sendmsg
0,48406189700,48406190000,00000000300,aca,futex
0,48406190700,48406190900,00000000200,aca,futex
0,48406193400,48406196100,00000002700,a07,poll
0,48406475200,48406479600,00000004400,a09,mmap
0,48406585300,48406590100,00000004800,a02,open
0,48406599100,48406601000,00000001900,a00,read
0,48406660900,48406661700,00000000800,a00,read
0,48406714900,48406715800,00000000900,a00,read
0,48406769300,48406770000,00000000700,a00,read
0,48406823400,48406824100,00000000700,a00,read
0,48406876000,48406876700,00000000700,a00,read
0,48406926900,48406927800,00000000900,a00,read
0,48406979200,48406980000,00000000800,a00,read
0,48407034300,48407035100,00000000800,a00,read
0,48407087900,48407088500,00000000600,a00,read
0,48407139000,48407139700,00000000700,a00,read
0,48407167700,48407169300,00000001600,a02,open
0,48407172200,48407173200,00000001000,a00,read
0,48407229900,48407230700,00000000800,a00,read
0,48407317000,48407317800,00000000800,a00,read
0,48407390900,48407391800,00000000900,a00,read
0,48407471100,48407471800,00000000700,a00,read
0,48407552500,48407553200,00000000700,a00,read
0,48407631800,48407632400,00000000600,a00,read
0,48407718900,48407719500,00000000600,a00,read
0,48407786800,48407787600,00000000800,a00,read
0,48407845800,48407846500,00000000700,a00,read
0,48404371300,48407940600,00003569300,a17,select
0,48407961000,48407961200,00000000200,a2f,recvmsg
0,48407975700,48407976000,00000000300,a2f,recvmsg
0,48407976600,48407976800,00000000200,a2f,recvmsg
0,48407964400,48407982500,00000018100,a17,select
0,48407986800,48407987000,00000000200,a2f,recvmsg
0,48407992900,48407993100,00000000200,a2f,recvmsg
0,48407993500,48407993700,00000000200,a2f,recvmsg
0,48407998700,48408003900,00000005200,a06,lstat
0,48408004600,48408005600,00000001000,a06,lstat
0,48408024500,48408036400,00000011900,a01,write
0,48407987700,48408045300,00000057600,a17,select
0,48408051400,48408051600,00000000200,a2f,recvmsg
0,48408059500,48408059700,00000000200,a2f,recvmsg
0,48408060300,48408060400,00000000100,a2f,recvmsg
0,48408061800,48408376100,00000314300,a38,clone
0,48409694900,48409695000,00000000100,a0c,brk
0,48409706100,48409708500,00000002400,a15,access
0,48409709300,48409710400,00000001100,a09,mmap
0,48409714300,48409715200,00000000900,a15,access
0,48409727500,48409727900,00000000400,a15,access
0,48409735000,48409735900,00000000900,a00,read
0,48409737500,48409739200,00000001700,a09,mmap
0,48409743300,48409745400,00000002100,a09,mmap
0,48409756800,48409757400,00000000600,a15,access
0,48409760800,48409761500,00000000700,a00,read
0,48409762200,48409763200,00000001000,a09,mmap
0,48409765600,48409766900,00000001300,a09,mmap
0,48409775000,48409775500,00000000500,a15,access
0,48409778700,48409779300,00000000600,a00,read
0,48409779900,48409780800,00000000900,a09,mmap
0,48409782400,48409784500,00000002100,a09,mmap
0,48409789100,48409792300,00000003200,a09,mmap
0,48409794700,48409795800,00000001100,a09,mmap
0,48409804900,48409805400,00000000500,a15,access
0,48409808000,48409808900,00000000900,a00,read
0,48409809600,48409811100,00000001500,a09,mmap
0,48409814000,48409815700,00000001700,a09,mmap
0,48409823900,48409824500,00000000600,a15,access
0,48409827700,48409828300,00000000600,a00,read
0,48409829000,48409830500,00000001500,a09,mmap
0,48409834400,48409837000,00000002600,a09,mmap
0,48409845600,48409846300,00000000700,a15,access
0,48409848600,48409849100,00000000500,a00,read
0,48409849600,48409850600,00000001000,a09,mmap
0,48409851900,48409853300,00000001400,a09,mmap
0,48409863700,48409864200,00000000500,a15,access
0,48409866600,48409867100,00000000500,a00,read
0,48409867800,48409869100,00000001300,a09,mmap
0,48409871700,48409873400,00000001700,a09,mmap
0,48409887800,48409888400,00000000600,a09,mmap
0,48409892100,48409892400,00000000300,a09,mmap
0,48409893400,48409893700,00000000300,a09,mmap
0,48410072700,48410072800,00000000100,a0c,brk
0,48410072900,48410073700,00000000800,a0c,brk
0,48410109600,48410115100,00000005500,a00,read
0,48410126900,48410128500,00000001600,a00,read
0,48410166700,48410167600,00000000900,a00,read
0,48410288400,48410289100,00000000700,a00,read
0,48410361900,48410362200,00000000300,a00,read
0,48410448400,48410449100,00000000700,a00,read
0,48410579000,48410579800,00000000800,a00,read
0,48410707900,48410708600,00000000700,a00,read
0,48410863000,48410863700,00000000700,a00,read
0,48411012900,48411013700,00000000800,a00,read
0,48411166000,48411166900,00000000900,a00,read
0,48411314300,48411315000,00000000700,a00,read
0,48411468900,48411469700,00000000800,a00,read
0,48411627900,48411628700,00000000800,a00,read
0,48411736500,48411737400,00000000900,a00,read
0,48411768000,48411768400,00000000400,a0c,brk
0,48411875800,48411876500,00000000700,a00,read
0,48412117600,48412118200,00000000600,a00,read
0,48412130200,48412130700,00000000500,a00,read
0,48412174100,48412174500,00000000400,a00,read
0,48412194000,48412194800,00000000800,a00,read
0,48412402400,48412402700,00000000300,a00,read
0,48412431900,48412432800,00000000900,a00,read
0,48412530300,48412531100,00000000800,a00,read
0,48412555000,48412556300,00000001300,a0c,brk
0,48412601300,48412601700,00000000400,a00,read
0,48412677900,48412678700,00000000800,a00,read
0,48412831400,48412831900,00000000500,a00,read
0,48412944000,48412944500,00000000500,a00,read
0,48413039700,48413040200,00000000500,a00,read
0,48413051700,48413052200,00000000500,a00,read
0,48413134200,48413134700,00000000500,a00,read
0,48413158200,48413158500,00000000300,a00,read
0,48413180000,48413180600,00000000600,a00,read
0,48413281600,48413282700,00000001100,a0c,brk
0,48413284000,48413285000,00000001000,a00,read
0,48413496200,48413496900,00000000700,a00,read
0,48413582100,48413582600,00000000500,a00,read
0,48413647000,48413647800,00000000800,a00,read
0,48413778300,48413778800,00000000500,a00,read
0,48413811100,48413811700,00000000600,a00,read
0,48413826200,48413827900,00000001700,a02,open
0,48413939000,48413939500,00000000500,a00,read
0,48414010100,48414010500,00000000400,a00,read
0,48414062700,48414064000,00000001300,a0c,brk
0,48414070400,48414071000,00000000600,a00,read
0,48414177000,48414177600,00000000600,a00,read
0,48414326400,48414327400,00000001000,a00,read
0,48414458600,48414459300,00000000700,a00,read
0,48414516700,48414517400,00000000700,a00,read
0,48414572600,48414573400,00000000800,a00,read
0,48414642700,48414643300,00000000600,a00,read
0,48414695600,48414696200,00000000600,a00,read
0,48414783900,48414784600,00000000700,a0c,brk
0,48414814400,48414819500,00000005100,a0c,brk
0,48414833500,48414834400,00000000900,a00,read
0,48414949400,48414950200,00000000800,a00,read
0,48415107700,48415108300,00000000600,a00,read
0,48415224700,48415225500,00000000800,a00,read
0,48415371800,48415372400,00000000600,a00,read
0,48415488700,48415489400,00000000700,a00,read
0,48415649900,48415650500,00000000600,a00,read
0,48415655500,48415656400,00000000900,a0c,brk
0,48415771000,48415771600,00000000600,a00,read
0,48415888800,48415889500,00000000700,a00,read
0,48416030000,48416030800,00000000800,a00,read
0,48416161700,48416162400,00000000700,a00,read
0,48416255500,48416256100,00000000600,a00,read
0,48416367600,48416368200,00000000600,a00,read
0,48416491600,48416492400,00000000800,a00,read
0,48416603300,48416603800,00000000500,a0c,brk
0,48416626400,48416627100,00000000700,a00,read
0,48416795000,48416795600,00000000600,a00,read
0,48416945600,48416946200,00000000600,a00,read
0,48417055900,48417056700,00000000800,a00,read
0,48417223400,48417224400,00000001000,a00,read
0,48417300500,48417301100,00000000600,a00,read
0,48425385700,48425386600,00000000900,a00,read
0,48425453800,48425454700,00000000900,a0c,brk
0,48425468200,48425469000,00000000800,a00,read
0,48425541200,48425542000,00000000800,a00,read
0,48425642100,48425642900,00000000800,a00,read
0,48425745300,48425746000,00000000700,a00,read
0,48425834800,48425835600,00000000800,a00,read
0,48425915500,48425916100,00000000600,a00,read
0,48426017000,48426017600,00000000600,a00,read
0,48426097400,48426097900,00000000500,a0c,brk
0,48426100300,48426101100,00000000800,a00,read
0,48426208000,48426208500,00000000500,a00,read
0,48426300700,48426301200,00000000500,a00,read
0,48426419700,48426420400,00000000700,a00,read
0,48426533400,48426534100,00000000700,a00,read
0,48426636400,48426637000,00000000600,a00,read
0,48426737500,48426737900,00000000400,a0c,brk
0,48427099400,48427103000,00000003600,a57,unlink
0,48427126200,48427126700,00000000500,a48,fcntl
0,48427174200,48427188700,00000014500,a01,write
0,48427206600,48427209100,00000002500,a01,write
0,48427225100,48427227200,00000002100,a01,write
0,48408398700,48427400800,00019002100,a3d,wait4
0,48427420900,48427422300,00000001400,a00,read
0,48427424500,48427424800,00000000300,a00,read
0,48408052700,48427458100,00019405400,a17,select
0,48427479800,48427480100,00000000300,a2f,recvmsg
0,48427494700,48427494900,00000000200,a2f,recvmsg
0,48427495800,48427496000,00000000200,a2f,recvmsg
0,48427483400,48427503400,00000020000,a17,select
0,48427507300,48427507400,00000000100,a2f,recvmsg
0,48427513400,48427513500,00000000100,a2f,recvmsg
0,48427513900,48427514100,00000000200,a2f,recvmsg
0,48427508100,48427519400,00000011300,a17,select
0,48427522900,48427523000,00000000100,a2f,recvmsg
0,48427528400,48427528600,00000000200,a2f,recvmsg
0,48427528800,48427529000,00000000200,a2f,recvmsg
0,48427523700,48427534800,00000011100,a17,select
0,48427538400,48427538500,00000000100,a2f,recvmsg
0,48427543900,48427544000,00000000100,a2f,recvmsg
0,48427544400,48427544600,00000000200,a2f,recvmsg
0,48427539100,48427550200,00000011100,a17,select
0,48427554000,48427554200,00000000200,a2f,recvmsg
0,48427559400,48427559600,00000000200,a2f,recvmsg
0,48427559900,48427560100,00000000200,a2f,recvmsg
0,48427554800,48427565200,00000010400,a17,select
0,48427568500,48427568500,00000000000,a2f,recvmsg
0,48427573800,48427574000,00000000200,a2f,recvmsg
0,48427574200,48427574400,00000000200,a2f,recvmsg
0,48427575200,48427575400,00000000200,a08,lseek
0,48427587100,48427587200,00000000100,a08,lseek
0,48427569100,48427591700,00000022600,a17,select
0,48427595100,48427595300,00000000200,a2f,recvmsg
0,48427600800,48427601000,00000000200,a2f,recvmsg
0,48427601300,48427601500,00000000200,a2f,recvmsg
0,48427596000,48427608700,00000012700,a17,select
0,48427612100,48427612200,00000000100,a2f,recvmsg
0,48427617700,48427617900,00000000200,a2f,recvmsg
0,48427618200,48427618400,00000000200,a2f,recvmsg
0,48427612800,48427623300,00000010500,a17,select
0,48427626300,48427626400,00000000100,a2f,recvmsg
0,48427631600,48427631800,00000000200,a2f,recvmsg
0,48427632200,48427632300,00000000100,a2f,recvmsg
0,48427627000,48427638700,00000011700,a17,select
0,48427641700,48427641800,00000000100,a2f,recvmsg
0,48427647300,48427647400,00000000100,a2f,recvmsg
0,48427647800,48427648000,00000000200,a2f,recvmsg
0,48427642400,48427653300,00000010900,a17,select
0,48427656400,48427656600,00000000200,a2f,recvmsg
0,48427661900,48427662100,00000000200,a2f,recvmsg
0,48427662400,48427662600,00000000200,a2f,recvmsg
0,48427657200,48427668200,00000011000,a17,select
0,48427671200,48427671400,00000000200,a2f,recvmsg
0,48427676800,48427676900,00000000100,a2f,recvmsg
0,48427677300,48427677400,00000000100,a2f,recvmsg
0,48427672000,48427683600,00000011600,a17,select
0,48427686600,48427686800,00000000200,a2f,recvmsg
0,48427692100,48427692300,00000000200,a2f,recvmsg
0,48427692600,48427692800,00000000200,a2f,recvmsg
0,48427687400,48427698400,00000011000,a17,select
0,48427701400,48427701500,00000000100,a2f,recvmsg
0,48427706700,48427706900,00000000200,a2f,recvmsg
0,48427707200,48427707300,00000000100,a2f,recvmsg
0,48427702000,48427713500,00000011500,a17,select
0,48427716700,48427716900,00000000200,a2f,recvmsg
0,48427722200,48427722400,00000000200,a2f,recvmsg
0,48427722600,48427722800,00000000200,a2f,recvmsg
0,48427717400,48427728100,00000010700,a17,select
0,48427731300,48427731500,00000000200,a2f,recvmsg
0,48427736700,48427736800,00000000100,a2f,recvmsg
0,48427737200,48427737400,00000000200,a2f,recvmsg
0,48427732000,48427742400,00000010400,a17,select
0,48427745700,48427745800,00000000100,a2f,recvmsg
0,48427751100,48427751300,00000000200,a2f,recvmsg
0,48427751700,48427751800,00000000100,a2f,recvmsg
0,48427746400,48427757000,00000010600,a17,select
0,48427760200,48427760300,00000000100,a2f,recvmsg
0,48427765700,48427765900,00000000200,a2f,recvmsg
0,48427766100,48427766300,00000000200,a2f,recvmsg
0,48427760800,48427771400,00000010600,a17,select
0,48427774400,48427774600,00000000200,a2f,recvmsg
0,48427779700,48427779900,00000000200,a2f,recvmsg
0,48427780200,48427780400,00000000200,a2f,recvmsg
0,48427775100,48427785600,00000010500,a17,select
0,48427788600,48427788800,00000000200,a2f,recvmsg
0,48427794000,48427794200,00000000200,a2f,recvmsg
0,48427794600,48427794600,00000000000,a2f,recvmsg
0,48427789300,48427799600,00000010300,a17,select
0,48427802600,48427802800,00000000200,a2f,recvmsg
0,48427807900,48427808100,00000000200,a2f,recvmsg
0,48427808400,48427808600,00000000200,a2f,recvmsg
0,48427803400,48427813200,00000009800,a17,select
0,48427816200,48427816400,00000000200,a2f,recvmsg
0,48427821700,48427821800,00000000100,a2f,recvmsg
0,48427822200,48427822400,00000000200,a2f,recvmsg
0,48427817000,48427829000,00000012000,a17,select
0,48427832100,48427832300,00000000200,a2f,recvmsg
0,48427837600,48427837700,00000000100,a2f,recvmsg
0,48427838100,48427838300,00000000200,a2f,recvmsg
0,48427832800,48427842700,00000009900,a17,select
0,48427845800,48427845900,00000000100,a2f,recvmsg
0,48427851000,48427851200,00000000200,a2f,recvmsg
0,48427851600,48427851700,00000000100,a2f,recvmsg
0,48427846500,48427856100,00000009600,a17,select
0,48427859100,48427859200,00000000100,a2f,recvmsg
0,48427864400,48427864600,00000000200,a2f,recvmsg
0,48427864900,48427865000,00000000100,a2f,recvmsg
0,48427859800,48427869600,00000009800,a17,select
0,48427872600,48427872800,00000000200,a2f,recvmsg
0,48427878000,48427878100,00000000100,a2f,recvmsg
0,48427878400,48427878600,00000000200,a2f,recvmsg
0,48427873300,48427883500,00000010200,a17,select
0,48427886500,48427886700,00000000200,a2f,recvmsg
0,48427891800,48427892000,00000000200,a2f,recvmsg
0,48427892400,48427892600,00000000200,a2f,recvmsg
0,48427887300,48427897200,00000009900,a17,select
0,48427900200,48427900300,00000000100,a2f,recvmsg
0,48427905500,48427905700,00000000200,a2f,recvmsg
0,48427906100,48427906200,00000000100,a2f,recvmsg
0,48427900900,48427911700,00000010800,a17,select
0,48427914800,48427915000,00000000200,a2f,recvmsg
0,48427920100,48427920300,00000000200,a2f,recvmsg
0,48427920700,48427920800,00000000100,a2f,recvmsg
0,48427915500,48427926000,00000010500,a17,select
0,48427929200,48427929400,00000000200,a2f,recvmsg
0,48427934400,48427934600,00000000200,a2f,recvmsg
0,48427935000,48427935100,00000000100,a2f,recvmsg
0,48427929800,48427940800,00000011000,a17,select
0,48427944000,48427944200,00000000200,a2f,recvmsg
0,48427949400,48427949500,00000000100,a2f,recvmsg
0,48427949900,48427950100,00000000200,a2f,recvmsg
0,48427944700,48427955500,00000010800,a17,select
0,48427958400,48427958600,00000000200,a2f,recvmsg
0,48427963700,48427963800,00000000100,a2f,recvmsg
0,48427964200,48427964300,00000000100,a2f,recvmsg
0,48427959200,48427969700,00000010500,a17,select
0,48427972900,48427973100,00000000200,a2f,recvmsg
0,48427978300,48427978400,00000000100,a2f,recvmsg
0,48427978800,48427978900,00000000100,a2f,recvmsg
0,48427973600,48427986400,00000012800,a17,select
0,48427989600,48427989700,00000000100,a2f,recvmsg
0,48427994900,48427995100,00000000200,a2f,recvmsg
0,48427995400,48427995600,00000000200,a2f,recvmsg
0,48427990300,48428000400,00000010100,a17,select
0,48428003400,48428003600,00000000200,a2f,recvmsg
0,48428008700,48428008800,00000000100,a2f,recvmsg
0,48428009200,48428009300,00000000100,a2f,recvmsg
0,48428004100,48428014200,00000010100,a17,select
0,48428017200,48428017400,00000000200,a2f,recvmsg
0,48428022600,48428022700,00000000100,a2f,recvmsg
0,48428023100,48428023300,00000000200,a2f,recvmsg
0,48428018000,48428029000,00000011000,a17,select
0,48428032100,48428032300,00000000200,a2f,recvmsg
0,48428037600,48428037700,00000000100,a2f,recvmsg
0,48428038000,48428038200,00000000200,a2f,recvmsg
0,48428032900,48428043600,00000010700,a17,select
0,48428046800,48428047000,00000000200,a2f,recvmsg
0,48428052300,48428052400,00000000100,a2f,recvmsg
0,48428052800,48428053000,00000000200,a2f,recvmsg
0,48428047400,48428058700,00000011300,a17,select
0,48428061800,48428062000,00000000200,a2f,recvmsg
0,48428067100,48428067300,00000000200,a2f,recvmsg
0,48428067600,48428067800,00000000200,a2f,recvmsg
0,48428062500,48428072900,00000010400,a17,select
0,48428075900,48428076100,00000000200,a2f,recvmsg
0,48428081300,48428081400,00000000100,a2f,recvmsg
0,48428081700,48428081900,00000000200,a2f,recvmsg
0,48428076700,48428086800,00000010100,a17,select
0,48428089800,48428090000,00000000200,a2f,recvmsg
0,48428095100,48428095300,00000000200,a2f,recvmsg
0,48428095600,48428095800,00000000200,a2f,recvmsg
0,48428090600,48428100500,00000009900,a17,select
0,48428103600,48428103700,00000000100,a2f,recvmsg
0,48428108900,48428109100,00000000200,a2f,recvmsg
0,48428109400,48428109600,00000000200,a2f,recvmsg
0,48428104300,48428115100,00000010800,a17,select
0,48428118100,48428118300,00000000200,a2f,recvmsg
0,48428123400,48428123600,00000000200,a2f,recvmsg
0,48428123900,48428124100,00000000200,a2f,recvmsg
0,48428125400,48428125500,00000000100,a08,lseek
0,48428128100,48428129000,00000000900,a00,read
0,48428132700,48428132800,00000000100,a08,lseek
0,48428118900,48428137500,00000018600,a17,select
0,48428140700,48428140800,00000000100,a2f,recvmsg
0,48428146400,48428146600,00000000200,a2f,recvmsg
0,48428147000,48428147200,00000000200,a2f,recvmsg
0,48428141500,48428175500,00000034000,a17,select
0,48428178900,48428179100,00000000200,a2f,recvmsg
0,48428184600,48428184700,00000000100,a2f,recvmsg
0,48428185100,48428185300,00000000200,a2f,recvmsg
0,48428189300,48428190100,00000000800,a00,read
0,48428195600,48428195800,00000000200,a08,lseek
0,48428179700,48428201300,00000021600,a17,select
0,48428204700,48428204900,00000000200,a2f,recvmsg
0,48428210300,48428210400,00000000100,a2f,recvmsg
0,48428210700,48428210900,00000000200,a2f,recvmsg
0,48428205400,48428215500,00000010100,a17,select
0,48428218400,48428218500,00000000100,a2f,recvmsg
0,48428223700,48428223800,00000000100,a2f,recvmsg
0,48428224100,48428224300,00000000200,a2f,recvmsg
0,48428219100,48428228700,00000009600,a17,select
0,48428231600,48428231700,00000000100,a2f,recvmsg
0,48428236900,48428237100,00000000200,a2f,recvmsg
0,48428237300,48428237500,00000000200,a2f,recvmsg
0,48428232300,48428241900,00000009600,a17,select
0,48428244900,48428245000,00000000100,a2f,recvmsg
0,48428250100,48428250300,00000000200,a2f,recvmsg
0,48428250600,48428250700,00000000100,a2f,recvmsg
0,48428245600,48428255100,00000009500,a17,select
0,48428258200,48428258300,00000000100,a2f,recvmsg
0,48428263400,48428263600,00000000200,a2f,recvmsg
0,48428263900,48428264000,00000000100,a2f,recvmsg
0,48428258800,48428268300,00000009500,a17,select
0,48428271300,48428271500,00000000200,a2f,recvmsg
0,48428276500,48428276600,00000000100,a2f,recvmsg
0,48428277000,48428277200,00000000200,a2f,recvmsg
0,48428272000,48428281500,00000009500,a17,select
0,48428284500,48428284600,00000000100,a2f,recvmsg
0,48428289700,48428289800,00000000100,a2f,recvmsg
0,48428290200,48428290400,00000000200,a2f,recvmsg
0,48428285100,48428295400,00000010300,a17,select
0,48428298500,48428298700,00000000200,a2f,recvmsg
0,48428303800,48428303900,00000000100,a2f,recvmsg
0,48428304200,48428304400,00000000200,a2f,recvmsg
0,48428299300,48428309000,00000009700,a17,select
0,48428311900,48428312100,00000000200,a2f,recvmsg
0,48428317100,48428317200,00000000100,a2f,recvmsg
0,48428317600,48428317800,00000000200,a2f,recvmsg
0,48428318400,48428318500,00000000100,a08,lseek
0,48428312600,48428324400,00000011800,a17,select
0,48428327600,48428327700,00000000100,a2f,recvmsg
0,48428333000,48428333200,00000000200,a2f,recvmsg
0,48428333500,48428333700,00000000200,a2f,recvmsg
0,48428328300,48428340500,00000012200,a17,select
0,48428343800,48428343900,00000000100,a2f,recvmsg
0,48428349200,48428349400,00000000200,a2f,recvmsg
0,48428349600,48428349800,00000000200,a2f,recvmsg
0,48428344500,48428355000,00000010500,a17,select
0,48428357900,48428358000,00000000100,a2f,recvmsg
0,48428363100,48428363300,00000000200,a2f,recvmsg
0,48428363700,48428363800,00000000100,a2f,recvmsg
0,48428358600,48428368600,00000010000,a17,select
0,48428371700,48428371800,00000000100,a2f,recvmsg
0,48428376900,48428377100,00000000200,a2f,recvmsg
0,48428377400,48428377600,00000000200,a2f,recvmsg
0,48428372300,48428382300,00000010000,a17,select
0,48428385300,48428385500,00000000200,a2f,recvmsg
0,48428390600,48428390800,00000000200,a2f,recvmsg
0,48428391200,48428391200,00000000000,a2f,recvmsg
0,48428386000,48428396100,00000010100,a17,select
0,48428399000,48428399200,00000000200,a2f,recvmsg
0,48428404600,48428404800,00000000200,a2f,recvmsg
0,48428405100,48428405300,00000000200,a2f,recvmsg
0,48428399700,48428410500,00000010800,a17,select
0,48428413700,48428413900,00000000200,a2f,recvmsg
0,48428419000,48428419200,00000000200,a2f,recvmsg
0,48428419600,48428419700,00000000100,a2f,recvmsg
0,48428414400,48428424500,00000010100,a17,select
0,48428427500,48428427700,00000000200,a2f,recvmsg
0,48428432900,48428433000,00000000100,a2f,recvmsg
0,48428433300,48428433500,00000000200,a2f,recvmsg
0,48428428300,48428438300,00000010000,a17,select
0,48428441200,48428441400,00000000200,a2f,recvmsg
0,48428446500,48428446600,00000000100,a2f,recvmsg
0,48428447000,48428447200,00000000200,a2f,recvmsg
0,48428442000,48428451900,00000009900,a17,select
0,48428454800,48428455000,00000000200,a2f,recvmsg
0,48428460100,48428460200,00000000100,a2f,recvmsg
0,48428460600,48428460800,00000000200,a2f,recvmsg
0,48428455600,48428465400,00000009800,a17,select
0,48428468400,48428468600,00000000200,a2f,recvmsg
0,48428473700,48428473900,00000000200,a2f,recvmsg
0,48428474200,48428474400,00000000200,a2f,recvmsg
0,48428469100,48428479000,00000009900,a17,select
0,48428482100,48428482200,00000000100,a2f,recvmsg
0,48428487300,48428487400,00000000100,a2f,recvmsg
0,48428487800,48428488000,00000000200,a2f,recvmsg
0,48428482700,48428493200,00000010500,a17,select
0,48428496200,48428496400,00000000200,a2f,recvmsg
0,48428501500,48428501700,00000000200,a2f,recvmsg
0,48428502100,48428502200,00000000100,a2f,recvmsg
0,48428497000,48428507000,00000010000,a17,select
0,48428510200,48428510400,00000000200,a2f,recvmsg
0,48428515400,48428515600,00000000200,a2f,recvmsg
0,48428516000,48428516200,00000000200,a2f,recvmsg
0,48428510900,48428520900,00000010000,a17,select
0,48428523900,48428524100,00000000200,a2f,recvmsg
0,48428529200,48428529400,00000000200,a2f,recvmsg
0,48428529700,48428529900,00000000200,a2f,recvmsg
0,48428524500,48428534600,00000010100,a17,select
0,48428537600,48428537700,00000000100,a2f,recvmsg
0,48428542900,48428543100,00000000200,a2f,recvmsg
0,48428543400,48428543600,00000000200,a2f,recvmsg
0,48428538300,48428554400,00000016100,a17,select
0,48428557700,48428557800,00000000100,a2f,recvmsg
0,48428563200,48428563400,00000000200,a2f,recvmsg
0,48428563800,48428564000,00000000200,a2f,recvmsg
0,48428558500,48428568900,00000010400,a17,select
0,48428571800,48428572000,00000000200,a2f,recvmsg
0,48428577200,48428577400,00000000200,a2f,recvmsg
0,48428577600,48428577800,00000000200,a2f,recvmsg
0,48428572600,48428582600,00000010000,a17,select
0,48428585400,48428585600,00000000200,a2f,recvmsg
0,48428590700,48428590800,00000000100,a2f,recvmsg
0,48428591100,48428591300,00000000200,a2f,recvmsg
0,48428586200,48428596300,00000010100,a17,select
0,48428599100,48428599300,00000000200,a2f,recvmsg
0,48428604300,48428604400,00000000100,a2f,recvmsg
0,48428604800,48428605000,00000000200,a2f,recvmsg
0,48428599900,48428610000,00000010100,a17,select
0,48428613000,48428613200,00000000200,a2f,recvmsg
0,48428618400,48428618600,00000000200,a2f,recvmsg
0,48428618900,48428619100,00000000200,a2f,recvmsg
0,48428663400,48428667200,00000003800,a14,writev
0,48428613700,48428671200,00000057500,a17,select
0,48428673600,48428674800,00000001200,a2f,recvmsg
0,48428760000,48428764900,00000004900,a14,writev
0,48428765400,48428769000,00000003600,a14,writev
0,48428845300,48428847100,00000001800,a14,writev
0,48428902900,48428905600,00000002700,a14,writev
0,48428905800,48428907400,00000001600,a14,writev
0,48428961000,48428962700,00000001700,a14,writev
0,48428962900,48428964300,00000001400,a14,writev
0,48429017200,48429018900,00000001700,a14,writev
0,48429019100,48429020800,00000001700,a14,writev
0,48429074300,48429076200,00000001900,a14,writev
0,48429076400,48429077800,00000001400,a14,writev
0,48429082100,48429082800,00000000700,a2f,recvmsg
0,48429130800,48429132400,00000001600,a14,writev
0,48429174900,48429176500,00000001600,a14,writev
0,48429218900,48429220500,00000001600,a14,writev
0,48429262000,48429263600,00000001600,a14,writev
0,48429303500,48429305000,00000001500,a14,writev
0,48429363200,48429364800,00000001600,a14,writev
0,48429390200,48429392200,00000002000,a2f,recvmsg
0,48429416800,48429419100,00000002300,a14,writev
0,48429436100,48429437900,00000001800,a14,writev
0,48429452200,48429453800,00000001600,a14,writev
0,48429468300,48429469900,00000001600,a14,writev
0,48429482900,48429484500,00000001600,a14,writev
0,48429496800,48429498700,00000001900,a14,writev
0,48429503100,48429503300,00000000200,a2f,recvmsg
0,48429504000,48429504400,00000000400,a14,writev
0,48429504600,48429504900,00000000300,a14,writev
0,48429522200,48429523800,00000001600,a14,writev
0,48429524100,48429525400,00000001300,a14,writev
0,48429525900,48429526100,00000000200,a2f,recvmsg
0,48428662900,48429534300,00000871400,a07,poll
0,48429539900,48429546100,00000006200,a2f,recvmsg
0,48429557700,48429557800,00000000100,a2f,recvmsg
0,48429584800,48429589600,00000004800,a07,poll
0,48429595800,48429602100,00000006300,a2f,recvmsg
0,48429614600,48429614800,00000000200,a2f,recvmsg
0,48429637200,48429641800,00000004600,a07,poll
0,48429647400,48429653900,00000006500,a2f,recvmsg
0,48429666100,48429666300,00000000200,a2f,recvmsg
0,48429526900,48429694200,00000167300,a17,select
0,48429708900,48429710100,00000001200,a14,writev
0,48429710600,48429710800,00000000200,a2f,recvmsg
0,48429724000,48429725000,00000001000,a14,writev
0,48429725300,48429725500,00000000200,a2f,recvmsg
0,48429737600,48429738600,00000001000,a14,writev
0,48429738900,48429739000,00000000100,a2f,recvmsg
0,48429688800,48429743300,00000054500,a07,poll
0,48429744000,48429744900,00000000900,a2f,recvmsg
0,48429749200,48429750000,00000000800,a2d,recvfrom
0,48429750900,48429751100,00000000200,a2f,recvmsg
0,48429751700,48429751900,00000000200,a2f,recvmsg
0,48429792700,48429793000,00000000300,a2f,recvmsg
0,48429795200,48429795300,00000000100,a2f,recvmsg
0,48429797400,48429799600,00000002200,a07,poll
0,48429800100,48429801200,00000001100,a2f,recvmsg
0,48429806100,48429806700,00000000600,a2d,recvfrom
0,48429807500,48429807700,00000000200,a2f,recvmsg
0,48429808400,48429808600,00000000200,a2f,recvmsg
0,48429837300,48429837600,00000000300,a2f,recvmsg
0,48429839500,48429839700,00000000200,a2f,recvmsg
0,48429842800,48429844800,00000002000,a07,poll
0,48429845400,48429846500,00000001100,a2f,recvmsg
0,48429851900,48429852400,00000000500,a2d,recvfrom
0,48429853500,48429853700,00000000200,a2f,recvmsg
0,48429854300,48429854400,00000000100,a2f,recvmsg
0,48429884300,48429884500,00000000200,a2f,recvmsg
0,48429886300,48429886500,00000000200,a2f,recvmsg
0,48429897200,48429897400,00000000200,a2f,recvmsg
0,48429897900,48429898100,00000000200,a2f,recvmsg
0,48429739600,48429931300,00000191700,a17,select
0,48429941600,48429944000,00000002400,a14,writev
0,48429946000,48429946100,00000000100,a2f,recvmsg
0,48429954000,48429954200,00000000200,a2f,recvmsg
0,48429954800,48429954900,00000000100,a2f,recvmsg
0,48430678200,48430685200,00000007000,a02,open
0,48430695200,48430697900,00000002700,a00,read
0,48430749600,48430750500,00000000900,a00,read
0,48430799000,48430799800,00000000800,a00,read
0,48430845700,48430846400,00000000700,a00,read
0,48430893500,48430894200,00000000700,a00,read
0,48430939900,48430940600,00000000700,a00,read
0,48430984700,48430985400,00000000700,a00,read
0,48431030700,48431031500,00000000800,a00,read
0,48431079100,48431079700,00000000600,a00,read
0,48431127800,48431128600,00000000800,a00,read
0,48431176600,48431177300,00000000700,a00,read
0,48431204800,48431206400,00000001600,a02,open
0,48431209700,48431210700,00000001000,a00,read
0,48431265300,48431266100,00000000800,a00,read
0,48431349100,48431349900,00000000800,a00,read
0,48431421100,48431421800,00000000700,a00,read
0,48431498900,48431499600,00000000700,a00,read
0,48431577500,48431578100,00000000600,a00,read
0,48431654600,48431655400,00000000800,a00,read
0,48431738500,48431739200,00000000700,a00,read
0,48431805900,48431806600,00000000700,a00,read
0,48431863700,48431864400,00000000700,a00,read
0,48429947300,48431950100,00002002800,a17,select
0,48431963500,48431963800,00000000300,a2f,recvmsg
0,48431932000,48431976100,00000044100,a07,poll
0,48431996700,48432001100,00000004400,a2e,sendmsg
0,48432008700,48432008800,00000000100,a00,read
0,48432013800,48432014900,00000001100,a2e,sendmsg
0,48432041400,48432041600,00000000200,a2f,recvmsg
0,48432042200,48432042400,00000000200,a2f,recvmsg
0,48431965900,48432049700,00000083800,a17,select
0,48432056000,48432056200,00000000200,a2f,recvmsg
0,48432063100,48432063300,00000000200,a2f,recvmsg
0,48432063700,48432063900,00000000200,a2f,recvmsg
0,48432069700,48432075600,00000005900,a06,lstat
0,48432076500,48432077300,00000000800,a06,lstat
0,48432101900,48432117900,00000016000,a01,write
0,48432057400,48432127300,00000069900,a17,select
0,48432133400,48432133600,00000000200,a2f,recvmsg
0,48432141000,48432141400,00000000400,a2f,recvmsg
0,48432141900,48432142100,00000000200,a2f,recvmsg
0,48432143600,48432490500,00000346900,a38,clone
0,48433270200,48433270400,00000000200,a0c,brk
0,48433280600,48433283400,00000002800,a15,access
0,48433284100,48433285000,00000000900,a09,mmap
0,48433288900,48433289700,00000000800,a15,access
0,48433296200,48433297100,00000000900,a09,mmap
0,48433300800,48433301300,00000000500,a15,access
0,48433308300,48433309200,00000000900,a00,read
0,48433310600,48433312300,00000001700,a09,mmap
0,48433316800,48433318900,00000002100,a09,mmap
0,48433330100,48433330800,00000000700,a15,access
0,48433334100,48433334800,00000000700,a00,read
0,48433335500,48433336400,00000000900,a09,mmap
0,48433336400,48433349000,00000012600,a0a,mprotect
0,48433349200,48433350600,00000001400,a09,mmap
0,48433359700,48433360300,00000000600,a15,access
0,48433363500,48433364300,00000000800,a00,read
0,48433368500,48433370800,00000002300,a09,mmap
0,48433375300,48433378400,00000003100,a09,mmap
0,48433380600,48433381600,00000001000,a09,mmap
0,48433390500,48433391300,00000000800,a15,access
0,48433393900,48433394500,00000000600,a00,read
0,48433395300,48433396800,00000001500,a09,mmap
0,48433399400,48433401000,00000001600,a09,mmap
0,48433409200,48433409900,00000000700,a15,access
0,48433413200,48433413800,00000000600,a00,read
0,48433414500,48433416000,00000001500,a09,mmap
0,48433419400,48433421700,00000002300,a09,mmap
0,48433430000,48433430600,00000000600,a15,access
0,48433433200,48433433800,00000000600,a00,read
0,48433434200,48433435400,00000001200,a09,mmap
0,48433436700,48433438000,00000001300,a09,mmap
0,48433440700,48433442100,00000001400,a09,mmap
0,48433448400,48433449000,00000000600,a15,access
0,48433451300,48433452000,00000000700,a00,read
0,48433452700,48433454000,00000001300,a09,mmap
0,48433456000,48433457700,00000001700,a09,mmap
0,48433474000,48433474600,00000000600,a09,mmap
0,48433478300,48433478800,00000000500,a09,mmap
0,48433479800,48433480100,00000000300,a09,mmap
0,48433654400,48433654500,00000000100,a0c,brk
0,48433654600,48433655500,00000000900,a0c,brk
0,48433692700,48433699200,00000006500,a00,read
0,48433710700,48433712300,00000001600,a00,read
0,48433748900,48433750000,00000001100,a00,read
0,48433870100,48433870800,00000000700,a00,read
0,48433942100,48433942800,00000000700,a00,read
0,48434029100,48434029900,00000000800,a00,read
0,48434159100,48434159800,00000000700,a00,read
0,48434288900,48434289600,00000000700,a00,read
0,48434444600,48434445300,00000000700,a00,read
0,48434594700,48434595400,00000000700,a00,read
0,48434632000,48434633200,00000001200,a0c,brk
0,48434747800,48434748600,00000000800,a00,read
0,48434895800,48434896600,00000000800,a00,read
0,48435050700,48435051300,00000000600,a00,read
0,48435209900,48435210500,00000000600,a00,read
0,48435320400,48435321000,00000000600,a00,read
0,48435351600,48435352200,00000000600,a0c,brk
0,48435459900,48435460700,00000000800,a00,read
0,48435697500,48435698100,00000000600,a00,read
0,48435710000,48435710300,00000000300,a00,read
0,48435753700,48435754100,00000000400,a00,read
0,48435773900,48435774600,00000000700,a00,read
0,48435982700,48435983200,00000000500,a00,read
0,48436011700,48436012500,00000000800,a00,read
0,48436109600,48436110300,00000000700,a00,read
0,48436134100,48436135200,00000001100,a0c,brk
0,48436180300,48436180700,00000000400,a00,read
0,48436256500,48436257300,00000000800,a00,read
0,48436410000,48436410500,00000000500,a00,read
0,48436522100,48436522700,00000000600,a00,read
0,48436618000,48436618500,00000000500,a00,read
0,48436630300,48436630800,00000000500,a00,read
0,48436711500,48436711900,00000000400,a00,read
0,48436735700,48436736000,00000000300,a00,read
0,48436757900,48436758500,00000000600,a00,read
0,48436859200,48436860300,00000001100,a0c,brk
0,48436861500,48436862500,00000001000,a00,read
0,48437061900,48437062600,00000000700,a00,read
0,48437144900,48437145500,00000000600,a00,read
0,48437208500,48437209100,00000000600,a00,read
0,48437344500,48437345000,00000000500,a00,read
0,48437377900,48437378300,00000000400,a00,read
0,48437395400,48437396700,00000001300,a02,open
0,48437509400,48437509900,00000000500,a00,read
0,48437580500,48437580900,00000000400,a00,read
0,48437632800,48437634000,00000001200,a0c,brk
0,48437640500,48437641400,00000000900,a00,read
0,48437748000,48437748600,00000000600,a00,read
0,48437897500,48437898500,00000001000,a00,read
0,48438027700,48438028300,00000000600,a00,read
0,48438086900,48438087600,00000000700,a00,read
0,48438143700,48438144400,00000000700,a00,read
0,48438214200,48438214900,00000000700,a00,read
0,48438267500,48438268200,00000000700,a00,read
0,48438356400,48438357100,00000000700,a0c,brk
0,48438387700,48438391900,00000004200,a0c,brk
0,48438406100,48438406800,00000000700,a00,read
0,48438521700,48438522500,00000000800,a00,read
0,48438680800,48438681600,00000000800,a00,read
0,48438798300,48438799200,00000000900,a00,read
0,48438943900,48438944700,00000000800,a00,read
0,48439062800,48439063500,00000000700,a00,read
0,48439224300,48439225000,00000000700,a00,read
0,48439229900,48439230600,00000000700,a0c,brk
0,48439344700,48439345300,00000000600,a00,read
0,48439463100,48439463800,00000000700,a00,read
0,48439604500,48439605100,00000000600,a00,read
0,48439736000,48439736600,00000000600,a00,read
0,48439829300,48439830000,00000000700,a00,read
0,48439942600,48439943200,00000000600,a00,read
0,48440066400,48440067000,00000000600,a00,read
0,48440177900,48440178500,00000000600,a0c,brk
0,48440201100,48440201600,00000000500,a00,read
0,48440369900,48440370600,00000000700,a00,read
0,48440520300,48440520900,00000000600,a00,read
0,48440630800,48440631500,00000000700,a00,read
0,48440798800,48440799700,00000000900,a00,read
0,48440876200,48440876900,00000000700,a00,read
0,48440957800,48440958400,00000000600,a00,read
0,48441024300,48441024900,00000000600,a0c,brk
0,48441038500,48441039100,00000000600,a00,read
0,48441111300,48441111900,00000000600,a00,read
0,48441212400,48441213000,00000000600,a00,read
0,48441314500,48441315100,00000000600,a00,read
0,48432139300,48445345500,00013206200,a07,poll
0,48445464600,48445467500,00000002900,a01,write
0,48445479500,48445480400,00000000900,a2f,recvmsg
0,48445482700,48445482900,00000000200,a00,read
0,48445491700,48445492700,00000001000,aca,futex
0,48445497300,48445502700,00000005400,aca,futex
0,48445542600,48445575800,00000033200,a07,poll
0,48445577900,48445578300,00000000400,aca,futex
0,48445581400,48445586200,00000004800,a2e,sendmsg
0,48445589200,48445589400,00000000200,a00,read
0,48445656100,48445658300,00000002200,a00,read
0,48445739300,48445740000,00000000700,a00,read
0,48445722300,48448058800,00002336500,60e,page_fault
0,48448383500,48448390900,00000007400,a02,open
0,48448401100,48448403900,00000002800,a00,read
0,48448455100,48448455800,00000000700,a00,read
0,48448504100,48448505000,00000000900,a00,read
0,48448550500,48448551300,00000000800,a00,read
0,48448598500,48448599300,00000000800,a00,read
0,48448645300,48448646100,00000000800,a00,read
0,48448690000,48448690700,00000000700,a00,read
0,48448736000,48448736700,00000000700,a00,read
0,48448784100,48448784800,00000000700,a00,read
0,48448833100,48448833700,00000000600,a00,read
0,48448880900,48448881600,00000000700,a00,read
0,48448909300,48448911000,00000001700,a02,open
0,48448914000,48448915000,00000001000,a00,read
0,48448969200,48448970100,00000000900,a00,read
0,48449062000,48449062900,00000000900,a00,read
0,48449134100,48449134900,00000000800,a00,read
0,48449211600,48449212300,00000000700,a00,read
0,48449289300,48449290000,00000000700,a00,read
0,48449365500,48449366300,00000000800,a00,read
0,48449448700,48449449400,00000000700,a00,read
0,48449514600,48449515300,00000000700,a00,read
0,48449572200,48449572900,00000000700,a00,read
0,48432134600,48449658200,00017523600,a17,select
0,48449671300,48449671500,00000000200,a2f,recvmsg
0,48449640700,48449683200,00000042500,a07,poll
0,48449704600,48449709600,00000005000,a2e,sendmsg
0,48449717100,48449717300,00000000200,a00,read
0,48449720400,48449721300,00000000900,a2e,sendmsg
0,48449745300,48449745500,00000000200,a2f,recvmsg
0,48449746100,48449746300,00000000200,a2f,recvmsg
0,48449673800,48449754400,00000080600,a17,select
0,48449760500,48449760700,00000000200,a2f,recvmsg
0,48449767600,48449767800,00000000200,a2f,recvmsg
0,48449768100,48449768300,00000000200,a2f,recvmsg
0,48449774700,48449780600,00000005900,a06,lstat
0,48449781400,48449782500,00000001100,a06,lstat
0,48449806000,48449821500,00000015500,a01,write
0,48449761800,48449831400,00000069600,a17,select
0,48449837400,48449837600,00000000200,a2f,recvmsg
0,48449845000,48449845200,00000000200,a2f,recvmsg
0,48449845800,48449845900,00000000100,a2f,recvmsg
0,48449847400,48450189700,00000342300,a38,clone
0,48458384300,48458385100,00000000800,a00,read
0,48458537000,48458537500,00000000500,a00,read
0,48458648900,48458649500,00000000600,a00,read
0,48458742500,48458742900,00000000400,a00,read
0,48458754800,48458755300,00000000500,a00,read
0,48458834800,48458835200,00000000400,a00,read
0,48458859000,48458859400,00000000400,a00,read
0,48458881700,48458882300,00000000600,a00,read
0,48458983800,48458984700,00000000900,a0c,brk
0,48458985800,48458986900,00000001100,a00,read
0,48459200000,48459200000,00000000000,a00,read
0,48459284400,48459285100,00000000700,a00,read
0,48459349700,48459349700,00000000000,a00,read
0,48459478100,48459478500,00000000400,a00,read
0,48459510500,48459511100,00000000600,a00,read
0,48459528000,48459529300,00000001300,a02,open
0,48459640000,48459640500,00000000500,a00,read
0,48459711600,48459711900,00000000300,a00,read
0,48459764000,48459765000,00000001000,a0c,brk
0,48459771700,48459772300,00000000600,a00,read
0,48459881000,48459881600,00000000600,a00,read
0,48460031000,48460032000,00000001000,a00,read
0,48460161900,48460162400,00000000500,a00,read
0,48460219500,48460220100,00000000600,a00,read
0,48460275900,48460276500,00000000600,a00,read
0,48460346200,48460346900,00000000700,a00,read
0,48460399600,48460400300,00000000700,a00,read
0,48460488700,48460489500,00000000800,a0c,brk
0,48460521000,48460525400,00000004400,a0c,brk
0,48460539400,48460540100,00000000700,a00,read
0,48460654900,48460655700,00000000800,a00,read
0,48460813100,48460813700,00000000600,a00,read
0,48460929900,48460930600,00000000700,a00,read
0,48461075700,48461076200,00000000500,a00,read
0,48461193000,48461193600,00000000600,a00,read
0,48461354300,48461355000,00000000700,a00,read
0,48461359800,48461360600,00000000800,a0c,brk
0,48461475000,48461475800,00000000800,a00,read
0,48461594900,48461595700,00000000800,a00,read
0,48461736400,48461737000,00000000600,a00,read
0,48461867500,48461868100,00000000600,a00,read
0,48461960100,48461960900,00000000800,a00,read
0,48462072400,48462073100,00000000700,a00,read
0,48462196700,48462197300,00000000600,a00,read
0,48462308300,48462308900,00000000600,a0c,brk
0,48462331700,48462332300,00000000600,a00,read
0,48462502200,48462502800,00000000600,a00,read
0,48462652400,48462653100,00000000700,a00,read
0,48462763200,48462763900,00000000700,a00,read
0,48462930600,48462931500,00000000900,a00,read
0,48463007900,48463008500,00000000600,a00,read
0,48463110600,48463111200,00000000600,a00,read
0,48463178200,48463179100,00000000900,a0c,brk
0,48463192500,48463193200,00000000700,a00,read
0,48463266800,48463267500,00000000700,a00,read
0,48463368100,48463368800,00000000700,a00,read
0,48463470400,48463471100,00000000700,a00,read
0,48463560100,48463560700,00000000600,a00,read
0,48463640800,48463641300,00000000500,a00,read
0,48463741700,48463742400,00000000700,a00,read
0,48463823900,48463824400,00000000500,a0c,brk
0,48463826800,48463827400,00000000600,a00,read
0,48463934000,48463934700,00000000700,a00,read
0,48464026600,48464027300,00000000700,a00,read
0,48464145700,48464146200,00000000500,a00,read
0,48464258900,48464259600,00000000700,a00,read
0,48464362000,48464362700,00000000700,a00,read
0,48464463500,48464464000,00000000500,a0c,brk
0,48464819000,48464822600,00000003600,a57,unlink
0,48464844200,48464844800,00000000600,a48,fcntl
0,48464893700,48464910100,00000016400,a01,write
0,48464928400,48464930900,00000002500,a01,write
0,48464946800,48464949100,00000002300,a01,write
0,48450211100,48465118200,00014907100,a3d,wait4
0,48465139400,48465140800,00000001400,a00,read
0,48465143300,48465143700,00000000400,a00,read
0,48449838600,48465173500,00015334900,a17,select
0,48465195900,48465196200,00000000300,a2f,recvmsg
0,48465210500,48465210700,00000000200,a2f,recvmsg
0,48465211800,48465211900,00000000100,a2f,recvmsg
0,48465199500,48465219400,00000019900,a17,select
0,48465223200,48465223400,00000000200,a2f,recvmsg
0,48465229200,48465229300,00000000100,a2f,recvmsg
0,48465229700,48465230000,00000000300,a2f,recvmsg
0,48465224000,48465235300,00000011300,a17,select
0,48465238900,48465239100,00000000200,a2f,recvmsg
0,48465244400,48465244600,00000000200,a2f,recvmsg
0,48465245000,48465245200,00000000200,a2f,recvmsg
0,48465239700,48465251100,00000011400,a17,select
0,48465254800,48465255000,00000000200,a2f,recvmsg
0,48465260300,48465260500,00000000200,a2f,recvmsg
0,48465260900,48465261000,00000000100,a2f,recvmsg
0,48465255600,48465266700,00000011100,a17,select
0,48465270500,48465270700,00000000200,a2f,recvmsg
0,48465275900,48465276000,00000000100,a2f,recvmsg
0,48465276400,48465276600,00000000200,a2f,recvmsg
0,48465271200,48465280800,00000009600,a17,select
0,48465284000,48465284200,00000000200,a2f,recvmsg
0,48465289300,48465289500,00000000200,a2f,recvmsg
0,48465289900,48465290000,00000000100,a2f,recvmsg
0,48465290700,48465290900,00000000200,a08,lseek
0,48465300600,48465300800,00000000200,a08,lseek
0,48465284700,48465305200,00000020500,a17,select
0,48465309000,48465309100,00000000100,a2f,recvmsg
0,48465314700,48465314900,00000000200,a2f,recvmsg
0,48465315300,48465315500,00000000200,a2f,recvmsg
0,48465309700,48465322300,00000012600,a17,select
0,48465325700,48465325900,00000000200,a2f,recvmsg
0,48465331400,48465331600,00000000200,a2f,recvmsg
0,48465331800,48465332000,00000000200,a2f,recvmsg
0,48465326400,48465337100,00000010700,a17,select
0,48465340200,48465340400,00000000200,a2f,recvmsg
0,48465345800,48465346000,00000000200,a2f,recvmsg
0,48465346300,48465346500,00000000200,a2f,recvmsg
0,48465341000,48465351900,00000010900,a17,select
0,48465354800,48465355000,00000000200,a2f,recvmsg
0,48465360500,48465360600,00000000100,a2f,recvmsg
0,48465361000,48465361200,00000000200,a2f,recvmsg
0,48465355600,48465366400,00000010800,a17,select
0,48465369800,48465369900,00000000100,a2f,recvmsg
0,48465375300,48465375400,00000000100,a2f,recvmsg
0,48465375700,48465375900,00000000200,a2f,recvmsg
0,48465370500,48465381400,00000010900,a17,select
0,48465384600,48465384800,00000000200,a2f,recvmsg
0,48465390200,48465390400,00000000200,a2f,recvmsg
0,48465390700,48465390800,00000000100,a2f,recvmsg
0,48465385300,48465396100,00000010800,a17,select
0,48465399300,48465399400,00000000100,a2f,recvmsg
0,48465404700,48465404800,00000000100,a2f,recvmsg
0,48465405200,48465405400,00000000200,a2f,recvmsg
0,48465400000,48465410000,00000010000,a17,select
0,48465413000,48465413200,00000000200,a2f,recvmsg
0,48465418600,48465418800,00000000200,a2f,recvmsg
0,48465419200,48465419300,00000000100,a2f,recvmsg
0,48465413700,48465425700,00000012000,a17,select
0,48465429100,48465429300,00000000200,a2f,recvmsg
0,48465434500,48465434700,00000000200,a2f,recvmsg
0,48465435000,48465435200,00000000200,a2f,recvmsg
0,48465429800,48465440400,00000010600,a17,select
0,48465443700,48465443900,00000000200,a2f,recvmsg
0,48465449100,48465449300,00000000200,a2f,recvmsg
0,48465449600,48465449800,00000000200,a2f,recvmsg
0,48465444300,48465454900,00000010600,a17,select
0,48465458100,48465458200,00000000100,a2f,recvmsg
0,48465463400,48465463600,00000000200,a2f,recvmsg
0,48465464000,48465464200,00000000200,a2f,recvmsg
0,48465458800,48465469300,00000010500,a17,select
0,48465472500,48465472700,00000000200,a2f,recvmsg
0,48465478000,48465478100,00000000100,a2f,recvmsg
0,48465478400,48465478600,00000000200,a2f,recvmsg
0,48465473200,48465483800,00000010600,a17,select
0,48465486900,48465487100,00000000200,a2f,recvmsg
0,48465493300,48465493400,00000000100,a2f,recvmsg
0,48465493800,48465494000,00000000200,a2f,recvmsg
0,48465487600,48465499400,00000011800,a17,select
0,48465502600,48465502800,00000000200,a2f,recvmsg
0,48465508000,48465508200,00000000200,a2f,recvmsg
0,48465508500,48465508600,00000000100,a2f,recvmsg
0,48465503200,48465513800,00000010600,a17,select
0,48465516900,48465517000,00000000100,a2f,recvmsg
0,48465522200,48465522400,00000000200,a2f,recvmsg
0,48465522700,48465522900,00000000200,a2f,recvmsg
0,48465517600,48465527500,00000009900,a17,select
0,48465530700,48465530900,00000000200,a2f,recvmsg
0,48465536100,48465536200,00000000100,a2f,recvmsg
0,48465536600,48465536800,00000000200,a2f,recvmsg
0,48465531400,48465543600,00000012200,a17,select
0,48465546700,48465546900,00000000200,a2f,recvmsg
0,48465552200,48465552300,00000000100,a2f,recvmsg
0,48465552700,48465552900,00000000200,a2f,recvmsg
0,48465547500,48465557500,00000010000,a17,select
0,48465560600,48465560800,00000000200,a2f,recvmsg
0,48465565900,48465566100,00000000200,a2f,recvmsg
0,48465566500,48465566600,00000000100,a2f,recvmsg
0,48465561400,48465571200,00000009800,a17,select
0,48465574100,48465574300,00000000200,a2f,recvmsg
0,48465579400,48465579600,00000000200,a2f,recvmsg
0,48465579900,48465580100,00000000200,a2f,recvmsg
0,48465574900,48465584600,00000009700,a17,select
0,48465587700,48465587900,00000000200,a2f,recvmsg
0,48465593000,48465593200,00000000200,a2f,recvmsg
0,48465593600,48465593700,00000000100,a2f,recvmsg
0,48465588400,48465598600,00000010200,a17,select
0,48465601600,48465601800,00000000200,a2f,recvmsg
0,48465607100,48465607200,00000000100,a2f,recvmsg
0,48465607500,48465607700,00000000200,a2f,recvmsg
0,48465602400,48465612500,00000010100,a17,select
0,48465615500,48465615700,00000000200,a2f,recvmsg
0,48465620900,48465621100,00000000200,a2f,recvmsg
0,48465621400,48465621600,00000000200,a2f,recvmsg
0,48465616300,48465628000,00000011700,a17,select
0,48465631100,48465631300,00000000200,a2f,recvmsg
0,48465636400,48465636600,00000000200,a2f,recvmsg
0,48465637000,48465637200,00000000200,a2f,recvmsg
0,48465631800,48465642400,00000010600,a17,select
0,48465645500,48465645700,00000000200,a2f,recvmsg
0,48465650900,48465651000,00000000100,a2f,recvmsg
0,48465651400,48465651600,00000000200,a2f,recvmsg
0,48465646300,48465657400,00000011100,a17,select
0,48465660600,48465660800,00000000200,a2f,recvmsg
0,48465666100,48465666200,00000000100,a2f,recvmsg
0,48465666600,48465666700,00000000100,a2f,recvmsg
0,48465661400,48465672400,00000011000,a17,select
0,48465675500,48465675700,00000000200,a2f,recvmsg
0,48465680900,48465681100,00000000200,a2f,recvmsg
0,48465681400,48465681500,00000000100,a2f,recvmsg
0,48465676300,48465687100,00000010800,a17,select
0,48465690300,48465690500,00000000200,a2f,recvmsg
0,48465695600,48465695800,00000000200,a2f,recvmsg
0,48465696100,48465696300,00000000200,a2f,recvmsg
0,48465690900,48465703900,00000013000,a17,select
0,48465707100,48465707300,00000000200,a2f,recvmsg
0,48465712700,48465712900,00000000200,a2f,recvmsg
0,48465713300,48465713500,00000000200,a2f,recvmsg
0,48465707900,48465718400,00000010500,a17,select
0,48465721400,48465721600,00000000200,a2f,recvmsg
0,48465726800,48465727000,00000000200,a2f,recvmsg
0,48465727200,48465727400,00000000200,a2f,recvmsg
0,48465722100,48465732400,00000010300,a17,select
0,48465735700,48465735900,00000000200,a2f,recvmsg
0,48465741100,48465741200,00000000100,a2f,recvmsg
0,48465741600,48465741800,00000000200,a2f,recvmsg
0,48465736500,48465747800,00000011300,a17,select
0,48465750900,48465751100,00000000200,a2f,recvmsg
0,48465756300,48465756400,00000000100,a2f,recvmsg
0,48465756800,48465757000,00000000200,a2f,recvmsg
0,48465751700,48465762400,00000010700,a17,select
0,48465765700,48465765800,00000000100,a2f,recvmsg
0,48465771900,48465772100,00000000200,a2f,recvmsg
0,48465772500,48465772600,00000000100,a2f,recvmsg
0,48465766400,48465778500,00000012100,a17,select
0,48465781900,48465782100,00000000200,a2f,recvmsg
0,48465787400,48465787500,00000000100,a2f,recvmsg
0,48465787800,48465788000,00000000200,a2f,recvmsg
0,48465782600,48465793400,00000010800,a17,select
0,48465796600,48465796800,00000000200,a2f,recvmsg
0,48465801900,48465802000,00000000100,a2f,recvmsg
0,48465802400,48465802600,00000000200,a2f,recvmsg
0,48465797300,48465807500,00000010200,a17,select
0,48465810700,48465810900,00000000200,a2f,recvmsg
0,48465816100,48465816300,00000000200,a2f,recvmsg
0,48465816600,48465816800,00000000200,a2f,recvmsg
0,48465811400,48465821700,00000010300,a17,select
0,48465824700,48465824900,00000000200,a2f,recvmsg
0,48465830200,48465830400,00000000200,a2f,recvmsg
0,48465830700,48465830900,00000000200,a2f,recvmsg
0,48465825500,48465836300,00000010800,a17,select
0,48465839400,48465839600,00000000200,a2f,recvmsg
0,48465844800,48465845000,00000000200,a2f,recvmsg
0,48465845400,48465845500,00000000100,a2f,recvmsg
0,48465846800,48465846900,00000000100,a08,lseek
0,48465849700,48465850600,00000000900,a00,read
0,48465854300,48465854300,00000000000,a08,lseek
0,48465840200,48465859200,00000019000,a17,select
0,48465862500,48465862600,00000000100,a2f,recvmsg
0,48465868200,48465868300,00000000100,a2f,recvmsg
0,48465868700,48465868900,00000000200,a2f,recvmsg
0,48465863300,48465899200,00000035900,a17,select
0,48465902600,48465902800,00000000200,a2f,recvmsg
0,48465908300,48465908400,00000000100,a2f,recvmsg
0,48465908800,48465909000,00000000200,a2f,recvmsg
0,48465913200,48465914000,00000000800,a00,read
0,48465920000,48465920100,00000000100,a08,lseek
0,48465903400,48465925600,00000022200,a17,select
0,48465928900,48465929000,00000000100,a2f,recvmsg
0,48465934400,48465934600,00000000200,a2f,recvmsg
0,48465934900,48465935100,00000000200,a2f,recvmsg
0,48465929700,48465939800,00000010100,a17,select
0,48465942700,48465942900,00000000200,a2f,recvmsg
0,48465948000,48465948200,00000000200,a2f,recvmsg
0,48465948600,48465948700,00000000100,a2f,recvmsg
0,48465943400,48465953100,00000009700,a17,select
0,48465956000,48465956200,00000000200,a2f,recvmsg
0,48465961200,48465961400,00000000200,a2f,recvmsg
0,48465961800,48465961900,00000000100,a2f,recvmsg
0,48465956800,48465966400,00000009600,a17,select
0,48465969400,48465969500,00000000100,a2f,recvmsg
0,48465974600,48465974800,00000000200,a2f,recvmsg
0,48465975100,48465975300,00000000200,a2f,recvmsg
0,48465970100,48465979700,00000009600,a17,select
0,48465982600,48465982800,00000000200,a2f,recvmsg
0,48465987900,48465988000,00000000100,a2f,recvmsg
0,48465988400,48465988600,00000000200,a2f,recvmsg
0,48465983400,48465993000,00000009600,a17,select
0,48465996000,48465996100,00000000100,a2f,recvmsg
0,48466001200,48466001400,00000000200,a2f,recvmsg
0,48466001800,48466002000,00000000200,a2f,recvmsg
0,48465996700,48466006300,00000009600,a17,select
0,48466009200,48466009300,00000000100,a2f,recvmsg
0,48466014400,48466014600,00000000200,a2f,recvmsg
0,48466014900,48466015100,00000000200,a2f,recvmsg
0,48466009900,48466020200,00000010300,a17,select
0,48466023600,48466023800,00000000200,a2f,recvmsg
0,48466028900,48466029100,00000000200,a2f,recvmsg
0,48466029300,48466029500,00000000200,a2f,recvmsg
0,48466024300,48466034100,00000009800,a17,select
0,48466037100,48466037300,00000000200,a2f,recvmsg
0,48466042400,48466042500,00000000100,a2f,recvmsg
0,48466042900,48466043000,00000000100,a2f,recvmsg
0,48466043600,48466043800,00000000200,a08,lseek
0,48466037800,48466049500,00000011700,a17,select
0,48466052500,48466052700,00000000200,a2f,recvmsg
0,48466058000,48466058100,00000000100,a2f,recvmsg
0,48466058500,48466058700,00000000200,a2f,recvmsg
0,48466053300,48466065400,00000012100,a17,select
0,48466068600,48466068800,00000000200,a2f,recvmsg
0,48466074000,48466074200,00000000200,a2f,recvmsg
0,48466074600,48466074700,00000000100,a2f,recvmsg
0,48466069300,48466079800,00000010500,a17,select
0,48466082700,48466082900,00000000200,a2f,recvmsg
0,48466088000,48466088200,00000000200,a2f,recvmsg
0,48466088500,48466088700,00000000200,a2f,recvmsg
0,48466083400,48466093600,00000010200,a17,select
0,48466096500,48466096700,00000000200,a2f,recvmsg
0,48466101900,48466102100,00000000200,a2f,recvmsg
0,48466102400,48466102600,00000000200,a2f,recvmsg
0,48466097300,48466107200,00000009900,a17,select
0,48466110200,48466110400,00000000200,a2f,recvmsg
0,48466115600,48466115800,00000000200,a2f,recvmsg
0,48466116100,48466116300,00000000200,a2f,recvmsg
0,48466110800,48466121100,00000010300,a17,select
0,48466124100,48466124200,00000000100,a2f,recvmsg
0,48466129500,48466129600,00000000100,a2f,recvmsg
0,48466129900,48466130100,00000000200,a2f,recvmsg
0,48466124800,48466135400,00000010600,a17,select
0,48466138300,48466138500,00000000200,a2f,recvmsg
0,48466143600,48466143700,00000000100,a2f,recvmsg
0,48466144100,48466144300,00000000200,a2f,recvmsg
0,48466139100,48466149100,00000010000,a17,select
0,48466152100,48466152300,00000000200,a2f,recvmsg
0,48466157700,48466157900,00000000200,a2f,recvmsg
0,48466158300,48466158400,00000000100,a2f,recvmsg
0,48466152800,48466163100,00000010300,a17,select
0,48466166100,48466166200,00000000100,a2f,recvmsg
0,48466171400,48466171600,00000000200,a2f,recvmsg
0,48466171900,48466172000,00000000100,a2f,recvmsg
0,48466166800,48466176800,00000010000,a17,select
0,48466179800,48466180000,00000000200,a2f,recvmsg
0,48466185100,48466185300,00000000200,a2f,recvmsg
0,48466185700,48466185900,00000000200,a2f,recvmsg
0,48466180600,48466190600,00000010000,a17,select
0,48466193500,48466193700,00000000200,a2f,recvmsg
0,48471067400,48471067500,00000000100,a2f,recvmsg
0,48471067900,48471068100,00000000200,a2f,recvmsg
0,48466194200,48471074300,00004880100,a17,select
0,48471078200,48471078300,00000000100,a2f,recvmsg
0,48471084000,48471084200,00000000200,a2f,recvmsg
0,48471084500,48471084700,00000000200,a2f,recvmsg
0,48471079100,48471090100,00000011000,a17,select
0,48471093200,48471093300,00000000100,a2f,recvmsg
0,48471098500,48471098700,00000000200,a2f,recvmsg
0,48471099000,48471099200,00000000200,a2f,recvmsg
0,48471094000,48471104000,00000010000,a17,select
0,48471107000,48471107200,00000000200,a2f,recvmsg
0,48471112200,48471112400,00000000200,a2f,recvmsg
0,48471112700,48471112900,00000000200,a2f,recvmsg
0,48471107700,48471117700,00000010000,a17,select
0,48471120900,48471121000,00000000100,a2f,recvmsg
0,48471126100,48471126300,00000000200,a2f,recvmsg
0,48471126600,48471126800,00000000200,a2f,recvmsg
0,48471121500,48471131500,00000010000,a17,select
0,48471134400,48471134600,00000000200,a2f,recvmsg
0,48471139800,48471139900,00000000100,a2f,recvmsg
0,48471140200,48471140400,00000000200,a2f,recvmsg
0,48471135200,48471151100,00000015900,a17,select
0,48471154200,48471154300,00000000100,a2f,recvmsg
0,48471160000,48471160200,00000000200,a2f,recvmsg
0,48471160500,48471160700,00000000200,a2f,recvmsg
0,48471155000,48471165600,00000010600,a17,select
0,48471168600,48471168700,00000000100,a2f,recvmsg
0,48471173900,48471174100,00000000200,a2f,recvmsg
0,48471174400,48471174500,00000000100,a2f,recvmsg
0,48471169300,48471179300,00000010000,a17,select
0,48471182200,48471182400,00000000200,a2f,recvmsg
0,48471187700,48471187900,00000000200,a2f,recvmsg
0,48471188200,48471188400,00000000200,a2f,recvmsg
0,48471183000,48471193400,00000010400,a17,select
0,48471196400,48471196600,00000000200,a2f,recvmsg
0,48471201600,48471201800,00000000200,a2f,recvmsg
0,48471202100,48471202300,00000000200,a2f,recvmsg
0,48471197100,48471207300,00000010200,a17,select
0,48471210300,48471210400,00000000100,a2f,recvmsg
0,48471215600,48471215800,00000000200,a2f,recvmsg
0,48471216100,48471216300,00000000200,a2f,recvmsg
0,48471260300,48471264300,00000004000,a14,writev
0,48471211000,48471268000,00000057000,a17,select
0,48471270500,48471271600,00000001100,a2f,recvmsg
0,48471356700,48471360300,00000003600,a14,writev
0,48471360900,48471364100,00000003200,a14,writev
0,48471440000,48471441800,00000001800,a14,writev
0,48471442100,48471443800,00000001700,a14,writev
0,48471499700,48471501700,00000002000,a14,writev
0,48471502000,48471504200,00000002200,a14,writev
0,48471558900,48471560600,00000001700,a14,writev
0,48471560800,48471562400,00000001600,a14,writev
0,48471615100,48471616800,00000001700,a14,writev
0,48471617000,48471618500,00000001500,a14,writev
0,48471671000,48471672900,00000001900,a14,writev
0,48471673200,48471674600,00000001400,a14,writev
0,48471678800,48471679500,00000000700,a2f,recvmsg
0,48471726700,48471728200,00000001500,a14,writev
0,48471769200,48471770900,00000001700,a14,writev
0,48471812000,48471813400,00000001400,a14,writev
0,48471854500,48471856300,00000001800,a14,writev
0,48471897000,48471898800,00000001800,a14,writev
0,48471939700,48471941100,00000001400,a14,writev
0,48471965600,48471967300,00000001700,a2f,recvmsg
0,48471992100,48471994200,00000002100,a14,writev
0,48472010300,48472012400,00000002100,a14,writev
0,48472026400,48472028000,00000001600,a14,writev
0,48472041800,48472043400,00000001600,a14,writev
0,48472056100,48472057900,00000001800,a14,writev
0,48472071300,48472073000,00000001700,a14,writev
0,48472077200,48472077400,00000000200,a2f,recvmsg
0,48472078200,48472078600,00000000400,a14,writev
0,48472078800,48472079200,00000000400,a14,writev
0,48472096100,48472098000,00000001900,a14,writev
0,48472098200,48472099900,00000001700,a14,writev
0,48472100500,48472100700,00000000200,a2f,recvmsg
0,48471259800,48472108800,00000849000,a07,poll
0,48472114700,48472121200,00000006500,a2f,recvmsg
0,48472132700,48472132900,00000000200,a2f,recvmsg
0,48472159900,48472164800,00000004900,a07,poll
0,48472170600,48472177000,00000006400,a2f,recvmsg
0,48472189500,48472189700,00000000200,a2f,recvmsg
0,48472212900,48472217200,00000004300,a07,poll
0,48472223100,48472228900,00000005800,a2f,recvmsg
0,48472241700,48472242000,00000000300,a2f,recvmsg
0,48472101500,48472270600,00000169100,a17,select
0,48472285100,48472286600,00000001500,a14,writev
0,48472287100,48472287300,00000000200,a2f,recvmsg
0,48472301000,48472301900,00000000900,a14,writev
0,48472302200,48472302400,00000000200,a2f,recvmsg
0,48472314400,48472315800,00000001400,a14,writev
0,48472316100,48472316200,00000000100,a2f,recvmsg
0,48472265400,48472320300,00000054900,a07,poll
0,48472321000,48472321900,00000000900,a2f,recvmsg
0,48472326700,48472327600,00000000900,a2d,recvfrom
0,48472328500,48472328700,00000000200,a2f,recvmsg
0,48472329400,48472329500,00000000100,a2f,recvmsg
0,48472370600,48472370900,00000000300,a2f,recvmsg
0,48472373100,48472373200,00000000100,a2f,recvmsg
0,48472375400,48472377500,00000002100,a07,poll
0,48472378000,48472379200,00000001200,a2f,recvmsg
0,48472384000,48472384600,00000000600,a2d,recvfrom
0,48472385400,48472385600,00000000200,a2f,recvmsg
0,48472386200,48472386400,00000000200,a2f,recvmsg
0,48472414800,48472415000,00000000200,a2f,recvmsg
0,48472416800,48472416900,00000000100,a2f,recvmsg
0,48472420000,48472422100,00000002100,a07,poll
0,48472422600,48472423800,00000001200,a2f,recvmsg
0,48472428700,48472429400,00000000700,a2d,recvfrom
0,48472430400,48472430600,00000000200,a2f,recvmsg
0,48472431300,48472431500,00000000200,a2f,recvmsg
0,48472460600,48472460800,00000000200,a2f,recvmsg
0,48472462500,48472462700,00000000200,a2f,recvmsg
0,48472473900,48472474000,00000000100,a2f,recvmsg
0,48472474600,48472474800,00000000200,a2f,recvmsg
0,48472316700,48472507100,00000190400,a17,select
0,48472517000,48472519100,00000002100,a14,writev
0,48472520900,48472521100,00000000200,a2f,recvmsg
0,48472528900,48472529000,00000000100,a2f,recvmsg
0,48472529500,48472529700,00000000200,a2f,recvmsg
0,48473128900,48473135100,00000006200,a07,poll
0,48473148100,48473153400,00000005300,a2e,sendmsg
0,48405812000,48473156700,00067344700,ae8,epoll_wait
0,48473169500,48473171200,00000001700,a2f,recvmsg
0,48473185400,48473185700,00000000300,a2f,recvmsg
0,48473243300,48473246900,00000003600,a2e,sendmsg
0,48473128900,48473256600,00000127700,a07,poll
0,48473274900,48473276100,00000001200,a2f,recvmsg
0,48473351700,48473354000,00000002300,a07,poll
0,48473351700,48473495600,00000143900,a07,poll
0,48473498900,48473500500,00000001600,aca,futex
0,48473502800,48473503700,00000000900,aca,futex
0,48473505300,48473506100,00000000800,aca,futex
0,48473509400,48473512300,00000002900,a2e,sendmsg
0,48473515100,48473515300,00000000200,a00,read
0,48473252800,48473534300,00000281500,ae8,epoll_wait
0,48473538000,48473539400,00000001400,a2f,recvmsg
0,48473558600,48473558800,00000000200,a2f,recvmsg
0,48473587000,48473588200,00000001200,a2e,sendmsg
0,48473603900,48473606300,00000002400,a2f,recvmsg
0,48473613800,48473614600,00000000800,a2f,recvmsg
0,48473629200,48473631700,00000002500,a2e,sendmsg
0,48473591000,48473633300,00000042300,ae8,epoll_wait
0,48473635800,48473636400,00000000600,a2f,recvmsg
0,48473643800,48473644000,00000000200,a2f,recvmsg
0,48473675300,48473676700,00000001400,a2e,sendmsg
0,48473612800,48473682300,00000069500,a07,poll
0,48473690100,48473690700,00000000600,a2f,recvmsg
0,48473740800,48473742500,00000001700,a07,poll
0,48473740800,48473847900,00000107100,a07,poll
0,48473849900,48473851100,00000001200,aca,futex
0,48473853100,48473854000,00000000900,aca,futex
0,48473855300,48473856100,00000000800,aca,futex
0,48473858600,48473860700,00000002100,a2e,sendmsg
0,48473863200,48473863400,00000000200,a00,read
0,48473680500,48473881800,00000201300,ae8,epoll_wait
0,48473885300,48473886500,00000001200,a2f,recvmsg
0,48473905000,48473905200,00000000200,a2f,recvmsg
0,48473930100,48473931200,00000001100,a2e,sendmsg
0,48474091700,48474092000,00000000300,a00,read
0,48474093700,48474094500,00000000800,a2f,recvmsg
0,48474198900,48474201300,00000002400,a07,poll
0,48474521500,48474529300,00000007800,a02,open
0,48474541100,48474544100,00000003000,a00,read
0,48474598800,48474599800,00000001000,a00,read
0,48474650100,48474650900,00000000800,a00,read
0,48474700600,48474701300,00000000700,a00,read
0,48474751500,48474752100,00000000600,a00,read
0,48474800800,48474801400,00000000600,a00,read
0,48474847400,48474848200,00000000800,a00,read
0,48474897200,48474897900,00000000700,a00,read
0,48474949200,48474949800,00000000600,a00,read
0,48475000200,48475000900,00000000700,a00,read
0,48475061200,48475062000,00000000800,a00,read
0,48475089900,48475091800,00000001900,a02,open
0,48475095400,48475096300,00000000900,a00,read
0,48475152200,48475152900,00000000700,a00,read
0,48475237500,48475238300,00000000800,a00,read
0,48475310800,48475311500,00000000700,a00,read
0,48475389100,48475389800,00000000700,a00,read
0,48475468600,48475469300,00000000700,a00,read
0,48475546400,48475547200,00000000800,a00,read
0,48475631600,48475632200,00000000600,a00,read
0,48475698900,48475699600,00000000700,a00,read
0,48475757400,48475758100,00000000700,a00,read
0,48472522300,48475848100,00003325800,a17,select
0,48475865500,48475865800,00000000300,a2f,recvmsg
0,48475880200,48475880400,00000000200,a2f,recvmsg
0,48475881000,48475881100,00000000100,a2f,recvmsg
0,48475868800,48475886600,00000017800,a17,select
0,48475890900,48475891100,00000000200,a2f,recvmsg
0,48475897000,48475897200,00000000200,a2f,recvmsg
0,48475897600,48475897700,00000000100,a2f,recvmsg
0,48475903400,48475910000,00000006600,a06,lstat
0,48475910800,48475911900,00000001100,a06,lstat
0,48475934200,48475948100,00000013900,a01,write
0,48475891900,48475957400,00000065500,a17,select
0,48475963200,48475963400,00000000200,a2f,recvmsg
0,48475971200,48475971400,00000000200,a2f,recvmsg
0,48475971900,48475972000,00000000100,a2f,recvmsg
0,48475973500,48476289100,00000315600,a38,clone
0,48476765800,48476765900,00000000100,a0c,brk
0,48476775600,48476778400,00000002800,a15,access
0,48476779100,48476780000,00000000900,a09,mmap
0,48476783900,48476784800,00000000900,a15,access
0,48476791100,48476792300,00000001200,a09,mmap
0,48476795900,48476796400,00000000500,a15,access
0,48476803500,48476804500,00000001000,a00,read
0,48476807000,48476808400,00000001400,a09,mmap
0,48476812500,48476814700,00000002200,a09,mmap
0,48476826200,48476826800,00000000600,a15,access
0,48476830400,48476830900,00000000500,a00,read
0,48476831800,48476832500,00000000700,a09,mmap
0,48476835400,48476836600,00000001200,a09,mmap
0,48476844300,48476844900,00000000600,a15,access
0,48476847700,48476848300,00000000600,a00,read
0,48476849000,48476849900,00000000900,a09,mmap
0,48476851800,48476854000,00000002200,a09,mmap
0,48476858900,48476862100,00000003200,a09,mmap
0,48476864200,48476865400,00000001200,a09,mmap
0,48476875000,48476875500,00000000500,a15,access
0,48476878100,48476878600,00000000500,a00,read
0,48476879400,48476880900,00000001500,a09,mmap
0,48476884400,48476886000,00000001600,a09,mmap
0,48476894200,48476894700,00000000500,a15,access
0,48476897700,48476898200,00000000500,a00,read
0,48476899000,48476900400,00000001400,a09,mmap
0,48476904500,48476906600,00000002100,a09,mmap
0,48476915400,48476916000,00000000600,a15,access
0,48476918200,48476918800,00000000600,a00,read
0,48476926400,48476927600,00000001200,a09,mmap
0,48476933900,48476934500,00000000600,a15,access
0,48476936700,48476937200,00000000500,a00,read
0,48476937800,48476939200,00000001400,a09,mmap
0,48476942000,48476943600,00000001600,a09,mmap
0,48476957900,48476958400,00000000500,a09,mmap
0,48476961900,48476962300,00000000400,a09,mmap
0,48476963500,48476963700,00000000200,a09,mmap
0,48477145100,48477145200,00000000100,a0c,brk
0,48477145300,48477146100,00000000800,a0c,brk
0,48477180900,48477181900,00000001000,a00,read
0,48477193400,48477194900,00000001500,a00,read
0,48477231700,48477232600,00000000900,a00,read
0,48477353400,48477354200,00000000800,a00,read
0,48477428000,48477428700,00000000700,a00,read
0,48477517800,48477518600,00000000800,a00,read
0,48475969400,48477649800,00001680400,a07,poll
0,48477653800,48477654600,00000000800,a00,read
0,48477783200,48477784200,00000001000,a2f,recvmsg
0,48477786300,48477786400,00000000100,a00,read
0,48477850200,48477851500,00000001300,a00,read
0,48477985200,48477986200,00000001000,a00,read
0,48477831900,48478079300,00000247400,a07,poll
0,48478086400,48478091200,00000004800,a2e,sendmsg
0,48478094300,48478094500,00000000200,a00,read
0,48478174400,48478176000,00000001600,a00,read
0,48478327800,48478328600,00000000800,a00,read
0,48478483500,48478484200,00000000700,a00,read
0,48478632800,48478633500,00000000700,a00,read
0,48478789500,48478790100,00000000600,a00,read
0,48478950000,48478950800,00000000800,a00,read
0,48479068800,48479069700,00000000900,a00,read
0,48479100800,48479101600,00000000800,a0c,brk
0,48479211400,48479212200,00000000800,a00,read
0,48479465900,48479466400,00000000500,a00,read
0,48479478600,48479479000,00000000400,a00,read
0,48479523400,48479523800,00000000400,a00,read
0,48479543800,48479544400,00000000600,a00,read
0,48479754800,48479755300,00000000500,a00,read
0,48479785000,48479785800,00000000800,a00,read
0,48479883500,48479884300,00000000800,a00,read
0,48479908300,48479909400,00000001100,a0c,brk
0,48479954400,48479954900,00000000500,a00,read
0,48480031900,48480032600,00000000700,a00,read
0,48480185900,48480186300,00000000400,a00,read
0,48480300700,48480301400,00000000700,a00,read
0,48480396000,48480396500,00000000500,a00,read
0,48480408400,48480408900,00000000500,a00,read
0,48480491400,48480491900,00000000500,a00,read
0,48480516300,48480516600,00000000300,a00,read
0,48480538900,48480539400,00000000500,a00,read
0,48480641500,48480642500,00000001000,a0c,brk
0,48480643600,48480644500,00000000900,a00,read
0,48480845500,48480846000,00000000500,a00,read
0,48480929500,48480930100,00000000600,a00,read
0,48480993400,48480994000,00000000600,a00,read
0,48481123600,48481124100,00000000500,a00,read
0,48481156200,48481156900,00000000700,a00,read
0,48481174100,48481175500,00000001400,a02,open
0,48481287100,48481287700,00000000600,a00,read
0,48481358300,48481358600,00000000300,a00,read
0,48481411600,48481412800,00000001200,a0c,brk
0,48481418900,48481419500,00000000600,a00,read
0,48481527400,48481528000,00000000600,a00,read
0,48481679400,48481680400,00000001000,a00,read
0,48481810500,48481811200,00000000700,a00,read
0,48481869000,48481869600,00000000600,a00,read
0,48481925900,48481926500,00000000600,a00,read
0,48481996700,48481997300,00000000600,a00,read
0,48482050200,48482050900,00000000700,a00,read
0,48482139500,48482140400,00000000900,a0c,brk
0,48482170800,48482175600,00000004800,a0c,brk
0,48482189800,48482190500,00000000700,a00,read
0,48482306000,48482306700,00000000700,a00,read
0,48482465200,48482466000,00000000800,a00,read
0,48482583300,48482583900,00000000600,a00,read
0,48482731300,48482732000,00000000700,a00,read
0,48482849700,48482850200,00000000500,a00,read
0,48483012100,48483012800,00000000700,a00,read
0,48483017800,48483018700,00000000900,a0c,brk
0,48483140800,48483141500,00000000700,a00,read
0,48483259700,48483260300,00000000600,a00,read
0,48483401400,48483402200,00000000800,a00,read
0,48483534500,48483535200,00000000700,a00,read
0,48483628800,48483629700,00000000900,a00,read
0,48483742200,48483742900,00000000700,a00,read
0,48483867300,48483868100,00000000800,a00,read
0,48483979500,48483980200,00000000700,a0c,brk
0,48484002900,48484003500,00000000600,a00,read
0,48484172900,48484173600,00000000700,a00,read
0,48484325200,48484325900,00000000700,a00,read
0,48484436400,48484437200,00000000800,a00,read
0,48484606000,48484607100,00000001100,a00,read
0,48484683900,48484684600,00000000700,a00,read
0,48484766100,48484766900,00000000800,a00,read
0,48484833600,48484834400,00000000800,a0c,brk
0,48484848000,48484848600,00000000600,a00,read
0,48484921400,48484922300,00000000900,a00,read
0,48485023300,48485023900,00000000600,a00,read
0,48485127300,48485127900,00000000600,a00,read
0,48485217600,48485218300,00000000700,a00,read
0,48485299000,48485299800,00000000800,a00,read
0,48485400600,48485401300,00000000700,a00,read
0,48485482800,48485483200,00000000400,a0c,brk
0,48485485500,48485486300,00000000800,a00,read
0,48485593000,48485593600,00000000600,a00,read
0,48485687400,48485688000,00000000600,a00,read
0,48485806900,48485807600,00000000700,a00,read
0,48485921000,48485921700,00000000700,a00,read
0,48486024700,48486025200,00000000500,a00,read
0,48486125100,48486125400,00000000300,a0c,brk
0,48486479800,48486483100,00000003300,a57,unlink
0,48486508400,48486509000,00000000600,a48,fcntl
0,48486555300,48486569100,00000013800,a01,write
0,48486586900,48486589100,00000002200,a01,write
0,48486605100,48486607300,00000002200,a01,write
0,48476310300,48491047800,00014737500,a3d,wait4
0,48491065700,48491069200,00000003500,a00,read
0,48491071300,48491071600,00000000300,a00,read
0,48475964400,48491103200,00015138800,a17,select
0,48491124300,48491124600,00000000300,a2f,recvmsg
0,48491139600,48491139800,00000000200,a2f,recvmsg
0,48491140700,48491140900,00000000200,a2f,recvmsg
0,48491128300,48491147500,00000019200,a17,select
0,48491151200,48491151400,00000000200,a2f,recvmsg
0,48491157400,48491157600,00000000200,a2f,recvmsg
0,48491158000,48491158200,00000000200,a2f,recvmsg
0,48491152200,48491163500,00000011300,a17,select
0,48491166900,48491167100,00000000200,a2f,recvmsg
0,48491172400,48491172500,00000000100,a2f,recvmsg
0,48491172900,48491173100,00000000200,a2f,recvmsg
0,48491167700,48491178000,00000010300,a17,select
0,48491181400,48491181600,00000000200,a2f,recvmsg
0,48491186800,48491187000,00000000200,a2f,recvmsg
0,48491187300,48491187500,00000000200,a2f,recvmsg
0,48491182200,48491192300,00000010100,a17,select
0,48491196000,48491196100,00000000100,a2f,recvmsg
0,48491201300,48491201400,00000000100,a2f,recvmsg
0,48491201800,48491202000,00000000200,a2f,recvmsg
0,48491196600,48491206200,00000009600,a17,select
0,48491209400,48491209600,00000000200,a2f,recvmsg
0,48491214700,48491214900,00000000200,a2f,recvmsg
0,48491215300,48491215500,00000000200,a2f,recvmsg
0,48491216200,48491216400,00000000200,a08,lseek
0,48491226700,48491226800,00000000100,a08,lseek
0,48491210100,48491231100,00000021000,a17,select
0,48491234500,48491234700,00000000200,a2f,recvmsg
0,48491240200,48491240200,00000000000,a2f,recvmsg
0,48491240600,48491240800,00000000200,a2f,recvmsg
0,48491235300,48491247600,00000012300,a17,select
0,48491250800,48491251000,00000000200,a2f,recvmsg
0,48491256300,48491256500,00000000200,a2f,recvmsg
0,48491256800,48491257000,00000000200,a2f,recvmsg
0,48491251600,48491261800,00000010200,a17,select
0,48491264900,48491265000,00000000100,a2f,recvmsg
0,48491270300,48491270500,00000000200,a2f,recvmsg
0,48491270800,48491270900,00000000100,a2f,recvmsg
0,48491265600,48491276300,00000010700,a17,select
0,48491279400,48491279500,00000000100,a2f,recvmsg
0,48491285000,48491285200,00000000200,a2f,recvmsg
0,48491285600,48491285700,00000000100,a2f,recvmsg
0,48491280100,48491290900,00000010800,a17,select
0,48491294100,48491294300,00000000200,a2f,recvmsg
0,48491299700,48491299900,00000000200,a2f,recvmsg
0,48491300300,48491300500,00000000200,a2f,recvmsg
0,48491294900,48491305900,00000011000,a17,select
0,48491308900,48491309100,00000000200,a2f,recvmsg
0,48491314600,48491314700,00000000100,a2f,recvmsg
0,48491315100,48491315300,00000000200,a2f,recvmsg
0,48491309700,48491320300,00000010600,a17,select
0,48491323700,48491323800,00000000100,a2f,recvmsg
0,48491329300,48491329400,00000000100,a2f,recvmsg
0,48491329700,48491329900,00000000200,a2f,recvmsg
0,48491324400,48491334600,00000010200,a17,select
0,48491337500,48491337700,00000000200,a2f,recvmsg
0,48491342900,48491343100,00000000200,a2f,recvmsg
0,48491343500,48491343700,00000000200,a2f,recvmsg
0,48491338300,48491349900,00000011600,a17,select
0,48491353400,48491353500,00000000100,a2f,recvmsg
0,48491358900,48491359100,00000000200,a2f,recvmsg
0,48491359500,48491359700,00000000200,a2f,recvmsg
0,48491354100,48491365000,00000010900,a17,select
0,48491368100,48491368300,00000000200,a2f,recvmsg
0,48491373500,48491373700,00000000200,a2f,recvmsg
0,48491374100,48491374300,00000000200,a2f,recvmsg
0,48491368900,48491379400,00000010500,a17,select
0,48491382700,48491382700,00000000000,a2f,recvmsg
0,48491388000,48491388200,00000000200,a2f,recvmsg
0,48491388500,48491388700,00000000200,a2f,recvmsg
0,48491383300,48491393800,00000010500,a17,select
0,48491396900,48491397000,00000000100,a2f,recvmsg
0,48491402400,48491402600,00000000200,a2f,recvmsg
0,48491403000,48491403100,00000000100,a2f,recvmsg
0,48491397600,48491409300,00000011700,a17,select
0,48491412400,48491412500,00000000100,a2f,recvmsg
0,48491417800,48491418000,00000000200,a2f,recvmsg
0,48491418400,48491418600,00000000200,a2f,recvmsg
0,48491413100,48491423700,00000010600,a17,select
0,48491426800,48491427000,00000000200,a2f,recvmsg
0,48491432300,48491432500,00000000200,a2f,recvmsg
0,48491432800,48491433000,00000000200,a2f,recvmsg
0,48491427600,48491438000,00000010400,a17,select
0,48491441100,48491441300,00000000200,a2f,recvmsg
0,48491446500,48491446600,00000000100,a2f,recvmsg
0,48491447000,48491447200,00000000200,a2f,recvmsg
0,48491441700,48491451800,00000010100,a17,select
0,48491455000,48491455100,00000000100,a2f,recvmsg
0,48491460400,48491460600,00000000200,a2f,recvmsg
0,48491460900,48491461100,00000000200,a2f,recvmsg
0,48491455700,48491468600,00000012900,a17,select
0,48491471900,48491472000,00000000100,a2f,recvmsg
0,48491477300,48491477500,00000000200,a2f,recvmsg
0,48491477800,48491478000,00000000200,a2f,recvmsg
0,48491472600,48491482400,00000009800,a17,select
0,48491485600,48491485800,00000000200,a2f,recvmsg
0,48491491000,48491491100,00000000100,a2f,recvmsg
0,48491491400,48491491600,00000000200,a2f,recvmsg
0,48491486400,48491496100,00000009700,a17,select
0,48491499000,48491499200,00000000200,a2f,recvmsg
0,48491504500,48491504700,00000000200,a2f,recvmsg
0,48491505100,48491505200,00000000100,a2f,recvmsg
0,48491499800,48491509800,00000010000,a17,select
0,48491512900,48491513100,00000000200,a2f,recvmsg
0,48491518400,48491518500,00000000100,a2f,recvmsg
0,48491518900,48491519100,00000000200,a2f,recvmsg
0,48491513700,48491523900,00000010200,a17,select
0,48491527000,48491527100,00000000100,a2f,recvmsg
0,48491532400,48491532600,00000000200,a2f,recvmsg
0,48491532900,48491533000,00000000100,a2f,recvmsg
0,48491527700,48491537900,00000010200,a17,select
0,48491541000,48491541100,00000000100,a2f,recvmsg
0,48491546400,48491546600,00000000200,a2f,recvmsg
0,48491546900,48491547100,00000000200,a2f,recvmsg
0,48491541700,48491552300,00000010600,a17,select
0,48491555500,48491555600,00000000100,a2f,recvmsg
0,48491560900,48491561100,00000000200,a2f,recvmsg
0,48491561400,48491561500,00000000100,a2f,recvmsg
0,48491556100,48491566800,00000010700,a17,select
0,48491569800,48491569900,00000000100,a2f,recvmsg
0,48491575200,48491575300,00000000100,a2f,recvmsg
0,48491575700,48491575900,00000000200,a2f,recvmsg
0,48491570500,48491581800,00000011300,a17,select
0,48491585200,48491585400,00000000200,a2f,recvmsg
0,48491590600,48491590800,00000000200,a2f,recvmsg
0,48491591200,48491591300,00000000100,a2f,recvmsg
0,48491586000,48491596900,00000010900,a17,select
0,48491599900,48491600100,00000000200,a2f,recvmsg
0,48491605300,48491605500,00000000200,a2f,recvmsg
0,48491605900,48491606000,00000000100,a2f,recvmsg
0,48491600800,48491611400,00000010600,a17,select
0,48491614600,48491614800,00000000200,a2f,recvmsg
0,48491620200,48491620300,00000000100,a2f,recvmsg
0,48491620600,48491620800,00000000200,a2f,recvmsg
0,48491615400,48491628400,00000013000,a17,select
0,48491631600,48491631700,00000000100,a2f,recvmsg
0,48491637200,48491637300,00000000100,a2f,recvmsg
0,48491637600,48491637800,00000000200,a2f,recvmsg
0,48491632300,48491642800,00000010500,a17,select
0,48491645800,48491646000,00000000200,a2f,recvmsg
0,48491651200,48491651300,00000000100,a2f,recvmsg
0,48491651700,48491651900,00000000200,a2f,recvmsg
0,48491646600,48491656800,00000010200,a17,select
0,48491660100,48491660200,00000000100,a2f,recvmsg
0,48491665500,48491665600,00000000100,a2f,recvmsg
0,48491665900,48491666100,00000000200,a2f,recvmsg
0,48491660800,48491671900,00000011100,a17,select
0,48491675100,48491675300,00000000200,a2f,recvmsg
0,48491680600,48491680800,00000000200,a2f,recvmsg
0,48491681000,48491681200,00000000200,a2f,recvmsg
0,48491675800,48491686700,00000010900,a17,select
0,48491689900,48491690100,00000000200,a2f,recvmsg
0,48491695400,48491695600,00000000200,a2f,recvmsg
0,48491696000,48491696200,00000000200,a2f,recvmsg
0,48491690600,48491701900,00000011300,a17,select
0,48491705300,48491705400,00000000100,a2f,recvmsg
0,48491710800,48491710900,00000000100,a2f,recvmsg
0,48491711300,48491711400,00000000100,a2f,recvmsg
0,48491706000,48491716600,00000010600,a17,select
0,48491719800,48491720000,00000000200,a2f,recvmsg
0,48491725100,48491725300,00000000200,a2f,recvmsg
0,48491725700,48491725900,00000000200,a2f,recvmsg
0,48491720600,48491730800,00000010200,a17,select
0,48491734000,48491734200,00000000200,a2f,recvmsg
0,48491739400,48491739600,00000000200,a2f,recvmsg
0,48491739900,48491740100,00000000200,a2f,recvmsg
0,48491734700,48491744800,00000010100,a17,select
0,48491747800,48491748000,00000000200,a2f,recvmsg
0,48491753300,48491753400,00000000100,a2f,recvmsg
0,48491753800,48491754000,00000000200,a2f,recvmsg
0,48491748500,48491759500,00000011000,a17,select
0,48491762600,48491762700,00000000100,a2f,recvmsg
0,48491768000,48491768200,00000000200,a2f,recvmsg
0,48491768500,48491768700,00000000200,a2f,recvmsg
0,48491770100,48491770300,00000000200,a08,lseek
0,48491773000,48491774000,00000001000,a00,read
0,48491777600,48491777700,00000000100,a08,lseek
0,48491763300,48491782500,00000019200,a17,select
0,48491785900,48491786100,00000000200,a2f,recvmsg
0,48491791700,48491791900,00000000200,a2f,recvmsg
0,48491792200,48491792400,00000000200,a2f,recvmsg
0,48491786700,48491822700,00000036000,a17,select
0,48491826100,48491826300,00000000200,a2f,recvmsg
0,48491832000,48491832200,00000000200,a2f,recvmsg
0,48491832500,48491832700,00000000200,a2f,recvmsg
0,48491836800,48491837500,00000000700,a00,read
0,48491843200,48491843300,00000000100,a08,lseek
0,48491826900,48491848700,00000021800,a17,select
0,48491852200,48491852300,00000000100,a2f,recvmsg
0,48491857800,48491858000,00000000200,a2f,recvmsg
0,48491858400,48491858500,00000000100,a2f,recvmsg
0,48491853000,48491863100,00000010100,a17,select
0,48491866100,48491866300,00000000200,a2f,recvmsg
0,48491871400,48491871600,00000000200,a2f,recvmsg
0,48491871900,48491872100,00000000200,a2f,recvmsg
0,48491866900,48491876600,00000009700,a17,select
0,48491879500,48491879600,00000000100,a2f,recvmsg
0,48491884700,48491884900,00000000200,a2f,recvmsg
0,48491885200,48491885400,00000000200,a2f,recvmsg
0,48491880200,48491889900,00000009700,a17,select
0,48491892800,48491893000,00000000200,a2f,recvmsg
0,48491898000,48491898200,00000000200,a2f,recvmsg
0,48491898600,48491898800,00000000200,a2f,recvmsg
0,48491893500,48491903300,00000009800,a17,select
0,48491906300,48491906500,00000000200,a2f,recvmsg
0,48491911500,48491911700,00000000200,a2f,recvmsg
0,48491912000,48491912200,00000000200,a2f,recvmsg
0,48491907100,48491916600,00000009500,a17,select
0,48491919700,48491919800,00000000100,a2f,recvmsg
0,48491925000,48491925100,00000000100,a2f,recvmsg
0,48491925500,48491925700,00000000200,a2f,recvmsg
0,48491920400,48491930000,00000009600,a17,select
0,48491933000,48491933100,00000000100,a2f,recvmsg
0,48491938200,48491938400,00000000200,a2f,recvmsg
0,48491938700,48491938900,00000000200,a2f,recvmsg
0,48491933700,48491944100,00000010400,a17,select
0,48491947200,48491947300,00000000100,a2f,recvmsg
0,48491952500,48491952700,00000000200,a2f,recvmsg
0,48491952900,48491953100,00000000200,a2f,recvmsg
0,48491947900,48491957700,00000009800,a17,select
0,48491960600,48491960800,00000000200,a2f,recvmsg
0,48491965900,48491966000,00000000100,a2f,recvmsg
0,48491966400,48491966600,00000000200,a2f,recvmsg
0,48491967200,48491967300,00000000100,a08,lseek
0,48491961400,48491973000,00000011600,a17,select
0,48491976200,48491976400,00000000200,a2f,recvmsg
0,48491981700,48491981900,00000000200,a2f,recvmsg
0,48491982300,48491982500,00000000200,a2f,recvmsg
0,48491977000,48491989300,00000012300,a17,select
0,48491992500,48491992600,00000000100,a2f,recvmsg
0,48491997900,48491998100,00000000200,a2f,recvmsg
0,48491998300,48491998500,00000000200,a2f,recvmsg
0,48491993200,48492003700,00000010500,a17,select
0,48492006600,48492006800,00000000200,a2f,recvmsg
0,48492011900,48492012100,00000000200,a2f,recvmsg
0,48492012500,48492012700,00000000200,a2f,recvmsg
0,48492007400,48492017400,00000010000,a17,select
0,48492020400,48492020600,00000000200,a2f,recvmsg
0,48492025800,48492025900,00000000100,a2f,recvmsg
0,48492026300,48492026500,00000000200,a2f,recvmsg
0,48492021100,48492031200,00000010100,a17,select
0,48492034400,48492034400,00000000000,a2f,recvmsg
0,48492039700,48492039900,00000000200,a2f,recvmsg
0,48492040200,48492040300,00000000100,a2f,recvmsg
0,48492035000,48492045100,00000010100,a17,select
0,48492048100,48492048300,00000000200,a2f,recvmsg
0,48492053400,48492053600,00000000200,a2f,recvmsg
0,48492054000,48492054100,00000000100,a2f,recvmsg
0,48492048900,48492059400,00000010500,a17,select
0,48492062400,48492062600,00000000200,a2f,recvmsg
0,48492067700,48492067900,00000000200,a2f,recvmsg
0,48492068300,48492068400,00000000100,a2f,recvmsg
0,48492063100,48492073200,00000010100,a17,select
0,48492076200,48492076300,00000000100,a2f,recvmsg
0,48492081600,48492081700,00000000100,a2f,recvmsg
0,48492082000,48492082200,00000000200,a2f,recvmsg
0,48492076900,48492086900,00000010000,a17,select
0,48492089900,48492090000,00000000100,a2f,recvmsg
0,48492095200,48492095300,00000000100,a2f,recvmsg
0,48492095700,48492095900,00000000200,a2f,recvmsg
0,48492090700,48492100700,00000010000,a17,select
0,48492103600,48492103800,00000000200,a2f,recvmsg
0,48492109000,48492109200,00000000200,a2f,recvmsg
0,48492109500,48492109700,00000000200,a2f,recvmsg
0,48492104400,48492114400,00000010000,a17,select
0,48492117400,48492117600,00000000200,a2f,recvmsg
0,48492122800,48492123000,00000000200,a2f,recvmsg
0,48492123400,48492123600,00000000200,a2f,recvmsg
0,48492118100,48492128300,00000010200,a17,select
0,48492131300,48492131400,00000000100,a2f,recvmsg
0,48492136800,48492136900,00000000100,a2f,recvmsg
0,48492137200,48492137400,00000000200,a2f,recvmsg
0,48492132000,48492142700,00000010700,a17,select
0,48492145600,48492145800,00000000200,a2f,recvmsg
0,48492151100,48492151200,00000000100,a2f,recvmsg
0,48492151600,48492151800,00000000200,a2f,recvmsg
0,48492146400,48492156500,00000010100,a17,select
0,48492159500,48492159700,00000000200,a2f,recvmsg
0,48492164800,48492165000,00000000200,a2f,recvmsg
0,48492165400,48492165500,00000000100,a2f,recvmsg
0,48492160200,48492170200,00000010000,a17,select
0,48492173100,48492173300,00000000200,a2f,recvmsg
0,48492178800,48492178900,00000000100,a2f,recvmsg
0,48492179300,48492179500,00000000200,a2f,recvmsg
0,48492173900,48492184200,00000010300,a17,select
0,48492187200,48492187400,00000000200,a2f,recvmsg
0,48492192900,48492193000,00000000100,a2f,recvmsg
0,48492193400,48492193600,00000000200,a2f,recvmsg
0,48492188000,48492203800,00000015800,a17,select
0,48492207000,48492207200,00000000200,a2f,recvmsg
0,48492214500,48492214700,00000000200,a2f,recvmsg
0,48492215000,48492215300,00000000300,a2f,recvmsg
0,48492207800,48492220600,00000012800,a17,select
0,48492223700,48492223800,00000000100,a2f,recvmsg
0,48492229000,48492229200,00000000200,a2f,recvmsg
0,48492229600,48492229800,00000000200,a2f,recvmsg
0,48492224400,48492234500,00000010100,a17,select
0,48492237700,48492237700,00000000000,a2f,recvmsg
0,48492242900,48492243100,00000000200,a2f,recvmsg
0,48492243400,48492243600,00000000200,a2f,recvmsg
0,48492238300,48492248600,00000010300,a17,select
0,48492251500,48492251700,00000000200,a2f,recvmsg
0,48492256900,48492257100,00000000200,a2f,recvmsg
0,48492257400,48492257600,00000000200,a2f,recvmsg
0,48492252300,48492262500,00000010200,a17,select
0,48492265400,48492265600,00000000200,a2f,recvmsg
0,48492270800,48492271000,00000000200,a2f,recvmsg
0,48492271300,48492271500,00000000200,a2f,recvmsg
0,48492315700,48492319800,00000004100,a14,writev
0,48492266200,48492323500,00000057300,a17,select
0,48492325900,48492327200,00000001300,a2f,recvmsg
0,48492412200,48492416400,00000004200,a14,writev
0,48492416900,48492420000,00000003100,a14,writev
0,48492497300,48492499500,00000002200,a14,writev
0,48492555000,48492557000,00000002000,a14,writev
0,48492557200,48492559500,00000002300,a14,writev
0,48492613400,48492615100,00000001700,a14,writev
0,48492615300,48492617000,00000001700,a14,writev
0,48492670900,48492672700,00000001800,a14,writev
0,48492672800,48492674300,00000001500,a14,writev
0,48492726400,48492728100,00000001700,a14,writev
0,48492728300,48492730600,00000002300,a14,writev
0,48492734400,48492735200,00000000800,a2f,recvmsg
0,48492782300,48492784300,00000002000,a14,writev
0,48492785600,48492786000,00000000400,a14,writev
0,48492829500,48492831500,00000002000,a14,writev
0,48492873000,48492874700,00000001700,a14,writev
0,48492916700,48492918400,00000001700,a14,writev
0,48492960000,48492961800,00000001800,a14,writev
0,48493003100,48493005000,00000001900,a14,writev
0,48493030100,48493032000,00000001900,a2f,recvmsg
0,48493056000,48493058400,00000002400,a14,writev
0,48493074900,48493076900,00000002000,a14,writev
0,48493091600,48493093400,00000001800,a14,writev
0,48493106100,48493107900,00000001800,a14,writev
0,48493121000,48493122500,00000001500,a14,writev
0,48493134800,48493136700,00000001900,a14,writev
0,48493141100,48493141400,00000000300,a2f,recvmsg
0,48493142100,48493142300,00000000200,a14,writev
0,48493142500,48493142700,00000000200,a14,writev
0,48493161000,48493163200,00000002200,a14,writev
0,48493163500,48493164800,00000001300,a14,writev
0,48493165200,48493165400,00000000200,a2f,recvmsg
0,48492315300,48493173600,00000858300,a07,poll
0,48493178200,48493185000,00000006800,a2f,recvmsg
0,48493196300,48493196500,00000000200,a2f,recvmsg
0,48493223100,48493227600,00000004500,a07,poll
0,48493233300,48493239200,00000005900,a2f,recvmsg
0,48493251300,48493251500,00000000200,a2f,recvmsg
0,48493273600,48493278100,00000004500,a07,poll
0,48493283700,48493290200,00000006500,a2f,recvmsg
0,48493302700,48493302900,00000000200,a2f,recvmsg
0,48493166100,48493331900,00000165800,a17,select
0,48493346300,48493348000,00000001700,a14,writev
0,48493348500,48493348700,00000000200,a2f,recvmsg
0,48493362100,48493363000,00000000900,a14,writev
0,48493363300,48493363500,00000000200,a2f,recvmsg
0,48493375300,48493376100,00000000800,a14,writev
0,48493376400,48493376600,00000000200,a2f,recvmsg
0,48493326400,48493380700,00000054300,a07,poll
0,48493381300,48493382200,00000000900,a2f,recvmsg
0,48493387000,48493387800,00000000800,a2d,recvfrom
0,48493388800,48493389000,00000000200,a2f,recvmsg
0,48493389500,48493389700,00000000200,a2f,recvmsg
0,48493430500,48493430800,00000000300,a2f,recvmsg
0,48493432900,48493433100,00000000200,a2f,recvmsg
0,48493435500,48493437400,00000001900,a07,poll
0,48493437900,48493438900,00000001000,a2f,recvmsg
0,48493443900,48493444400,00000000500,a2d,recvfrom
0,48493445200,48493445400,00000000200,a2f,recvmsg
0,48493446000,48493446100,00000000100,a2f,recvmsg
0,48493475200,48493475400,00000000200,a2f,recvmsg
0,48493477400,48493477600,00000000200,a2f,recvmsg
0,48493480400,48493482600,00000002200,a07,poll
0,48493483200,48493484400,00000001200,a2f,recvmsg
0,48493489800,48493490400,00000000600,a2d,recvfrom
0,48493491600,48493491700,00000000100,a2f,recvmsg
0,48493492400,48493492500,00000000100,a2f,recvmsg
0,48493521800,48493522100,00000000300,a2f,recvmsg
0,48493523900,48493524000,00000000100,a2f,recvmsg
0,48493535200,48493535400,00000000200,a2f,recvmsg
0,48493535900,48493536100,00000000200,a2f,recvmsg
0,48493377100,48493568700,00000191600,a17,select
0,48493579200,48493581400,00000002200,a14,writev
0,48493583100,48493583300,00000000200,a2f,recvmsg
0,48493591600,48493591800,00000000200,a2f,recvmsg
0,48493592300,48493592400,00000000100,a2f,recvmsg
0,48494027600,48494031700,00000004100,a09,mmap
0,48494384900,48494390300,00000005400,a02,open
0,48494398000,48494400100,00000002100,a00,read
0,48494453800,48494454700,00000000900,a00,read
0,48494503400,48494504200,00000000800,a00,read
0,48494550000,48494550700,00000000700,a00,read
0,48494598000,48494598700,00000000700,a00,read
0,48494644700,48494645700,00000001000,a00,read
0,48494689500,48494690200,00000000700,a00,read
0,48494735200,48494735900,00000000700,a00,read
0,48494784000,48494784800,00000000800,a00,read
0,48494833100,48494833800,00000000700,a00,read
0,48494881400,48494882100,00000000700,a00,read
0,48494908900,48494910500,00000001600,a02,open
0,48543178300,48543179000,00000000700,a00,read
0,48543259600,48543261800,00000002200,a0c,brk
0,48543264400,48543265000,00000000600,a00,read
0,48543371400,48543372100,00000000700,a00,read
0,48543464300,48543465100,00000000800,a00,read
0,48543584500,48543585200,00000000700,a00,read
0,48543697900,48543698600,00000000700,a00,read
0,48543801100,48543801900,00000000800,a00,read
0,48544281300,48544285000,00000003700,a57,unlink
0,48544305500,48544306000,00000000500,a48,fcntl
0,48544358600,48544369400,00000010800,a01,write
0,48544386900,48544389300,00000002400,a01,write
0,48544405500,48544407600,00000002100,a01,write
0,48476310300,48544576500,00068266200,a3d,wait4
0,48544594200,48544595700,00000001500,a00,read
0,48544597700,48544598000,00000000300,a00,read
0,48493584600,48544624500,00051039900,a17,select
0,48544643900,48544644100,00000000200,a2f,recvmsg
0,48544659200,48544659400,00000000200,a2f,recvmsg
0,48544660400,48544660500,00000000100,a2f,recvmsg
0,48544647500,48544667900,00000020400,a17,select
0,48544671700,48544671900,00000000200,a2f,recvmsg
0,48544677700,48544677800,00000000100,a2f,recvmsg
0,48544678200,48544678400,00000000200,a2f,recvmsg
0,48544672600,48544683600,00000011000,a17,select
0,48544687000,48544687200,00000000200,a2f,recvmsg
0,48544692400,48544692600,00000000200,a2f,recvmsg
0,48544692900,48544693000,00000000100,a2f,recvmsg
0,48544687700,48544698000,00000010300,a17,select
0,48544701400,48544701600,00000000200,a2f,recvmsg
0,48544706700,48544706900,00000000200,a2f,recvmsg
0,48544707200,48544707400,00000000200,a2f,recvmsg
0,48544702200,48544712300,00000010100,a17,select
0,48544716100,48544716200,00000000100,a2f,recvmsg
0,48544721500,48544721600,00000000100,a2f,recvmsg
0,48544722000,48544722200,00000000200,a2f,recvmsg
0,48544716800,48544726600,00000009800,a17,select
0,48544729700,48544729800,00000000100,a2f,recvmsg
0,48544735700,48544735800,00000000100,a2f,recvmsg
0,48544736200,48544736400,00000000200,a2f,recvmsg
0,48544737100,48544737200,00000000100,a08,lseek
0,48544746900,48544747000,00000000100,a08,lseek
0,48544730400,48544751600,00000021200,a17,select
0,48544755000,48544755100,00000000100,a2f,recvmsg
0,48544761200,48544761300,00000000100,a2f,recvmsg
0,48544761700,48544761900,00000000200,a2f,recvmsg
0,48544755600,48544767900,00000012300,a17,select
0,48544771100,48544771300,00000000200,a2f,recvmsg
0,48544776900,48544777100,00000000200,a2f,recvmsg
0,48544777400,48544777600,00000000200,a2f,recvmsg
0,48544771900,48544782500,00000010600,a17,select
0,48544785600,48544785800,00000000200,a2f,recvmsg
0,48544790900,48544791000,00000000100,a2f,recvmsg
0,48544791400,48544791600,00000000200,a2f,recvmsg
0,48544786200,48544797000,00000010800,a17,select
0,48544800000,48544800100,00000000100,a2f,recvmsg
0,48544805600,48544805800,00000000200,a2f,recvmsg
0,48544806100,48544806300,00000000200,a2f,recvmsg
0,48544800700,48544811600,00000010900,a17,select
0,48544814800,48544815000,00000000200,a2f,recvmsg
0,48544820200,48544820400,00000000200,a2f,recvmsg
0,48544820700,48544820900,00000000200,a2f,recvmsg
0,48544815600,48544826400,00000010800,a17,select
0,48544829400,48544829600,00000000200,a2f,recvmsg
0,48544835000,48544835100,00000000100,a2f,recvmsg
0,48544835400,48544835600,00000000200,a2f,recvmsg
0,48544830100,48544840800,00000010700,a17,select
0,48544843900,48544844100,00000000200,a2f,recvmsg
0,48544850300,48544850500,00000000200,a2f,recvmsg
0,48544850700,48544850900,00000000200,a2f,recvmsg
0,48544844700,48544855800,00000011100,a17,select
0,48544858600,48544858800,00000000200,a2f,recvmsg
0,48544863900,48544864100,00000000200,a2f,recvmsg
0,48544864500,48544864700,00000000200,a2f,recvmsg
0,48544859400,48544870900,00000011500,a17,select
0,48544874200,48544874400,00000000200,a2f,recvmsg
0,48544879600,48544879800,00000000200,a2f,recvmsg
0,48544880200,48544880300,00000000100,a2f,recvmsg
0,48544875000,48544885600,00000010600,a17,select
0,48544888800,48544889000,00000000200,a2f,recvmsg
0,48544894300,48544894400,00000000100,a2f,recvmsg
0,48544894700,48544894900,00000000200,a2f,recvmsg
0,48544889600,48544900800,00000011200,a17,select
0,48544903900,48544904100,00000000200,a2f,recvmsg
0,48544909500,48544909600,00000000100,a2f,recvmsg
0,48544909900,48544910100,00000000200,a2f,recvmsg
0,48544904700,48544915200,00000010500,a17,select
0,48544918300,48544918500,00000000200,a2f,recvmsg
0,48544923800,48544924000,00000000200,a2f,recvmsg
0,48544924300,48544924500,00000000200,a2f,recvmsg
0,48544919000,48544929700,00000010700,a17,select
0,48544932600,48544932800,00000000200,a2f,recvmsg
0,48544938100,48544938300,00000000200,a2f,recvmsg
0,48544938700,48544938800,00000000100,a2f,recvmsg
0,48544933400,48544944100,00000010700,a17,select
0,48544947200,48544947400,00000000200,a2f,recvmsg
0,48544952700,48544952900,00000000200,a2f,recvmsg
0,48544953200,48544953400,00000000200,a2f,recvmsg
0,48544947900,48544958500,00000010600,a17,select
0,48544961500,48544961700,00000000200,a2f,recvmsg
0,48544967000,48544967200,00000000200,a2f,recvmsg
0,48544967700,48544967900,00000000200,a2f,recvmsg
0,48544962300,48544972400,00000010100,a17,select
0,48544975600,48544975800,00000000200,a2f,recvmsg
0,48544981000,48544981100,00000000100,a2f,recvmsg
0,48544981500,48544981700,00000000200,a2f,recvmsg
0,48544976300,48544989300,00000013000,a17,select
0,48544992600,48544992800,00000000200,a2f,recvmsg
0,48544998000,48544998100,00000000100,a2f,recvmsg
0,48544998500,48544998700,00000000200,a2f,recvmsg
0,48544993200,48545003200,00000010000,a17,select
0,48545006400,48545006600,00000000200,a2f,recvmsg
0,48545011800,48545012000,00000000200,a2f,recvmsg
0,48545012300,48545012500,00000000200,a2f,recvmsg
0,48545007100,48545017000,00000009900,a17,select
0,48545019900,48545020100,00000000200,a2f,recvmsg
0,48545025300,48545025400,00000000100,a2f,recvmsg
0,48545025700,48545025900,00000000200,a2f,recvmsg
0,48545020700,48545030500,00000009800,a17,select
0,48545033500,48545033700,00000000200,a2f,recvmsg
0,48545038800,48545039000,00000000200,a2f,recvmsg
0,48545039400,48545039500,00000000100,a2f,recvmsg
0,48545034300,48545044400,00000010100,a17,select
0,48545047600,48545047700,00000000100,a2f,recvmsg
0,48545053000,48545053100,00000000100,a2f,recvmsg
0,48545053500,48545053700,00000000200,a2f,recvmsg
0,48545048200,48545058300,00000010100,a17,select
0,48545061400,48545061500,00000000100,a2f,recvmsg
0,48545066800,48545067000,00000000200,a2f,recvmsg
0,48545067200,48545067400,00000000200,a2f,recvmsg
0,48545062100,48545072900,00000010800,a17,select
0,48545076000,48545076100,00000000100,a2f,recvmsg
0,48545081300,48545081500,00000000200,a2f,recvmsg
0,48545081800,48545082000,00000000200,a2f,recvmsg
0,48545076700,48545087200,00000010500,a17,select
0,48545090200,48545090400,00000000200,a2f,recvmsg
0,48545095700,48545095800,00000000100,a2f,recvmsg
0,48545096200,48545096300,00000000100,a2f,recvmsg
0,48545091000,48545102400,00000011400,a17,select
0,48545105800,48545105900,00000000100,a2f,recvmsg
0,48545111100,48545111300,00000000200,a2f,recvmsg
0,48545111600,48545111800,00000000200,a2f,recvmsg
0,48545106500,48545117300,00000010800,a17,select
0,48545120300,48545120400,00000000100,a2f,recvmsg
0,48545125500,48545125700,00000000200,a2f,recvmsg
0,48545126100,48545126200,00000000100,a2f,recvmsg
0,48545120900,48545131700,00000010800,a17,select
0,48545135000,48545135200,00000000200,a2f,recvmsg
0,48545140300,48545140500,00000000200,a2f,recvmsg
0,48545140900,48545141100,00000000200,a2f,recvmsg
0,48545135600,48545148400,00000012800,a17,select
0,48545151600,48545151800,00000000200,a2f,recvmsg
0,48545157000,48545157200,00000000200,a2f,recvmsg
0,48545157500,48545157700,00000000200,a2f,recvmsg
0,48545152400,48545162800,00000010400,a17,select
0,48545165800,48545166000,00000000200,a2f,recvmsg
0,48545171100,48545171300,00000000200,a2f,recvmsg
0,48545171700,48545171700,00000000000,a2f,recvmsg
0,48545166500,48545176800,00000010300,a17,select
0,48545179900,48545180000,00000000100,a2f,recvmsg
0,48545185200,48545185300,00000000100,a2f,recvmsg
0,48545185700,48545185900,00000000200,a2f,recvmsg
0,48545180600,48545191700,00000011100,a17,select
0,48545194700,48545194900,00000000200,a2f,recvmsg
0,48545200200,48545200300,00000000100,a2f,recvmsg
0,48545200700,48545200900,00000000200,a2f,recvmsg
0,48545195500,48545206300,00000010800,a17,select
0,48545209700,48545209800,00000000100,a2f,recvmsg
0,48545215100,48545215300,00000000200,a2f,recvmsg
0,48545215600,48545215800,00000000200,a2f,recvmsg
0,48545210400,48545221700,00000011300,a17,select
0,48545224900,48545225100,00000000200,a2f,recvmsg
0,48545230500,48545230600,00000000100,a2f,recvmsg
0,48545230900,48545231100,00000000200,a2f,recvmsg
0,48545225700,48545236400,00000010700,a17,select
0,48545239500,48545239700,00000000200,a2f,recvmsg
0,48545245100,48545245200,00000000100,a2f,recvmsg
0,48545245600,48545245800,00000000200,a2f,recvmsg
0,48545240200,48545250800,00000010600,a17,select
0,48545253900,48545254100,00000000200,a2f,recvmsg
0,48545259300,48545259500,00000000200,a2f,recvmsg
0,48545259800,48545260000,00000000200,a2f,recvmsg
0,48545254700,48545264800,00000010100,a17,select
0,48545267700,48545267900,00000000200,a2f,recvmsg
0,48545273100,48545273200,00000000100,a2f,recvmsg
0,48545273600,48545273800,00000000200,a2f,recvmsg
0,48545268500,48545279200,00000010700,a17,select
0,48545282300,48545282500,00000000200,a2f,recvmsg
0,48545287700,48545287800,00000000100,a2f,recvmsg
0,48545288200,48545288400,00000000200,a2f,recvmsg
0,48545289700,48545289800,00000000100,a08,lseek
0,48545292300,48545293200,00000000900,a00,read
0,48545296800,48545296900,00000000100,a08,lseek
0,48545283100,48545301600,00000018500,a17,select
0,48545304900,48545305100,00000000200,a2f,recvmsg
0,48545310600,48545310800,00000000200,a2f,recvmsg
0,48545311100,48545311300,00000000200,a2f,recvmsg
0,48545305700,48545339300,00000033600,a17,select
0,48545342700,48545342800,00000000100,a2f,recvmsg
0,48545348400,48545348500,00000000100,a2f,recvmsg
0,48545348800,48545349000,00000000200,a2f,recvmsg
0,48545353000,48545353900,00000000900,a00,read
0,48545359400,48545359600,00000000200,a08,lseek
0,48545343400,48545364800,00000021400,a17,select
0,48545368100,48545368300,00000000200,a2f,recvmsg
0,48545373700,48545373900,00000000200,a2f,recvmsg
0,48545374300,48545374400,00000000100,a2f,recvmsg
0,48545368900,48545378900,00000010000,a17,select
0,48545381900,48545382100,00000000200,a2f,recvmsg
0,48545387200,48545387300,00000000100,a2f,recvmsg
0,48545387700,48545387900,00000000200,a2f,recvmsg
0,48545382600,48545392200,00000009600,a17,select
0,48545395100,48545395300,00000000200,a2f,recvmsg
0,48545400400,48545400600,00000000200,a2f,recvmsg
0,48545400900,48545401100,00000000200,a2f,recvmsg
0,48545395800,48545405600,00000009800,a17,select
0,48545408500,48545408600,00000000100,a2f,recvmsg
0,48545414100,48545414200,00000000100,a2f,recvmsg
0,48545414600,48545414800,00000000200,a2f,recvmsg
0,48545409200,48545419200,00000010000,a17,select
0,48545422200,48545422400,00000000200,a2f,recvmsg
0,48545427500,48545427700,00000000200,a2f,recvmsg
0,48545428000,48545428200,00000000200,a2f,recvmsg
0,48545422800,48545432600,00000009800,a17,select
0,48545435600,48545435700,00000000100,a2f,recvmsg
0,48545440900,48545441100,00000000200,a2f,recvmsg
0,48545441500,48545441500,00000000000,a2f,recvmsg
0,48545436200,48545446100,00000009900,a17,select
0,48545448900,48545449100,00000000200,a2f,recvmsg
0,48545454200,48545454400,00000000200,a2f,recvmsg
0,48545454700,48545454800,00000000100,a2f,recvmsg
0,48545449600,48545460000,00000010400,a17,select
0,48545463000,48545463100,00000000100,a2f,recvmsg
0,48545468300,48545468500,00000000200,a2f,recvmsg
0,48545468800,48545469000,00000000200,a2f,recvmsg
0,48545463700,48545473700,00000010000,a17,select
0,48545476500,48545476600,00000000100,a2f,recvmsg
0,48545481700,48545481900,00000000200,a2f,recvmsg
0,48545482300,48545482400,00000000100,a2f,recvmsg
0,48545483100,48545483200,00000000100,a08,lseek
0,48545477200,48545489000,00000011800,a17,select
0,48545492200,48545492300,00000000100,a2f,recvmsg
0,48545497600,48545497800,00000000200,a2f,recvmsg
0,48545498200,48545498400,00000000200,a2f,recvmsg
0,48545492800,48545505400,00000012600,a17,select
0,48545508500,48545508700,00000000200,a2f,recvmsg
0,48545514000,48545514200,00000000200,a2f,recvmsg
0,48545514600,48545514700,00000000100,a2f,recvmsg
0,48545509300,48545519900,00000010600,a17,select
0,48545522800,48545523000,00000000200,a2f,recvmsg
0,48545528300,48545528400,00000000100,a2f,recvmsg
0,48545528800,48545528900,00000000100,a2f,recvmsg
0,48545523500,48545533800,00000010300,a17,select
0,48545536700,48545536800,00000000100,a2f,recvmsg
0,48545542200,48545542300,00000000100,a2f,recvmsg
0,48545542700,48545542800,00000000100,a2f,recvmsg
0,48545537400,48545547600,00000010200,a17,select
0,48545550500,48545550600,00000000100,a2f,recvmsg
0,48545556000,48545556200,00000000200,a2f,recvmsg
0,48545556600,48545556700,00000000100,a2f,recvmsg
0,48545551200,48545561400,00000010200,a17,select
0,48545564400,48545564600,00000000200,a2f,recvmsg
0,48545569900,48545570100,00000000200,a2f,recvmsg
0,48545570500,48545570700,00000000200,a2f,recvmsg
0,48545565100,48545575900,00000010800,a17,select
0,48545578800,48545579000,00000000200,a2f,recvmsg
0,48545584200,48545584400,00000000200,a2f,recvmsg
0,48545584800,48545584900,00000000100,a2f,recvmsg
0,48545579600,48545589700,00000010100,a17,select
0,48545592700,48545592900,00000000200,a2f,recvmsg
0,48545598000,48545598200,00000000200,a2f,recvmsg
0,48545598600,48545598800,00000000200,a2f,recvmsg
0,48545593500,48545603400,00000009900,a17,select
0,48545606400,48545606600,00000000200,a2f,recvmsg
0,48545611800,48545611900,00000000100,a2f,recvmsg
0,48545612300,48545612500,00000000200,a2f,recvmsg
0,48545607000,48545617300,00000010300,a17,select
0,48545620200,48545620300,00000000100,a2f,recvmsg
0,48545625700,48545625800,00000000100,a2f,recvmsg
0,48545626200,48545626400,00000000200,a2f,recvmsg
0,48545620900,48545631200,00000010300,a17,select
0,48545634000,48545634200,00000000200,a2f,recvmsg
0,48545639500,48545639600,00000000100,a2f,recvmsg
0,48545640000,48545640200,00000000200,a2f,recvmsg
0,48545634800,48545644900,00000010100,a17,select
0,48545647900,48545648000,00000000100,a2f,recvmsg
0,48545653200,48545653400,00000000200,a2f,recvmsg
0,48545653800,48545654000,00000000200,a2f,recvmsg
0,48545648600,48545659300,00000010700,a17,select
0,48545662200,48545662300,00000000100,a2f,recvmsg
0,48545667600,48545667700,00000000100,a2f,recvmsg
0,48545668100,48545668200,00000000100,a2f,recvmsg
0,48545662900,48545673100,00000010200,a17,select
0,48545676100,48545676200,00000000100,a2f,recvmsg
0,48545681700,48545681900,00000000200,a2f,recvmsg
0,48545682300,48545682400,00000000100,a2f,recvmsg
0,48545676800,48545687200,00000010400,a17,select
0,48545690200,48545690300,00000000100,a2f,recvmsg
0,48545695500,48545695600,00000000100,a2f,recvmsg
0,48545696000,48545696100,00000000100,a2f,recvmsg
0,48545690800,48545700900,00000010100,a17,select
0,48545703900,48545704100,00000000200,a2f,recvmsg
0,48545709300,48545709400,00000000100,a2f,recvmsg
0,48545709800,48545709900,00000000100,a2f,recvmsg
0,48545704700,48545720400,00000015700,a17,select
0,48545723500,48545723600,00000000100,a2f,recvmsg
0,48545729100,48545729300,00000000200,a2f,recvmsg
0,48545729700,48545729900,00000000200,a2f,recvmsg
0,48545724400,48545734800,00000010400,a17,select
0,48545737900,48545738000,00000000100,a2f,recvmsg
0,48545743300,48545743500,00000000200,a2f,recvmsg
0,48545743700,48545743900,00000000200,a2f,recvmsg
0,48545738600,48545748700,00000010100,a17,select
0,48545751500,48545751700,00000000200,a2f,recvmsg
0,48545756900,48545757000,00000000100,a2f,recvmsg
0,48545757400,48545757600,00000000200,a2f,recvmsg
0,48545752300,48545762600,00000010300,a17,select
0,48545765600,48545765800,00000000200,a2f,recvmsg
0,48545770900,48545771100,00000000200,a2f,recvmsg
0,48545771400,48545771600,00000000200,a2f,recvmsg
0,48545766400,48545776400,00000010000,a17,select
0,48545779400,48545779500,00000000100,a2f,recvmsg
0,48545784700,48545784800,00000000100,a2f,recvmsg
0,48545785200,48545785400,00000000200,a2f,recvmsg
0,48545827600,48545831300,00000003700,a14,writev
0,48545780000,48545835100,00000055100,a17,select
0,48545837600,48545838900,00000001300,a2f,recvmsg
0,48545922900,48545926800,00000003900,a14,writev
0,48545927300,48545930600,00000003300,a14,writev
0,48546005400,48546007500,00000002100,a14,writev
0,48546061700,48546063500,00000001800,a14,writev
0,48546063700,48546065400,00000001700,a14,writev
0,48546119800,48546121700,00000001900,a14,writev
0,48546121800,48546123600,00000001800,a14,writev
0,48546177500,48546179200,00000001700,a14,writev
0,48546179400,48546181300,00000001900,a14,writev
0,48546234700,48546236300,00000001600,a14,writev
0,48546236600,48546238100,00000001500,a14,writev
0,48546242800,48546243500,00000000700,a2f,recvmsg
0,48546292100,48546293700,00000001600,a14,writev
0,48546336000,48546337400,00000001400,a14,writev
0,48546379600,48546381200,00000001600,a14,writev
0,48546422700,48546424400,00000001700,a14,writev
0,48546466200,48546468300,00000002100,a14,writev
0,48546510900,48546512500,00000001600,a14,writev
0,48546537500,48546539400,00000001900,a2f,recvmsg
0,48546564600,48546567200,00000002600,a14,writev
0,48546583600,48546585400,00000001800,a14,writev
0,48546600000,48546602100,00000002100,a14,writev
0,48546615400,48546617000,00000001600,a14,writev
0,48546630500,48546632100,00000001600,a14,writev
0,48546645200,48546648000,00000002800,a14,writev
0,48546652200,48546652400,00000000200,a2f,recvmsg
0,48546653100,48546653500,00000000400,a14,writev
0,48546653700,48546654100,00000000400,a14,writev
0,48546688600,48546690400,00000001800,a14,writev
0,48546690600,48546692000,00000001400,a14,writev
0,48546692500,48546692800,00000000300,a2f,recvmsg
0,48545827200,48546701100,00000873900,a07,poll
0,48546705400,48546712200,00000006800,a2f,recvmsg
0,48546723700,48546723900,00000000200,a2f,recvmsg
0,48546750000,48546754800,00000004800,a07,poll
0,48546760100,48546766600,00000006500,a2f,recvmsg
0,48546778600,48546778800,00000000200,a2f,recvmsg
0,48546800500,48546805100,00000004600,a07,poll
0,48546810400,48546816600,00000006200,a2f,recvmsg
0,48546829100,48546829300,00000000200,a2f,recvmsg
0,48546693900,48546856800,00000162900,a17,select
0,48546871600,48546872900,00000001300,a14,writev
0,48546873400,48546873600,00000000200,a2f,recvmsg
0,48546887100,48546887900,00000000800,a14,writev
0,48546888300,48546888500,00000000200,a2f,recvmsg
0,48546900200,48546901000,00000000800,a14,writev
0,48546901300,48546901500,00000000200,a2f,recvmsg
0,48546851600,48546905700,00000054100,a07,poll
0,48546906300,48546907300,00000001000,a2f,recvmsg
0,48546911600,48546912400,00000000800,a2d,recvfrom
0,48546913600,48546913800,00000000200,a2f,recvmsg
0,48546914400,48546914600,00000000200,a2f,recvmsg
0,48546955100,48546955400,00000000300,a2f,recvmsg
0,48546957600,48546957700,00000000100,a2f,recvmsg
0,48546960000,48546961900,00000001900,a07,poll
0,48546962400,48546963400,00000001000,a2f,recvmsg
0,48546968300,48546968900,00000000600,a2d,recvfrom
0,48546969700,48546969900,00000000200,a2f,recvmsg
0,48546970600,48546970800,00000000200,a2f,recvmsg
0,48546999000,48546999300,00000000300,a2f,recvmsg
0,48547001200,48547001300,00000000100,a2f,recvmsg
0,48547004200,48547006400,00000002200,a07,poll
0,48547007200,48547008200,00000001000,a2f,recvmsg
0,48547013300,48547014000,00000000700,a2d,recvfrom
0,48547014800,48547015000,00000000200,a2f,recvmsg
0,48547015600,48547015800,00000000200,a2f,recvmsg
0,48547045000,48547045200,00000000200,a2f,recvmsg
0,48547046900,48547047000,00000000100,a2f,recvmsg
0,48547058000,48547058200,00000000200,a2f,recvmsg
0,48547058700,48547058900,00000000200,a2f,recvmsg
0,48546902000,48547092300,00000190300,a17,select
0,48547102300,48547104700,00000002400,a14,writev
0,48547106400,48547106600,00000000200,a2f,recvmsg
0,48547114700,48547114900,00000000200,a2f,recvmsg
0,48547115400,48547115500,00000000100,a2f,recvmsg
0,48547567900,48547572200,00000004300,a09,mmap
0,48547723900,48547728800,00000004900,a02,open
0,48547736400,48547738600,00000002200,a00,read
0,48547789900,48547790700,00000000800,a00,read
0,48547839100,48547839900,00000000800,a00,read
0,48547885500,48547886300,00000000800,a00,read
0,48547933000,48547933800,00000000800,a00,read
0,48547979200,48547979900,00000000700,a00,read
0,48548023700,48548024500,00000000800,a00,read
0,48548069500,48548070200,00000000700,a00,read
0,48548117700,48548118500,00000000800,a00,read
0,48548166600,48548167300,00000000700,a00,read
0,48548215000,48548215500,00000000500,a00,read
0,48548242100,48548243500,00000001400,a02,open
0,48548246600,48548247600,00000001000,a00,read
0,48548302900,48548303700,00000000800,a00,read
0,48548386700,48548387500,00000000800,a00,read
0,48548458800,48548459600,00000000800,a00,read
0,48548536300,48548536900,00000000600,a00,read
0,48548613900,48548614600,00000000700,a00,read
0,48548690300,48548690900,00000000600,a00,read
0,48548773400,48548774100,00000000700,a00,read
0,48548840500,48548841100,00000000600,a00,read
0,48548898000,48548898700,00000000700,a00,read
0,48547107800,48548983400,00001875600,a17,select
0,48548996400,48548996500,00000000100,a2f,recvmsg
0,48549008100,48549008300,00000000200,a2f,recvmsg
0,48549009000,48549009200,00000000200,a2f,recvmsg
0,48548998500,48549014500,00000016000,a17,select
0,48549018700,48549018900,00000000200,a2f,recvmsg
0,48549024500,48549024700,00000000200,a2f,recvmsg
0,48549025000,48549025200,00000000200,a2f,recvmsg
0,48549030300,48549035100,00000004800,a06,lstat
0,48549036000,48549036800,00000000800,a06,lstat
0,48549053400,48549064500,00000011100,a01,write
0,48549019500,48549073400,00000053900,a17,select
0,48549079100,48549079300,00000000200,a2f,recvmsg
0,48549087200,48549087400,00000000200,a2f,recvmsg
0,48549087800,48549088000,00000000200,a2f,recvmsg
0,48549089500,48549394600,00000305100,a38,clone
0,48555034300,48555036600,00000002300,a15,access
0,48555037700,48555038500,00000000800,a09,mmap
0,48555042200,48555042900,00000000700,a15,access
0,48555049900,48555051100,00000001200,a09,mmap
0,48555055200,48555055800,00000000600,a15,access
0,48555062400,48555063500,00000001100,a00,read
0,48555065000,48555066600,00000001600,a09,mmap
0,48555070800,48555072900,00000002100,a09,mmap
0,48555084300,48555084900,00000000600,a15,access
0,48555088400,48555089100,00000000700,a00,read
0,48555089700,48555090600,00000000900,a09,mmap
0,48555092500,48555093700,00000001200,a09,mmap
0,48555101900,48555102500,00000000600,a15,access
0,48555105100,48555105800,00000000700,a00,read
0,48555108900,48555111100,00000002200,a09,mmap
0,48555115600,48555118800,00000003200,a09,mmap
0,48555120900,48555122000,00000001100,a09,mmap
0,48555130100,48555130700,00000000600,a15,access
0,48555133100,48555133700,00000000600,a00,read
0,48555134400,48555135900,00000001500,a09,mmap
0,48555138500,48555140300,00000001800,a09,mmap
0,48555148400,48555148900,00000000500,a15,access
0,48555152000,48555152500,00000000500,a00,read
0,48555153100,48555154600,00000001500,a09,mmap
0,48555157700,48555160000,00000002300,a09,mmap
0,48555168400,48555169000,00000000600,a15,access
0,48555171600,48555172100,00000000500,a00,read
0,48555172700,48555173700,00000001000,a09,mmap
0,48555175200,48555176500,00000001300,a09,mmap
0,48555179100,48555180600,00000001500,a09,mmap
0,48555186700,48555187300,00000000600,a15,access
0,48555189400,48555190000,00000000600,a00,read
0,48555190600,48555192000,00000001400,a09,mmap
0,48555194200,48555195700,00000001500,a09,mmap
0,48555212300,48555213100,00000000800,a09,mmap
0,48555217000,48555217200,00000000200,a09,mmap
0,48555218400,48555218700,00000000300,a09,mmap
0,48555394100,48555394900,00000000800,a0c,brk
0,48555431800,48555437900,00000006100,a00,read
0,48555449500,48555450900,00000001400,a00,read
0,48555487400,48555488300,00000000900,a00,read
0,48555609000,48555609700,00000000700,a00,read
0,48555682100,48555682500,00000000400,a00,read
0,48555769200,48555769900,00000000700,a00,read
0,48555899600,48555900400,00000000800,a00,read
0,48556029600,48556030200,00000000600,a00,read
0,48556185300,48556186000,00000000700,a00,read
0,48556335600,48556336200,00000000600,a00,read
0,48556372300,48556373600,00000001300,a0c,brk
0,48556488200,48556488900,00000000700,a00,read
0,48556636600,48556637400,00000000800,a00,read
0,48556791400,48556792100,00000000700,a00,read
0,48556950800,48556951500,00000000700,a00,read
0,48557059300,48557060000,00000000700,a00,read
0,48557090700,48557091300,00000000600,a0c,brk
0,48557199200,48557200000,00000000800,a00,read
0,48557440000,48557440500,00000000500,a00,read
0,48557452800,48557453200,00000000400,a00,read
0,48557497500,48557497900,00000000400,a00,read
0,48557517800,48557518500,00000000700,a00,read
0,48557723700,48557724300,00000000600,a00,read
0,48557753500,48557754200,00000000700,a00,read
0,48557850500,48557851300,00000000800,a00,read
0,48557875000,48557876200,00000001200,a0c,brk
0,48557920800,48557921200,00000000400,a00,read
1,48408791900,48463800100,00055008200,a07,poll
1,48408791900,48463803000,00055011100,a07,poll
1,48463815200,48463815300,00000000100,a2f,recvmsg
1,48463819500,48463819700,00000000200,a2f,recvmsg
1,48463819900,48463820100,00000000200,a2f,recvmsg
1,48463823800,48463824000,00000000200,a2f,recvmsg
1,48463824100,48463824300,00000000200,a2f,recvmsg
1,48463837600,48463837900,00000000300,a2f,recvmsg
1,48463868100,48463875800,00000007700,a07,poll
1,48463876100,48463877400,00000001300,a2f,recvmsg
1,48463868100,48463878800,00000010700,a07,poll
1,48463881400,48463881600,00000000200,a2f,recvmsg
1,48463882300,48463882500,00000000200,a2f,recvmsg
1,48463882700,48463882800,00000000100,a2f,recvmsg
1,48463883700,48463883800,00000000100,a2f,recvmsg
1,48463884000,48463884200,00000000200,a2f,recvmsg
1,48463886300,48463935600,00000049300,a07,poll
1,48463935800,48463937000,00000001200,a2f,recvmsg
1,48463886300,48463938200,00000051900,a07,poll
1,48463939900,48463940100,00000000200,a2f,recvmsg
1,48463940600,48463940700,00000000100,a2f,recvmsg
1,48463940900,48463941100,00000000200,a2f,recvmsg
1,48463941600,48463941800,00000000200,a2f,recvmsg
1,48463942000,48463942200,00000000200,a2f,recvmsg
1,48463943900,48463992800,00000048900,a07,poll
1,48463993100,48463994100,00000001000,a2f,recvmsg
1,48463943900,48463995200,00000051300,a07,poll
1,48463996900,48463997100,00000000200,a2f,recvmsg
1,48463997600,48463997700,00000000100,a2f,recvmsg
1,48463997800,48463998000,00000000200,a2f,recvmsg
1,48463998500,48463998700,00000000200,a2f,recvmsg
1,48463998900,48463999100,00000000200,a2f,recvmsg
1,48464000800,48464050900,00000050100,a07,poll
1,48464051100,48464052200,00000001100,a2f,recvmsg
1,48464000800,48464053300,00000052500,a07,poll
1,48464054900,48464055000,00000000100,a2f,recvmsg
1,48464055600,48464055700,00000000100,a2f,recvmsg
1,48464055900,48464056100,00000000200,a2f,recvmsg
1,48464056600,48464056700,00000000100,a2f,recvmsg
1,48464056900,48464057100,00000000200,a2f,recvmsg
1,48464058800,48464108200,00000049400,a07,poll
1,48464108400,48464109500,00000001100,a2f,recvmsg
1,48464058800,48464110600,00000051800,a07,poll
1,48464112800,48464113000,00000000200,a2f,recvmsg
1,48464113500,48464113600,00000000100,a2f,recvmsg
1,48464113800,48464113900,00000000100,a2f,recvmsg
1,48464114500,48464114700,00000000200,a2f,recvmsg
1,48464114900,48464115100,00000000200,a2f,recvmsg
1,48464117400,48464164900,00000047500,a07,poll
1,48464166300,48464208900,00000042600,a07,poll
1,48464210200,48464252600,00000042400,a07,poll
1,48408127400,48464262300,00056134900,ae8,epoll_wait
1,48464275100,48464275200,00000000100,a2f,recvmsg
1,48464254100,48464296300,00000042200,a07,poll
1,48464291600,48464320000,00000028400,ae8,epoll_wait
1,48464322100,48464323000,00000000900,a2f,recvmsg
1,48464328100,48464328200,00000000100,a2f,recvmsg
1,48464297600,48464339400,00000041800,a07,poll
1,48464342400,48464343200,00000000800,a2e,sendmsg
1,48464340500,48464382300,00000041800,a07,poll
1,48464383400,48464393100,00000009700,a07,poll
1,48464409900,48464430700,00000020800,a07,poll
1,48464409900,48464435200,00000025300,a07,poll
1,48464441000,48464453300,00000012300,a07,poll
1,48464454700,48464469600,00000014900,a07,poll
1,48464470800,48464484400,00000013600,a07,poll
1,48464485700,48464498500,00000012800,a07,poll
1,48464499800,48464513100,00000013300,a07,poll
1,48464515100,48464539300,00000024200,a07,poll
1,48464539500,48464541100,00000001600,a2f,recvmsg
1,48464542200,48464543700,00000001500,a2d,recvfrom
1,48464547200,48464547400,00000000200,a2f,recvmsg
1,48464547900,48464548100,00000000200,a2f,recvmsg
1,48464601900,48464602200,00000000300,a2f,recvmsg
1,48464604200,48464604400,00000000200,a2f,recvmsg
1,48464607000,48464954200,00000347200,a07,poll
1,48464957200,48464957300,00000000100,a2f,recvmsg
1,48464958100,48464958300,00000000200,a2f,recvmsg
1,48464958500,48464958700,00000000200,a2f,recvmsg
1,48464959400,48464959600,00000000200,a2f,recvmsg
1,48464959800,48464959900,00000000100,a2f,recvmsg
1,48464344800,48467067300,00002722500,ae8,epoll_wait
1,48467078100,48467080000,00000001900,a2f,recvmsg
1,48467102800,48467103000,00000000200,a2f,recvmsg
1,48467125900,48467130200,00000004300,a2e,sendmsg
1,48467137400,48467138400,00000001000,a2e,sendmsg
1,48464960300,48467144700,00002184400,a07,poll
1,48467146400,48467147100,00000000700,a00,read
1,48467163600,48467164900,00000001300,a2f,recvmsg
1,48467246500,48467247100,00000000600,a2f,recvmsg
1,48467249500,48467249600,00000000100,a00,read
1,48467300900,48467305500,00000004600,a07,poll
1,48467790100,48467792200,00000002100,a2f,recvmsg
1,48467802000,48467802300,00000000300,a2f,recvmsg
1,48467802800,48474474700,00006671900,a07,poll
1,48467802800,48474477700,00006674900,a07,poll
1,48474487500,48474487600,00000000100,a2f,recvmsg
1,48474492400,48474492600,00000000200,a2f,recvmsg
1,48474492900,48474493000,00000000100,a2f,recvmsg
1,48474493300,48474493400,00000000100,a2f,recvmsg
1,48474497000,48474497100,00000000100,a2f,recvmsg
1,48474497400,48474497500,00000000100,a2f,recvmsg
1,48474510500,48474510700,00000000200,a2f,recvmsg
1,48474539500,48474553100,00000013600,a07,poll
1,48474553400,48474554600,00000001200,a2f,recvmsg
1,48474539500,48474556000,00000016500,a07,poll
1,48474560200,48474560400,00000000200,a2f,recvmsg
1,48474561200,48474561400,00000000200,a2f,recvmsg
1,48474561600,48474561700,00000000100,a2f,recvmsg
1,48474562500,48474562700,00000000200,a2f,recvmsg
1,48474562900,48474563100,00000000200,a2f,recvmsg
1,48474565100,48474613000,00000047900,a07,poll
1,48474565100,48474615500,00000050400,a07,poll
1,48474617300,48474617500,00000000200,a2f,recvmsg
1,48474618000,48474618200,00000000200,a2f,recvmsg
1,48474618400,48474618500,00000000100,a2f,recvmsg
1,48474619000,48474619200,00000000200,a2f,recvmsg
1,48474619300,48474619500,00000000200,a2f,recvmsg
1,48474621600,48474671800,00000050200,a07,poll
1,48474672000,48474673300,00000001300,a2f,recvmsg
1,48474621600,48474674300,00000052700,a07,poll
1,48474676000,48474676200,00000000200,a2f,recvmsg
1,48474676700,48474676900,00000000200,a2f,recvmsg
1,48474677100,48474677200,00000000100,a2f,recvmsg
1,48474677700,48474677900,00000000200,a2f,recvmsg
1,48474678000,48474678200,00000000200,a2f,recvmsg
1,48474680000,48474728000,00000048000,a07,poll
1,48474728200,48474729400,00000001200,a2f,recvmsg
1,48474680000,48474730500,00000050500,a07,poll
1,48474732100,48474732300,00000000200,a2f,recvmsg
1,48474732700,48474732900,00000000200,a2f,recvmsg
1,48474733100,48474733200,00000000100,a2f,recvmsg
1,48474733800,48474734000,00000000200,a2f,recvmsg
1,48474734100,48474734300,00000000200,a2f,recvmsg
1,48474736000,48474784000,00000048000,a07,poll
1,48474784300,48474785600,00000001300,a2f,recvmsg
1,48474736000,48474786700,00000050700,a07,poll
1,48474788300,48474788500,00000000200,a2f,recvmsg
1,48474789000,48474789200,00000000200,a2f,recvmsg
1,48474789400,48474789500,00000000100,a2f,recvmsg
1,48474790000,48474790200,00000000200,a2f,recvmsg
1,48474790400,48474790500,00000000100,a2f,recvmsg
1,48474793000,48474839300,00000046300,a07,poll
1,48474840900,48474882200,00000041300,a07,poll
1,48474883300,48474924600,00000041300,a07,poll
1,48474926500,48474967500,00000041000,a07,poll
1,48474968700,48475010100,00000041400,a07,poll
1,48475011200,48475052300,00000041100,a07,poll
1,48475053500,48475105400,00000051900,a07,poll
1,48475106600,48475123600,00000017000,a07,poll
1,48475124800,48475139100,00000014300,a07,poll
1,48475140300,48475154600,00000014300,a07,poll
1,48475155900,48475169200,00000013300,a07,poll
1,48475170400,48475184200,00000013800,a07,poll
1,48475185400,48475209200,00000023800,a07,poll
1,48475209400,48475211000,00000001600,a2f,recvmsg
1,48475212100,48475213400,00000001300,a2d,recvfrom
1,48475217200,48475217300,00000000100,a2f,recvmsg
1,48475217700,48475217900,00000000200,a2f,recvmsg
1,48475271200,48475271600,00000000400,a2f,recvmsg
1,48475273200,48475273400,00000000200,a2f,recvmsg
1,48475275900,48475631200,00000355300,a07,poll
1,48475634000,48475634200,00000000200,a2f,recvmsg
1,48475634900,48475635100,00000000200,a2f,recvmsg
1,48475635200,48475635400,00000000200,a2f,recvmsg
1,48475636200,48475636400,00000000200,a2f,recvmsg
1,48475636600,48475636800,00000000200,a2f,recvmsg
1,48401417400,48480524400,00079107000,a4a,fsync
1,48480584200,48480588000,00000003800,a09,mmap
1,48475637100,48480662600,00005025500,a07,poll
1,48480666600,48480668200,00000001600,aca,futex
1,48480672100,48480672900,00000000800,aca,futex
1,48480674700,48480675700,00000001000,aca,futex
1,48480693700,48480693900,00000000200,a00,read
1,48467140300,48480701500,00013561200,ae8,epoll_wait
1,48480728700,48480728900,00000000200,a2f,recvmsg
1,48480748700,48480753000,00000004300,a2e,sendmsg
1,48480698400,48480811600,00000113200,a07,poll
1,48480813200,48480814200,00000001000,aca,futex
1,48480816300,48480817000,00000000700,aca,futex
1,48480818300,48480819100,00000000800,aca,futex
1,48480821800,48480823800,00000002000,a2e,sendmsg
1,48480756200,48480830900,00000074700,ae8,epoll_wait
1,48480833800,48480835000,00000001200,a2f,recvmsg
1,48480842800,48480843000,00000000200,a2f,recvmsg
1,48480865200,48480866000,00000000800,a2e,sendmsg
1,48481026100,48481034400,00000008300,a01,write
1,48480885600,48481068200,00000182600,a07,poll
1,48481133400,48481133700,00000000300,a00,read
1,48481184600,48481186700,00000002100,a01,write
1,48480868300,48481208500,00000340200,ae8,epoll_wait
1,48481213200,48481215400,00000002200,a2f,recvmsg
1,48481224400,48481224600,00000000200,a2f,recvmsg
1,48481237500,48481240800,00000003300,a2e,sendmsg
1,48481190500,48481242500,00000052000,a07,poll
1,48481243300,48481243800,00000000500,a00,read
1,48481252500,48481253200,00000000700,a2f,recvmsg
1,48481321300,48483904900,00002583600,a07,poll
1,48481321300,48483908300,00002587000,a07,poll
1,48483921000,48483921100,00000000100,a2f,recvmsg
1,48483925600,48483925800,00000000200,a2f,recvmsg
1,48483926100,48483926300,00000000200,a2f,recvmsg
1,48483931200,48483931400,00000000200,a2f,recvmsg
1,48483931600,48483931800,00000000200,a2f,recvmsg
1,48483936300,48483937000,00000000700,a00,read
1,48483945900,48483946100,00000000200,a2f,recvmsg
1,48483980300,48483983200,00000002900,a14,writev
1,48483979700,48483984600,00000004900,a07,poll
1,48483987300,48483987500,00000000200,a2f,recvmsg
1,48483988300,48483988400,00000000100,a2f,recvmsg
1,48483988700,48483988800,00000000100,a2f,recvmsg
1,48483989600,48483989800,00000000200,a2f,recvmsg
1,48483990000,48483990200,00000000200,a2f,recvmsg
1,48483994300,48484040500,00000046200,a07,poll
1,48484040700,48484042800,00000002100,a2f,recvmsg
1,48483994300,48484044100,00000049800,a07,poll
1,48484045900,48484046000,00000000100,a2f,recvmsg
1,48484046500,48484046700,00000000200,a2f,recvmsg
1,48484046900,48484047000,00000000100,a2f,recvmsg
1,48484047600,48484047700,00000000100,a2f,recvmsg
1,48484047900,48484048100,00000000200,a2f,recvmsg
1,48484049900,48484097300,00000047400,a07,poll
1,48484097600,48484098700,00000001100,a2f,recvmsg
1,48484049900,48484099800,00000049900,a07,poll
1,48484101500,48484101600,00000000100,a2f,recvmsg
1,48484102100,48484102200,00000000100,a2f,recvmsg
1,48484102400,48484102600,00000000200,a2f,recvmsg
1,48484103100,48484103300,00000000200,a2f,recvmsg
1,48484103500,48484103600,00000000100,a2f,recvmsg
1,48484105400,48484154000,00000048600,a07,poll
1,48484154200,48484155200,00000001000,a2f,recvmsg
1,48484105400,48484156300,00000050900,a07,poll
1,48484158000,48484158100,00000000100,a2f,recvmsg
1,48484158600,48484158700,00000000100,a2f,recvmsg
1,48484158900,48484159100,00000000200,a2f,recvmsg
1,48484159600,48484159800,00000000200,a2f,recvmsg
1,48484160000,48484160100,00000000100,a2f,recvmsg
1,48484161800,48484209700,00000047900,a07,poll
1,48484209900,48484211200,00000001300,a2f,recvmsg
1,48484161800,48484212200,00000050400,a07,poll
1,48484213900,48484214100,00000000200,a2f,recvmsg
1,48484214600,48484214800,00000000200,a2f,recvmsg
1,48484214900,48484215100,00000000200,a2f,recvmsg
1,48484215600,48484215700,00000000100,a2f,recvmsg
1,48484215900,48484216100,00000000200,a2f,recvmsg
1,48484217700,48484266300,00000048600,a07,poll
1,48484267600,48484311100,00000043500,a07,poll
1,48484312400,48484353900,00000041500,a07,poll
1,48484356000,48484396700,00000040700,a07,poll
1,48484398000,48484440900,00000042900,a07,poll
1,48484442100,48484484300,00000042200,a07,poll
1,48484485600,48484537100,00000051500,a07,poll
1,48484538300,48484555400,00000017100,a07,poll
1,48484556600,48484570900,00000014300,a07,poll
1,48484572500,48484586600,00000014100,a07,poll
1,48484587900,48484601500,00000013600,a07,poll
1,48484603000,48484615900,00000012900,a07,poll
1,48484617200,48484641400,00000024200,a07,poll
1,48484641600,48484643200,00000001600,a2f,recvmsg
1,48484646700,48484648300,00000001600,a2d,recvfrom
1,48484652400,48484652600,00000000200,a2f,recvmsg
1,48484653000,48484653200,00000000200,a2f,recvmsg
1,48484708800,48484709200,00000000400,a2f,recvmsg
1,48484710900,48484711100,00000000200,a2f,recvmsg
1,48484713300,48485064400,00000351100,a07,poll
1,48485067400,48485067600,00000000200,a2f,recvmsg
1,48485068500,48485068600,00000000100,a2f,recvmsg
1,48485068700,48485068900,00000000200,a2f,recvmsg
1,48485069800,48485069900,00000000100,a2f,recvmsg
1,48485070100,48485070300,00000000200,a2f,recvmsg
1,48481330300,48491115700,00009785400,ae8,epoll_wait
1,48491126400,48491126500,00000000100,a2f,recvmsg
1,48491139900,48491173400,00000033500,ae8,epoll_wait
1,48491174800,48491175500,00000000700,a2f,recvmsg
1,48491180700,48491180800,00000000100,a2f,recvmsg
1,48491195500,48491196300,00000000800,a2e,sendmsg
1,48485070500,48491390400,00006319900,a07,poll
1,48491400900,48491401400,00000000500,aca,futex
1,48491410500,48491433700,00000023200,a07,poll
1,48491445100,48495532300,00004087200,a07,poll
1,48491445100,48495535500,00004090400,a07,poll
1,48495549400,48495549600,00000000200,a2f,recvmsg
1,48495554500,48495554700,00000000200,a2f,recvmsg
1,48495554900,48495555000,00000000100,a2f,recvmsg
1,48495560000,48495560200,00000000200,a2f,recvmsg
1,48495560300,48495560500,00000000200,a2f,recvmsg
1,48495574700,48495575000,00000000300,a2f,recvmsg
1,48495561200,48495611500,00000050300,a07,poll
1,48495614500,48495614700,00000000200,a2f,recvmsg
1,48495615500,48495615600,00000000100,a2f,recvmsg
1,48495615700,48495615900,00000000200,a2f,recvmsg
1,48495616800,48495617000,00000000200,a2f,recvmsg
1,48495617200,48495617300,00000000100,a2f,recvmsg
1,48495628400,48495668400,00000040000,a07,poll
1,48495628400,48495670900,00000042500,a07,poll
1,48495672900,48495673100,00000000200,a2f,recvmsg
1,48495673700,48495673900,00000000200,a2f,recvmsg
1,48495674100,48495674300,00000000200,a2f,recvmsg
1,48495674800,48495674900,00000000100,a2f,recvmsg
1,48495675100,48495675300,00000000200,a2f,recvmsg
1,48495677100,48495726300,00000049200,a07,poll
1,48495726500,48495727700,00000001200,a2f,recvmsg
1,48495677100,48495728700,00000051600,a07,poll
1,48495730400,48495730600,00000000200,a2f,recvmsg
1,48495731100,48495731300,00000000200,a2f,recvmsg
1,48495731500,48495731600,00000000100,a2f,recvmsg
1,48495732100,48495732300,00000000200,a2f,recvmsg
1,48495732500,48495732600,00000000100,a2f,recvmsg
1,48495734300,48495783800,00000049500,a07,poll
1,48495784000,48495785100,00000001100,a2f,recvmsg
1,48495734300,48495786200,00000051900,a07,poll
1,48495787700,48495787900,00000000200,a2f,recvmsg
1,48495788400,48495788500,00000000100,a2f,recvmsg
1,48495788700,48495788900,00000000200,a2f,recvmsg
1,48495789400,48495789600,00000000200,a2f,recvmsg
1,48495789700,48495789900,00000000200,a2f,recvmsg
1,48495791500,48495839300,00000047800,a07,poll
1,48495840900,48495842400,00000001500,a07,poll
1,48495844000,48495844200,00000000200,a2f,recvmsg
1,48495844700,48495844900,00000000200,a2f,recvmsg
1,48495845100,48495845300,00000000200,a2f,recvmsg
1,48495845700,48495845900,00000000200,a2f,recvmsg
1,48495846100,48495846200,00000000100,a2f,recvmsg
1,48495846400,48495895600,00000049200,a07,poll
1,48495897000,48495942600,00000045600,a07,poll
1,48495943900,48495986000,00000042100,a07,poll
1,48495988100,48496029700,00000041600,a07,poll
1,48496031000,48496073000,00000042000,a07,poll
1,48496074200,48496116200,00000042000,a07,poll
1,48496117300,48496169600,00000052300,a07,poll
1,48496170900,48496188100,00000017200,a07,poll
1,48496189400,48496204500,00000015100,a07,poll
1,48496205800,48496219100,00000013300,a07,poll
1,48496220400,48496233600,00000013200,a07,poll
1,48496235000,48496247900,00000012900,a07,poll
1,48496249600,48496274500,00000024900,a07,poll
1,48496274700,48496276300,00000001600,a2f,recvmsg
1,48496277900,48496279400,00000001500,a2d,recvfrom
1,48496283500,48496283700,00000000200,a2f,recvmsg
1,48496284200,48496284400,00000000200,a2f,recvmsg
1,48496340100,48496340400,00000000300,a2f,recvmsg
1,48496342600,48496342800,00000000200,a2f,recvmsg
1,48496345300,48496693400,00000348100,a07,poll
1,48496696400,48496696600,00000000200,a2f,recvmsg
1,48496697200,48496697400,00000000200,a2f,recvmsg
1,48496697600,48496697800,00000000200,a2f,recvmsg
1,48496698600,48496698800,00000000200,a2f,recvmsg
1,48496699000,48496699100,00000000100,a2f,recvmsg
1,48491197800,48498825600,00007627800,ae8,epoll_wait
1,48498836500,48498838400,00000001900,a2f,recvmsg
1,48498861500,48498861700,00000000200,a2f,recvmsg
1,48498885100,48498889200,00000004100,a2e,sendmsg
1,48498896300,48498897300,00000001000,a2e,sendmsg
1,48496699400,48498904100,00002204700,a07,poll
1,48498905800,48498906500,00000000700,a00,read
1,48498923600,48498924800,00000001200,a2f,recvmsg
1,48499003900,48499004700,00000000800,a2f,recvmsg
1,48499009300,48499009400,00000000100,a00,read
1,48499059200,48499063900,00000004700,a07,poll
1,48499545900,48499548300,00000002400,a2f,recvmsg
1,48499557600,48499557900,00000000300,a2f,recvmsg
1,48499558400,48503888200,00004329800,a07,poll
1,48499558400,48503891100,00004332700,a07,poll
1,48503900900,48503901100,00000000200,a2f,recvmsg
1,48503906000,48503906200,00000000200,a2f,recvmsg
1,48503906500,48503906600,00000000100,a2f,recvmsg
1,48503906900,48503907100,00000000200,a2f,recvmsg
1,48503910700,48503910900,00000000200,a2f,recvmsg
1,48503911000,48503911200,00000000200,a2f,recvmsg
1,48503923300,48503923500,00000000200,a2f,recvmsg
1,48503952700,48503966700,00000014000,a07,poll
1,48503967000,48503968200,00000001200,a2f,recvmsg
1,48503952700,48503969700,00000017000,a07,poll
1,48503971900,48503972100,00000000200,a2f,recvmsg
1,48503972800,48503973000,00000000200,a2f,recvmsg
1,48503973200,48503973300,00000000100,a2f,recvmsg
1,48503974000,48503974200,00000000200,a2f,recvmsg
1,48503974400,48503974600,00000000200,a2f,recvmsg
1,48503976600,48504025000,00000048400,a07,poll
1,48504025300,48504026500,00000001200,a2f,recvmsg
1,48503976600,48504027600,00000051000,a07,poll
1,48504029200,48504029400,00000000200,a2f,recvmsg
1,48504029900,48504030100,00000000200,a2f,recvmsg
1,48504030300,48504030500,00000000200,a2f,recvmsg
1,48504030900,48504031100,00000000200,a2f,recvmsg
1,48504031300,48504031400,00000000100,a2f,recvmsg
1,48504033200,48504082100,00000048900,a07,poll
1,48504033200,48504084200,00000051000,a07,poll
1,48504085800,48504086000,00000000200,a2f,recvmsg
1,48504086500,48504086700,00000000200,a2f,recvmsg
1,48504086900,48504087000,00000000100,a2f,recvmsg
1,48504087600,48504087700,00000000100,a2f,recvmsg
1,48504087800,48504088000,00000000200,a2f,recvmsg
1,48504089900,48504137700,00000047800,a07,poll
1,48504137900,48504139000,00000001100,a2f,recvmsg
1,48504089900,48504140100,00000050200,a07,poll
1,48504141700,48504141900,00000000200,a2f,recvmsg
1,48504142400,48504142600,00000000200,a2f,recvmsg
1,48504142700,48504142800,00000000100,a2f,recvmsg
1,48504143300,48504143500,00000000200,a2f,recvmsg
1,48504143700,48504143900,00000000200,a2f,recvmsg
1,48504145700,48504195100,00000049400,a07,poll
1,48504195400,48504197200,00000001800,a2f,recvmsg
1,48504145700,48504198300,00000052600,a07,poll
1,48504199800,48504200000,00000000200,a2f,recvmsg
1,48504200500,48504200700,00000000200,a2f,recvmsg
1,48504200800,48504201000,00000000200,a2f,recvmsg
1,48504201500,48504201700,00000000200,a2f,recvmsg
1,48504201800,48504202000,00000000200,a2f,recvmsg
1,48504204100,48504251100,00000047000,a07,poll
1,48504252400,48504293900,00000041500,a07,poll
1,48481038000,48504336700,00023298700,a4a,fsync
1,48504390000,48504395400,00000005400,a09,mmap
1,48504295100,48504471600,00000176500,a07,poll
1,48504475200,48504476600,00000001400,aca,futex
1,48504480200,48504481000,00000000800,aca,futex
1,48504483300,48504484300,00000001000,aca,futex
1,48504500700,48504500900,00000000200,a00,read
1,48498899000,48504509100,00005610100,ae8,epoll_wait
1,48504535700,48504535900,00000000200,a2f,recvmsg
1,48504505500,48504617000,00000111500,a07,poll
1,48504618600,48504619700,00000001100,aca,futex
1,48504621500,48504622300,00000000800,aca,futex
1,48504623500,48504624400,00000000900,aca,futex
1,48504626900,48504629000,00000002100,a2e,sendmsg
1,48504562800,48504636200,00000073400,ae8,epoll_wait
1,48504638800,48504639900,00000001100,a2f,recvmsg
1,48504647800,48504648000,00000000200,a2f,recvmsg
1,48504671200,48504672200,00000001000,a2e,sendmsg
1,48504840600,48504849800,00000009200,a01,write
1,48504692400,48504885000,00000192600,a07,poll
1,48504886000,48504893100,00000007100,a2f,recvmsg
1,48504899000,48504900200,00000001200,a2d,recvfrom
1,48504905700,48504906000,00000000300,a2f,recvmsg
1,48504906600,48504906700,00000000100,a2f,recvmsg
1,48504967700,48504968100,00000000400,a2f,recvmsg
1,48504970900,48504971100,00000000200,a2f,recvmsg
1,48504974400,48505173100,00000198700,a07,poll
1,48504405700,48505500300,00001094600,a57,unlink
1,48505506300,48505510800,00000004500,a14,writev
1,48505511900,48505540800,00000028900,a07,poll
1,48505548600,48505548800,00000000200,a2f,recvmsg
1,48505551100,48505551300,00000000200,a2f,recvmsg
1,48505551500,48505551700,00000000200,a2f,recvmsg
1,48505554400,48505554500,00000000100,a2f,recvmsg
1,48505554700,48505554900,00000000200,a2f,recvmsg
1,48505555400,48505557700,00000002300,a07,poll
1,48505575900,48505578100,00000002200,a07,poll
1,48505580900,48505581100,00000000200,a2f,recvmsg
1,48505581600,48505581800,00000000200,a2f,recvmsg
1,48506005500,48506009100,00000003600,a09,mmap
1,48506171500,48506234000,00000062500,a2f,recvmsg
1,48506277200,48506333200,00000056000,a2f,recvmsg
1,48506374200,48506386500,00000012300,a2f,recvmsg
1,48506425300,48506426100,00000000800,a2f,recvmsg
1,48506462900,48506463200,00000000300,a2f,recvmsg
1,48504674300,48506519700,00001845400,ae8,epoll_wait
1,48506528300,48506529900,00000001600,a2f,recvmsg
1,48506539600,48506540100,00000000500,a2f,recvmsg
1,48506555800,48506559500,00000003700,a2e,sendmsg
1,48506514700,48506562500,00000047800,a07,poll
1,48506564300,48506565000,00000000700,a00,read
1,48506578800,48506580100,00000001300,a2f,recvmsg
1,48506648300,48506783800,00000135500,a07,poll
1,48506784700,48506786700,00000002000,a2f,recvmsg
1,48506802400,48506804000,00000001600,a2d,recvfrom
1,48506805400,48506805700,00000000300,a2f,recvmsg
1,48506806500,48506806600,00000000100,a2f,recvmsg
1,48506845200,48506876700,00000031500,a07,poll
1,48506877000,48506878900,00000001900,a2f,recvmsg
1,48506880100,48506880300,00000000200,a2f,recvmsg
1,48506880700,48506880800,00000000100,a2f,recvmsg
1,48506901400,48506902000,00000000600,aca,futex
1,48506907000,48506908800,00000001800,a14,writev
1,48506909200,48506925400,00000016200,a07,poll
1,48506925700,48506927100,00000001400,a2f,recvmsg
1,48506928400,48506928600,00000000200,a2f,recvmsg
1,48506929000,48506929200,00000000200,a2f,recvmsg
1,48506939000,48506939300,00000000300,aca,futex
1,48506953300,48506954900,00000001600,a14,writev
1,48506955400,48506970900,00000015500,a07,poll
1,48506971200,48506972600,00000001400,a2f,recvmsg
1,48506974600,48506974800,00000000200,a2f,recvmsg
1,48506975100,48506975300,00000000200,a2f,recvmsg
1,48506997200,48506998900,00000001700,a14,writev
1,48506999300,48507013600,00000014300,a07,poll
1,48507013800,48507015300,00000001500,a2f,recvmsg
1,48507016200,48507016300,00000000100,a2f,recvmsg
1,48507016700,48507016900,00000000200,a2f,recvmsg
1,48507038400,48507040200,00000001800,a14,writev
1,48507040600,48507054100,00000013500,a07,poll
1,48507054400,48507055800,00000001400,a2f,recvmsg
1,48507056700,48507056800,00000000100,a2f,recvmsg
1,48507057200,48507057400,00000000200,a2f,recvmsg
1,48507079100,48507080700,00000001600,a14,writev
1,48507081100,48507094200,00000013100,a07,poll
1,48507094500,48507095900,00000001400,a2f,recvmsg
1,48507096700,48507096900,00000000200,a2f,recvmsg
1,48507097200,48507097300,00000000100,a2f,recvmsg
1,48507119100,48507120700,00000001600,a14,writev
1,48507121100,48507134100,00000013000,a07,poll
1,48507134400,48507135800,00000001400,a2f,recvmsg
1,48507136600,48507136800,00000000200,a2f,recvmsg
1,48507137200,48507137300,00000000100,a2f,recvmsg
1,48506657600,48508769000,00002111400,ae8,epoll_wait
1,48508774200,48508775100,00000000900,a2f,recvmsg
1,48508785600,48508785800,00000000200,a2f,recvmsg
1,48508801600,48508805100,00000003500,a2e,sendmsg
1,48507121100,48508811600,00001690500,a07,poll
1,48508813400,48508814100,00000000700,a00,read
1,48508828100,48508829200,00000001100,a2f,recvmsg
1,48508906100,48508910800,00000004700,a07,poll
1,48508929300,48508929900,00000000600,a2f,recvmsg
1,48508934900,48508935100,00000000200,a2f,recvmsg
1,48508935600,48517667600,00008732000,a07,poll
1,48517680900,48517681100,00000000200,a2f,recvmsg
1,48517686000,48517686100,00000000100,a2f,recvmsg
1,48517686300,48517686500,00000000200,a2f,recvmsg
1,48517691400,48517691500,00000000100,a2f,recvmsg
1,48517691700,48517691800,00000000100,a2f,recvmsg
1,48517692600,48517697100,00000004500,a07,poll
1,48517699000,48517699800,00000000800,a00,read
1,48517708700,48517708800,00000000100,a2f,recvmsg
1,48517741200,48517743500,00000002300,a07,poll
1,48517746500,48517746700,00000000200,a2f,recvmsg
1,48517747500,48517747700,00000000200,a2f,recvmsg
1,48517747900,48517748100,00000000200,a2f,recvmsg
1,48517748900,48517749100,00000000200,a2f,recvmsg
1,48517749300,48517749500,00000000200,a2f,recvmsg
1,48504854200,48517755300,00012901100,a4a,fsync
1,48517810200,48517816300,00000006100,a09,mmap
1,48517752500,48517891600,00000139100,a07,poll
1,48517895000,48517896500,00000001500,aca,futex
1,48517899600,48517900700,00000001100,aca,futex
1,48517902600,48517903600,00000001000,aca,futex
1,48517919900,48517920100,00000000200,a00,read
1,48508807400,48517927900,00009120500,ae8,epoll_wait
1,48517953300,48517953500,00000000200,a2f,recvmsg
1,48517924700,48518031100,00000106400,a07,poll
1,48518032600,48518033700,00000001100,aca,futex
1,48518035500,48518036300,00000000800,aca,futex
1,48518037700,48518038500,00000000800,aca,futex
1,48518041000,48518043000,00000002000,a2e,sendmsg
1,48517979800,48518050000,00000070200,ae8,epoll_wait
1,48518052500,48518053500,00000001000,a2f,recvmsg
1,48518061600,48518061700,00000000100,a2f,recvmsg
1,48518083100,48518084000,00000000900,a2e,sendmsg
1,48518250800,48518259100,00000008300,a01,write
1,48518102700,48518297400,00000194700,a07,poll
1,48518301000,48518305900,00000004900,a2f,recvmsg
1,48518309800,48518310000,00000000200,a2f,recvmsg
1,48518312100,48518312200,00000000100,a2f,recvmsg
1,48518312500,48518312700,00000000200,a2f,recvmsg
1,48518314400,48518314600,00000000200,a2f,recvmsg
1,48518314800,48518314900,00000000100,a2f,recvmsg
1,48518315400,48518318100,00000002700,a07,poll
1,48518319100,48518324700,00000005600,a2f,recvmsg
1,48518330700,48518345100,00000014400,a07,poll
1,48518346400,48518360000,00000013600,a07,poll
1,48518361200,48518376300,00000015100,a07,poll
1,48518377600,48518392500,00000014900,a07,poll
1,48518393700,48518430700,00000037000,a07,poll
1,48518431000,48518433000,00000002000,a2f,recvmsg
1,48518436600,48518438100,00000001500,a2d,recvfrom
1,48518443400,48518443600,00000000200,a2f,recvmsg
1,48518444300,48518444500,00000000200,a2f,recvmsg
1,48518508600,48518508800,00000000200,a2f,recvmsg
1,48518511900,48518512100,00000000200,a2f,recvmsg
1,48518515600,48518953900,00000438300,a07,poll
1,48519059900,48519087700,00000027800,a07,poll
1,48519094700,48519094900,00000000200,a2f,recvmsg
1,48519096700,48519096800,00000000100,a2f,recvmsg
1,48519097100,48519097200,00000000100,a2f,recvmsg
1,48519099400,48519099600,00000000200,a2f,recvmsg
1,48519099600,48519099800,00000000200,a2f,recvmsg
1,48518086200,48519107300,00001021100,ae8,epoll_wait
1,48519115000,48519116100,00000001100,a2f,recvmsg
1,48519127100,48519127300,00000000200,a2f,recvmsg
1,48519145300,48519149000,00000003700,a2e,sendmsg
1,48519100400,48519151300,00000050900,a07,poll
1,48519152700,48519153200,00000000500,a00,read
1,48519164300,48519165400,00000001100,a2f,recvmsg
1,48521885600,48521885700,00000000100,a0c,brk
1,48521896000,48521898800,00000002800,a15,access
1,48521899700,48521900500,00000000800,a09,mmap
1,48521905300,48521906000,00000000700,a15,access
1,48521912300,48521913400,00000001100,a09,mmap
1,48521917300,48521918100,00000000800,a15,access
1,48521925200,48521926100,00000000900,a00,read
1,48521927600,48521929100,00000001500,a09,mmap
1,48521933600,48521935700,00000002100,a09,mmap
1,48521947900,48521948600,00000000700,a15,access
1,48521952000,48521952700,00000000700,a00,read
1,48521953400,48521954400,00000001000,a09,mmap
1,48521966400,48521967000,00000000600,a15,access
1,48521969900,48521970500,00000000600,a00,read
1,48521971000,48521971900,00000000900,a09,mmap
1,48521973500,48521975700,00000002200,a09,mmap
1,48521980200,48521983600,00000003400,a09,mmap
1,48521985700,48521986800,00000001100,a09,mmap
1,48521995400,48521996300,00000000900,a15,access
1,48521999000,48521999500,00000000500,a00,read
1,48522000100,48522001600,00000001500,a09,mmap
1,48522004700,48522006300,00000001600,a09,mmap
1,48522014500,48522015200,00000000700,a15,access
1,48522018200,48522018800,00000000600,a00,read
1,48522019500,48522020900,00000001400,a09,mmap
1,48522024900,48522027000,00000002100,a09,mmap
1,48522035700,48522036500,00000000800,a15,access
1,48522039200,48522039800,00000000600,a00,read
1,48522040300,48522041300,00000001000,a09,mmap
1,48522042600,48522043900,00000001300,a09,mmap
1,48522047200,48522048400,00000001200,a09,mmap
1,48522054600,48522055100,00000000500,a15,access
1,48522057300,48522057800,00000000500,a00,read
1,48522058300,48522059700,00000001400,a09,mmap
1,48522062100,48522063900,00000001800,a09,mmap
1,48522078400,48522079000,00000000600,a09,mmap
1,48522082900,48522083300,00000000400,a09,mmap
1,48522086300,48522086500,00000000200,a09,mmap
1,48522135000,48522150200,00000015200,60e,page_fault
1,48522281000,48522281100,00000000100,a0c,brk
1,48522281200,48522282100,00000000900,a0c,brk
1,48522314500,48522321100,00000006600,a00,read
1,48522333100,48522334500,00000001400,a00,read
1,48522369500,48522370300,00000000800,a00,read
1,48522493100,48522493900,00000000800,a00,read
1,48522564200,48522564700,00000000500,a00,read
1,48522650100,48522650700,00000000600,a00,read
1,48522781700,48522782800,00000001100,a00,read
1,48522912400,48522913000,00000000600,a00,read
1,48523067800,48523068500,00000000700,a00,read
1,48523218000,48523218800,00000000800,a00,read
1,48523255100,48523256400,00000001300,a0c,brk
1,48523370900,48523371600,00000000700,a00,read
1,48523520700,48523521300,00000000600,a00,read
1,48523678700,48523679600,00000000900,a00,read
1,48523838100,48523838600,00000000500,a00,read
1,48523946700,48523947400,00000000700,a00,read
1,48523977500,48523978200,00000000700,a0c,brk
1,48524085300,48524086200,00000000900,a00,read
1,48524328100,48524328600,00000000500,a00,read
1,48524340400,48524340800,00000000400,a00,read
1,48524383900,48524384300,00000000400,a00,read
1,48524404900,48524404900,00000000000,a00,read
1,48524610900,48524611400,00000000500,a00,read
1,48524640300,48524641200,00000000900,a00,read
1,48524738000,48524738800,00000000800,a00,read
1,48524762600,48524763800,00000001200,a0c,brk
1,48524808600,48524809000,00000000400,a00,read
1,48524886100,48524886900,00000000800,a00,read
1,48525039900,48525040400,00000000500,a00,read
1,48525151800,48525152400,00000000600,a00,read
1,48525246400,48525246900,00000000500,a00,read
1,48525258500,48525259000,00000000500,a00,read
1,48525338400,48525338900,00000000500,a00,read
1,48525362800,48525363200,00000000400,a00,read
1,48525384700,48525385100,00000000400,a00,read
1,48525486300,48525487400,00000001100,a0c,brk
1,48525489400,48525490400,00000001000,a00,read
1,48525691700,48525692200,00000000500,a00,read
1,48525774600,48525775500,00000000900,a00,read
1,48525839700,48525840400,00000000700,a00,read
1,48525968700,48525969200,00000000500,a00,read
1,48526001200,48526002000,00000000800,a00,read
1,48526019200,48526020600,00000001400,a02,open
1,48526130300,48526130800,00000000500,a00,read
1,47334437000,48528417000,01193980000,a17,select
1,48340086400,48528503700,00188417300,a3d,wait4
1,48528541100,48528541400,00000000300,a3d,wait4
1,48528560900,48528563400,00000002500,a04,stat
1,48528444300,48528746900,00000302600,a17,select
1,48530227400,48530227900,00000000500,a00,read
1,48530280700,48530282000,00000001300,a0c,brk
1,48530288300,48530288900,00000000600,a00,read
1,48530398200,48530398800,00000000600,a00,read
1,48530548600,48530549400,00000000800,a00,read
1,48530679100,48530679800,00000000700,a00,read
1,48530737700,48530738400,00000000700,a00,read
1,48530793800,48530794500,00000000700,a00,read
1,48530864500,48530865200,00000000700,a00,read
1,48530917600,48530918300,00000000700,a00,read
1,48531006300,48531007100,00000000800,a0c,brk
1,48531039100,48531042100,00000003000,a0c,brk
1,48531056200,48531057000,00000000800,a00,read
1,48531171100,48531171900,00000000800,a00,read
1,48531329900,48531330600,00000000700,a00,read
1,48531447100,48531447800,00000000700,a00,read
1,48531592900,48531593600,00000000700,a00,read
1,48531710000,48531710700,00000000700,a00,read
1,48531871200,48531871700,00000000500,a00,read
1,48531876700,48531877300,00000000600,a0c,brk
1,48531992500,48531993100,00000000600,a00,read
1,48532110400,48532111000,00000000600,a00,read
1,48532251500,48532252300,00000000800,a00,read
1,48532382700,48532383400,00000000700,a00,read
1,48532475600,48532476200,00000000600,a00,read
1,48532588000,48532588600,00000000600,a00,read
1,48532711900,48532712500,00000000600,a00,read
1,48532823500,48532824100,00000000600,a0c,brk
1,48532846800,48532847600,00000000800,a00,read
1,48533016500,48533017200,00000000700,a00,read
1,48533166400,48533167100,00000000700,a00,read
1,48533276500,48533277200,00000000700,a00,read
1,48533444000,48533445000,00000001000,a00,read
1,48533520900,48533521600,00000000700,a00,read
1,48533602300,48533603000,00000000700,a00,read
1,48533669000,48533669900,00000000900,a0c,brk
1,48533684500,48533685100,00000000600,a00,read
1,48533757700,48533758300,00000000600,a00,read
1,48533860300,48533860900,00000000600,a00,read
1,48533963100,48533963800,00000000700,a00,read
1,48534052800,48534053500,00000000700,a00,read
1,48534143700,48534144400,00000000700,a00,read
1,48534245500,48534246200,00000000700,a00,read
1,48534327400,48534328000,00000000600,a0c,brk
1,48534330300,48534331000,00000000700,a00,read
1,48534437800,48534438400,00000000600,a00,read
1,48534530700,48534531400,00000000700,a00,read
1,48534650000,48534650700,00000000700,a00,read
1,48534764100,48534764800,00000000700,a00,read
1,48534867400,48534868000,00000000600,a00,read
1,48535331300,48535334600,00000003300,a57,unlink
1,48535335400,48535360700,00000025300,a02,open
1,48535361800,48535362500,00000000700,a48,fcntl
1,48535410600,48535425100,00000014500,a01,write
1,48535442900,48535445400,00000002500,a01,write
1,48535461900,48535464000,00000002100,a01,write
1,48519232500,48537043100,00017810600,a07,poll
1,48519232500,48537046900,00017814400,a07,poll
1,48537061400,48537061700,00000000300,a2f,recvmsg
1,48537066200,48537066400,00000000200,a2f,recvmsg
1,48537066700,48537066900,00000000200,a2f,recvmsg
1,48537071700,48537071900,00000000200,a2f,recvmsg
1,48537072100,48537072300,00000000200,a2f,recvmsg
1,48537087200,48537087500,00000000300,a2f,recvmsg
1,48537073200,48537120800,00000047600,a07,poll
1,48537123600,48537123800,00000000200,a2f,recvmsg
1,48537124500,48537124700,00000000200,a2f,recvmsg
1,48537124900,48537124900,00000000000,a2f,recvmsg
1,48537125800,48537126000,00000000200,a2f,recvmsg
1,48537126200,48537126300,00000000100,a2f,recvmsg
1,48537138100,48537177300,00000039200,a07,poll
1,48537177500,48537178600,00000001100,a2f,recvmsg
1,48537138100,48537179800,00000041700,a07,poll
1,48537181900,48537182000,00000000100,a2f,recvmsg
1,48537182600,48537182700,00000000100,a2f,recvmsg
1,48537182900,48537183100,00000000200,a2f,recvmsg
1,48537183600,48537183800,00000000200,a2f,recvmsg
1,48537183900,48537184100,00000000200,a2f,recvmsg
1,48537185900,48537235500,00000049600,a07,poll
1,48537235700,48537236900,00000001200,a2f,recvmsg
1,48537185900,48537238000,00000052100,a07,poll
1,48537240700,48537240800,00000000100,a2f,recvmsg
1,48537241300,48537241500,00000000200,a2f,recvmsg
1,48537241700,48537241900,00000000200,a2f,recvmsg
1,48537242400,48537242600,00000000200,a2f,recvmsg
1,48537242700,48537242900,00000000200,a2f,recvmsg
1,48537244600,48537290600,00000046000,a07,poll
1,48537290800,48537292000,00000001200,a2f,recvmsg
1,48537244600,48537293000,00000048400,a07,poll
1,48537294700,48537294900,00000000200,a2f,recvmsg
1,48537295400,48537295600,00000000200,a2f,recvmsg
1,48537295700,48537295900,00000000200,a2f,recvmsg
1,48537296300,48537296500,00000000200,a2f,recvmsg
1,48537296700,48537296900,00000000200,a2f,recvmsg
1,48537298500,48537346000,00000047500,a07,poll
1,48537346200,48537347300,00000001100,a2f,recvmsg
1,48537298500,48537348500,00000050000,a07,poll
1,48537350000,48537350200,00000000200,a2f,recvmsg
1,48537350700,48537350900,00000000200,a2f,recvmsg
1,48537351000,48537351200,00000000200,a2f,recvmsg
1,48537351700,48537351900,00000000200,a2f,recvmsg
1,48537352100,48537352200,00000000100,a2f,recvmsg
1,48537353900,48537400600,00000046700,a07,poll
1,48537402100,48537444800,00000042700,a07,poll
1,48537446000,48537487500,00000041500,a07,poll
1,48537490000,48537529600,00000039600,a07,poll
1,48537530800,48537571400,00000040600,a07,poll
1,48537572900,48537613900,00000041000,a07,poll
1,48537615100,48537668400,00000053300,a07,poll
1,48537669700,48537687800,00000018100,a07,poll
1,48537689200,48537704600,00000015400,a07,poll
1,48537706000,48537720500,00000014500,a07,poll
1,48537721800,48537736200,00000014400,a07,poll
1,48537738000,48537750400,00000012400,a07,poll
1,48537751800,48537778700,00000026900,a07,poll
1,48537778900,48537780400,00000001500,a2f,recvmsg
1,48537782000,48537783400,00000001400,a2d,recvfrom
1,48537787400,48537787600,00000000200,a2f,recvmsg
1,48537788000,48537788200,00000000200,a2f,recvmsg
1,48537845000,48537845300,00000000300,a2f,recvmsg
1,48537847700,48537847900,00000000200,a2f,recvmsg
1,48537850500,48538038800,00000188300,a07,poll
1,48538041700,48538041900,00000000200,a2f,recvmsg
1,48538042600,48538042800,00000000200,a2f,recvmsg
1,48538043000,48538043200,00000000200,a2f,recvmsg
1,48538044200,48538044300,00000000100,a2f,recvmsg
1,48538044500,48538044600,00000000100,a2f,recvmsg
1,48538044900,48549347600,00011302700,a07,poll
1,48549347700,48549349000,00000001300,a2f,recvmsg
1,48538044900,48549350100,00011305200,a07,poll
1,48549351700,48549351900,00000000200,a2f,recvmsg
1,48549352400,48549352600,00000000200,a2f,recvmsg
1,48549352800,48549352900,00000000100,a2f,recvmsg
1,48549353500,48549353600,00000000100,a2f,recvmsg
1,48549353800,48549354000,00000000200,a2f,recvmsg
1,48549355700,48549404900,00000049200,a07,poll
1,48549406200,48549448500,00000042300,a07,poll
1,48549449800,48549492300,00000042500,a07,poll
1,48549494500,48549535700,00000041200,a07,poll
1,48549536900,48549579400,00000042500,a07,poll
1,48549580700,48549623700,00000043000,a07,poll
1,48549625200,48549678300,00000053100,a07,poll
1,48549679600,48549696600,00000017000,a07,poll
1,48549697700,48549713300,00000015600,a07,poll
1,48549714700,48549728200,00000013500,a07,poll
1,48549729400,48549743200,00000013800,a07,poll
1,48549744600,48549759200,00000014600,a07,poll
1,48549760800,48549801600,00000040800,a07,poll
1,48549801700,48549803400,00000001700,a2f,recvmsg
1,48549807100,48549808600,00000001500,a2d,recvfrom
1,48549812800,48549813000,00000000200,a2f,recvmsg
1,48549813400,48549813600,00000000200,a2f,recvmsg
1,48549870100,48549870500,00000000400,a2f,recvmsg
1,48549872800,48549873000,00000000200,a2f,recvmsg
1,48549875600,48550216500,00000340900,a07,poll
1,48550219700,48550219800,00000000100,a2f,recvmsg
1,48550220700,48550220900,00000000200,a2f,recvmsg
1,48550221100,48550221300,00000000200,a2f,recvmsg
1,48550222100,48550222300,00000000200,a2f,recvmsg
1,48550222500,48550222700,00000000200,a2f,recvmsg
1,48550223100,48553603900,00003380800,a07,poll
1,48553621300,48553621400,00000000100,a00,read
1,48519242700,48553632100,00034389400,ae8,epoll_wait
1,48553629300,48553643800,00000014500,a07,poll
1,48553646600,48553647600,00000001000,a2e,sendmsg
1,48553662500,48553663100,00000000600,a2f,recvmsg
1,48553668800,48553669000,00000000200,a2f,recvmsg
1,48553703300,48553704100,00000000800,a2e,sendmsg
1,48553655600,48553890900,00000235300,a07,poll
1,48553924700,48553928900,00000004200,aca,futex
1,48553962000,48553962200,00000000200,a00,read
1,48553706100,48554027600,00000321500,ae8,epoll_wait
1,48554031500,48554033400,00000001900,a2f,recvmsg
1,48554041700,48554041800,00000000100,a2f,recvmsg
1,48554053300,48554055900,00000002600,a2e,sendmsg
1,48518263500,48554811500,00036548000,a4a,fsync
1,48554874100,48554879100,00000005000,a09,mmap
1,48553999300,48554959500,00000960200,a07,poll
1,48554964200,48554965800,00000001600,aca,futex
1,48554970000,48554970900,00000000900,aca,futex
1,48554973200,48554974100,00000000900,aca,futex
1,48554994400,48554994600,00000000200,a00,read
1,48554060100,48555002500,00000942400,ae8,epoll_wait
1,48555031900,48555032200,00000000300,a2f,recvmsg
1,48555052000,48555056300,00000004300,a2e,sendmsg
1,48554999000,48555116900,00000117900,a07,poll
1,48555118500,48555119600,00000001100,aca,futex
1,48555121400,48555122200,00000000800,aca,futex
1,48555123600,48555124300,00000000700,aca,futex
1,48555126900,48555128800,00000001900,a2e,sendmsg
1,48555059700,48555136200,00000076500,ae8,epoll_wait
1,48555138800,48555139900,00000001100,a2f,recvmsg
1,48555148000,48555148200,00000000200,a2f,recvmsg
1,48555171100,48555172000,00000000900,a2e,sendmsg
1,48555333900,48555343200,00000009300,a01,write
1,48555191800,48555380000,00000188200,a07,poll
1,48555444900,48555445200,00000000300,a00,read
1,48555498800,48555500700,00000001900,a01,write
1,48555174200,48555516900,00000342700,ae8,epoll_wait
1,48555521600,48555523800,00000002200,a2f,recvmsg
1,48555532800,48555533000,00000000200,a2f,recvmsg
1,48555546000,48555549000,00000003000,a2e,sendmsg
1,48555503600,48555550600,00000047000,a07,poll
1,48555551300,48555551800,00000000500,a00,read
1,48555560100,48555560800,00000000700,a2f,recvmsg
0,48510878800,48510879100,00000000300,a2f,recvmsg
0,48510879600,48510879800,00000000200,a2f,recvmsg
0,48549080300,48510888600,-0038191700,a17,select
0,48510893100,48510893300,00000000200,a2f,recvmsg
0,48510900000,48510900200,00000000200,a2f,recvmsg
0,48510900500,48510900700,00000000200,a2f,recvmsg
0,48510894300,48510906400,00000012100,a17,select
0,48510909900,48510910000,00000000100,a2f,recvmsg
0,48510915400,48510915500,00000000100,a2f,recvmsg
0,48510915800,48510916000,00000000200,a2f,recvmsg
0,48510910700,48510921900,00000011200,a17,select
0,48510925400,48510925500,00000000100,a2f,recvmsg
0,48510930800,48510931000,00000000200,a2f,recvmsg
0,48510931300,48510931500,00000000200,a2f,recvmsg
0,48510926200,48510937100,00000010900,a17,select
0,48510941000,48510941100,00000000100,a2f,recvmsg
0,48510946400,48510946500,00000000100,a2f,recvmsg
0,48510946900,48510947100,00000000200,a2f,recvmsg
0,48510941700,48510951500,00000009800,a17,select
0,48510954600,48510954800,00000000200,a2f,recvmsg
0,48510960000,48510960200,00000000200,a2f,recvmsg
0,48510960500,48510960700,00000000200,a2f,recvmsg
0,48510961400,48510961600,00000000200,a08,lseek
0,48510970500,48510970500,00000000000,a08,lseek
0,48510955300,48510974900,00000019600,a17,select
0,48510978400,48510978600,00000000200,a2f,recvmsg
0,48510984000,48510984200,00000000200,a2f,recvmsg
0,48510984500,48510984700,00000000200,a2f,recvmsg
0,48510979200,48510990800,00000011600,a17,select
0,48510993900,48510994100,00000000200,a2f,recvmsg
0,48510999400,48510999600,00000000200,a2f,recvmsg
0,48510999900,48511000100,00000000200,a2f,recvmsg
0,48510994700,48511004900,00000010200,a17,select
0,48511008000,48511008100,00000000100,a2f,recvmsg
0,48511013400,48511013500,00000000100,a2f,recvmsg
0,48511013900,48511014100,00000000200,a2f,recvmsg
0,48511008600,48511019400,00000010800,a17,select
0,48511022400,48511022500,00000000100,a2f,recvmsg
0,48511027900,48511028000,00000000100,a2f,recvmsg
0,48511028400,48511028600,00000000200,a2f,recvmsg
0,48511023100,48511033900,00000010800,a17,select
0,48511037000,48511037200,00000000200,a2f,recvmsg
0,48511042700,48511042900,00000000200,a2f,recvmsg
0,48511043300,48511043500,00000000200,a2f,recvmsg
0,48511037700,48511049900,00000012200,a17,select
0,48511052900,48511053000,00000000100,a2f,recvmsg
0,48511058300,48511058400,00000000100,a2f,recvmsg
0,48511058800,48511059000,00000000200,a2f,recvmsg
0,48511053600,48511064100,00000010500,a17,select
0,48511067400,48511067500,00000000100,a2f,recvmsg
0,48511072800,48511073000,00000000200,a2f,recvmsg
0,48511073200,48511073400,00000000200,a2f,recvmsg
0,48511068100,48511078800,00000010700,a17,select
0,48511081900,48511082100,00000000200,a2f,recvmsg
0,48511087200,48511087400,00000000200,a2f,recvmsg
0,48511087700,48511087900,00000000200,a2f,recvmsg
0,48511082600,48511094200,00000011600,a17,select
0,48511097600,48511097800,00000000200,a2f,recvmsg
0,48511103000,48511103200,00000000200,a2f,recvmsg
0,48511103500,48511103600,00000000100,a2f,recvmsg
0,48511098300,48511108900,00000010600,a17,select
0,48511112000,48511112200,00000000200,a2f,recvmsg
0,48511117400,48511117600,00000000200,a2f,recvmsg
0,48511117900,48511118100,00000000200,a2f,recvmsg
0,48511112800,48511123200,00000010400,a17,select
0,48511126300,48511126400,00000000100,a2f,recvmsg
0,48511132600,48511132800,00000000200,a2f,recvmsg
0,48511133200,48511133300,00000000100,a2f,recvmsg
0,48511127000,48511138500,00000011500,a17,select
0,48511141600,48511141800,00000000200,a2f,recvmsg
0,48511147100,48511147200,00000000100,a2f,recvmsg
0,48511147500,48511147700,00000000200,a2f,recvmsg
0,48511142400,48511152900,00000010500,a17,select
0,48511155800,48511156000,00000000200,a2f,recvmsg
0,48511161100,48511161300,00000000200,a2f,recvmsg
0,48511161600,48511161800,00000000200,a2f,recvmsg
0,48511156500,48511167000,00000010500,a17,select
0,48511170000,48511170200,00000000200,a2f,recvmsg
0,48511175400,48511175600,00000000200,a2f,recvmsg
0,48511175900,48511176100,00000000200,a2f,recvmsg
0,48511170700,48511181200,00000010500,a17,select
0,48511184200,48511184400,00000000200,a2f,recvmsg
0,48511189500,48511189700,00000000200,a2f,recvmsg
0,48511190000,48511190200,00000000200,a2f,recvmsg
0,48511185000,48511194800,00000009800,a17,select
0,48511198000,48511198200,00000000200,a2f,recvmsg
0,48511203300,48511203400,00000000100,a2f,recvmsg
0,48511203800,48511204000,00000000200,a2f,recvmsg
0,48511198700,48511210700,00000012000,a17,select
0,48511213800,48511214000,00000000200,a2f,recvmsg
0,48511219300,48511219400,00000000100,a2f,recvmsg
0,48511219700,48511219900,00000000200,a2f,recvmsg
0,48511214600,48511224500,00000009900,a17,select
0,48511227600,48511227800,00000000200,a2f,recvmsg
0,48511232800,48511233000,00000000200,a2f,recvmsg
0,48511233300,48511233500,00000000200,a2f,recvmsg
0,48511228300,48511238100,00000009800,a17,select
0,48511241100,48511241200,00000000100,a2f,recvmsg
0,48511246300,48511246500,00000000200,a2f,recvmsg
0,48511246800,48511247000,00000000200,a2f,recvmsg
0,48511241800,48511251600,00000009800,a17,select
0,48511254600,48511254800,00000000200,a2f,recvmsg
0,48511259800,48511260000,00000000200,a2f,recvmsg
0,48511260300,48511260500,00000000200,a2f,recvmsg
0,48511255400,48511265400,00000010000,a17,select
0,48511268500,48511268700,00000000200,a2f,recvmsg
0,48511273900,48511274000,00000000100,a2f,recvmsg
0,48511274400,48511274500,00000000100,a2f,recvmsg
0,48511269200,48511279200,00000010000,a17,select
0,48511282200,48511282400,00000000200,a2f,recvmsg
0,48511287700,48511287800,00000000100,a2f,recvmsg
0,48511288100,48511288300,00000000200,a2f,recvmsg
0,48511283000,48511293900,00000010900,a17,select
0,48511297100,48511297300,00000000200,a2f,recvmsg
0,48511302400,48511302600,00000000200,a2f,recvmsg
0,48511302900,48511303000,00000000100,a2f,recvmsg
0,48511297700,48511308400,00000010700,a17,select
0,48511311400,48511311600,00000000200,a2f,recvmsg
0,48511316700,48511316900,00000000200,a2f,recvmsg
0,48511317200,48511317400,00000000200,a2f,recvmsg
0,48511312200,48511323200,00000011000,a17,select
0,48511326500,48511326600,00000000100,a2f,recvmsg
0,48511331700,48511331900,00000000200,a2f,recvmsg
0,48511332300,48511332500,00000000200,a2f,recvmsg
0,48511327200,48511338000,00000010800,a17,select
0,48511341000,48511341200,00000000200,a2f,recvmsg
0,48511346300,48511346500,00000000200,a2f,recvmsg
0,48511346700,48511346900,00000000200,a2f,recvmsg
0,48511341700,48511352400,00000010700,a17,select
0,48511355700,48511355800,00000000100,a2f,recvmsg
0,48511361100,48511361200,00000000100,a2f,recvmsg
0,48511361600,48511361800,00000000200,a2f,recvmsg
0,48511356300,48511369300,00000013000,a17,select
0,48511372400,48511372600,00000000200,a2f,recvmsg
0,48511377800,48511378000,00000000200,a2f,recvmsg
0,48511378300,48511378500,00000000200,a2f,recvmsg
0,48511373200,48511383500,00000010300,a17,select
0,48511386500,48511386600,00000000100,a2f,recvmsg
0,48511391800,48511392000,00000000200,a2f,recvmsg
0,48511392300,48511392400,00000000100,a2f,recvmsg
0,48511387200,48511397400,00000010200,a17,select
0,48511400500,48511400700,00000000200,a2f,recvmsg
0,48511405700,48511405900,00000000200,a2f,recvmsg
0,48511406200,48511406400,00000000200,a2f,recvmsg
0,48511401200,48511413200,00000012000,a17,select
0,48511416400,48511416500,00000000100,a2f,recvmsg
0,48511421700,48511421900,00000000200,a2f,recvmsg
0,48511422300,48511422400,00000000100,a2f,recvmsg
0,48511417000,48511427800,00000010800,a17,select
0,48511431000,48511431100,00000000100,a2f,recvmsg
0,48511436300,48511436500,00000000200,a2f,recvmsg
0,48511436900,48511437100,00000000200,a2f,recvmsg
0,48511431800,48511442700,00000010900,a17,select
0,48511446000,48511446100,00000000100,a2f,recvmsg
0,48511451300,48511451400,00000000100,a2f,recvmsg
0,48511451800,48511452000,00000000200,a2f,recvmsg
0,48511446700,48511457200,00000010500,a17,select
0,48511460400,48511460600,00000000200,a2f,recvmsg
0,48511465700,48511465800,00000000100,a2f,recvmsg
0,48511466200,48511466400,00000000200,a2f,recvmsg
0,48511461100,48511471300,00000010200,a17,select
0,48511474400,48511474600,00000000200,a2f,recvmsg
0,48511480100,48511480200,00000000100,a2f,recvmsg
0,48511480600,48511480800,00000000200,a2f,recvmsg
0,48511475200,48511485500,00000010300,a17,select
0,48511488600,48511488800,00000000200,a2f,recvmsg
0,48511494200,48511494400,00000000200,a2f,recvmsg
0,48511494800,48511494900,00000000100,a2f,recvmsg
0,48511489300,48511500300,00000011000,a17,select
0,48511503300,48511503500,00000000200,a2f,recvmsg
0,48511508700,48511508900,00000000200,a2f,recvmsg
0,48511509200,48511509400,00000000200,a2f,recvmsg
0,48511510700,48511510800,00000000100,a08,lseek
0,48511513400,48511516400,00000003000,a00,read
0,48511520100,48511520200,00000000100,a08,lseek
0,48511504100,48511525300,00000021200,a17,select
0,48511528800,48511529000,00000000200,a2f,recvmsg
0,48511534800,48511534800,00000000000,a2f,recvmsg
0,48511535200,48511535400,00000000200,a2f,recvmsg
0,48511529600,48511562800,00000033200,a17,select
0,48511566200,48511566400,00000000200,a2f,recvmsg
0,48511571900,48511572100,00000000200,a2f,recvmsg
0,48511572400,48511572600,00000000200,a2f,recvmsg
0,48511576600,48511577500,00000000900,a00,read
0,48511583000,48511583200,00000000200,a08,lseek
0,48511567000,48511588300,00000021300,a17,select
0,48511591800,48511591900,00000000100,a2f,recvmsg
0,48511597400,48511597500,00000000100,a2f,recvmsg
0,48511597800,48511598000,00000000200,a2f,recvmsg
0,48511592600,48511602600,00000010000,a17,select
0,48511605500,48511605700,00000000200,a2f,recvmsg
0,48511610800,48511610900,00000000100,a2f,recvmsg
0,48511611300,48511611500,00000000200,a2f,recvmsg
0,48511606300,48511616000,00000009700,a17,select
0,48511618900,48511619100,00000000200,a2f,recvmsg
0,48511624100,48511624300,00000000200,a2f,recvmsg
0,48511624700,48511624800,00000000100,a2f,recvmsg
0,48511619600,48511629400,00000009800,a17,select
0,48511632300,48511632500,00000000200,a2f,recvmsg
0,48511637600,48511637800,00000000200,a2f,recvmsg
0,48511638100,48511638300,00000000200,a2f,recvmsg
0,48511633000,48511642900,00000009900,a17,select
0,48511645800,48511646000,00000000200,a2f,recvmsg
0,48511651100,48511651200,00000000100,a2f,recvmsg
0,48511651600,48511651800,00000000200,a2f,recvmsg
0,48511646600,48511656200,00000009600,a17,select
0,48511659100,48511659300,00000000200,a2f,recvmsg
0,48511664400,48511664600,00000000200,a2f,recvmsg
0,48511664900,48511665100,00000000200,a2f,recvmsg
0,48511659900,48511669600,00000009700,a17,select
0,48511672400,48511672600,00000000200,a2f,recvmsg
0,48511677700,48511677900,00000000200,a2f,recvmsg
0,48511678200,48511678400,00000000200,a2f,recvmsg
0,48511673200,48511683500,00000010300,a17,select
0,48511686600,48511686800,00000000200,a2f,recvmsg
0,48511691800,48511692000,00000000200,a2f,recvmsg
0,48511692300,48511692500,00000000200,a2f,recvmsg
0,48511687300,48511697000,00000009700,a17,select
0,48511700000,48511700100,00000000100,a2f,recvmsg
0,48511705300,48511705500,00000000200,a2f,recvmsg
0,48511705800,48511705900,00000000100,a2f,recvmsg
0,48511706500,48511706700,00000000200,a08,lseek
0,48511700700,48511712600,00000011900,a17,select
0,48511715700,48511715800,00000000100,a2f,recvmsg
0,48511721300,48511721400,00000000100,a2f,recvmsg
0,48511721800,48511722000,00000000200,a2f,recvmsg
0,48511716400,48511728900,00000012500,a17,select
0,48511732100,48511732200,00000000100,a2f,recvmsg
0,48511737400,48511737600,00000000200,a2f,recvmsg
0,48511737900,48511738100,00000000200,a2f,recvmsg
0,48511732700,48511743300,00000010600,a17,select
0,48511746100,48511746300,00000000200,a2f,recvmsg
0,48511751400,48511751600,00000000200,a2f,recvmsg
0,48511751900,48511752100,00000000200,a2f,recvmsg
0,48511746900,48511757000,00000010100,a17,select
0,48511759800,48511760000,00000000200,a2f,recvmsg
0,48511765100,48511765200,00000000100,a2f,recvmsg
0,48511765600,48511765800,00000000200,a2f,recvmsg
0,48511760600,48511770500,00000009900,a17,select
0,48511773500,48511773600,00000000100,a2f,recvmsg
0,48511779000,48511779200,00000000200,a2f,recvmsg
0,48511779500,48511779700,00000000200,a2f,recvmsg
0,48511774200,48511784400,00000010200,a17,select
0,48511787400,48511787500,00000000100,a2f,recvmsg
0,48511792700,48511792900,00000000200,a2f,recvmsg
0,48511793200,48511793300,00000000100,a2f,recvmsg
0,48511788100,48511798700,00000010600,a17,select
0,48511801600,48511801800,00000000200,a2f,recvmsg
0,48511806800,48511807000,00000000200,a2f,recvmsg
0,48511807300,48511807500,00000000200,a2f,recvmsg
0,48511802300,48511812200,00000009900,a17,select
0,48511815200,48511815400,00000000200,a2f,recvmsg
0,48511820500,48511820700,00000000200,a2f,recvmsg
0,48511821000,48511821200,00000000200,a2f,recvmsg
0,48511816000,48511825800,00000009800,a17,select
0,48511828800,48511829000,00000000200,a2f,recvmsg
0,48511834100,48511834300,00000000200,a2f,recvmsg
0,48511834600,48511834800,00000000200,a2f,recvmsg
0,48511829500,48511839500,00000010000,a17,select
0,48511842500,48511842600,00000000100,a2f,recvmsg
0,48511847700,48511847900,00000000200,a2f,recvmsg
0,48511848200,48511848300,00000000100,a2f,recvmsg
0,48511843100,48511853100,00000010000,a17,select
0,48511856100,48511856300,00000000200,a2f,recvmsg
0,48511861500,48511861600,00000000100,a2f,recvmsg
0,48511862000,48511862200,00000000200,a2f,recvmsg
0,48511856900,48511866900,00000010000,a17,select
0,48511869800,48511870000,00000000200,a2f,recvmsg
0,48511875400,48511875500,00000000100,a2f,recvmsg
0,48511875900,48511876100,00000000200,a2f,recvmsg
0,48511870600,48511881600,00000011000,a17,select
0,48511884500,48511884700,00000000200,a2f,recvmsg
0,48511890100,48511890300,00000000200,a2f,recvmsg
0,48511890600,48511890800,00000000200,a2f,recvmsg
0,48511885300,48511895600,00000010300,a17,select
0,48511898500,48511898700,00000000200,a2f,recvmsg
0,48511903900,48511904100,00000000200,a2f,recvmsg
0,48511904400,48511904600,00000000200,a2f,recvmsg
0,48511899300,48511909400,00000010100,a17,select
0,48511912400,48511912600,00000000200,a2f,recvmsg
0,48511918000,48511918200,00000000200,a2f,recvmsg
0,48511918600,48511918600,00000000000,a2f,recvmsg
0,48511913000,48511923500,00000010500,a17,select
0,48511926500,48511926600,00000000100,a2f,recvmsg
0,48511931800,48511931900,00000000100,a2f,recvmsg
0,48511932300,48511932500,00000000200,a2f,recvmsg
0,48511927200,48511943300,00000016100,a17,select
0,48511946400,48511946500,00000000100,a2f,recvmsg
0,48511952000,48511952100,00000000100,a2f,recvmsg
0,48511952500,48511952700,00000000200,a2f,recvmsg
0,48511947200,48511957700,00000010500,a17,select
0,48511960600,48511960700,00000000100,a2f,recvmsg
0,48511966000,48511966100,00000000100,a2f,recvmsg
0,48511966400,48511966600,00000000200,a2f,recvmsg
0,48511961400,48511971400,00000010000,a17,select
0,48511974300,48511974500,00000000200,a2f,recvmsg
0,48511979600,48511979800,00000000200,a2f,recvmsg
0,48511980100,48511980300,00000000200,a2f,recvmsg
0,48511975100,48511985300,00000010200,a17,select
0,48511988200,48511988400,00000000200,a2f,recvmsg
0,48511993500,48511993700,00000000200,a2f,recvmsg
0,48511994000,48511994200,00000000200,a2f,recvmsg
0,48511988900,48511999100,00000010200,a17,select
0,48512002100,48512002200,00000000100,a2f,recvmsg
0,48512007400,48512007600,00000000200,a2f,recvmsg
0,48512007900,48512008100,00000000200,a2f,recvmsg
0,48512050500,48512055000,00000004500,a14,writev
0,48512002800,48512058700,00000055900,a17,select
0,48512061100,48512062500,00000001400,a2f,recvmsg
0,48512147300,48512151100,00000003800,a14,writev
0,48512151700,48512154800,00000003100,a14,writev
0,48512228300,48512230500,00000002200,a14,writev
0,48512230700,48512232400,00000001700,a14,writev
0,48512288600,48512290500,00000001900,a14,writev
0,48512290700,48512292200,00000001500,a14,writev
0,48512346000,48512347700,00000001700,a14,writev
0,48512347900,48512349500,00000001600,a14,writev
0,48512403900,48512405700,00000001800,a14,writev
0,48512405900,48512407400,00000001500,a14,writev
0,48512461500,48512463000,00000001500,a14,writev
0,48512463200,48512464800,00000001600,a14,writev
0,48512468200,48512469000,00000000800,a2f,recvmsg
0,48512517700,48512519600,00000001900,a14,writev
0,48512562200,48512563700,00000001500,a14,writev
0,48512605500,48512607400,00000001900,a14,writev
0,48512649200,48512651000,00000001800,a14,writev
0,48512692800,48512694200,00000001400,a14,writev
0,48512735700,48512737100,00000001400,a14,writev
0,48512761500,48512763300,00000001800,a2f,recvmsg
0,48512787700,48512790100,00000002400,a14,writev
0,48512806500,48512808100,00000001600,a14,writev
0,48512822200,48512824500,00000002300,a14,writev
0,48512837300,48512839200,00000001900,a14,writev
0,48512851800,48512853400,00000001600,a14,writev
0,48512865900,48512867900,00000002000,a14,writev
0,48512873800,48512874100,00000000300,a2f,recvmsg
0,48512874600,48512875100,00000000500,a14,writev
0,48512875300,48512875700,00000000400,a14,writev
0,48512892500,48512894100,00000001600,a14,writev
0,48512894300,48512895500,00000001200,a14,writev
0,48512896000,48512896200,00000000200,a2f,recvmsg
0,48512050000,48512904100,00000854100,a07,poll
0,48512909600,48512916100,00000006500,a2f,recvmsg
0,48512927600,48512927800,00000000200,a2f,recvmsg
0,48512954100,48512958700,00000004600,a07,poll
0,48512964400,48512970800,00000006400,a2f,recvmsg
0,48512982700,48512982900,00000000200,a2f,recvmsg
0,48513004600,48513009000,00000004400,a07,poll
0,48513014700,48513020600,00000005900,a2f,recvmsg
0,48513032900,48513033100,00000000200,a2f,recvmsg
0,48512897000,48513061900,00000164900,a17,select
0,48513076500,48513077700,00000001200,a14,writev
0,48513078200,48513078400,00000000200,a2f,recvmsg
0,48513092300,48513093200,00000000900,a14,writev
0,48513093500,48513093700,00000000200,a2f,recvmsg
0,48513105600,48513106500,00000000900,a14,writev
0,48511576600,48546380900,00034804300,a00,read
0,48546434800,48546435700,00000000900,a00,read
0,48546535000,48546536000,00000001000,a00,read
0,48546607400,48546608200,00000000800,a00,read
0,48546684300,48546685000,00000000700,a00,read
0,48546762300,48546763000,00000000700,a00,read
0,48546839000,48546839700,00000000700,a00,read
0,48546923200,48546924000,00000000800,a00,read
0,48546989000,48546989700,00000000700,a00,read
0,48547046400,48547047100,00000000700,a00,read
0,48513094300,48547133700,00034039400,a17,select
0,48547148500,48547148800,00000000300,a2f,recvmsg
0,48547115400,48547159100,00000043700,a07,poll
0,48547173400,48547178100,00000004700,a2e,sendmsg
0,48547188300,48547189200,00000000900,a2e,sendmsg
0,48547198100,48547198300,00000000200,a00,read
0,48547212500,48547212700,00000000200,a2f,recvmsg
0,48547213200,48547213400,00000000200,a2f,recvmsg
0,48547151300,48547220300,00000069000,a17,select
0,48547226200,48547226300,00000000100,a2f,recvmsg
0,48547233200,48547233400,00000000200,a2f,recvmsg
0,48547233800,48547233900,00000000100,a2f,recvmsg
0,48547240400,48547246000,00000005600,a06,lstat
0,48547246900,48547247800,00000000900,a06,lstat
0,48547270700,48547285200,00000014500,a01,write
0,48547227500,48547294500,00000067000,a17,select
0,48547300800,48547301000,00000000200,a2f,recvmsg
0,48547308900,48547309100,00000000200,a2f,recvmsg
0,48547309600,48547309800,00000000200,a2f,recvmsg
0,48547311300,48547648100,00000336800,a38,clone
0,48550874200,48550874300,00000000100,a0c,brk
0,48550884200,48550887000,00000002800,a15,access
0,48550887600,48550888600,00000001000,a09,mmap
0,48550892200,48550893000,00000000800,a15,access
0,48550900100,48550901000,00000000900,a09,mmap
0,48550904700,48550905200,00000000500,a15,access
0,48550912300,48550913200,00000000900,a00,read
0,48550914600,48550916100,00000001500,a09,mmap
0,48550920400,48550922600,00000002200,a09,mmap
0,48550933700,48550934400,00000000700,a15,access
0,48550937800,48550938500,00000000700,a00,read
0,48550939200,48550940000,00000000800,a09,mmap
0,48550941900,48550943200,00000001300,a09,mmap
0,48550951300,48550951800,00000000500,a15,access
0,48550955000,48550955600,00000000600,a00,read
0,48550956300,48550957200,00000000900,a09,mmap
0,48550959000,48550961200,00000002200,a09,mmap
0,48550965200,48550968600,00000003400,a09,mmap
0,48550970700,48550971700,00000001000,a09,mmap
0,48550981600,48550982200,00000000600,a15,access
0,48550984500,48550985300,00000000800,a00,read
0,48550986000,48550987400,00000001400,a09,mmap
0,48550990000,48550991700,00000001700,a09,mmap
0,48550999700,48551000300,00000000600,a15,access
0,48551003200,48551003700,00000000500,a00,read
0,48551004300,48551005800,00000001500,a09,mmap
0,48551009200,48551011200,00000002000,a09,mmap
0,48551019500,48551020100,00000000600,a15,access
0,48551022400,48551023000,00000000600,a00,read
0,48551029600,48551030800,00000001200,a09,mmap
0,48551037200,48551037700,00000000500,a15,access
0,48551039800,48551040300,00000000500,a00,read
0,48551041100,48551042300,00000001200,a09,mmap
0,48551044100,48551045800,00000001700,a09,mmap
0,48551060000,48551060500,00000000500,a09,mmap
0,48551064300,48551064500,00000000200,a09,mmap
0,48551065700,48551066000,00000000300,a09,mmap
0,48551243400,48551243500,00000000100,a0c,brk
0,48551243600,48551244500,00000000900,a0c,brk
0,48551279700,48551285600,00000005900,a00,read
0,48551297600,48551299100,00000001500,a00,read
0,48551335500,48551336400,00000000900,a00,read
0,48551457200,48551457900,00000000700,a00,read
0,48551529900,48551530300,00000000400,a00,read
0,48551618000,48551618700,00000000700,a00,read
0,48551749300,48551750200,00000000900,a00,read
0,48551878500,48551879300,00000000800,a00,read
0,48552034900,48552035600,00000000700,a00,read
0,48552185900,48552186500,00000000600,a00,read
0,48552223100,48552224500,00000001400,a0c,brk
0,48552339800,48552340600,00000000800,a00,read
0,48552488700,48552489300,00000000600,a00,read
0,48552644100,48552644900,00000000800,a00,read
0,48552803200,48552803900,00000000700,a00,read
0,48552911900,48552912600,00000000700,a00,read
0,48552943200,48552943800,00000000600,a0c,brk
0,48553052100,48553053000,00000000900,a00,read
0,48553291900,48553292600,00000000700,a00,read
0,48553304900,48553305400,00000000500,a00,read
0,48553348900,48553349300,00000000400,a00,read
0,48553368900,48553369600,00000000700,a00,read
0,48553578700,48553579200,00000000500,a00,read
0,48553608400,48553609300,00000000900,a00,read
0,48553706400,48553707300,00000000900,a00,read
0,48553777600,48553778100,00000000500,a00,read
0,48553854100,48553855000,00000000900,a00,read
0,48554008400,48554009000,00000000600,a00,read
0,48554123300,48554123900,00000000600,a00,read
0,48554217400,48554217900,00000000500,a00,read
0,48554229900,48554230400,00000000500,a00,read
0,48554310700,48554311200,00000000500,a00,read
0,48554335300,48554335700,00000000400,a00,read
0,48554357800,48554358400,00000000600,a00,read
0,48554460200,48554461400,00000001200,a0c,brk
0,48554462500,48554463600,00000001100,a00,read
0,48554677000,48554677600,00000000600,a00,read
0,48554761100,48554761800,00000000700,a00,read
0,48554825600,48554826300,00000000700,a00,read
0,48554957400,48554957800,00000000400,a00,read
0,48554990100,48554990700,00000000600,a00,read
0,48555007400,48555008800,00000001400,a02,open
0,48555120200,48555120800,00000000600,a00,read
0,48555191400,48555191900,00000000500,a00,read
0,48555244700,48555246000,00000001300,a0c,brk
0,48555252400,48555253100,00000000700,a00,read
0,48555360300,48555360900,00000000600,a00,read
0,48555514700,48555515800,00000001100,a00,read
0,48555650100,48555650900,00000000800,a00,read
0,48555711800,48555712500,00000000700,a00,read
0,48555771500,48555772300,00000000800,a00,read
0,48555845000,48555845700,00000000700,a00,read
0,48555901300,48555901900,00000000600,a00,read
0,48555994800,48555995600,00000000800,a0c,brk
0,48556025800,48556030200,00000004400,a0c,brk
0,48556044700,48556045500,00000000800,a00,read
0,48556164200,48556165100,00000000900,a00,read
0,48556323100,48556323800,00000000700,a00,read
0,48556440400,48556441200,00000000800,a00,read
0,48556588200,48556588900,00000000700,a00,read
0,48556705700,48556706400,00000000700,a00,read
0,48556867300,48556868000,00000000700,a00,read
0,48556872900,48556873800,00000000900,a0c,brk
0,48556988500,48556989200,00000000700,a00,read
0,48557107200,48557108000,00000000800,a00,read
0,48557248700,48557249400,00000000700,a00,read
0,48557381500,48557382100,00000000600,a00,read
0,48557474900,48557475600,00000000700,a00,read
0,48557587600,48557588400,00000000800,a00,read
0,48557712300,48557712800,00000000500,a00,read
0,48557824000,48557824500,00000000500,a0c,brk
0,48557847300,48557848000,00000000700,a00,read
0,48558016800,48558017500,00000000700,a00,read
0,48558168500,48558169300,00000000800,a00,read
0,48558279900,48558280700,00000000800,a00,read
0,48558448900,48558449800,00000000900,a00,read
0,48562555500,48562556300,00000000800,a00,read
0,48562639100,48562639800,00000000700,a00,read
0,48562707500,48562708500,00000001000,a0c,brk
0,48562722400,48562723100,00000000700,a00,read
0,48562795300,48562796000,00000000700,a00,read
0,48562896700,48562897400,00000000700,a00,read
0,48563000500,48563001100,00000000600,a00,read
0,48563090500,48563091100,00000000600,a00,read
0,48563171300,48563171900,00000000600,a00,read
0,48563273100,48563273800,00000000700,a00,read
0,48563353700,48563354200,00000000500,a0c,brk
0,48563356800,48563357500,00000000700,a00,read
0,48563464100,48563464900,00000000800,a00,read
0,48563558400,48563559000,00000000600,a00,read
0,48563677300,48563678000,00000000700,a00,read
0,48563791300,48563792100,00000000800,a00,read
0,48563894800,48563895300,00000000500,a00,read
0,48563997300,48563997800,00000000500,a0c,brk
0,48564356400,48564359700,00000003300,a57,unlink
0,48564382600,48564383200,00000000600,a48,fcntl
0,48564429700,48564444700,00000015000,a01,write
0,48564462300,48564464600,00000002300,a01,write
0,48564480600,48564482600,00000002000,a01,write
0,48547669700,48564647000,00016977300,a3d,wait4
0,48564671000,48564672400,00000001400,a00,read
0,48564674600,48564675000,00000000400,a00,read
0,48547302200,48564706500,00017404300,a17,select
0,48564728100,48564728300,00000000200,a2f,recvmsg
0,48564745000,48564745200,00000000200,a2f,recvmsg
0,48564746100,48564746200,00000000100,a2f,recvmsg
0,48564731800,48564753900,00000022100,a17,select
0,48564758200,48564758300,00000000100,a2f,recvmsg
0,48564764200,48564764400,00000000200,a2f,recvmsg
0,48564764800,48564765000,00000000200,a2f,recvmsg
0,48564759100,48564770300,00000011200,a17,select
0,48564773500,48564773600,00000000100,a2f,recvmsg
0,48564778700,48564778900,00000000200,a2f,recvmsg
0,48564779200,48564779500,00000000300,a2f,recvmsg
0,48564774200,48564784300,00000010100,a17,select
0,48564787900,48564788000,00000000100,a2f,recvmsg
0,48564793200,48564793400,00000000200,a2f,recvmsg
0,48564793700,48564793800,00000000100,a2f,recvmsg
0,48564788600,48564798800,00000010200,a17,select
0,48564802500,48564802700,00000000200,a2f,recvmsg
0,48564807800,48564808000,00000000200,a2f,recvmsg
0,48564808400,48564808500,00000000100,a2f,recvmsg
0,48564803200,48564812800,00000009600,a17,select
0,48564815800,48564816000,00000000200,a2f,recvmsg
0,48564822000,48564822200,00000000200,a2f,recvmsg
0,48564822400,48564822600,00000000200,a2f,recvmsg
0,48564824100,48564824300,00000000200,a08,lseek
0,48564833600,48564833700,00000000100,a08,lseek
0,48564816500,48564838100,00000021600,a17,select
0,48564841500,48564841700,00000000200,a2f,recvmsg
0,48564847400,48564847600,00000000200,a2f,recvmsg
0,48564847900,48564848100,00000000200,a2f,recvmsg
0,48564842300,48564855800,00000013500,a17,select
0,48564859000,48564859100,00000000100,a2f,recvmsg
0,48564865300,48564865500,00000000200,a2f,recvmsg
0,48564865900,48564866000,00000000100,a2f,recvmsg
0,48564859700,48564871100,00000011400,a17,select
0,48564874200,48564874400,00000000200,a2f,recvmsg
0,48564879600,48564879800,00000000200,a2f,recvmsg
0,48564880200,48564880400,00000000200,a2f,recvmsg
0,48564875000,48564885800,00000010800,a17,select
0,48564888700,48564888900,00000000200,a2f,recvmsg
0,48564894200,48564894400,00000000200,a2f,recvmsg
0,48564894700,48564894900,00000000200,a2f,recvmsg
0,48564889500,48564901000,00000011500,a17,select
0,48564904200,48564904400,00000000200,a2f,recvmsg
0,48564909600,48564909800,00000000200,a2f,recvmsg
0,48564910200,48564910400,00000000200,a2f,recvmsg
0,48564905000,48564915800,00000010800,a17,select
0,48564918800,48564919000,00000000200,a2f,recvmsg
0,48564924300,48564924400,00000000100,a2f,recvmsg
0,48564924800,48564924900,00000000100,a2f,recvmsg
0,48564919500,48564930100,00000010600,a17,select
0,48564933300,48564933400,00000000100,a2f,recvmsg
0,48564938700,48564938800,00000000100,a2f,recvmsg
0,48564939200,48564939400,00000000200,a2f,recvmsg
0,48564934000,48564944000,00000010000,a17,select
0,48564947000,48564947200,00000000200,a2f,recvmsg
0,48564952500,48564952700,00000000200,a2f,recvmsg
0,48564953000,48564953200,00000000200,a2f,recvmsg
0,48564947700,48564959500,00000011800,a17,select
0,48564962800,48564962900,00000000100,a2f,recvmsg
0,48564968500,48564968500,00000000000,a2f,recvmsg
0,48564968900,48564969100,00000000200,a2f,recvmsg
0,48564963500,48564974400,00000010900,a17,select
0,48564977700,48564977900,00000000200,a2f,recvmsg
0,48564983200,48564983300,00000000100,a2f,recvmsg
0,48564983700,48564983800,00000000100,a2f,recvmsg
0,48564978400,48564989100,00000010700,a17,select
0,48564992400,48564992500,00000000100,a2f,recvmsg
0,48564997900,48564998000,00000000100,a2f,recvmsg
0,48564998400,48564998600,00000000200,a2f,recvmsg
0,48564993100,48565003800,00000010700,a17,select
0,48565006900,48565007100,00000000200,a2f,recvmsg
0,48565012500,48565012700,00000000200,a2f,recvmsg
0,48565013100,48565013300,00000000200,a2f,recvmsg
0,48565007700,48565018400,00000010700,a17,select
0,48565021400,48565021600,00000000200,a2f,recvmsg
0,48565026900,48565027100,00000000200,a2f,recvmsg
0,48565027400,48565027500,00000000100,a2f,recvmsg
0,48565022100,48565032800,00000010700,a17,select
0,48565035900,48565036000,00000000100,a2f,recvmsg
0,48565042300,48565042500,00000000200,a2f,recvmsg
0,48565042800,48565043000,00000000200,a2f,recvmsg
0,48565036600,48565048100,00000011500,a17,select
0,48565051200,48565051400,00000000200,a2f,recvmsg
0,48565056500,48565056700,00000000200,a2f,recvmsg
0,48565057000,48565057200,00000000200,a2f,recvmsg
0,48565052000,48565061700,00000009700,a17,select
0,48565065000,48565065100,00000000100,a2f,recvmsg
0,48565070300,48565070400,00000000100,a2f,recvmsg
0,48565070800,48565071000,00000000200,a2f,recvmsg
0,48565065600,48565077700,00000012100,a17,select
0,48565080900,48565081000,00000000100,a2f,recvmsg
0,48565086300,48565086500,00000000200,a2f,recvmsg
0,48565086900,48565087000,00000000100,a2f,recvmsg
0,48565081600,48565091500,00000009900,a17,select
0,48565094600,48565094800,00000000200,a2f,recvmsg
0,48565099900,48565100000,00000000100,a2f,recvmsg
0,48565100400,48565100600,00000000200,a2f,recvmsg
0,48565095300,48565105100,00000009800,a17,select
0,48565108000,48565108200,00000000200,a2f,recvmsg
0,48565113400,48565113600,00000000200,a2f,recvmsg
0,48565113900,48565114100,00000000200,a2f,recvmsg
0,48565108800,48565118600,00000009800,a17,select
0,48565121700,48565121800,00000000100,a2f,recvmsg
0,48565127000,48565127200,00000000200,a2f,recvmsg
0,48565127600,48565127700,00000000100,a2f,recvmsg
0,48565122400,48565132700,00000010300,a17,select
0,48565135700,48565135800,00000000100,a2f,recvmsg
0,48565141100,48565141300,00000000200,a2f,recvmsg
0,48565141600,48565141800,00000000200,a2f,recvmsg
0,48565136400,48565146500,00000010100,a17,select
0,48565149500,48565149700,00000000200,a2f,recvmsg
0,48565154900,48565155100,00000000200,a2f,recvmsg
0,48565155400,48565155600,00000000200,a2f,recvmsg
0,48565150300,48565161900,00000011600,a17,select
0,48565164900,48565165100,00000000200,a2f,recvmsg
0,48565170200,48565170400,00000000200,a2f,recvmsg
0,48565170700,48565170900,00000000200,a2f,recvmsg
0,48565165600,48565176300,00000010700,a17,select
0,48565179400,48565179500,00000000100,a2f,recvmsg
0,48565184700,48565184900,00000000200,a2f,recvmsg
0,48565185200,48565185300,00000000100,a2f,recvmsg
0,48565180100,48565191300,00000011200,a17,select
0,48565194600,48565194700,00000000100,a2f,recvmsg
0,48565200000,48565200200,00000000200,a2f,recvmsg
0,48565200400,48565200600,00000000200,a2f,recvmsg
0,48565195300,48565206100,00000010800,a17,select
0,48565209200,48565209300,00000000100,a2f,recvmsg
0,48565214500,48565214700,00000000200,a2f,recvmsg
0,48565215000,48565215200,00000000200,a2f,recvmsg
0,48565209800,48565220700,00000010900,a17,select
0,48565223900,48565224100,00000000200,a2f,recvmsg
0,48565229300,48565229500,00000000200,a2f,recvmsg
0,48565229800,48565230000,00000000200,a2f,recvmsg
0,48565224600,48565237300,00000012700,a17,select
0,48565240300,48565240500,00000000200,a2f,recvmsg
0,48565245900,48565245900,00000000000,a2f,recvmsg
0,48565246300,48565246500,00000000200,a2f,recvmsg
0,48565241100,48565251400,00000010300,a17,select
0,48565254400,48565254500,00000000100,a2f,recvmsg
0,48565259800,48565260000,00000000200,a2f,recvmsg
0,48565260400,48565260600,00000000200,a2f,recvmsg
0,48565255100,48565265500,00000010400,a17,select
0,48565268700,48565268800,00000000100,a2f,recvmsg
0,48565274100,48565274300,00000000200,a2f,recvmsg
0,48565274500,48565274700,00000000200,a2f,recvmsg
0,48565269400,48565280600,00000011200,a17,select
0,48565283700,48565283900,00000000200,a2f,recvmsg
0,48565289100,48565289300,00000000200,a2f,recvmsg
0,48565289600,48565289700,00000000100,a2f,recvmsg
0,48565284300,48565295200,00000010900,a17,select
0,48565298400,48565298500,00000000100,a2f,recvmsg
0,48565304000,48565304200,00000000200,a2f,recvmsg
0,48565304500,48565304700,00000000200,a2f,recvmsg
0,48565299100,48565310500,00000011400,a17,select
0,48565313700,48565313900,00000000200,a2f,recvmsg
0,48565319200,48565319400,00000000200,a2f,recvmsg
0,48565319700,48565319900,00000000200,a2f,recvmsg
0,48565314400,48565325200,00000010800,a17,select
0,48565328200,48565328400,00000000200,a2f,recvmsg
0,48565333500,48565333700,00000000200,a2f,recvmsg
0,48565334000,48565334200,00000000200,a2f,recvmsg
0,48565329000,48565339200,00000010200,a17,select
0,48565342400,48565342500,00000000100,a2f,recvmsg
0,48565347800,48565347900,00000000100,a2f,recvmsg
0,48565348300,48565348500,00000000200,a2f,recvmsg
0,48565343000,48565353100,00000010100,a17,select
0,48565356100,48565356200,00000000100,a2f,recvmsg
0,48565361500,48565361700,00000000200,a2f,recvmsg
0,48565361900,48565362100,00000000200,a2f,recvmsg
0,48565356700,48565367500,00000010800,a17,select
0,48565370700,48565370800,00000000100,a2f,recvmsg
0,48565376100,48565376300,00000000200,a2f,recvmsg
0,48565376600,48565376800,00000000200,a2f,recvmsg
0,48565378100,48565378200,00000000100,a08,lseek
0,48565381000,48565381900,00000000900,a00,read
0,48565385600,48565385700,00000000100,a08,lseek
0,48565371300,48565390400,00000019100,a17,select
0,48565393800,48565394000,00000000200,a2f,recvmsg
0,48565399400,48565399500,00000000100,a2f,recvmsg
0,48565399800,48565400000,00000000200,a2f,recvmsg
0,48565394500,48565427500,00000033000,a17,select
0,48565430800,48565431000,00000000200,a2f,recvmsg
0,48565436400,48565436600,00000000200,a2f,recvmsg
0,48565436900,48565437100,00000000200,a2f,recvmsg
0,48565441100,48565441800,00000000700,a00,read
0,48565447300,48565447500,00000000200,a08,lseek
0,48565431600,48565453000,00000021400,a17,select
0,48565456500,48565456700,00000000200,a2f,recvmsg
0,48565462200,48565462300,00000000100,a2f,recvmsg
0,48565462600,48565462800,00000000200,a2f,recvmsg
0,48565457300,48565467400,00000010100,a17,select
0,48565470400,48565470500,00000000100,a2f,recvmsg
0,48565475700,48565475800,00000000100,a2f,recvmsg
0,48565476100,48565476300,00000000200,a2f,recvmsg
0,48565471100,48565480700,00000009600,a17,select
0,48565483500,48565483700,00000000200,a2f,recvmsg
0,48565488800,48565489000,00000000200,a2f,recvmsg
0,48565489300,48565489400,00000000100,a2f,recvmsg
0,48565484300,48565493900,00000009600,a17,select
0,48565496700,48565496900,00000000200,a2f,recvmsg
0,48565502100,48565502300,00000000200,a2f,recvmsg
0,48565502500,48565502700,00000000200,a2f,recvmsg
0,48565497500,48565507200,00000009700,a17,select
0,48565510100,48565510300,00000000200,a2f,recvmsg
0,48565515500,48565515600,00000000100,a2f,recvmsg
0,48565515900,48565516100,00000000200,a2f,recvmsg
0,48565510800,48565520500,00000009700,a17,select
0,48565523300,48565523500,00000000200,a2f,recvmsg
0,48565528800,48565529000,00000000200,a2f,recvmsg
0,48565529200,48565529400,00000000200,a2f,recvmsg
0,48565524100,48565533800,00000009700,a17,select
0,48565536600,48565536800,00000000200,a2f,recvmsg
0,48565542000,48565542100,00000000100,a2f,recvmsg
0,48565542400,48565542600,00000000200,a2f,recvmsg
0,48565537400,48565547700,00000010300,a17,select
0,48565550700,48565550900,00000000200,a2f,recvmsg
0,48565556000,48565556200,00000000200,a2f,recvmsg
0,48565556500,48565556700,00000000200,a2f,recvmsg
0,48565551500,48565561200,00000009700,a17,select
0,48565564200,48565564400,00000000200,a2f,recvmsg
0,48565569400,48565569600,00000000200,a2f,recvmsg
0,48565569900,48565570100,00000000200,a2f,recvmsg
0,48565570700,48565570800,00000000100,a08,lseek
0,48565564900,48565576600,00000011700,a17,select
0,48565579700,48565579900,00000000200,a2f,recvmsg
0,48565585200,48565585400,00000000200,a2f,recvmsg
0,48565585700,48565585900,00000000200,a2f,recvmsg
0,48565580400,48565593000,00000012600,a17,select
0,48565596300,48565596500,00000000200,a2f,recvmsg
0,48565601700,48565601900,00000000200,a2f,recvmsg
0,48565602200,48565602400,00000000200,a2f,recvmsg
0,48565597100,48565607500,00000010400,a17,select
0,48565610400,48565610600,00000000200,a2f,recvmsg
0,48565615800,48565615900,00000000100,a2f,recvmsg
0,48565616300,48565616400,00000000100,a2f,recvmsg
0,48565611100,48565621400,00000010300,a17,select
0,48565624300,48565624400,00000000100,a2f,recvmsg
0,48565629600,48565629700,00000000100,a2f,recvmsg
0,48565630000,48565630200,00000000200,a2f,recvmsg
0,48565625000,48565635000,00000010000,a17,select
0,48565637900,48565638000,00000000100,a2f,recvmsg
0,48565643200,48565643300,00000000100,a2f,recvmsg
0,48565643700,48565643900,00000000200,a2f,recvmsg
0,48565638600,48565648700,00000010100,a17,select
0,48565651800,48565652000,00000000200,a2f,recvmsg
0,48565657100,48565657300,00000000200,a2f,recvmsg
0,48565657600,48565657800,00000000200,a2f,recvmsg
0,48565652500,48565663000,00000010500,a17,select
0,48565665900,48565666100,00000000200,a2f,recvmsg
0,48565671300,48565671500,00000000200,a2f,recvmsg
0,48565671700,48565671900,00000000200,a2f,recvmsg
0,48565666600,48565676800,00000010200,a17,select
0,48565679700,48565679800,00000000100,a2f,recvmsg
0,48565685000,48565685200,00000000200,a2f,recvmsg
0,48565685500,48565685700,00000000200,a2f,recvmsg
0,48565680400,48565690500,00000010100,a17,select
0,48565693500,48565693600,00000000100,a2f,recvmsg
0,48565698900,48565699100,00000000200,a2f,recvmsg
0,48565699400,48565699600,00000000200,a2f,recvmsg
0,48565694200,48565704400,00000010200,a17,select
0,48565707400,48565707600,00000000200,a2f,recvmsg
0,48565712600,48565712800,00000000200,a2f,recvmsg
0,48565713200,48565713300,00000000100,a2f,recvmsg
0,48565708000,48565718000,00000010000,a17,select
0,48565720900,48565721000,00000000100,a2f,recvmsg
0,48565726200,48565726300,00000000100,a2f,recvmsg
0,48565726600,48565726800,00000000200,a2f,recvmsg
0,48565721600,48565731500,00000009900,a17,select
0,48565734400,48565734600,00000000200,a2f,recvmsg
0,48565739700,48565739900,00000000200,a2f,recvmsg
0,48565740200,48565740400,00000000200,a2f,recvmsg
0,48565735200,48565745800,00000010600,a17,select
0,48565748900,48565749000,00000000100,a2f,recvmsg
0,48565754300,48565754400,00000000100,a2f,recvmsg
0,48565754800,48565755000,00000000200,a2f,recvmsg
0,48565749500,48565759700,00000010200,a17,select
0,48565762700,48565762800,00000000100,a2f,recvmsg
0,48565767900,48565768100,00000000200,a2f,recvmsg
0,48565768400,48565768500,00000000100,a2f,recvmsg
0,48565763300,48565773400,00000010100,a17,select
0,48565776400,48565776500,00000000100,a2f,recvmsg
0,48565781800,48565782000,00000000200,a2f,recvmsg
0,48565782400,48565782600,00000000200,a2f,recvmsg
0,48565777100,48565787400,00000010300,a17,select
0,48565790400,48565790600,00000000200,a2f,recvmsg
0,48565795600,48565795800,00000000200,a2f,recvmsg
0,48565796200,48565796300,00000000100,a2f,recvmsg
0,48565791100,48565806700,00000015600,a17,select
0,48565809900,48565810000,00000000100,a2f,recvmsg
0,48565815600,48565815700,00000000100,a2f,recvmsg
0,48565816000,48565816200,00000000200,a2f,recvmsg
0,48565810600,48565821200,00000010600,a17,select
0,48565824100,48565824300,00000000200,a2f,recvmsg
0,48565829300,48565829500,00000000200,a2f,recvmsg
0,48565829900,48565830100,00000000200,a2f,recvmsg
0,48565824900,48565834800,00000009900,a17,select
0,48565837700,48565837900,00000000200,a2f,recvmsg
0,48565842900,48565843100,00000000200,a2f,recvmsg
0,48565843500,48565843700,00000000200,a2f,recvmsg
0,48565838500,48565848700,00000010200,a17,select
0,48565851600,48565851800,00000000200,a2f,recvmsg
0,48565856700,48565856900,00000000200,a2f,recvmsg
0,48565857300,48565857500,00000000200,a2f,recvmsg
0,48565852200,48565862400,00000010200,a17,select
0,48565865300,48565865300,00000000000,a2f,recvmsg
0,48565870500,48565870700,00000000200,a2f,recvmsg
0,48565871000,48565871100,00000000100,a2f,recvmsg
0,48565914800,48565918600,00000003800,a14,writev
0,48565865900,48565922300,00000056400,a17,select
0,48565924800,48565926100,00000001300,a2f,recvmsg
0,48566094400,48566096600,00000002200,a14,writev
0,48566328400,48566329100,00000000700,a2f,recvmsg
0,48566630000,48566632600,00000002600,a2f,recvmsg
0,48566696700,48566699300,00000002600,a14,writev
0,48566713100,48566714800,00000001700,a14,writev
0,48566729100,48566731200,00000002100,a14,writev
0,48566745300,48566747200,00000001900,a14,writev
0,48566752700,48566752900,00000000200,a2f,recvmsg
0,48566753800,48566754300,00000000500,a14,writev
0,48566754600,48566755000,00000000400,a14,writev
0,48566778900,48566780300,00000001400,a14,writev
0,48566780900,48566781100,00000000200,a2f,recvmsg
0,48565914300,48566789900,00000875600,a07,poll
0,48566795000,48566802700,00000007700,a2f,recvmsg
0,48566815300,48566815500,00000000200,a2f,recvmsg
0,48566843800,48566848400,00000004600,a07,poll
0,48566854200,48566861900,00000007700,a2f,recvmsg
0,48566874200,48566874400,00000000200,a2f,recvmsg
0,48566899300,48566904100,00000004800,a07,poll
0,48566910000,48566918000,00000008000,a2f,recvmsg
0,48566931300,48566931500,00000000200,a2f,recvmsg
0,48566781900,48566961200,00000179300,a17,select
0,48566977900,48566979300,00000001400,a14,writev
0,48566979900,48566980000,00000000100,a2f,recvmsg
0,48566994300,48566995300,00000001000,a14,writev
0,48566995700,48566995800,00000000100,a2f,recvmsg
0,48567008600,48567009500,00000000900,a14,writev
0,48567009800,48567010000,00000000200,a2f,recvmsg
0,48566955000,48567014800,00000059800,a07,poll
0,48567015300,48567016300,00000001000,a2f,recvmsg
0,48567021300,48567022200,00000000900,a2d,recvfrom
0,48567023100,48567023300,00000000200,a2f,recvmsg
0,48567023900,48567024100,00000000200,a2f,recvmsg
0,48567065500,48567065800,00000000300,a2f,recvmsg
0,48567067800,48567067900,00000000100,a2f,recvmsg
0,48567070100,48567072300,00000002200,a07,poll
0,48567073000,48567073900,00000000900,a2f,recvmsg
0,48567079100,48567079700,00000000600,a2d,recvfrom
0,48567080500,48567080700,00000000200,a2f,recvmsg
0,48567081300,48567081400,00000000100,a2f,recvmsg
0,48567113500,48567113600,00000000100,a2f,recvmsg
0,48567115500,48567115600,00000000100,a2f,recvmsg
0,48567118800,48567120900,00000002100,a07,poll
0,48567121500,48567122700,00000001200,a2f,recvmsg
0,48567127900,48567128600,00000000700,a2d,recvfrom
0,48567129600,48567129800,00000000200,a2f,recvmsg
0,48567130500,48567130700,00000000200,a2f,recvmsg
0,48567161900,48567162100,00000000200,a2f,recvmsg
0,48567163900,48567164100,00000000200,a2f,recvmsg
0,48567167400,48567175500,00000008100,a07,poll
0,48567302000,48567305200,00000003200,a01,write
0,48567317800,48567318800,00000001000,a2f,recvmsg
0,48567321000,48567321200,00000000200,a00,read
0,48567331600,48567332900,00000001300,aca,futex
0,48567381800,48567382000,00000000200,a2f,recvmsg
0,48567382600,48567382700,00000000100,a2f,recvmsg
0,48567383700,48567410300,00000026600,a57,unlink
0,48567010600,48567424600,00000414000,a17,select
0,48567438000,48567440900,00000002900,a14,writev
0,48567443000,48567443200,00000000200,a2f,recvmsg
0,48567414700,48567449900,00000035200,a07,poll
0,48567457900,48567460500,00000002600,a2e,sendmsg
0,48567464600,48567464800,00000000200,a00,read
0,48567476700,48567476900,00000000200,a2f,recvmsg
0,48567477400,48567477600,00000000200,a2f,recvmsg
0,48567932400,48567936200,00000003800,a09,mmap
0,48568077300,48568082500,00000005200,a02,open
0,48568099200,48568101000,00000001800,a00,read
0,48568152700,48568153400,00000000700,a00,read
0,48568202000,48568202700,00000000700,a00,read
0,48568248400,48568249200,00000000800,a00,read
0,48568296300,48568297100,00000000800,a00,read
0,48568342600,48568343400,00000000800,a00,read
0,48568387400,48568388100,00000000700,a00,read
0,48568433200,48568434000,00000000800,a00,read
0,48568481700,48568482400,00000000700,a00,read
0,48568530700,48568531400,00000000700,a00,read
0,48568579100,48568579800,00000000700,a00,read
0,48568606400,48568607900,00000001500,a02,open
0,48568611100,48568612200,00000001100,a00,read
0,48568667900,48568668900,00000001000,a00,read
0,48568750900,48568751600,00000000700,a00,read
0,48568822000,48568822700,00000000700,a00,read
0,48568898600,48568899300,00000000700,a00,read
0,48568976600,48568977300,00000000700,a00,read
0,48569052700,48569053500,00000000800,a00,read
0,48569136100,48569136800,00000000700,a00,read
0,48569202500,48569203100,00000000600,a00,read
0,48569260000,48569260600,00000000600,a00,read
0,48567444700,48569346800,00001902100,a17,select
0,48569360800,48569361100,00000000300,a2f,recvmsg
0,48569373600,48569373700,00000000100,a2f,recvmsg
0,48569374400,48569374600,00000000200,a2f,recvmsg
0,48569363200,48569380200,00000017000,a17,select
0,48569384600,48569384800,00000000200,a2f,recvmsg
0,48569391100,48569391300,00000000200,a2f,recvmsg
0,48569391700,48569391800,00000000100,a2f,recvmsg
0,48569397200,48569401900,00000004700,a06,lstat
0,48569402800,48569403900,00000001100,a06,lstat
0,48569420900,48569431500,00000010600,a01,write
0,48569385700,48569440400,00000054700,a17,select
0,48569446200,48569446400,00000000200,a2f,recvmsg
0,48569454100,48569454300,00000000200,a2f,recvmsg
0,48569454700,48569454900,00000000200,a2f,recvmsg
0,48569456300,48569767800,00000311500,a38,clone
0,48569790000,48583992700,00014202700,a3d,wait4
0,48584009900,48584011500,00000001600,a00,read
0,48584013700,48584014100,00000000400,a00,read
0,48569447400,48584045400,00014598000,a17,select
0,48584066300,48584066500,00000000200,a2f,recvmsg
0,48584031700,48584073700,00000042000,a07,poll
0,48584076800,48584077000,00000000200,a2f,recvmsg
0,48584078100,48584078300,00000000200,a2f,recvmsg
0,48584069400,48584086400,00000017000,a17,select
0,48584090600,48584090700,00000000100,a2f,recvmsg
0,48584083700,48584094600,00000010900,a07,poll
0,48584095900,48584096100,00000000200,a2f,recvmsg
0,48584096500,48584096700,00000000200,a2f,recvmsg
0,48584091400,48584102600,00000011200,a17,select
0,48584106300,48584106400,00000000100,a2f,recvmsg
0,48584099900,48584110000,00000010100,a07,poll
0,48584111200,48584111400,00000000200,a2f,recvmsg
0,48584111800,48584112000,00000000200,a2f,recvmsg
0,48584107000,48584118000,00000011000,a17,select
0,48584121900,48584122100,00000000200,a2f,recvmsg
0,48584115500,48584125700,00000010200,a07,poll
0,48584126900,48584127100,00000000200,a2f,recvmsg
0,48584127400,48584127600,00000000200,a2f,recvmsg
0,48584122600,48584133800,00000011200,a17,select
0,48584137800,48584137900,00000000100,a2f,recvmsg
0,48584131300,48584141500,00000010200,a07,poll
0,48584142700,48584142900,00000000200,a2f,recvmsg
0,48584143300,48584143400,00000000100,a2f,recvmsg
0,48584138600,48584148300,00000009700,a17,select
0,48584151900,48584152000,00000000100,a2f,recvmsg
0,48584145800,48584155500,00000009700,a07,poll
0,48584156800,48584157000,00000000200,a2f,recvmsg
0,48584157400,48584157600,00000000200,a2f,recvmsg
0,48584158400,48584158500,00000000100,a08,lseek
0,48584168000,48584168100,00000000100,a08,lseek
0,48584152600,48584173100,00000020500,a17,select
0,48584177000,48584177200,00000000200,a2f,recvmsg
0,48584170400,48584180900,00000010500,a07,poll
0,48584182200,48584182400,00000000200,a2f,recvmsg
0,48584182800,48584183000,00000000200,a2f,recvmsg
0,48584177800,48584192000,00000014200,a17,select
0,48584195700,48584195900,00000000200,a2f,recvmsg
0,48584189300,48584199500,00000010200,a07,poll
0,48584200800,48584201000,00000000200,a2f,recvmsg
0,48584201400,48584201600,00000000200,a2f,recvmsg
0,48584196500,48584207000,00000010500,a17,select
0,48584210400,48584210600,00000000200,a2f,recvmsg
0,48584204400,48584214200,00000009800,a07,poll
0,48584215500,48584215700,00000000200,a2f,recvmsg
0,48584216100,48584216200,00000000100,a2f,recvmsg
0,48584211200,48584222100,00000010900,a17,select
0,48584225600,48584225800,00000000200,a2f,recvmsg
0,48584219300,48584229300,00000010000,a07,poll
0,48584230700,48584230800,00000000100,a2f,recvmsg
0,48584231200,48584231300,00000000100,a2f,recvmsg
0,48584226400,48584237300,00000010900,a17,select
0,48584241100,48584241200,00000000100,a2f,recvmsg
0,48584234500,48584244700,00000010200,a07,poll
0,48584246100,48584246200,00000000100,a2f,recvmsg
0,48584246600,48584246800,00000000200,a2f,recvmsg
0,48584241800,48584253700,00000011900,a17,select
0,48584257300,48584257400,00000000100,a2f,recvmsg
0,48584251100,48584261100,00000010000,a07,poll
0,48584262400,48584262600,00000000200,a2f,recvmsg
0,48584263000,48584263100,00000000100,a2f,recvmsg
0,48584258000,48584268800,00000010800,a17,select
0,48584272500,48584272700,00000000200,a2f,recvmsg
0,48584266300,48584276300,00000010000,a07,poll
0,48584277700,48584277900,00000000200,a2f,recvmsg
0,48584278200,48584278400,00000000200,a2f,recvmsg
0,48584273300,48584283700,00000010400,a17,select
0,48584287100,48584287300,00000000200,a2f,recvmsg
0,48584281100,48584290700,00000009600,a07,poll
0,48584291900,48584292100,00000000200,a2f,recvmsg
0,48584292500,48584292700,00000000200,a2f,recvmsg
0,48584287700,48584299400,00000011700,a17,select
0,48584303200,48584303400,00000000200,a2f,recvmsg
0,48584296900,48584307000,00000010100,a07,poll
0,48584310000,48584310200,00000000200,a2f,recvmsg
0,48584310500,48584310700,00000000200,a2f,recvmsg
0,48584304000,48584316500,00000012500,a17,select
0,48584320200,48584320300,00000000100,a2f,recvmsg
0,48584313900,48584323900,00000010000,a07,poll
0,48584325300,48584325500,00000000200,a2f,recvmsg
0,48584325800,48584326000,00000000200,a2f,recvmsg
0,48584320900,48584331700,00000010800,a17,select
0,48584335300,48584335500,00000000200,a2f,recvmsg
0,48584329100,48584339000,00000009900,a07,poll
0,48584340300,48584340500,00000000200,a2f,recvmsg
0,48584340900,48584341000,00000000100,a2f,recvmsg
0,48584336100,48584346600,00000010500,a17,select
0,48584350400,48584350500,00000000100,a2f,recvmsg
0,48584344000,48584354200,00000010200,a07,poll
0,48584355400,48584355600,00000000200,a2f,recvmsg
0,48584355900,48584356100,00000000200,a2f,recvmsg
0,48584351100,48584361700,00000010600,a17,select
0,48584365200,48584365400,00000000200,a2f,recvmsg
0,48584359100,48584369000,00000009900,a07,poll
0,48584370200,48584370300,00000000100,a2f,recvmsg
0,48584370700,48584370900,00000000200,a2f,recvmsg
0,48584365900,48584376600,00000010700,a17,select
0,48584380300,48584380500,00000000200,a2f,recvmsg
0,48584374000,48584384000,00000010000,a07,poll
0,48584385200,48584385400,00000000200,a2f,recvmsg
0,48584385800,48584386000,00000000200,a2f,recvmsg
0,48584380900,48584391500,00000010600,a17,select
0,48584394900,48584395100,00000000200,a2f,recvmsg
0,48584388900,48584398600,00000009700,a07,poll
0,48584399900,48584400100,00000000200,a2f,recvmsg
0,48584400500,48584400700,00000000200,a2f,recvmsg
0,48584395700,48584405800,00000010100,a17,select
0,48584409300,48584409500,00000000200,a2f,recvmsg
0,48584403100,48584413000,00000009900,a07,poll
0,48584414200,48584414400,00000000200,a2f,recvmsg
0,48584414800,48584415000,00000000200,a2f,recvmsg
0,48584410000,48584422000,00000012000,a17,select
0,48584425500,48584425700,00000000200,a2f,recvmsg
0,48584419300,48584429200,00000009900,a07,poll
0,48584430500,48584430700,00000000200,a2f,recvmsg
0,48584431100,48584431300,00000000200,a2f,recvmsg
0,48584426300,48584436200,00000009900,a17,select
0,48584439900,48584440000,00000000100,a2f,recvmsg
0,48584433700,48584443500,00000009800,a07,poll
0,48584444800,48584444900,00000000100,a2f,recvmsg
0,48584445300,48584445400,00000000100,a2f,recvmsg
0,48584440600,48584450400,00000009800,a17,select
0,48584453800,48584453900,00000000100,a2f,recvmsg
0,48584447900,48584457400,00000009500,a07,poll
0,48584459000,48584459100,00000000100,a2f,recvmsg
0,48584459500,48584459700,00000000200,a2f,recvmsg
0,48584454500,48584464700,00000010200,a17,select
0,48584468200,48584468300,00000000100,a2f,recvmsg
0,48584462200,48584471900,00000009700,a07,poll
0,48584473100,48584473300,00000000200,a2f,recvmsg
0,48584473700,48584473900,00000000200,a2f,recvmsg
0,48584468900,48584479300,00000010400,a17,select
0,48584482700,48584482900,00000000200,a2f,recvmsg
0,48584476600,48584486400,00000009800,a07,poll
0,48584487700,48584487800,00000000100,a2f,recvmsg
0,48584488200,48584488400,00000000200,a2f,recvmsg
0,48584483400,48584493600,00000010200,a17,select
0,48584497000,48584497200,00000000200,a2f,recvmsg
0,48584491000,48584500800,00000009800,a07,poll
0,48584502100,48584502300,00000000200,a2f,recvmsg
0,48584502600,48584502800,00000000200,a2f,recvmsg
0,48584497800,48584508500,00000010700,a17,select
0,48584512000,48584512200,00000000200,a2f,recvmsg
0,48584505900,48584515700,00000009800,a07,poll
0,48584517000,48584517200,00000000200,a2f,recvmsg
0,48584517600,48584517700,00000000100,a2f,recvmsg
0,48584512800,48584523600,00000010800,a17,select
0,48584527100,48584527100,00000000000,a2f,recvmsg
0,48584521000,48584530700,00000009700,a07,poll
0,48584531900,48584532100,00000000200,a2f,recvmsg
0,48584532500,48584532700,00000000200,a2f,recvmsg
0,48584527700,48584538900,00000011200,a17,select
0,48584542600,48584542800,00000000200,a2f,recvmsg
0,48584536300,48584546300,00000010000,a07,poll
0,48584547600,48584547800,00000000200,a2f,recvmsg
0,48584548100,48584548300,00000000200,a2f,recvmsg
0,48584543400,48584554300,00000010900,a17,select
0,48584557600,48584557800,00000000200,a2f,recvmsg
0,48584551700,48584561300,00000009600,a07,poll
0,48584562600,48584562700,00000000100,a2f,recvmsg
0,48584563100,48584563200,00000000100,a2f,recvmsg
0,48584558400,48584569100,00000010700,a17,select
0,48584572700,48584572900,00000000200,a2f,recvmsg
0,48584566500,48584576500,00000010000,a07,poll
0,48584577700,48584577900,00000000200,a2f,recvmsg
0,48584578300,48584578400,00000000100,a2f,recvmsg
0,48584573500,48584586400,00000012900,a17,select
0,48584590100,48584590200,00000000100,a2f,recvmsg
0,48584583800,48584593800,00000010000,a07,poll
0,48584595100,48584595300,00000000200,a2f,recvmsg
0,48584595600,48584595800,00000000200,a2f,recvmsg
0,48584590800,48584601200,00000010400,a17,select
0,48584604800,48584604900,00000000100,a2f,recvmsg
0,48584598700,48584608500,00000009800,a07,poll
0,48584609700,48584609900,00000000200,a2f,recvmsg
0,48584610300,48584610500,00000000200,a2f,recvmsg
0,48584605400,48584615900,00000010500,a17,select
0,48584619500,48584619700,00000000200,a2f,recvmsg
0,48584613300,48584623200,00000009900,a07,poll
0,48584624500,48584624600,00000000100,a2f,recvmsg
0,48584625000,48584625200,00000000200,a2f,recvmsg
0,48584620200,48584631600,00000011400,a17,select
0,48584635200,48584635400,00000000200,a2f,recvmsg
0,48584628900,48584638900,00000010000,a07,poll
0,48584640100,48584640300,00000000200,a2f,recvmsg
0,48584640700,48584640900,00000000200,a2f,recvmsg
0,48584635800,48584646800,00000011000,a17,select
0,48584650500,48584650600,00000000100,a2f,recvmsg
0,48584644100,48584654200,00000010100,a07,poll
0,48584655500,48584655700,00000000200,a2f,recvmsg
0,48584656000,48584656200,00000000200,a2f,recvmsg
0,48584651200,48584662300,00000011100,a17,select
0,48584666000,48584666200,00000000200,a2f,recvmsg
0,48584659800,48584669700,00000009900,a07,poll
0,48584671100,48584671300,00000000200,a2f,recvmsg
0,48584671600,48584671800,00000000200,a2f,recvmsg
0,48584666800,48584677800,00000011000,a17,select
0,48584681500,48584681600,00000000100,a2f,recvmsg
0,48584675000,48584685100,00000010100,a07,poll
0,48584686500,48584686600,00000000100,a2f,recvmsg
0,48584686900,48584687100,00000000200,a2f,recvmsg
0,48584682200,48584692600,00000010400,a17,select
0,48584696200,48584696300,00000000100,a2f,recvmsg
0,48584690000,48584700000,00000010000,a07,poll
0,48584701200,48584701400,00000000200,a2f,recvmsg
0,48584701800,48584701900,00000000100,a2f,recvmsg
0,48584696900,48584707100,00000010200,a17,select
0,48584710500,48584710700,00000000200,a2f,recvmsg
0,48584704500,48584714200,00000009700,a07,poll
0,48584715400,48584715600,00000000200,a2f,recvmsg
0,48584716000,48584716200,00000000200,a2f,recvmsg
0,48584711300,48584721900,00000010600,a17,select
0,48584725700,48584725900,00000000200,a2f,recvmsg
0,48584719300,48584729500,00000010200,a07,poll
0,48584730700,48584730900,00000000200,a2f,recvmsg
0,48584731300,48584731500,00000000200,a2f,recvmsg
0,48584732700,48584732800,00000000100,a08,lseek
0,48584735600,48584736400,00000000800,a00,read
0,48584740200,48584740300,00000000100,a08,lseek
0,48584726500,48584745800,00000019300,a17,select
0,48584749700,48584749900,00000000200,a2f,recvmsg
0,48584742900,48584753500,00000010600,a07,poll
0,48584755000,48584755100,00000000100,a2f,recvmsg
0,48584755500,48584755700,00000000200,a2f,recvmsg
0,48584750500,48584784900,00000034400,a17,select
0,48584788900,48584789100,00000000200,a2f,recvmsg
0,48584782100,48584792700,00000010600,a07,poll
0,48584794000,48584794200,00000000200,a2f,recvmsg
0,48584794600,48584794800,00000000200,a2f,recvmsg
0,48584798800,48584799600,00000000800,a00,read
0,48584805100,48584805200,00000000100,a08,lseek
0,48584789600,48584811000,00000021400,a17,select
0,48584814800,48584814900,00000000100,a2f,recvmsg
0,48584808300,48584818600,00000010300,a07,poll
0,48584819800,48584820000,00000000200,a2f,recvmsg
0,48584820400,48584820600,00000000200,a2f,recvmsg
0,48584815600,48584825600,00000010000,a17,select
0,48584829100,48584829200,00000000100,a2f,recvmsg
0,48584823200,48584832700,00000009500,a07,poll
0,48584833900,48584834100,00000000200,a2f,recvmsg
0,48584834500,48584834700,00000000200,a2f,recvmsg
0,48584829800,48584839600,00000009800,a17,select
0,48584842900,48584843100,00000000200,a2f,recvmsg
0,48584837100,48584846500,00000009400,a07,poll
0,48584847800,48584848000,00000000200,a2f,recvmsg
0,48584848300,48584848500,00000000200,a2f,recvmsg
0,48584843700,48584853400,00000009700,a17,select
0,48584856800,48584856900,00000000100,a2f,recvmsg
0,48584850900,48584860400,00000009500,a07,poll
0,48584861600,48584861800,00000000200,a2f,recvmsg
0,48584862200,48584862400,00000000200,a2f,recvmsg
0,48584857500,48584867300,00000009800,a17,select
0,48584870800,48584870900,00000000100,a2f,recvmsg
0,48584864900,48584874500,00000009600,a07,poll
0,48584875700,48584875900,00000000200,a2f,recvmsg
0,48584876200,48584876400,00000000200,a2f,recvmsg
0,48584871400,48584881300,00000009900,a17,select
0,48584884600,48584884800,00000000200,a2f,recvmsg
0,48584878800,48584888200,00000009400,a07,poll
0,48584889500,48584889700,00000000200,a2f,recvmsg
0,48584890000,48584890200,00000000200,a2f,recvmsg
0,48584885400,48584895100,00000009700,a17,select
0,48584898300,48584898500,00000000200,a2f,recvmsg
0,48584892600,48584902000,00000009400,a07,poll
0,48584903300,48584903300,00000000000,a2f,recvmsg
0,48584903700,48584903900,00000000200,a2f,recvmsg
0,48584899100,48584909500,00000010400,a17,select
0,48584913300,48584913400,00000000100,a2f,recvmsg
0,48584907000,48584916900,00000009900,a07,poll
0,48584918200,48584918400,00000000200,a2f,recvmsg
0,48584918700,48584918900,00000000200,a2f,recvmsg
0,48584914000,48584924000,00000010000,a17,select
0,48584927300,48584927500,00000000200,a2f,recvmsg
0,48584921500,48584931000,00000009500,a07,poll
0,48584932100,48584932300,00000000200,a2f,recvmsg
0,48584932700,48584932900,00000000200,a2f,recvmsg
0,48584933500,48584933600,00000000100,a08,lseek
0,48584928000,48584940700,00000012700,a17,select
0,48584944200,48584944400,00000000200,a2f,recvmsg
0,48584938000,48584947900,00000009900,a07,poll
0,48584949100,48584949300,00000000200,a2f,recvmsg
0,48584949700,48584949900,00000000200,a2f,recvmsg
0,48584945000,48584957300,00000012300,a17,select
0,48584960800,48584961000,00000000200,a2f,recvmsg
0,48584954700,48584964500,00000009800,a07,poll
0,48584965900,48584966000,00000000100,a2f,recvmsg
0,48584966300,48584966500,00000000200,a2f,recvmsg
0,48584961600,48584972100,00000010500,a17,select
0,48584975600,48584975800,00000000200,a2f,recvmsg
0,48584969700,48584979300,00000009600,a07,poll
0,48584980600,48584980800,00000000200,a2f,recvmsg
0,48584981200,48584981300,00000000100,a2f,recvmsg
0,48584976400,48584986600,00000010200,a17,select
0,48584990000,48584990100,00000000100,a2f,recvmsg
0,48584984100,48584993600,00000009500,a07,poll
0,48584994800,48584995000,00000000200,a2f,recvmsg
0,48584995400,48584995500,00000000100,a2f,recvmsg
0,48584990700,48585000800,00000010100,a17,select
0,48585004100,48585004300,00000000200,a2f,recvmsg
0,48584998300,48585007800,00000009500,a07,poll
0,48585009100,48585009300,00000000200,a2f,recvmsg
0,48585009600,48585009700,00000000100,a2f,recvmsg
0,48585004900,48585015000,00000010100,a17,select
0,48585018500,48585018600,00000000100,a2f,recvmsg
0,48585012500,48585022100,00000009600,a07,poll
0,48585023300,48585023500,00000000200,a2f,recvmsg
0,48585023900,48585024100,00000000200,a2f,recvmsg
0,48585019200,48585029800,00000010600,a17,select
0,48585033200,48585033300,00000000100,a2f,recvmsg
0,48585027300,48585037000,00000009700,a07,poll
0,48585038200,48585038400,00000000200,a2f,recvmsg
0,48585038700,48585038900,00000000200,a2f,recvmsg
0,48585033900,48585044200,00000010300,a17,select
0,48585047600,48585047700,00000000100,a2f,recvmsg
0,48585041700,48585051200,00000009500,a07,poll
0,48585052400,48585052600,00000000200,a2f,recvmsg
0,48585053000,48585053100,00000000100,a2f,recvmsg
0,48585048200,48585058300,00000010100,a17,select
0,48585061700,48585061800,00000000100,a2f,recvmsg
0,48585055800,48585065400,00000009600,a07,poll
0,48585066700,48585066800,00000000100,a2f,recvmsg
0,48585067100,48585067300,00000000200,a2f,recvmsg
0,48585062500,48585072500,00000010000,a17,select
0,48585076000,48585076200,00000000200,a2f,recvmsg
0,48585070100,48585079600,00000009500,a07,poll
0,48585080800,48585081000,00000000200,a2f,recvmsg
0,48585081400,48585081600,00000000200,a2f,recvmsg
0,48585076700,48585086900,00000010200,a17,select
0,48585090200,48585090400,00000000200,a2f,recvmsg
0,48585084300,48585093900,00000009600,a07,poll
0,48585095200,48585095300,00000000100,a2f,recvmsg
0,48585095700,48585095900,00000000200,a2f,recvmsg
0,48585091000,48585101100,00000010100,a17,select
0,48585104500,48585104700,00000000200,a2f,recvmsg
0,48585098700,48585108200,00000009500,a07,poll
0,48585109400,48585109500,00000000100,a2f,recvmsg
0,48585109900,48585110100,00000000200,a2f,recvmsg
0,48585105200,48585115800,00000010600,a17,select
0,48585119300,48585119500,00000000200,a2f,recvmsg
0,48585113300,48585123000,00000009700,a07,poll
0,48585124200,48585124400,00000000200,a2f,recvmsg
0,48585124800,48585125000,00000000200,a2f,recvmsg
0,48585120000,48585130200,00000010200,a17,select
0,48585133600,48585133800,00000000200,a2f,recvmsg
0,48585127600,48585137300,00000009700,a07,poll
0,48585138600,48585138800,00000000200,a2f,recvmsg
0,48585139000,48585139200,00000000200,a2f,recvmsg
0,48585134400,48585144500,00000010100,a17,select
0,48585147800,48585147900,00000000100,a2f,recvmsg
0,48585141900,48585151400,00000009500,a07,poll
0,48585152600,48585152800,00000000200,a2f,recvmsg
0,48585153200,48585153400,00000000200,a2f,recvmsg
0,48585148400,48585158500,00000010100,a17,select
0,48585161800,48585162000,00000000200,a2f,recvmsg
0,48585156000,48585165500,00000009500,a07,poll
0,48585166800,48585167000,00000000200,a2f,recvmsg
0,48585167400,48585167500,00000000100,a2f,recvmsg
0,48585162600,48585178600,00000016000,a17,select
0,48585182200,48585182400,00000000200,a2f,recvmsg
0,48585175800,48585186000,00000010200,a07,poll
0,48585187300,48585187500,00000000200,a2f,recvmsg
0,48585187800,48585188000,00000000200,a2f,recvmsg
0,48585183000,48585193500,00000010500,a17,select
0,48585196900,48585197100,00000000200,a2f,recvmsg
0,48585191000,48585200600,00000009600,a07,poll
0,48585201900,48585202100,00000000200,a2f,recvmsg
0,48585202500,48585202600,00000000100,a2f,recvmsg
0,48585197700,48585207900,00000010200,a17,select
0,48585211300,48585211400,00000000100,a2f,recvmsg
0,48585205400,48585214900,00000009500,a07,poll
0,48585216200,48585216400,00000000200,a2f,recvmsg
0,48585216700,48585216800,00000000100,a2f,recvmsg
0,48585212000,48585222300,00000010300,a17,select
0,48585225600,48585225800,00000000200,a2f,recvmsg
0,48585219800,48585229300,00000009500,a07,poll
0,48585230500,48585230700,00000000200,a2f,recvmsg
0,48585231000,48585231200,00000000200,a2f,recvmsg
0,48585226300,48585236600,00000010300,a17,select
0,48585240000,48585240200,00000000200,a2f,recvmsg
0,48585234100,48585243600,00000009500,a07,poll
0,48585244900,48585245100,00000000200,a2f,recvmsg
0,48585245400,48585245600,00000000200,a2f,recvmsg
0,48585291200,48585295100,00000003900,a14,writev
0,48585240700,48585299900,00000059200,a17,select
0,48585302300,48585303800,00000001500,a2f,recvmsg
0,48585388700,48585392900,00000004200,a14,writev
0,48585393400,48585397000,00000003600,a14,writev
0,48585472700,48585474800,00000002100,a14,writev
0,48585530100,48585532100,00000002000,a14,writev
0,48585532200,48585534000,00000001800,a14,writev
0,48585588600,48585590300,00000001700,a14,writev
0,48585590500,48585592000,00000001500,a14,writev
0,48585643800,48585645500,00000001700,a14,writev
0,48585645700,48585647600,00000001900,a14,writev
0,48585699300,48585701000,00000001700,a14,writev
0,48585701200,48585702600,00000001400,a14,writev
0,48585706100,48585707000,00000000900,a2f,recvmsg
0,48585753800,48585755500,00000001700,a14,writev
0,48585797500,48585799700,00000002200,a14,writev
0,48585840700,48585842200,00000001500,a14,writev
0,48585882800,48585884400,00000001600,a14,writev
0,48585924500,48585926100,00000001600,a14,writev
0,48585967000,48585968800,00000001800,a14,writev
0,48585994300,48585996300,00000002000,a2f,recvmsg
0,48586021400,48586023300,00000001900,a14,writev
0,48586040900,48586042700,00000001800,a14,writev
0,48586057600,48586059500,00000001900,a14,writev
0,48586073500,48586075300,00000001800,a14,writev
0,48586088800,48586091000,00000002200,a14,writev
0,48586103600,48586105300,00000001700,a14,writev
0,48586112300,48586112500,00000000200,a2f,recvmsg
0,48586113100,48586113600,00000000500,a14,writev
0,48586113800,48586114200,00000000400,a14,writev
0,48586132000,48586133600,00000001600,a14,writev
0,48586133800,48586135100,00000001300,a14,writev
0,48586135600,48586135800,00000000200,a2f,recvmsg
0,48585295700,48586144000,00000848300,a07,poll
0,48586148700,48586155300,00000006600,a2f,recvmsg
0,48586167100,48586167300,00000000200,a2f,recvmsg
0,48586192600,48586197200,00000004600,a07,poll
0,48586202900,48586209200,00000006300,a2f,recvmsg
0,48586221900,48586222100,00000000200,a2f,recvmsg
0,48586243800,48586248500,00000004700,a07,poll
0,48586254000,48586260200,00000006200,a2f,recvmsg
0,48586272600,48586272800,00000000200,a2f,recvmsg
0,48586295400,48586297100,00000001700,a07,poll
0,48586300000,48586300200,00000000200,a2f,recvmsg
0,48586300800,48586301000,00000000200,a2f,recvmsg
0,48586136500,48586331200,00000194700,a17,select
0,48586346700,48586348100,00000001400,a14,writev
0,48586348800,48586349000,00000000200,a2f,recvmsg
0,48586362700,48586363800,00000001100,a14,writev
0,48586364100,48586364300,00000000200,a2f,recvmsg
0,48586376000,48586377000,00000001000,a14,writev
0,48586377300,48586377500,00000000200,a2f,recvmsg
0,48586391000,48586393200,00000002200,a14,writev
0,48586395300,48586395500,00000000200,a2f,recvmsg
0,48586325800,48586400000,00000074200,a07,poll
0,48586400700,48586401900,00000001200,a2f,recvmsg
0,48586406200,48586407100,00000000900,a2d,recvfrom
0,48586408000,48586408100,00000000100,a2f,recvmsg
0,48586408800,48586409000,00000000200,a2f,recvmsg
0,48586450800,48586451100,00000000300,a2f,recvmsg
0,48586453500,48586453700,00000000200,a2f,recvmsg
0,48586455800,48586457800,00000002000,a07,poll
0,48586458400,48586459600,00000001200,a2f,recvmsg
0,48586464600,48586465100,00000000500,a2d,recvfrom
0,48586466000,48586466100,00000000100,a2f,recvmsg
0,48586466900,48586467000,00000000100,a2f,recvmsg
0,48586510400,48586510700,00000000300,a2f,recvmsg
0,48586512600,48586512700,00000000100,a2f,recvmsg
0,48586515700,48586518000,00000002300,a07,poll
0,48586518700,48586519800,00000001100,a2f,recvmsg
0,48586525700,48586526200,00000000500,a2d,recvfrom
0,48586527300,48586527500,00000000200,a2f,recvmsg
0,48586528100,48586528300,00000000200,a2f,recvmsg
0,48586558200,48586558400,00000000200,a2f,recvmsg
0,48586560200,48586560400,00000000200,a2f,recvmsg
0,48586563700,48586566700,00000003000,a07,poll
0,48586569200,48586569300,00000000100,a2f,recvmsg
0,48586569900,48586570100,00000000200,a2f,recvmsg
0,48586563700,48587111900,00000548200,a07,poll
0,48587117300,48587119000,00000001700,aca,futex
0,48587125800,48587126600,00000000800,aca,futex
0,48587138100,48587139100,00000001000,aca,futex
0,48587145500,48587150900,00000005400,a2e,sendmsg
0,48587160400,48587216700,00000056300,a07,poll
0,48587218000,48587219100,00000001100,aca,futex
0,48587221000,48587221800,00000000800,aca,futex
0,48587223900,48587224900,00000001000,aca,futex
0,48587226900,48587228400,00000001500,a2e,sendmsg
0,48587230700,48587230800,00000000100,a00,read
0,48473933800,48587240800,00113307000,ae8,epoll_wait
0,48587253600,48587255800,00000002200,a2f,recvmsg
0,48587275300,48587275500,00000000200,a2f,recvmsg
0,48587331600,48587335900,00000004300,a2e,sendmsg
0,48587364900,48587365600,00000000700,a2e,sendmsg
0,48587237000,48587373300,00000136300,a07,poll
0,48587390600,48587391900,00000001300,a2f,recvmsg
0,48587463800,48587464500,00000000700,a2f,recvmsg
0,48587466500,48587466700,00000000200,a00,read
0,48587501900,48587504400,00000002500,a07,poll
0,48587501900,48587646600,00000144700,a07,poll
0,48587648500,48587649800,00000001300,aca,futex
0,48587652100,48587653000,00000000900,aca,futex
0,48587654500,48587655200,00000000700,aca,futex
0,48587658300,48587661400,00000003100,a2e,sendmsg
0,48587664000,48587664200,00000000200,a00,read
0,48587667300,48587780400,00000113100,a07,poll
0,48587781700,48587782600,00000000900,aca,futex
0,48587784100,48587784900,00000000800,aca,futex
0,48587786100,48587786900,00000000800,aca,futex
0,48587788900,48587790800,00000001900,a2e,sendmsg
0,48587369800,48587810800,00000441000,ae8,epoll_wait
0,48587814500,48587816200,00000001700,a2f,recvmsg
0,48587850800,48587851000,00000000200,a2f,recvmsg
0,48587877900,48587880500,00000002600,a2e,sendmsg
0,48587900300,48587901000,00000000700,a2e,sendmsg
0,48587809000,48587905800,00000096800,a07,poll
0,48587918800,48587919600,00000000800,a2f,recvmsg
0,48588071700,48588072300,00000000600,a2f,recvmsg
0,48588074400,48588074500,00000000100,a00,read
0,48588178400,48588180800,00000002400,a07,poll
0,48588504100,48588512300,00000008200,a02,open
0,48588524900,48588528400,00000003500,a00,read
0,48588584900,48588585700,00000000800,a00,read
0,48588637000,48588637800,00000000800,a00,read
0,48588687700,48588688300,00000000600,a00,read
0,48588738800,48588739500,00000000700,a00,read
0,48588789000,48588789800,00000000800,a00,read
0,48588836900,48588837700,00000000800,a00,read
0,48588886700,48588887400,00000000700,a00,read
0,48588939900,48588940800,00000000900,a00,read
0,48588991800,48588992500,00000000700,a00,read
0,48589042100,48589042800,00000000700,a00,read
0,48589070000,48589071800,00000001800,a02,open
0,48589075000,48589075900,00000000900,a00,read
0,48589132000,48589132700,00000000700,a00,read
0,48589217100,48589217900,00000000800,a00,read
0,48589290400,48589291100,00000000700,a00,read
0,48589369200,48589370000,00000000800,a00,read
0,48589448900,48589449600,00000000700,a00,read
0,48589527300,48589527900,00000000600,a00,read
0,48589612400,48589613100,00000000700,a00,read
0,48589680600,48589681400,00000000800,a00,read
0,48589738900,48589739600,00000000700,a00,read
0,48586396100,48589831000,00003434900,a17,select
0,48589850200,48589850500,00000000300,a2f,recvmsg
0,48589865500,48589865700,00000000200,a2f,recvmsg
0,48589866200,48589866400,00000000200,a2f,recvmsg
0,48589853600,48589872200,00000018600,a17,select
0,48589876600,48589876700,00000000100,a2f,recvmsg
0,48589882700,48589882900,00000000200,a2f,recvmsg
0,48589883200,48589883400,00000000200,a2f,recvmsg
0,48589888800,48589895100,00000006300,a06,lstat
0,48589895900,48589896800,00000000900,a06,lstat
0,48589919700,48589933900,00000014200,a01,write
0,48589877500,48589942900,00000065400,a17,select
0,48589948900,48589949100,00000000200,a2f,recvmsg
0,48589956800,48589957000,00000000200,a2f,recvmsg
0,48589957400,48589957600,00000000200,a2f,recvmsg
0,48589959200,48590273400,00000314200,a38,clone
0,48594824900,48594825100,00000000200,a0c,brk
0,48594835300,48594837400,00000002100,a15,access
0,48594838100,48594839000,00000000900,a09,mmap
0,48594842800,48594843700,00000000900,a15,access
0,48594849600,48594850700,00000001100,a09,mmap
0,48594854400,48594854900,00000000500,a15,access
0,48594862000,48594863200,00000001200,a00,read
0,48594864800,48594866300,00000001500,a09,mmap
0,48594882900,48594883600,00000000700,a15,access
0,48594886800,48594887600,00000000800,a00,read
0,48594888300,48594889300,00000001000,a09,mmap
0,48594891500,48594892700,00000001200,a09,mmap
0,48594901000,48594901500,00000000500,a15,access
0,48594904300,48594904900,00000000600,a00,read
0,48594905600,48594906400,00000000800,a09,mmap
0,48594908000,48594910000,00000002000,a09,mmap
0,48594914700,48594918000,00000003300,a09,mmap
0,48594920200,48594921300,00000001100,a09,mmap
0,48594930500,48594931100,00000000600,a15,access
0,48594933500,48594934200,00000000700,a00,read
0,48594934800,48594936300,00000001500,a09,mmap
0,48594939000,48594940600,00000001600,a09,mmap
0,48594949000,48594949600,00000000600,a15,access
0,48594952900,48594953600,00000000700,a00,read
0,48594955400,48594956900,00000001500,a09,mmap
0,48594960500,48594962800,00000002300,a09,mmap
0,48594971100,48594971600,00000000500,a15,access
0,48594974200,48594974900,00000000700,a00,read
0,48594975400,48594976500,00000001100,a09,mmap
0,48594977900,48594979100,00000001200,a09,mmap
0,48594982100,48594983300,00000001200,a09,mmap
0,48594989500,48594990100,00000000600,a15,access
0,48594992300,48594992700,00000000400,a00,read
0,48594993400,48594994700,00000001300,a09,mmap
0,48595012900,48595013400,00000000500,a09,mmap
0,48595018800,48595018900,00000000100,a09,mmap
0,48595198100,48595198200,00000000100,a0c,brk
0,48595198300,48595199300,00000001000,a0c,brk
0,48595233100,48595239300,00000006200,a00,read
0,48595251200,48595252700,00000001500,a00,read
0,48595292300,48595293200,00000000900,a00,read
0,48595414200,48595415000,00000000800,a00,read
0,48595486300,48595486700,00000000400,a00,read
0,48595572000,48595572700,00000000700,a00,read
0,48595703500,48595704400,00000000900,a00,read
0,48595832200,48595833000,00000000800,a00,read
0,48595988300,48595989100,00000000800,a00,read
0,48596139200,48596139900,00000000700,a00,read
0,48596176400,48596177800,00000001400,a0c,brk
0,48596293500,48596294200,00000000700,a00,read
0,48596442500,48596443200,00000000700,a00,read
0,48596598000,48596598700,00000000700,a00,read
0,48596758700,48596759300,00000000600,a00,read
0,48596867300,48596867900,00000000600,a00,read
0,48596898400,48596899200,00000000800,a0c,brk
0,48597007500,48597008400,00000000900,a00,read
0,48597249100,48597249500,00000000400,a00,read
0,48597261900,48597262300,00000000400,a00,read
0,48597306900,48597307300,00000000400,a00,read
0,48597327700,48597328500,00000000800,a00,read
0,48597535200,48597535700,00000000500,a00,read
0,48597566300,48597567100,00000000800,a00,read
0,48597664300,48597665100,00000000800,a00,read
0,48597689100,48597690400,00000001300,a0c,brk
0,48597735500,48597735900,00000000400,a00,read
0,48597812400,48597813300,00000000900,a00,read
0,48597967300,48597967700,00000000400,a00,read
0,48598080300,48598080300,00000000000,a00,read
0,48598174600,48598175000,00000000400,a00,read
0,48598188200,48598188700,00000000500,a00,read
0,48598272700,48598273300,00000000600,a00,read
0,48598297500,48598297800,00000000300,a00,read
0,48598320800,48598321200,00000000400,a00,read
0,48598422900,48598424000,00000001100,a0c,brk
0,48598425200,48598426300,00000001100,a00,read
0,48598482700,48598499800,00000017100,60e,page_fault
0,48598644300,48598645000,00000000700,a00,read
0,48598731500,48598732000,00000000500,a00,read
0,48598796000,48598796600,00000000600,a00,read
0,48598925600,48598926000,00000000400,a00,read
0,48598959100,48598959600,00000000500,a00,read
0,48598977300,48598978700,00000001400,a02,open
0,48599093600,48599094200,00000000600,a00,read
0,48599165100,48599165400,00000000300,a00,read
0,48599217900,48599219200,00000001300,a0c,brk
0,48599226100,48599226900,00000000800,a00,read
0,48599334500,48599335200,00000000700,a00,read
0,48599485900,48599486900,00000001000,a00,read
0,48599616200,48599616900,00000000700,a00,read
0,48599674600,48599675300,00000000700,a00,read
0,48599730900,48599731500,00000000600,a00,read
0,48599801500,48599802200,00000000700,a00,read
0,48599854700,48599855400,00000000700,a00,read
0,48599943600,48599944500,00000000900,a0c,brk
0,48599974700,48599979200,00000004500,a0c,brk
0,48599993400,48599994200,00000000800,a00,read
0,48600109000,48600109800,00000000800,a00,read
0,48600268100,48600268800,00000000700,a00,read
0,48600386800,48600387500,00000000700,a00,read
0,48600532900,48600533600,00000000700,a00,read
0,48600650200,48600650800,00000000600,a00,read
0,48600811600,48600812200,00000000600,a00,read
0,48600817100,48600818000,00000000900,a0c,brk
0,48600932500,48600933200,00000000700,a00,read
0,48601050500,48601051400,00000000900,a00,read
0,48601192900,48601193700,00000000800,a00,read
0,48601323500,48601324200,00000000700,a00,read
0,48601416600,48601417300,00000000700,a00,read
0,48601529100,48601529700,00000000600,a00,read
0,48601652900,48601653500,00000000600,a00,read
0,48601788400,48601788900,00000000500,a00,read
0,48601957800,48601958400,00000000600,a00,read
0,48602109200,48602109700,00000000500,a00,read
0,48602219800,48602220500,00000000700,a00,read
0,48602387500,48602388500,00000001000,a00,read
0,48602464800,48602465400,00000000600,a00,read
0,48602553000,48602553800,00000000800,a00,read
0,48602619900,48602620800,00000000900,a0c,brk
0,48602634400,48602635100,00000000700,a00,read
0,48602707600,48602708200,00000000600,a00,read
0,48602810000,48602810800,00000000800,a00,read
0,48602912600,48602913300,00000000700,a00,read
0,48603002500,48603003200,00000000700,a00,read
0,48603083400,48603084100,00000000700,a00,read
0,48603185600,48603186400,00000000800,a00,read
0,48603266500,48603266900,00000000400,a0c,brk
0,48603269400,48603270500,00000001100,a00,read
0,48603378600,48603379700,00000001100,a00,read
0,48589954700,48603419300,00013464600,a07,poll
0,48603424800,48603426000,00000001200,a00,read
0,48603558100,48603559000,00000000900,a2f,recvmsg
0,48603561300,48603561400,00000000100,a00,read
0,48603682200,48603683800,00000001600,a00,read
0,48603803000,48603804000,00000001000,a00,read
0,48603610300,48603858900,00000248600,a07,poll
0,48603865000,48603869500,00000004500,a2e,sendmsg
0,48603873100,48603873300,00000000200,a00,read
0,48603947300,48603948500,00000001200,a00,read
0,48604051200,48604051800,00000000600,a00,read
0,48604162500,48604165100,00000002600,a0c,brk
0,48604531000,48604534800,00000003800,a57,unlink
0,48604553200,48604553700,00000000500,a48,fcntl
0,48604607400,48604617000,00000009600,a01,write
0,48604634900,48604637400,00000002500,a01,write
0,48604653900,48604656100,00000002200,a01,write
0,48590296000,48604825200,00014529200,a3d,wait4
0,48604842100,48604843800,00000001700,a00,read
0,48604845800,48604846100,00000000300,a00,read
0,48589950100,48604874200,00014924100,a17,select
0,48604894000,48604894200,00000000200,a2f,recvmsg
0,48578880200,48578907500,00000027300,a52,rename
0,48578918100,48578923100,00000005000,a02,open
0,48604852800,48578961500,-0025891300,a07,poll
0,48578963700,48578965200,00000001500,aca,futex
0,48578967800,48578968900,00000001100,aca,futex
0,48578970500,48578971300,00000000800,aca,futex
0,48578975100,48578979300,00000004200,a2e,sendmsg
0,48578982900,48578983200,00000000300,a00,read
0,48578986900,48579026500,00000039600,a07,poll
0,48579027800,48579028800,00000001000,aca,futex
0,48579030300,48579031200,00000000900,aca,futex
0,48579032400,48579033300,00000000900,aca,futex
0,48579035100,48579037600,00000002500,a2e,sendmsg
0,48579055100,48579057800,00000002700,a07,poll
0,48579058700,48579059000,00000000300,a00,read
0,48579107700,48579109900,00000002200,a01,write
0,48579118600,48579119400,00000000800,a2f,recvmsg
0,48579121400,48579121500,00000000100,a00,read
0,48579147000,48579148300,00000001300,a01,write
0,48579469800,48579470700,00000000900,a2f,recvmsg
0,48579158600,48579474700,00000316100,a07,poll
0,48579475200,48579476300,00000001100,a2f,recvmsg
0,48579480900,48579481800,00000000900,a2d,recvfrom
0,48579482600,48579482800,00000000200,a2f,recvmsg
0,48579483500,48579483700,00000000200,a2f,recvmsg
0,48579523800,48579524100,00000000300,a2f,recvmsg
0,48579526200,48579526300,00000000100,a2f,recvmsg
0,48579528500,48579530400,00000001900,a07,poll
0,48579530900,48579532100,00000001200,a2f,recvmsg
0,48579536900,48579537500,00000000600,a2d,recvfrom
0,48579538300,48579538500,00000000200,a2f,recvmsg
0,48579539100,48579539300,00000000200,a2f,recvmsg
0,48579567400,48579567600,00000000200,a2f,recvmsg
0,48579569600,48579569700,00000000100,a2f,recvmsg
0,48579572600,48579574700,00000002100,a07,poll
0,48579575300,48579576400,00000001100,a2f,recvmsg
0,48579581400,48579582100,00000000700,a2d,recvfrom
0,48579583100,48579583200,00000000100,a2f,recvmsg
0,48579583900,48579584000,00000000100,a2f,recvmsg
0,48579613100,48579613400,00000000300,a2f,recvmsg
0,48579615000,48579615200,00000000200,a2f,recvmsg
0,48579625700,48579625800,00000000100,a2f,recvmsg
0,48579626500,48579626700,00000000200,a2f,recvmsg
0,48579471100,48579658700,00000187600,a17,select
0,48579668600,48579671300,00000002700,a14,writev
0,48579673300,48579673500,00000000200,a2f,recvmsg
0,48579681300,48579681500,00000000200,a2f,recvmsg
0,48579682000,48579682200,00000000200,a2f,recvmsg
0,48580105200,48580109100,00000003900,a09,mmap
0,48580462000,48580466800,00000004800,a02,open
0,48580474300,48580476500,00000002200,a00,read
0,48580528700,48580529400,00000000700,a00,read
0,48580578100,48580578800,00000000700,a00,read
0,48580624300,48580625100,00000000800,a00,read
0,48580672100,48580672900,00000000800,a00,read
0,48580719100,48580719800,00000000700,a00,read
0,48580763600,48580764400,00000000800,a00,read
0,48580809500,48580810200,00000000700,a00,read
0,48580857900,48580858500,00000000600,a00,read
0,48580906800,48580907500,00000000700,a00,read
0,48580955000,48580955700,00000000700,a00,read
0,48580982600,48580984300,00000001700,a02,open
0,48580987200,48580988100,00000000900,a00,read
0,48581042000,48581042700,00000000700,a00,read
0,48581125000,48581125900,00000000900,a00,read
0,48581196500,48581197200,00000000700,a00,read
0,48581290500,48581291300,00000000800,a00,read
0,48581368400,48581369100,00000000700,a00,read
0,48581445100,48581445800,00000000700,a00,read
0,48581529200,48581529900,00000000700,a00,read
0,48581595300,48581596000,00000000700,a00,read
0,48581653000,48581653700,00000000700,a00,read
0,48579674700,48581740600,00002065900,a17,select
0,48581755400,48581755700,00000000300,a2f,recvmsg
0,48581722700,48581766000,00000043300,a07,poll
0,48581778300,48581782900,00000004600,a2e,sendmsg
0,48581791500,48581792600,00000001100,a2e,sendmsg
0,48581800900,48581801100,00000000200,a00,read
0,48581815900,48581816100,00000000200,a2f,recvmsg
0,48581816700,48581816900,00000000200,a2f,recvmsg
0,48581758100,48581824200,00000066100,a17,select
0,48581830000,48581830200,00000000200,a2f,recvmsg
0,48581837200,48581837400,00000000200,a2f,recvmsg
0,48581837800,48581838000,00000000200,a2f,recvmsg
0,48581844000,48581849200,00000005200,a06,lstat
0,48581849900,48581851000,00000001100,a06,lstat
0,48581872800,48581886600,00000013800,a01,write
0,48581831300,48581895700,00000064400,a17,select
0,48581901800,48581902000,00000000200,a2f,recvmsg
0,48581909900,48581910000,00000000100,a2f,recvmsg
0,48581910600,48581910800,00000000200,a2f,recvmsg
0,48581912200,48582256000,00000343800,a38,clone
0,48583035600,48583035800,00000000200,a0c,brk
0,48583045500,48583048300,00000002800,a15,access
0,48583049000,48583050000,00000001000,a09,mmap
0,48583055200,48583057000,00000001800,a15,access
0,48583063400,48583064200,00000000800,a09,mmap
0,48583068200,48583068700,00000000500,a15,access
0,48583076000,48583077000,00000001000,a00,read
0,48583078400,48583079800,00000001400,a09,mmap
0,48583084200,48583086400,00000002200,a09,mmap
0,48583098100,48583098700,00000000600,a15,access
0,48583102000,48583102700,00000000700,a00,read
0,48583103500,48583104300,00000000800,a09,mmap
0,48583106200,48583107500,00000001300,a09,mmap
0,48583116900,48583117400,00000000500,a15,access
0,48583120500,48583121000,00000000500,a00,read
0,48583121700,48583122600,00000000900,a09,mmap
0,48583124100,48583126200,00000002100,a09,mmap
0,48583131200,48583134200,00000003000,a09,mmap
0,48583136300,48583137400,00000001100,a09,mmap
0,48583146700,48583147300,00000000600,a15,access
0,48583149800,48583150400,00000000600,a00,read
0,48583152200,48583153700,00000001500,a09,mmap
0,48583156000,48583157700,00000001700,a09,mmap
0,48583165800,48583166300,00000000500,a15,access
0,48583169300,48583170000,00000000700,a00,read
0,48583170600,48583172100,00000001500,a09,mmap
0,48583175100,48583177200,00000002100,a09,mmap
0,48583185500,48583186200,00000000700,a15,access
0,48583188700,48583189200,00000000500,a00,read
0,48583189600,48583190800,00000001200,a09,mmap
0,48583192000,48583193400,00000001400,a09,mmap
0,48583195800,48583197000,00000001200,a09,mmap
0,48583203200,48583204000,00000000800,a15,access
0,48583206100,48583206700,00000000600,a00,read
0,48583207400,48583208500,00000001100,a09,mmap
0,48583210300,48583212100,00000001800,a09,mmap
0,48583226000,48583226600,00000000600,a09,mmap
0,48583230500,48583230800,00000000300,a09,mmap
0,48583231900,48583232200,00000000300,a09,mmap
0,48583407500,48583407700,00000000200,a0c,brk
0,48583407800,48583408500,00000000700,a0c,brk
0,48583445900,48583446900,00000001000,a00,read
0,48583458400,48583459700,00000001300,a00,read
0,48583492400,48583493400,00000001000,a00,read
0,48583615000,48583615900,00000000900,a00,read
0,48583688100,48583688600,00000000500,a00,read
0,48583773400,48583774100,00000000700,a00,read
0,48583904500,48583905400,00000000900,a00,read
0,48584032600,48584033200,00000000600,a00,read
0,48584188800,48584189500,00000000700,a00,read
0,48584339600,48584340400,00000000800,a00,read
0,48584376800,48584378200,00000001400,a0c,brk
0,48584493700,48584494400,00000000700,a00,read
0,48584642500,48584643100,00000000600,a00,read
0,48584797400,48584798100,00000000700,a00,read
0,48584958800,48584959600,00000000800,a00,read
0,48585067800,48585068400,00000000600,a00,read
0,48585207400,48585208200,00000000800,a00,read
0,48585463600,48585464300,00000000700,a00,read
0,48585476200,48585476600,00000000400,a00,read
0,48585519600,48585520000,00000000400,a00,read
0,48585539600,48585540300,00000000700,a00,read
0,48585748800,48585749300,00000000500,a00,read
0,48585778000,48585778900,00000000900,a00,read
0,48585875600,48585876200,00000000600,a00,read
0,48585899900,48585901100,00000001200,a0c,brk
0,48585945900,48585946200,00000000300,a00,read
0,48586022200,48586022900,00000000700,a00,read
0,48586174900,48586175400,00000000500,a00,read
0,48586286100,48586286600,00000000500,a00,read
0,48586380700,48586381200,00000000500,a00,read
0,48586393000,48586393500,00000000500,a00,read
0,48586472400,48586472700,00000000300,a00,read
0,48586496600,48586497000,00000000400,a00,read
0,48586519100,48586519600,00000000500,a00,read
0,48586620800,48586621900,00000001100,a0c,brk
0,48586623000,48586624300,00000001300,a00,read
0,48586824000,48586824000,00000000000,a00,read
0,48586906800,48586907500,00000000700,a00,read
0,48586970300,48586970900,00000000600,a00,read
0,48587099600,48587100000,00000000400,a00,read
0,48587132100,48587132600,00000000500,a00,read
0,48587148800,48587150100,00000001300,a02,open
0,48587261100,48587261600,00000000500,a00,read
0,48587331600,48587332000,00000000400,a00,read
0,48587384400,48587385500,00000001100,a0c,brk
0,48587391700,48587392300,00000000600,a00,read
0,48587498300,48587498800,00000000500,a00,read
0,48587647600,48587648500,00000000900,a00,read
0,48587779900,48587780600,00000000700,a00,read
0,48587838200,48587838800,00000000600,a00,read
0,48587894600,48587895400,00000000800,a00,read
0,48587965200,48587965900,00000000700,a00,read
0,48588018700,48588019300,00000000600,a00,read
0,48588106900,48588107800,00000000900,a0c,brk
0,48588137700,48588142100,00000004400,a0c,brk
0,48588155900,48588156700,00000000800,a00,read
0,48588270700,48588271600,00000000900,a00,read
0,48588429500,48588430300,00000000800,a00,read
0,48588547300,48588547800,00000000500,a00,read
0,48588694500,48588695200,00000000700,a00,read
0,48588811700,48588812500,00000000800,a00,read
0,48588973300,48588974000,00000000700,a00,read
0,48588978900,48588979600,00000000700,a0c,brk
0,48589093900,48589094500,00000000600,a00,read
0,48589212700,48589213400,00000000700,a00,read
0,48589373900,48589374900,00000001000,a00,read
0,48589505900,48589506700,00000000800,a00,read
0,48589601100,48589601900,00000000800,a00,read
0,48589714400,48589715100,00000000700,a00,read
0,48589839300,48589839900,00000000600,a00,read
0,48589951100,48589951700,00000000600,a0c,brk
0,48589974400,48589975100,00000000700,a00,read
0,48590143700,48590144500,00000000800,a00,read
0,48590293600,48590294200,00000000600,a00,read
0,48590405500,48590406200,00000000700,a00,read
0,48590574300,48590575200,00000000900,a00,read
0,48590652400,48590653000,00000000600,a00,read
0,48590734100,48590734700,00000000600,a00,read
0,48590801300,48590802000,00000000700,a0c,brk
0,48590815500,48590816200,00000000700,a00,read
0,48590888500,48590889200,00000000700,a00,read
0,48590990000,48590990700,00000000700,a00,read
0,48591093400,48591094100,00000000700,a00,read
0,48591183100,48591183800,00000000700,a00,read
0,48591264100,48591264700,00000000600,a00,read
0,48591365400,48591366100,00000000700,a00,read
0,48591446200,48591446600,00000000400,a0c,brk
0,48591449000,48591449700,00000000700,a00,read
0,48591556300,48591557000,00000000700,a00,read
0,48591649200,48591650000,00000000800,a00,read
0,48591769100,48591769800,00000000700,a00,read
0,48591882500,48591883200,00000000700,a00,read
0,48591987100,48591987700,00000000600,a00,read
0,48592087600,48592088000,00000000400,a0c,brk
0,48592446600,48592450100,00000003500,a57,unlink
0,48592472900,48592473400,00000000500,a48,fcntl
0,48592519600,48592534600,00000015000,a01,write
0,48592553100,48592555700,00000002600,a01,write
0,48592572100,48592574500,00000002400,a01,write
0,48582278200,48597251200,00014973000,a3d,wait4
0,48597272400,48597275600,00000003200,a00,read
0,48597277800,48597278100,00000000300,a00,read
0,48581903200,48597309500,00015406300,a17,select
0,48597330200,48597330500,00000000300,a2f,recvmsg
0,48597347700,48597347900,00000000200,a2f,recvmsg
0,48597348800,48597349000,00000000200,a2f,recvmsg
0,48597334200,48597355800,00000021600,a17,select
0,48597359700,48597359800,00000000100,a2f,recvmsg
0,48597365800,48597366000,00000000200,a2f,recvmsg
0,48597366400,48597366600,00000000200,a2f,recvmsg
0,48597360700,48597371800,00000011100,a17,select
0,48597375000,48597375200,00000000200,a2f,recvmsg
0,48597380500,48597380600,00000000100,a2f,recvmsg
0,48597381000,48597381200,00000000200,a2f,recvmsg
0,48597375800,48597386100,00000010300,a17,select
0,48597389700,48597389900,00000000200,a2f,recvmsg
0,48597395100,48597395300,00000000200,a2f,recvmsg
0,48597395600,48597395700,00000000100,a2f,recvmsg
0,48597390400,48597400700,00000010300,a17,select
0,48597404400,48597404500,00000000100,a2f,recvmsg
0,48597409600,48597409800,00000000200,a2f,recvmsg
0,48597410100,48597410300,00000000200,a2f,recvmsg
0,48597405100,48597414600,00000009500,a17,select
0,48597417600,48597417800,00000000200,a2f,recvmsg
0,48597422900,48597423100,00000000200,a2f,recvmsg
0,48597423500,48597423700,00000000200,a2f,recvmsg
0,48597424300,48597424500,00000000200,a08,lseek
0,48597434200,48597434300,00000000100,a08,lseek
0,48597418300,48597438600,00000020300,a17,select
0,48597442000,48597442200,00000000200,a2f,recvmsg
0,48597448400,48597448600,00000000200,a2f,recvmsg
0,48597448900,48597449000,00000000100,a2f,recvmsg
0,48597442800,48597457400,00000014600,a17,select
0,48597460600,48597460800,00000000200,a2f,recvmsg
0,48597467100,48597467300,00000000200,a2f,recvmsg
0,48597467700,48597467800,00000000100,a2f,recvmsg
0,48597461400,48597472700,00000011300,a17,select
0,48597475600,48597475800,00000000200,a2f,recvmsg
0,48597481000,48597481100,00000000100,a2f,recvmsg
0,48597481400,48597481600,00000000200,a2f,recvmsg
0,48597476300,48597486800,00000010500,a17,select
0,48597489900,48597490000,00000000100,a2f,recvmsg
0,48597495400,48597495600,00000000200,a2f,recvmsg
0,48597495900,48597496100,00000000200,a2f,recvmsg
0,48597490600,48597501300,00000010700,a17,select
0,48597504700,48597504900,00000000200,a2f,recvmsg
0,48597510100,48597510300,00000000200,a2f,recvmsg
0,48597510700,48597510900,00000000200,a2f,recvmsg
0,48597505500,48597517200,00000011700,a17,select
0,48597520300,48597520500,00000000200,a2f,recvmsg
0,48597526000,48597526100,00000000100,a2f,recvmsg
0,48597526500,48597526700,00000000200,a2f,recvmsg
0,48597521000,48597531700,00000010700,a17,select
0,48597534900,48597535100,00000000200,a2f,recvmsg
0,48597540300,48597540500,00000000200,a2f,recvmsg
0,48597540800,48597541000,00000000200,a2f,recvmsg
0,48597535700,48597545700,00000010000,a17,select
0,48597548700,48597548800,00000000100,a2f,recvmsg
0,48597554000,48597554200,00000000200,a2f,recvmsg
0,48597554600,48597554800,00000000200,a2f,recvmsg
0,48597549400,48597560900,00000011500,a17,select
0,48597564400,48597564500,00000000100,a2f,recvmsg
0,48597570000,48597570200,00000000200,a2f,recvmsg
0,48597570400,48597570600,00000000200,a2f,recvmsg
0,48597565000,48597576000,00000011000,a17,select
0,48597579100,48597579300,00000000200,a2f,recvmsg
0,48597584600,48597584800,00000000200,a2f,recvmsg
0,48597585100,48597585300,00000000200,a2f,recvmsg
0,48597579900,48597590600,00000010700,a17,select
0,48597593700,48597593900,00000000200,a2f,recvmsg
0,48597599600,48597599700,00000000100,a2f,recvmsg
0,48597600100,48597600300,00000000200,a2f,recvmsg
0,48597594500,48597605400,00000010900,a17,select
0,48597608500,48597608700,00000000200,a2f,recvmsg
0,48597614100,48597614200,00000000100,a2f,recvmsg
0,48597614600,48597614700,00000000100,a2f,recvmsg
0,48597609300,48597619800,00000010500,a17,select
0,48597622900,48597623100,00000000200,a2f,recvmsg
0,48597628500,48597628700,00000000200,a2f,recvmsg
0,48597629000,48597629200,00000000200,a2f,recvmsg
0,48597623600,48597635600,00000012000,a17,select
0,48597638800,48597638900,00000000100,a2f,recvmsg
0,48597644400,48597644500,00000000100,a2f,recvmsg
0,48597644800,48597645000,00000000200,a2f,recvmsg
0,48597639500,48597650100,00000010600,a17,select
0,48597653100,48597653300,00000000200,a2f,recvmsg
0,48597658500,48597658600,00000000100,a2f,recvmsg
0,48597659000,48597659200,00000000200,a2f,recvmsg
0,48597653900,48597663600,00000009700,a17,select
0,48597666800,48597667000,00000000200,a2f,recvmsg
0,48597672100,48597672300,00000000200,a2f,recvmsg
0,48597672700,48597672900,00000000200,a2f,recvmsg
0,48597667500,48597679600,00000012100,a17,select
0,48597682700,48597682800,00000000100,a2f,recvmsg
0,48597688100,48597688200,00000000100,a2f,recvmsg
0,48597688600,48597688800,00000000200,a2f,recvmsg
0,48597683400,48597693300,00000009900,a17,select
0,48597696300,48597696400,00000000100,a2f,recvmsg
0,48597701500,48597701700,00000000200,a2f,recvmsg
0,48597702000,48597702200,00000000200,a2f,recvmsg
0,48597697000,48597706800,00000009800,a17,select
0,48597709700,48597709900,00000000200,a2f,recvmsg
0,48597715000,48597715200,00000000200,a2f,recvmsg
0,48597715600,48597715800,00000000200,a2f,recvmsg
0,48597710500,48597720300,00000009800,a17,select
0,48597723300,48597723400,00000000100,a2f,recvmsg
0,48597728600,48597728800,00000000200,a2f,recvmsg
0,48597729100,48597729300,00000000200,a2f,recvmsg
0,48597724000,48597734300,00000010300,a17,select
0,48597737400,48597737600,00000000200,a2f,recvmsg
0,48597742800,48597743000,00000000200,a2f,recvmsg
0,48597743300,48597743500,00000000200,a2f,recvmsg
0,48597738100,48597748200,00000010100,a17,select
0,48597751200,48597751400,00000000200,a2f,recvmsg
0,48597756600,48597756600,00000000000,a2f,recvmsg
0,48597757000,48597757200,00000000200,a2f,recvmsg
0,48597751900,48597762500,00000010600,a17,select
0,48597765700,48597765900,00000000200,a2f,recvmsg
0,48597771100,48597771300,00000000200,a2f,recvmsg
0,48597771600,48597771800,00000000200,a2f,recvmsg
0,48597766400,48597777100,00000010700,a17,select
0,48597780200,48597780400,00000000200,a2f,recvmsg
0,48597785500,48597785700,00000000200,a2f,recvmsg
0,48597786000,48597786200,00000000200,a2f,recvmsg
0,48597781000,48597792100,00000011100,a17,select
0,48597795400,48597795600,00000000200,a2f,recvmsg
0,48597800700,48597800900,00000000200,a2f,recvmsg
0,48597801200,48597801400,00000000200,a2f,recvmsg
0,48597796100,48597807100,00000011000,a17,select
0,48597810000,48597810200,00000000200,a2f,recvmsg
0,48597815400,48597815500,00000000100,a2f,recvmsg
0,48597815800,48597816000,00000000200,a2f,recvmsg
0,48597810800,48597821400,00000010600,a17,select
0,48597824600,48597824800,00000000200,a2f,recvmsg
0,48597830000,48597830100,00000000100,a2f,recvmsg
0,48597830500,48597830700,00000000200,a2f,recvmsg
0,48597825300,48597838300,00000013000,a17,select
0,48597841500,48597841700,00000000200,a2f,recvmsg
0,48597847300,48597847400,00000000100,a2f,recvmsg
0,48597847800,48597847900,00000000100,a2f,recvmsg
0,48597842200,48597852900,00000010700,a17,select
0,48597855900,48597856100,00000000200,a2f,recvmsg
0,48597861200,48597861400,00000000200,a2f,recvmsg
0,48597861700,48597861900,00000000200,a2f,recvmsg
0,48597856700,48597866800,00000010100,a17,select
0,48597870000,48597870200,00000000200,a2f,recvmsg
0,48597875400,48597875600,00000000200,a2f,recvmsg
0,48597875900,48597876100,00000000200,a2f,recvmsg
0,48597870700,48597881900,00000011200,a17,select
0,48597885000,48597885200,00000000200,a2f,recvmsg
0,48597890500,48597890600,00000000100,a2f,recvmsg
0,48597891000,48597891200,00000000200,a2f,recvmsg
0,48597885700,48597896500,00000010800,a17,select
0,48597899600,48597899800,00000000200,a2f,recvmsg
0,48597905300,48597905400,00000000100,a2f,recvmsg
0,48597905800,48597906000,00000000200,a2f,recvmsg
0,48597900400,48597911900,00000011500,a17,select
0,48597915200,48597915300,00000000100,a2f,recvmsg
0,48597920700,48597920900,00000000200,a2f,recvmsg
0,48597921300,48597921400,00000000100,a2f,recvmsg
0,48597915900,48597926700,00000010800,a17,select
0,48597929800,48597930000,00000000200,a2f,recvmsg
0,48597935100,48597935200,00000000100,a2f,recvmsg
0,48597935600,48597935800,00000000200,a2f,recvmsg
0,48597930500,48597940800,00000010300,a17,select
0,48597943800,48597944000,00000000200,a2f,recvmsg
0,48597949200,48597949400,00000000200,a2f,recvmsg
0,48597949800,48597949900,00000000100,a2f,recvmsg
0,48597944600,48597954600,00000010000,a17,select
0,48597957700,48597957900,00000000200,a2f,recvmsg
0,48597963100,48597963300,00000000200,a2f,recvmsg
0,48597963600,48597963700,00000000100,a2f,recvmsg
0,48597958400,48597969300,00000010900,a17,select
0,48597972300,48597972500,00000000200,a2f,recvmsg
0,48597977700,48597977900,00000000200,a2f,recvmsg
0,48597978200,48597978400,00000000200,a2f,recvmsg
0,48597979700,48597979800,00000000100,a08,lseek
0,48597982400,48597983400,00000001000,a00,read
0,48597987000,48597987100,00000000100,a08,lseek
0,48597973100,48597991900,00000018800,a17,select
0,48597995100,48597995300,00000000200,a2f,recvmsg
0,48598000700,48598000900,00000000200,a2f,recvmsg
0,48598001300,48598001500,00000000200,a2f,recvmsg
0,48597995900,48598030200,00000034300,a17,select
0,48598033800,48598033900,00000000100,a2f,recvmsg
0,48598039400,48598039600,00000000200,a2f,recvmsg
0,48598039900,48598040000,00000000100,a2f,recvmsg
0,48598044000,48598044800,00000000800,a00,read
0,48598050400,48598050500,00000000100,a08,lseek
0,48598034400,48598055900,00000021500,a17,select
0,48598059200,48598059300,00000000100,a2f,recvmsg
0,48598064700,48598064800,00000000100,a2f,recvmsg
0,48598065200,48598065400,00000000200,a2f,recvmsg
0,48598060000,48598070100,00000010100,a17,select
0,48598073100,48598073200,00000000100,a2f,recvmsg
0,48598078300,48598078500,00000000200,a2f,recvmsg
0,48598078900,48598079100,00000000200,a2f,recvmsg
0,48598073800,48598083400,00000009600,a17,select
0,48598086300,48598086500,00000000200,a2f,recvmsg
0,48598091400,48598091600,00000000200,a2f,recvmsg
0,48598092000,48598092200,00000000200,a2f,recvmsg
0,48598087000,48598096600,00000009600,a17,select
0,48598099400,48598099600,00000000200,a2f,recvmsg
0,48598104700,48598104900,00000000200,a2f,recvmsg
0,48598105200,48598105400,00000000200,a2f,recvmsg
0,48598100200,48598109900,00000009700,a17,select
0,48598112800,48598113000,00000000200,a2f,recvmsg
0,48598118000,48598118100,00000000100,a2f,recvmsg
0,48598118500,48598118700,00000000200,a2f,recvmsg
0,48598113600,48598123000,00000009400,a17,select
0,48598126000,48598126200,00000000200,a2f,recvmsg
0,48598131200,48598131400,00000000200,a2f,recvmsg
0,48598131800,48598132000,00000000200,a2f,recvmsg
0,48598126700,48598136400,00000009700,a17,select
0,48598139100,48598139300,00000000200,a2f,recvmsg
0,48598144300,48598144500,00000000200,a2f,recvmsg
0,48598144800,48598145000,00000000200,a2f,recvmsg
0,48598139900,48598150000,00000010100,a17,select
0,48598153100,48598153300,00000000200,a2f,recvmsg
0,48598158400,48598158600,00000000200,a2f,recvmsg
0,48598158900,48598159100,00000000200,a2f,recvmsg
0,48598153800,48598163600,00000009800,a17,select
0,48598166600,48598166700,00000000100,a2f,recvmsg
0,48598171700,48598171900,00000000200,a2f,recvmsg
0,48598172300,48598172500,00000000200,a2f,recvmsg
0,48598173000,48598173100,00000000100,a08,lseek
0,48598167200,48598179000,00000011800,a17,select
0,48598182200,48598182300,00000000100,a2f,recvmsg
0,48598187700,48598187900,00000000200,a2f,recvmsg
0,48598188100,48598188300,00000000200,a2f,recvmsg
0,48598182900,48598195300,00000012400,a17,select
0,48598198400,48598198600,00000000200,a2f,recvmsg
0,48598203900,48598204100,00000000200,a2f,recvmsg
0,48598204400,48598204600,00000000200,a2f,recvmsg
0,48598199200,48598209700,00000010500,a17,select
0,48598212600,48598212700,00000000100,a2f,recvmsg
0,48598218100,48598218200,00000000100,a2f,recvmsg
0,48598218500,48598218700,00000000200,a2f,recvmsg
0,48598213300,48598223600,00000010300,a17,select
0,48598226600,48598226800,00000000200,a2f,recvmsg
0,48598232100,48598232300,00000000200,a2f,recvmsg
0,48598232700,48598232800,00000000100,a2f,recvmsg
0,48598227400,48598237700,00000010300,a17,select
0,48598240600,48598240800,00000000200,a2f,recvmsg
0,48598245800,48598246000,00000000200,a2f,recvmsg
0,48598246400,48598246600,00000000200,a2f,recvmsg
0,48598241200,48598251300,00000010100,a17,select
0,48598254400,48598254400,00000000000,a2f,recvmsg
0,48598259800,48598260000,00000000200,a2f,recvmsg
0,48598260300,48598260500,00000000200,a2f,recvmsg
0,48598255000,48598265800,00000010800,a17,select
0,48598268700,48598268800,00000000100,a2f,recvmsg
0,48598273900,48598274100,00000000200,a2f,recvmsg
0,48598274400,48598274600,00000000200,a2f,recvmsg
0,48598269400,48598279300,00000009900,a17,select
0,48598282400,48598282500,00000000100,a2f,recvmsg
0,48598287600,48598287800,00000000200,a2f,recvmsg
0,48598288200,48598288400,00000000200,a2f,recvmsg
0,48598283000,48598293000,00000010000,a17,select
0,48598296000,48598296200,00000000200,a2f,recvmsg
0,48598301200,48598301400,00000000200,a2f,recvmsg
0,48598301800,48598301900,00000000100,a2f,recvmsg
0,48598296700,48598306700,00000010000,a17,select
0,48598309500,48598309700,00000000200,a2f,recvmsg
0,48598314900,48598315100,00000000200,a2f,recvmsg
0,48598315400,48598315500,00000000100,a2f,recvmsg
0,48598310300,48598320300,00000010000,a17,select
0,48598323200,48598323400,00000000200,a2f,recvmsg
0,48598328500,48598328600,00000000100,a2f,recvmsg
0,48598329000,48598329200,00000000200,a2f,recvmsg
0,48598323900,48598334000,00000010100,a17,select
0,48598336800,48598337000,00000000200,a2f,recvmsg
0,48598342100,48598342300,00000000200,a2f,recvmsg
0,48598342600,48598342800,00000000200,a2f,recvmsg
0,48598337600,48598348300,00000010700,a17,select
0,48598351300,48598351400,00000000100,a2f,recvmsg
0,48598356600,48598356800,00000000200,a2f,recvmsg
0,48598357100,48598357300,00000000200,a2f,recvmsg
0,48598352000,48598362000,00000010000,a17,select
0,48598364900,48598365100,00000000200,a2f,recvmsg
0,48598370300,48598370400,00000000100,a2f,recvmsg
0,48598370800,48598371000,00000000200,a2f,recvmsg
0,48598365700,48598375700,00000010000,a17,select
0,48598378600,48598378800,00000000200,a2f,recvmsg
0,48598383800,48598384000,00000000200,a2f,recvmsg
0,48598384400,48598384600,00000000200,a2f,recvmsg
0,48598379400,48598389200,00000009800,a17,select
0,48598392200,48598392300,00000000100,a2f,recvmsg
0,48598397400,48598397600,00000000200,a2f,recvmsg
0,48598397900,48598398100,00000000200,a2f,recvmsg
0,48598392900,48598408500,00000015600,a17,select
0,48598411700,48598411800,00000000100,a2f,recvmsg
0,48598417300,48598417500,00000000200,a2f,recvmsg
0,48598417800,48598418000,00000000200,a2f,recvmsg
0,48598412400,48598423000,00000010600,a17,select
0,48598425800,48598426000,00000000200,a2f,recvmsg
0,48598431200,48598431300,00000000100,a2f,recvmsg
0,48598431700,48598431900,00000000200,a2f,recvmsg
0,48598426600,48598436700,00000010100,a17,select
0,48598439600,48598439700,00000000100,a2f,recvmsg
0,48598444900,48598445100,00000000200,a2f,recvmsg
0,48598445400,48598445600,00000000200,a2f,recvmsg
0,48598440300,48598450500,00000010200,a17,select
0,48598453500,48598453700,00000000200,a2f,recvmsg
0,48598458700,48598458900,00000000200,a2f,recvmsg
0,48598459200,48598459400,00000000200,a2f,recvmsg
0,48598454200,48598464300,00000010100,a17,select
0,48598467200,48598467400,00000000200,a2f,recvmsg
0,48598472600,48598472800,00000000200,a2f,recvmsg
0,48598473100,48598473200,00000000100,a2f,recvmsg
0,48598518600,48598522300,00000003700,a14,writev
0,48598468000,48598526300,00000058300,a17,select
0,48598528800,48598530200,00000001400,a2f,recvmsg
0,48598615700,48598619600,00000003900,a14,writev
0,48598620000,48598623300,00000003300,a14,writev
0,48598699300,48598700900,00000001600,a14,writev
0,48598756100,48598758200,00000002100,a14,writev
0,48598758400,48598760100,00000001700,a14,writev
0,48598813200,48598815100,00000001900,a14,writev
0,48598815300,48598816800,00000001500,a14,writev
0,48598870100,48598871900,00000001800,a14,writev
0,48598872000,48598873700,00000001700,a14,writev
0,48598925800,48598927500,00000001700,a14,writev
0,48598927700,48598929600,00000001900,a14,writev
0,48598933200,48598933900,00000000700,a2f,recvmsg
0,48598982400,48598984100,00000001700,a14,writev
0,48599027400,48599029000,00000001600,a14,writev
0,48599070000,48599071700,00000001700,a14,writev
0,48599113000,48599114500,00000001500,a14,writev
0,48599156900,48599158700,00000001800,a14,writev
0,48599200300,48599202200,00000001900,a14,writev
0,48599226900,48599228700,00000001800,a2f,recvmsg
0,48599253200,48599254900,00000001700,a14,writev
0,48599271500,48599273100,00000001600,a14,writev
0,48599287300,48599288800,00000001500,a14,writev
0,48599302500,48599304500,00000002000,a14,writev
0,48599317700,48599319300,00000001600,a14,writev
0,48599331800,48599333700,00000001900,a14,writev
0,48599338200,48599338400,00000000200,a2f,recvmsg
0,48599339100,48599339300,00000000200,a14,writev
0,48599339500,48599339900,00000000400,a14,writev
0,48599357600,48599359300,00000001700,a14,writev
0,48599359500,48599360800,00000001300,a14,writev
0,48599361300,48599361500,00000000200,a2f,recvmsg
0,48598518100,48599370900,00000852800,a07,poll
0,48599376000,48599382700,00000006700,a2f,recvmsg
0,48599394400,48599394600,00000000200,a2f,recvmsg
0,48599421900,48599426600,00000004700,a07,poll
0,48599432700,48599439000,00000006300,a2f,recvmsg
0,48599451400,48599451500,00000000100,a2f,recvmsg
0,48599474000,48599478400,00000004400,a07,poll
0,48599484300,48599490200,00000005900,a2f,recvmsg
0,48599502900,48599503100,00000000200,a2f,recvmsg
0,48599362200,48599533300,00000171100,a17,select
0,48599548000,48599549300,00000001300,a14,writev
0,48599549800,48599550000,00000000200,a2f,recvmsg
0,48599563500,48599564500,00000001000,a14,writev
0,48599564800,48599565000,00000000200,a2f,recvmsg
0,48599576700,48599577600,00000000900,a14,writev
0,48599577900,48599578100,00000000200,a2f,recvmsg
0,48599525900,48599582200,00000056300,a07,poll
0,48599582700,48599583700,00000001000,a2f,recvmsg
0,48599588700,48599589700,00000001000,a2d,recvfrom
0,48599590500,48599590700,00000000200,a2f,recvmsg
0,48599591400,48599591600,00000000200,a2f,recvmsg
0,48599631800,48599632000,00000000200,a2f,recvmsg
0,48599634100,48599634300,00000000200,a2f,recvmsg
0,48599636500,48599638500,00000002000,a07,poll
0,48599639000,48599640000,00000001000,a2f,recvmsg
0,48599644800,48599645400,00000000600,a2d,recvfrom
0,48599646200,48599646400,00000000200,a2f,recvmsg
0,48599647100,48599647200,00000000100,a2f,recvmsg
0,48599675700,48599676000,00000000300,a2f,recvmsg
0,48599677800,48599678000,00000000200,a2f,recvmsg
0,48599681100,48599683200,00000002100,a07,poll
0,48599683900,48599684900,00000001000,a2f,recvmsg
0,48599690000,48599690600,00000000600,a2d,recvfrom
0,48599691500,48599691700,00000000200,a2f,recvmsg
0,48599692400,48599692600,00000000200,a2f,recvmsg
0,48599721700,48599722000,00000000300,a2f,recvmsg
0,48599723700,48599723900,00000000200,a2f,recvmsg
0,48599735000,48599735200,00000000200,a2f,recvmsg
0,48599735900,48599736100,00000000200,a2f,recvmsg
0,48599578600,48599769500,00000190900,a17,select
0,48599779400,48599781500,00000002100,a14,writev
0,48599783300,48599783500,00000000200,a2f,recvmsg
0,48599791500,48599791600,00000000100,a2f,recvmsg
0,48599792100,48599792300,00000000200,a2f,recvmsg
0,48600335100,48600341600,00000006500,a02,open
0,48600351600,48600354100,00000002500,a00,read
0,48600405300,48600406200,00000000900,a00,read
0,48600454200,48600455000,00000000800,a00,read
0,48600500600,48600501400,00000000800,a00,read
0,48600548200,48600549100,00000000900,a00,read
0,48600594700,48600595400,00000000700,a00,read
0,48600639400,48600640200,00000000800,a00,read
0,48600684600,48600685300,00000000700,a00,read
0,48600732500,48600733300,00000000800,a00,read
0,48600781100,48600781900,00000000800,a00,read
0,48600829600,48600830300,00000000700,a00,read
0,48600857700,48600859400,00000001700,a02,open
0,48600862500,48600863400,00000000900,a00,read
0,48600916900,48600917800,00000000900,a00,read
0,48600999600,48601000300,00000000700,a00,read
0,48601070600,48601071300,00000000700,a00,read
0,48601147200,48601148000,00000000800,a00,read
0,48601235700,48601236600,00000000900,a00,read
0,48601312400,48601313200,00000000800,a00,read
0,48601395800,48601396500,00000000700,a00,read
0,48601461300,48601461900,00000000600,a00,read
0,48601518500,48601519200,00000000700,a00,read
0,48599784700,48601602400,00001817700,a17,select
0,48601614300,48601614500,00000000200,a2f,recvmsg
0,48601625900,48601626100,00000000200,a2f,recvmsg
0,48601626700,48601626900,00000000200,a2f,recvmsg
0,48601616200,48601632200,00000016000,a17,select
0,48601636400,48601636500,00000000100,a2f,recvmsg
0,48601642400,48601642500,00000000100,a2f,recvmsg
0,48601642900,48601643100,00000000200,a2f,recvmsg
0,48601648300,48601653500,00000005200,a06,lstat
0,48601654300,48601655700,00000001400,a06,lstat
0,48601674400,48601687700,00000013300,a01,write
0,48601637300,48601696400,00000059100,a17,select
0,48601702000,48601702200,00000000200,a2f,recvmsg
0,48601709700,48601709900,00000000200,a2f,recvmsg
0,48601710500,48601710500,00000000000,a2f,recvmsg
0,48601712000,48602017900,00000305900,a38,clone
0,48602496200,48602496400,00000000200,a0c,brk
0,48602506400,48602509100,00000002700,a15,access
0,48602509900,48602510700,00000000800,a09,mmap
0,48602515800,48602516500,00000000700,a15,access
0,48602522200,48602523400,00000001200,a09,mmap
0,48602527300,48602527700,00000000400,a15,access
0,48602534800,48602535600,00000000800,a00,read
0,48602544100,48602546400,00000002300,a09,mmap
0,48602559000,48602559700,00000000700,a15,access
0,48602563100,48602563700,00000000600,a00,read
0,48602564400,48602565400,00000001000,a09,mmap
0,48602567900,48602569200,00000001300,a09,mmap
0,48602577500,48602578100,00000000600,a15,access
0,48602580900,48602581600,00000000700,a00,read
0,48602582200,48602583000,00000000800,a09,mmap
0,48602584800,48602587000,00000002200,a09,mmap
0,48602597300,48602598300,00000001000,a09,mmap
0,48602607400,48602608100,00000000700,a15,access
0,48602610700,48602611300,00000000600,a00,read
0,48602612000,48602613500,00000001500,a09,mmap
0,48602616600,48602618200,00000001600,a09,mmap
0,48602626400,48602627000,00000000600,a15,access
0,48602630400,48602631100,00000000700,a00,read
0,48602631800,48602633200,00000001400,a09,mmap
0,48602636800,48602639100,00000002300,a09,mmap
0,48602647700,48602648600,00000000900,a15,access
0,48602651500,48602652200,00000000700,a00,read
0,48602652700,48602653800,00000001100,a09,mmap
0,48602655000,48602656500,00000001500,a09,mmap
0,48602659800,48602661000,00000001200,a09,mmap
0,48602667200,48602667800,00000000600,a15,access
0,48602670100,48602670600,00000000500,a00,read
0,48602671300,48602672700,00000001400,a09,mmap
0,48602675400,48602677100,00000001700,a09,mmap
0,48602691000,48602691700,00000000700,a09,mmap
0,48602695600,48602696000,00000000400,a09,mmap
0,48602697200,48602697400,00000000200,a09,mmap
0,48602876700,48602876800,00000000100,a0c,brk
0,48602876900,48602877700,00000000800,a0c,brk
0,48602909900,48602911000,00000001100,a00,read
0,48602922700,48602924300,00000001600,a00,read
0,48602964400,48602965300,00000000900,a00,read
0,48603083000,48603083700,00000000700,a00,read
0,48603154400,48603154700,00000000300,a00,read
0,48603241600,48603242300,00000000700,a00,read
0,48603373100,48603374000,00000000900,a00,read
0,48603502400,48603503100,00000000700,a00,read
0,48603658600,48603659400,00000000800,a00,read
0,48603810000,48603810700,00000000700,a00,read
0,48603847400,48603848700,00000001300,a0c,brk
0,48603964000,48603964700,00000000700,a00,read
0,48604112600,48604113300,00000000700,a00,read
0,48604267900,48604268600,00000000700,a00,read
0,48604428600,48604429300,00000000700,a00,read
0,48604537600,48604538200,00000000600,a00,read
0,48604679100,48604679900,00000000800,a00,read
0,48604920700,48604921400,00000000700,a00,read
0,48604933700,48604934100,00000000400,a00,read
0,48604978100,48604978500,00000000400,a00,read
0,48604998700,48604999400,00000000700,a00,read
0,48605206300,48605206700,00000000400,a00,read
0,48605248500,48605249400,00000000900,a00,read
0,48605348700,48605349400,00000000700,a00,read
0,48605373400,48605374500,00000001100,a0c,brk
0,48605419400,48605419800,00000000400,a00,read
0,48605496700,48605497400,00000000700,a00,read
0,48605650100,48605650500,00000000400,a00,read
0,48605726400,48605759100,00000032700,a52,rename
0,48605762600,48605763200,00000000600,a00,read
0,48605770500,48605776500,00000006000,a02,open
0,48601707900,48605814900,00004107000,a07,poll
0,48605817200,48605818500,00000001300,aca,futex
0,48605821600,48605822600,00000001000,aca,futex
0,48605824100,48605825000,00000000900,aca,futex
0,48605828600,48605832900,00000004300,a2e,sendmsg
0,48605836500,48605836800,00000000300,a00,read
0,48605857800,48605858200,00000000400,a00,read
0,48605870500,48605871000,00000000500,a00,read
0,48605840400,48605880200,00000039800,a07,poll
0,48605881500,48605882500,00000001000,aca,futex
0,48605884100,48605884900,00000000800,aca,futex
0,48605886100,48605886800,00000000700,aca,futex
0,48605888700,48605891200,00000002500,a2e,sendmsg
0,48605955100,48605955600,00000000500,a00,read
0,48605979800,48605980100,00000000300,a00,read
0,48606003100,48606003700,00000000600,a00,read
0,48606025800,48606032100,00000006300,a01,write
0,48605908000,48606052700,00000144700,a07,poll
0,48606104400,48606106900,00000002500,a01,write
0,48606107700,48606108900,00000001200,a0c,brk
0,48606110000,48606110900,00000000900,a00,read
0,48606115200,48606116200,00000001000,a2f,recvmsg
0,48606118500,48606118500,00000000000,a00,read
0,48606145300,48606147000,00000001700,a01,write
0,48606312300,48606312800,00000000500,a00,read
0,48606395900,48606396600,00000000700,a00,read
0,48606460500,48606461200,00000000700,a00,read
0,48606589900,48606590300,00000000400,a00,read
0,48606623000,48606623600,00000000600,a00,read
0,48606640200,48606641600,00000001400,a02,open
0,48606753100,48606753600,00000000500,a00,read
0,48606826900,48606827300,00000000400,a00,read
0,48606880000,48606881000,00000001000,a0c,brk
0,48606887600,48606888200,00000000600,a00,read
0,48606995600,48606996200,00000000600,a00,read
0,48607146000,48607146800,00000000800,a00,read
0,48607276300,48607277000,00000000700,a00,read
0,48607333800,48607334500,00000000700,a00,read
0,48607389800,48607390600,00000000800,a00,read
0,48607459600,48607460200,00000000600,a00,read
0,48607512400,48607513100,00000000700,a00,read
0,48607602100,48607602900,00000000800,a0c,brk
0,48607633000,48607637200,00000004200,a0c,brk
0,48607651500,48607652200,00000000700,a00,read
0,48607767600,48607768300,00000000700,a00,read
0,48607925800,48607926600,00000000800,a00,read
0,48608043200,48608043900,00000000700,a00,read
0,48608189100,48608189700,00000000600,a00,read
0,48608306500,48608307200,00000000700,a00,read
0,48608469700,48608470400,00000000700,a00,read
0,48608475300,48608476000,00000000700,a0c,brk
0,48608590400,48608591100,00000000700,a00,read
0,48608708500,48608709500,00000001000,a00,read
0,48608850300,48608850900,00000000600,a00,read
0,48608981800,48608982400,00000000600,a00,read
0,48609074700,48609075400,00000000700,a00,read
0,48609187100,48609187800,00000000700,a00,read
0,48609332200,48609333000,00000000800,a00,read
0,48609443900,48609444600,00000000700,a0c,brk
0,48609467300,48609468000,00000000700,a00,read
0,48609635900,48609636600,00000000700,a00,read
0,48609786400,48609787100,00000000700,a00,read
0,48609897000,48609897700,00000000700,a00,read
0,48610066700,48610067700,00000001000,a00,read
0,48610144400,48610145000,00000000600,a00,read
0,48610226000,48610226600,00000000600,a00,read
0,48610293000,48610293500,00000000500,a0c,brk
0,48610306900,48610307700,00000000800,a00,read
0,48610379800,48610380400,00000000600,a00,read
0,48610481000,48610481700,00000000700,a00,read
0,48610583900,48610584600,00000000700,a00,read
0,48610674100,48610674700,00000000600,a00,read
0,48610756100,48610756700,00000000600,a00,read
0,48610857700,48610858400,00000000700,a00,read
0,48610938800,48610939100,00000000300,a0c,brk
0,48610941600,48610942300,00000000700,a00,read
0,48601703200,48611047600,00009344400,a17,select
0,48611048400,48611049000,00000000600,a00,read
0,48611054400,48611085200,00000030800,a00,read
0,48611076700,48611114500,00000037800,a17,select
0,48611141600,48611142200,00000000600,a00,read
0,48611260700,48611261500,00000000800,a00,read
0,48611375300,48611375900,00000000600,a00,read
0,48611478500,48611479100,00000000600,a00,read
0,48611578500,48611578800,00000000300,a0c,brk
0,48611937700,48611941100,00000003400,a57,unlink
0,48611965400,48611965900,00000000500,a48,fcntl
0,48612012300,48612027300,00000015000,a01,write
0,48612045000,48612047600,00000002600,a01,write
0,48612064200,48612066600,00000002400,a01,write
0,48615345600,48615389200,00000043600,a00,read
0,48615406500,48615424000,00000017500,a00,read
0,48615429900,48615430200,00000000300,a00,read
0,48602041900,48617233200,00015191300,a3d,wait4
0,48617252700,48617256000,00000003300,a00,read
0,48617258300,48617258700,00000000400,a00,read
0,48611135700,48617291300,00006155600,a17,select
0,48617313000,48617313200,00000000200,a2f,recvmsg
0,48617329200,48617329500,00000000300,a2f,recvmsg
0,48617330400,48617330500,00000000100,a2f,recvmsg
0,48617316900,48617338100,00000021200,a17,select
0,48617341900,48617342100,00000000200,a2f,recvmsg
0,48617348100,48617348200,00000000100,a2f,recvmsg
0,48617348600,48617348800,00000000200,a2f,recvmsg
0,48617342800,48617354100,00000011300,a17,select
0,48617357400,48617357600,00000000200,a2f,recvmsg
0,48617362900,48617363000,00000000100,a2f,recvmsg
0,48617363400,48617363600,00000000200,a2f,recvmsg
0,48617358200,48617369100,00000010900,a17,select
0,48617372800,48617372900,00000000100,a2f,recvmsg
0,48617378100,48617378300,00000000200,a2f,recvmsg
0,48617378600,48617378800,00000000200,a2f,recvmsg
0,48617373500,48617383600,00000010100,a17,select
0,48617387300,48617387400,00000000100,a2f,recvmsg
0,48617392600,48617392800,00000000200,a2f,recvmsg
0,48617393100,48617393300,00000000200,a2f,recvmsg
0,48617387900,48617397600,00000009700,a17,select
0,48617400700,48617400800,00000000100,a2f,recvmsg
0,48617406000,48617406200,00000000200,a2f,recvmsg
0,48617406400,48617406600,00000000200,a2f,recvmsg
0,48617407400,48617407600,00000000200,a08,lseek
0,48617417000,48617417100,00000000100,a08,lseek
0,48617401400,48617421500,00000020100,a17,select
0,48617424900,48617425100,00000000200,a2f,recvmsg
0,48617430500,48617430600,00000000100,a2f,recvmsg
0,48617431000,48617431100,00000000100,a2f,recvmsg
0,48617425600,48617438300,00000012700,a17,select
0,48617441500,48617441700,00000000200,a2f,recvmsg
0,48617447000,48617447200,00000000200,a2f,recvmsg
0,48617447600,48617447800,00000000200,a2f,recvmsg
0,48617442400,48617452600,00000010200,a17,select
0,48617455700,48617455800,00000000100,a2f,recvmsg
0,48617461100,48617461200,00000000100,a2f,recvmsg
0,48617461500,48617461700,00000000200,a2f,recvmsg
0,48617456400,48617467800,00000011400,a17,select
0,48617471000,48617471000,00000000000,a2f,recvmsg
0,48617476700,48617476800,00000000100,a2f,recvmsg
0,48617477200,48617477400,00000000200,a2f,recvmsg
0,48617471600,48617482800,00000011200,a17,select
0,48617486100,48617486200,00000000100,a2f,recvmsg
0,48617491700,48617491900,00000000200,a2f,recvmsg
0,48617492100,48617492300,00000000200,a2f,recvmsg
0,48617486800,48617497800,00000011000,a17,select
0,48617500900,48617501100,00000000200,a2f,recvmsg
0,48617506500,48617506700,00000000200,a2f,recvmsg
0,48617507000,48617507100,00000000100,a2f,recvmsg
0,48617501600,48617512300,00000010700,a17,select
0,48617515600,48617515800,00000000200,a2f,recvmsg
0,48617521200,48617521400,00000000200,a2f,recvmsg
0,48617521700,48617521900,00000000200,a2f,recvmsg
0,48617516400,48617526600,00000010200,a17,select
0,48617529800,48617529900,00000000100,a2f,recvmsg
0,48617535200,48617535300,00000000100,a2f,recvmsg
0,48617535600,48617535800,00000000200,a2f,recvmsg
0,48617530400,48617542100,00000011700,a17,select
0,48617545400,48617545600,00000000200,a2f,recvmsg
0,48617550900,48617551100,00000000200,a2f,recvmsg
0,48617551400,48617551600,00000000200,a2f,recvmsg
0,48617546200,48617556900,00000010700,a17,select
0,48617560200,48617560300,00000000100,a2f,recvmsg
0,48617565600,48617565800,00000000200,a2f,recvmsg
0,48617566000,48617566200,00000000200,a2f,recvmsg
0,48617560800,48617571400,00000010600,a17,select
0,48617574600,48617574800,00000000200,a2f,recvmsg
0,48617581800,48617581900,00000000100,a2f,recvmsg
0,48617582300,48617582500,00000000200,a2f,recvmsg
0,48617575400,48617587700,00000012300,a17,select
0,48617590800,48617591000,00000000200,a2f,recvmsg
0,48617596400,48617596500,00000000100,a2f,recvmsg
0,48617596800,48617597000,00000000200,a2f,recvmsg
0,48617591600,48617602100,00000010500,a17,select
0,48617605200,48617605400,00000000200,a2f,recvmsg
0,48617610600,48617610800,00000000200,a2f,recvmsg
0,48617611200,48617611400,00000000200,a2f,recvmsg
0,48617605900,48617616500,00000010600,a17,select
0,48617619600,48617619700,00000000100,a2f,recvmsg
0,48617625100,48617625200,00000000100,a2f,recvmsg
0,48617625600,48617625800,00000000200,a2f,recvmsg
0,48617620300,48617630700,00000010400,a17,select
0,48617634000,48617634200,00000000200,a2f,recvmsg
0,48617639500,48617639700,00000000200,a2f,recvmsg
0,48617640000,48617640100,00000000100,a2f,recvmsg
0,48617634700,48617644700,00000010000,a17,select
0,48617647800,48617648000,00000000200,a2f,recvmsg
0,48617653400,48617653400,00000000000,a2f,recvmsg
0,48617653800,48617654000,00000000200,a2f,recvmsg
0,48617648600,48617660700,00000012100,a17,select
0,48617663800,48617664000,00000000200,a2f,recvmsg
0,48617669300,48617669500,00000000200,a2f,recvmsg
0,48617669800,48617670000,00000000200,a2f,recvmsg
0,48617664600,48617674400,00000009800,a17,select
0,48617677600,48617677800,00000000200,a2f,recvmsg
0,48617682900,48617683100,00000000200,a2f,recvmsg
0,48617683500,48617683700,00000000200,a2f,recvmsg
0,48617678300,48617688100,00000009800,a17,select
0,48617691000,48617691200,00000000200,a2f,recvmsg
0,48617696500,48617696700,00000000200,a2f,recvmsg
0,48617697100,48617697200,00000000100,a2f,recvmsg
0,48617691700,48617701700,00000010000,a17,select
0,48617704700,48617704800,00000000100,a2f,recvmsg
0,48617710200,48617710400,00000000200,a2f,recvmsg
0,48617710600,48617710800,00000000200,a2f,recvmsg
0,48617705400,48617715800,00000010400,a17,select
0,48617718800,48617718900,00000000100,a2f,recvmsg
0,48617724400,48617724600,00000000200,a2f,recvmsg
0,48617725000,48617725100,00000000100,a2f,recvmsg
0,48617719500,48617729800,00000010300,a17,select
0,48617732900,48617733100,00000000200,a2f,recvmsg
0,48617738300,48617738400,00000000100,a2f,recvmsg
0,48617738800,48617738900,00000000100,a2f,recvmsg
0,48617733600,48617744300,00000010700,a17,select
0,48617747700,48617747900,00000000200,a2f,recvmsg
0,48617753200,48617753400,00000000200,a2f,recvmsg
0,48617753700,48617753900,00000000200,a2f,recvmsg
0,48617748400,48617759100,00000010700,a17,select
0,48617762300,48617762400,00000000100,a2f,recvmsg
0,48617767600,48617767800,00000000200,a2f,recvmsg
0,48617768100,48617768300,00000000200,a2f,recvmsg
0,48617763000,48617775200,00000012200,a17,select
0,48617778600,48617778700,00000000100,a2f,recvmsg
0,48617784000,48617784200,00000000200,a2f,recvmsg
0,48617784500,48617784600,00000000100,a2f,recvmsg
0,48617779200,48617790200,00000011000,a17,select
0,48617793200,48617793300,00000000100,a2f,recvmsg
0,48617798500,48617798600,00000000100,a2f,recvmsg
0,48617799000,48617799200,00000000200,a2f,recvmsg
0,48617793900,48617804700,00000010800,a17,select
0,48617807700,48617807900,00000000200,a2f,recvmsg
0,48617813100,48617813200,00000000100,a2f,recvmsg
0,48617813600,48617813800,00000000200,a2f,recvmsg
0,48617808500,48617822200,00000013700,a17,select
0,48617825300,48617825400,00000000100,a2f,recvmsg
0,48617830700,48617830900,00000000200,a2f,recvmsg
0,48617831200,48617831400,00000000200,a2f,recvmsg
0,48617826000,48617836300,00000010300,a17,select
0,48617839300,48617839500,00000000200,a2f,recvmsg
0,48617844700,48617844900,00000000200,a2f,recvmsg
0,48617845200,48617845300,00000000100,a2f,recvmsg
0,48617840000,48617850400,00000010400,a17,select
0,48617853500,48617853700,00000000200,a2f,recvmsg
0,48617858900,48617859100,00000000200,a2f,recvmsg
0,48617859500,48617859700,00000000200,a2f,recvmsg
0,48617854300,48617865700,00000011400,a17,select
0,48617868800,48617868900,00000000100,a2f,recvmsg
0,48617874100,48617874300,00000000200,a2f,recvmsg
0,48617874700,48617874900,00000000200,a2f,recvmsg
0,48617869500,48617880200,00000010700,a17,select
0,48617883300,48617883500,00000000200,a2f,recvmsg
0,48617888900,48617889000,00000000100,a2f,recvmsg
0,48617889300,48617889500,00000000200,a2f,recvmsg
0,48617884100,48617895300,00000011200,a17,select
0,48617898500,48617898600,00000000100,a2f,recvmsg
0,48617904000,48617904200,00000000200,a2f,recvmsg
0,48617904500,48617904700,00000000200,a2f,recvmsg
0,48617899200,48617909900,00000010700,a17,select
0,48617913100,48617913300,00000000200,a2f,recvmsg
0,48617918600,48617918700,00000000100,a2f,recvmsg
0,48617919100,48617919300,00000000200,a2f,recvmsg
0,48617913800,48617924500,00000010700,a17,select
0,48617927600,48617927700,00000000100,a2f,recvmsg
0,48617933000,48617933200,00000000200,a2f,recvmsg
0,48617933500,48617933700,00000000200,a2f,recvmsg
0,48617928300,48617938400,00000010100,a17,select
0,48617941500,48617941700,00000000200,a2f,recvmsg
0,48617946900,48617947100,00000000200,a2f,recvmsg
0,48617947400,48617947600,00000000200,a2f,recvmsg
0,48617942200,48617952900,00000010700,a17,select
0,48617955900,48617956100,00000000200,a2f,recvmsg
0,48617961400,48617961600,00000000200,a2f,recvmsg
0,48617961900,48617962100,00000000200,a2f,recvmsg
0,48617963400,48617963500,00000000100,a08,lseek
0,48617966300,48617967200,00000000900,a00,read
0,48617970800,48617970900,00000000100,a08,lseek
0,48617956700,48617975700,00000019000,a17,select
0,48617979000,48617979100,00000000100,a2f,recvmsg
0,48617984700,48617984900,00000000200,a2f,recvmsg
0,48617985200,48617985400,00000000200,a2f,recvmsg
0,48617979800,48618013600,00000033800,a17,select
0,48618016900,48618017100,00000000200,a2f,recvmsg
0,48618022600,48618022800,00000000200,a2f,recvmsg
0,48618023100,48618023300,00000000200,a2f,recvmsg
0,48618027300,48618028100,00000000800,a00,read
0,48618033600,48618033800,00000000200,a08,lseek
0,48618017700,48618038900,00000021200,a17,select
0,48618042200,48618042400,00000000200,a2f,recvmsg
0,48618047800,48618047900,00000000100,a2f,recvmsg
0,48618048300,48618048500,00000000200,a2f,recvmsg
0,48618042900,48618053100,00000010200,a17,select
0,48618056000,48618056200,00000000200,a2f,recvmsg
0,48618061300,48618061500,00000000200,a2f,recvmsg
0,48618061800,48618061900,00000000100,a2f,recvmsg
0,48618056700,48618066500,00000009800,a17,select
0,48618069300,48618069500,00000000200,a2f,recvmsg
0,48618074500,48618074700,00000000200,a2f,recvmsg
0,48618075000,48618075200,00000000200,a2f,recvmsg
0,48618070000,48618079700,00000009700,a17,select
0,48618082600,48618082800,00000000200,a2f,recvmsg
0,48618087900,48618088100,00000000200,a2f,recvmsg
0,48618088400,48618088500,00000000100,a2f,recvmsg
0,48618083300,48618093000,00000009700,a17,select
0,48618096000,48618096100,00000000100,a2f,recvmsg
0,48618101300,48618101400,00000000100,a2f,recvmsg
0,48618101800,48618101900,00000000100,a2f,recvmsg
0,48618096700,48618106400,00000009700,a17,select
0,48618109400,48618109400,00000000000,a2f,recvmsg
0,48618114600,48618114800,00000000200,a2f,recvmsg
0,48618115100,48618115200,00000000100,a2f,recvmsg
0,48618110000,48618119600,00000009600,a17,select
0,48618122500,48618122700,00000000200,a2f,recvmsg
0,48618127700,48618127900,00000000200,a2f,recvmsg
0,48618128200,48618128400,00000000200,a2f,recvmsg
0,48618123100,48618133400,00000010300,a17,select
0,48618136400,48618136600,00000000200,a2f,recvmsg
0,48618141700,48618141800,00000000100,a2f,recvmsg
0,48618142100,48618142300,00000000200,a2f,recvmsg
0,48618137200,48618146900,00000009700,a17,select
0,48618149700,48618149900,00000000200,a2f,recvmsg
0,48618155000,48618155000,00000000000,a2f,recvmsg
0,48618155400,48618155600,00000000200,a2f,recvmsg
0,48618156200,48618156300,00000000100,a08,lseek
0,48618150400,48618162400,00000012000,a17,select
0,48618165300,48618165500,00000000200,a2f,recvmsg
0,48618170700,48618170900,00000000200,a2f,recvmsg
0,48618171300,48618171400,00000000100,a2f,recvmsg
0,48618166100,48618178200,00000012100,a17,select
0,48618181500,48618181600,00000000100,a2f,recvmsg
0,48618186800,48618186900,00000000100,a2f,recvmsg
0,48618187300,48618187400,00000000100,a2f,recvmsg
0,48618182200,48618192500,00000010300,a17,select
0,48618195400,48618195500,00000000100,a2f,recvmsg
0,48618200800,48618201000,00000000200,a2f,recvmsg
0,48618201300,48618201500,00000000200,a2f,recvmsg
0,48618196100,48618206300,00000010200,a17,select
0,48618209300,48618209500,00000000200,a2f,recvmsg
0,48618214700,48618214900,00000000200,a2f,recvmsg
0,48618215200,48618215400,00000000200,a2f,recvmsg
0,48618210100,48618220100,00000010000,a17,select
0,48618223000,48618223200,00000000200,a2f,recvmsg
0,48618228500,48618228700,00000000200,a2f,recvmsg
0,48618229100,48618229100,00000000000,a2f,recvmsg
0,48618223700,48618234100,00000010400,a17,select
0,48618237100,48618237300,00000000200,a2f,recvmsg
0,48618242400,48618242600,00000000200,a2f,recvmsg
0,48618243000,48618243100,00000000100,a2f,recvmsg
0,48618237900,48618248400,00000010500,a17,select
0,48618251300,48618251500,00000000200,a2f,recvmsg
0,48618256700,48618256900,00000000200,a2f,recvmsg
0,48618257200,48618257400,00000000200,a2f,recvmsg
0,48618252000,48618262100,00000010100,a17,select
0,48618265100,48618265200,00000000100,a2f,recvmsg
0,48618270400,48618270600,00000000200,a2f,recvmsg
0,48618270900,48618271000,00000000100,a2f,recvmsg
0,48618265800,48618275700,00000009900,a17,select
0,48618278600,48618278800,00000000200,a2f,recvmsg
0,48618284000,48618284200,00000000200,a2f,recvmsg
0,48618284500,48618284700,00000000200,a2f,recvmsg
0,48618279400,48618290900,00000011500,a17,select
0,48618293900,48618294000,00000000100,a2f,recvmsg
0,48618299300,48618299400,00000000100,a2f,recvmsg
0,48618299800,48618300000,00000000200,a2f,recvmsg
0,48618294600,48618304800,00000010200,a17,select
0,48618307700,48618307800,00000000100,a2f,recvmsg
0,48618313000,48618313100,00000000100,a2f,recvmsg
0,48618313500,48618313700,00000000200,a2f,recvmsg
0,48618308400,48618318400,00000010000,a17,select
0,48618321400,48618321600,00000000200,a2f,recvmsg
0,48618326600,48618326800,00000000200,a2f,recvmsg
0,48618327200,48618327400,00000000200,a2f,recvmsg
0,48618322100,48618332700,00000010600,a17,select
0,48618335600,48618335800,00000000200,a2f,recvmsg
0,48618341100,48618341200,00000000100,a2f,recvmsg
0,48618341500,48618341700,00000000200,a2f,recvmsg
0,48618336400,48618346500,00000010100,a17,select
0,48618349400,48618349600,00000000200,a2f,recvmsg
0,48618354700,48618354900,00000000200,a2f,recvmsg
0,48618355200,48618355400,00000000200,a2f,recvmsg
0,48618350200,48618360100,00000009900,a17,select
0,48618363000,48618363200,00000000200,a2f,recvmsg
0,48618368300,48618368500,00000000200,a2f,recvmsg
0,48618368900,48618369000,00000000100,a2f,recvmsg
0,48618363800,48618373700,00000009900,a17,select
0,48618376700,48618376900,00000000200,a2f,recvmsg
0,48618382000,48618382200,00000000200,a2f,recvmsg
0,48618382500,48618382700,00000000200,a2f,recvmsg
0,48618377400,48618392700,00000015300,a17,select
0,48618395800,48618396000,00000000200,a2f,recvmsg
0,48618401300,48618401500,00000000200,a2f,recvmsg
0,48618401900,48618402000,00000000100,a2f,recvmsg
0,48618396600,48618406900,00000010300,a17,select
0,48618409800,48618409900,00000000100,a2f,recvmsg
0,48618415200,48618415300,00000000100,a2f,recvmsg
0,48618415600,48618415800,00000000200,a2f,recvmsg
0,48618410600,48618420600,00000010000,a17,select
0,48618423400,48618423600,00000000200,a2f,recvmsg
0,48618428800,48618429000,00000000200,a2f,recvmsg
0,48618429300,48618429500,00000000200,a2f,recvmsg
0,48618424200,48618434400,00000010200,a17,select
0,48618437400,48618437600,00000000200,a2f,recvmsg
0,48618442700,48618442800,00000000100,a2f,recvmsg
0,48618443200,48618443400,00000000200,a2f,recvmsg
0,48618438100,48618448200,00000010100,a17,select
0,48618451100,48618451300,00000000200,a2f,recvmsg
0,48618456400,48618456600,00000000200,a2f,recvmsg
0,48618456900,48618457100,00000000200,a2f,recvmsg
0,48618502700,48618506600,00000003900,a14,writev
0,48618451800,48618510400,00000058600,a17,select
0,48618512800,48618514100,00000001300,a2f,recvmsg
0,48618599000,48618602700,00000003700,a14,writev
0,48618603100,48618606500,00000003400,a14,writev
0,48618682500,48618684400,00000001900,a14,writev
0,48618684700,48618686300,00000001600,a14,writev
0,48618741100,48618742800,00000001700,a14,writev
0,48618743100,48618744600,00000001500,a14,writev
0,48618798300,48618799900,00000001600,a14,writev
0,48618800100,48618802000,00000001900,a14,writev
0,48618854000,48618855600,00000001600,a14,writev
0,48618855800,48618857400,00000001600,a14,writev
0,48618911200,48618913000,00000001800,a14,writev
0,48618913100,48618914800,00000001700,a14,writev
0,48618918300,48618919000,00000000700,a2f,recvmsg
0,48618966700,48618968800,00000002100,a14,writev
0,48619010100,48619011800,00000001700,a14,writev
0,48619210100,48619212400,00000002300,a2f,recvmsg
0,48619325300,48619325400,00000000100,a2f,recvmsg
0,48619326100,48619326500,00000000400,a14,writev
0,48619326800,48619327200,00000000400,a14,writev
0,48619348000,48619349500,00000001500,a14,writev
0,48619350100,48619350200,00000000100,a2f,recvmsg
0,48618502200,48619360200,00000858000,a07,poll
0,48619364900,48619372200,00000007300,a2f,recvmsg
0,48619384400,48619384600,00000000200,a2f,recvmsg
0,48619413100,48619418500,00000005400,a07,poll
0,48619424700,48619432600,00000007900,a2f,recvmsg
0,48619445800,48619446000,00000000200,a2f,recvmsg
0,48619413100,48619462800,00000049700,a07,poll
0,48619468900,48619473600,00000004700,a07,poll
0,48619479500,48619487600,00000008100,a2f,recvmsg
0,48619501200,48619501400,00000000200,a2f,recvmsg
0,48619350900,48619533600,00000182700,a17,select
0,48619551500,48619553000,00000001500,a14,writev
0,48619553400,48619553500,00000000100,a2f,recvmsg
0,48619567500,48619568400,00000000900,a14,writev
0,48619568700,48619568800,00000000100,a2f,recvmsg
0,48619581000,48619582000,00000001000,a14,writev
0,48619582300,48619582500,00000000200,a2f,recvmsg
0,48619558900,48619586800,00000027900,a07,poll
0,48619587500,48619588500,00000001000,a2f,recvmsg
0,48619595200,48619596300,00000001100,a2d,recvfrom
0,48619597300,48619597500,00000000200,a2f,recvmsg
0,48619598300,48619598400,00000000100,a2f,recvmsg
0,48619643000,48619643300,00000000300,a2f,recvmsg
0,48619645500,48619645700,00000000200,a2f,recvmsg
0,48619648400,48619650900,00000002500,a07,poll
0,48619651500,48619652600,00000001100,a2f,recvmsg
0,48619658800,48619659500,00000000700,a2d,recvfrom
0,48619660500,48619660700,00000000200,a2f,recvmsg
0,48619661500,48619661700,00000000200,a2f,recvmsg
0,48619691600,48619691900,00000000300,a2f,recvmsg
0,48619694100,48619694300,00000000200,a2f,recvmsg
0,48619697700,48619700400,00000002700,a07,poll
0,48619701200,48619702300,00000001100,a2f,recvmsg
0,48619708700,48619709200,00000000500,a2d,recvfrom
0,48619710500,48619710700,00000000200,a2f,recvmsg
0,48619711700,48619711800,00000000100,a2f,recvmsg
0,48619742900,48619743200,00000000300,a2f,recvmsg
0,48619745200,48619745300,00000000100,a2f,recvmsg
0,48619749000,48619757700,00000008700,a07,poll
0,48619883900,48619887200,00000003300,a01,write
0,48619897300,48619898300,00000001000,a2f,recvmsg
0,48619900700,48619900900,00000000200,a00,read
0,48619914400,48619915700,00000001300,aca,futex
0,48619932200,48619932400,00000000200,a2f,recvmsg
0,48619933000,48619933200,00000000200,a2f,recvmsg
0,48619923400,48619944600,00000021200,aca,futex
0,48619583000,48620237100,00000654100,a17,select
0,48620252400,48620256600,00000004200,a14,writev
0,48620260200,48620260300,00000000100,a2f,recvmsg
0,48619963000,48620267300,00000304300,aca,futex
0,48620292700,48620295300,00000002600,a2e,sendmsg
0,48620262300,48621038300,00000776000,a17,select
0,48621044700,48621049700,00000005000,a14,writev
0,48620304200,48621056300,00000752100,a07,poll
0,48621062000,48621065100,00000003100,a2e,sendmsg
0,48587903000,48621068100,00033165100,ae8,epoll_wait
0,48621081200,48621082900,00000001700,a2f,recvmsg
0,48621098000,48621098100,00000000100,a2f,recvmsg
0,48621155800,48621159600,00000003800,a2e,sendmsg
0,48620304200,48621169300,00000865100,a07,poll
0,48621171300,48621172000,00000000700,a00,read
0,48621188500,48621189700,00000001200,a2f,recvmsg
0,48621280600,48621283200,00000002600,a07,poll
0,48621280600,48621431900,00000151300,a07,poll
0,48621434800,48621436300,00000001500,aca,futex
0,48621438400,48621439400,00000001000,aca,futex
0,48621440800,48621441700,00000000900,aca,futex
0,48621445200,48621448100,00000002900,a2e,sendmsg
0,48621451100,48621451300,00000000200,a00,read
0,48621050700,48621476200,00000425500,a17,select
0,48621497800,48621500900,00000003100,a14,writev
0,48621501200,48621503100,00000001900,a14,writev
0,48621503700,48621503900,00000000200,a2f,recvmsg
0,48621165300,48621511300,00000346000,ae8,epoll_wait
0,48621516100,48621517200,00000001100,a2f,recvmsg
0,48621537500,48621537700,00000000200,a2f,recvmsg
0,48621570900,48621572100,00000001200,a2e,sendmsg
0,48621506100,48621580600,00000074500,a17,select
0,48621591800,48621594100,00000002300,a14,writev
0,48621594300,48621595600,00000001300,a14,writev
0,48621596000,48621596200,00000000200,a2f,recvmsg
0,48621609300,48621609600,00000000300,a00,read
0,48621616600,48621617400,00000000800,a2f,recvmsg
0,48621597400,48621632000,00000034600,a17,select
0,48621641100,48621643200,00000002100,a14,writev
0,48621643400,48621644100,00000000700,a14,writev
0,48621644500,48621644700,00000000200,a2f,recvmsg
0,48621653000,48621653300,00000000300,aca,futex
0,48621645700,48621677700,00000032000,a17,select
0,48621686600,48621688700,00000002100,a14,writev
0,48621689000,48621689800,00000000800,a14,writev
0,48621690200,48621690400,00000000200,a2f,recvmsg
0,48621691300,48621721200,00000029900,a17,select
0,48621729400,48621731400,00000002000,a14,writev
0,48621731600,48621732500,00000000900,a14,writev
0,48621732800,48621733000,00000000200,a2f,recvmsg
0,48621733800,48621762400,00000028600,a17,select
0,48621770200,48621772000,00000001800,a14,writev
0,48621772200,48621773000,00000000800,a14,writev
0,48621773300,48621773500,00000000200,a2f,recvmsg
0,48621774200,48621802900,00000028700,a17,select
0,48621810400,48621812000,00000001600,a14,writev
0,48621812300,48621813000,00000000700,a14,writev
0,48621813300,48621813500,00000000200,a2f,recvmsg
0,48621814200,48621842900,00000028700,a17,select
0,48621850200,48621851800,00000001600,a14,writev
0,48621852000,48621853000,00000001000,a14,writev
0,48621853300,48621853500,00000000200,a2f,recvmsg
0,48621876000,48621886500,00000010500,aca,futex
0,48621854200,48621901200,00000047000,a17,select
0,48621911300,48621912000,00000000700,a14,writev
0,48621912500,48621912600,00000000100,a2f,recvmsg
0,48621918800,48621919800,00000001000,a2f,recvmsg
0,48621922200,48621922400,00000000200,a2f,recvmsg
0,48621922900,48621923100,00000000200,a2f,recvmsg
0,48621913600,48621953000,00000039400,a17,select
0,48621961400,48621962000,00000000600,a14,writev
0,48621962300,48621962500,00000000200,a2f,recvmsg
0,48621967700,48621968500,00000000800,a2f,recvmsg
0,48621969400,48621969500,00000000100,a2f,recvmsg
0,48621969900,48621970100,00000000200,a2f,recvmsg
0,48621963100,48621996900,00000033800,a17,select
0,48622005300,48622005900,00000000600,a14,writev
0,48622006200,48622006300,00000000100,a2f,recvmsg
0,48622011400,48622012100,00000000700,a2f,recvmsg
0,48622012900,48622013100,00000000200,a2f,recvmsg
0,48622013500,48622013700,00000000200,a2f,recvmsg
0,48622007000,48622039700,00000032700,a17,select
0,48622047800,48622048200,00000000400,a14,writev
0,48622048600,48622048700,00000000100,a2f,recvmsg
0,48622053800,48622054600,00000000800,a2f,recvmsg
0,48622055400,48622055600,00000000200,a2f,recvmsg
0,48622055900,48622056100,00000000200,a2f,recvmsg
0,48622049500,48622082300,00000032800,a17,select
0,48622090300,48622090900,00000000600,a14,writev
0,48622091200,48622091400,00000000200,a2f,recvmsg
0,48622096200,48622097000,00000000800,a2f,recvmsg
0,48622097700,48622097900,00000000200,a2f,recvmsg
0,48622098300,48622098500,00000000200,a2f,recvmsg
0,48622092000,48622125100,00000033100,a17,select
0,48622133200,48622133600,00000000400,a14,writev
0,48622134000,48622134200,00000000200,a2f,recvmsg
0,48622139300,48622140000,00000000700,a2f,recvmsg
0,48622140800,48622141000,00000000200,a2f,recvmsg
0,48622141300,48622141400,00000000100,a2f,recvmsg
0,48622134800,48622167500,00000032700,a17,select
0,48622175600,48622176100,00000000500,a14,writev
0,48622176500,48622176700,00000000200,a2f,recvmsg
0,48622181600,48622182400,00000000800,a2f,recvmsg
0,48622183100,48622183300,00000000200,a2f,recvmsg
0,48622183700,48622183900,00000000200,a2f,recvmsg
0,48622177300,48622209700,00000032400,a17,select
0,48622217800,48622218300,00000000500,a14,writev
0,48622218700,48622218900,00000000200,a2f,recvmsg
0,48622223700,48622224500,00000000800,a2f,recvmsg
0,48622225200,48622225400,00000000200,a2f,recvmsg
0,48622225700,48622225900,00000000200,a2f,recvmsg
0,48622219500,48622251900,00000032400,a17,select
0,48622260000,48622260600,00000000600,a14,writev
0,48622260900,48622261000,00000000100,a2f,recvmsg
0,48622265900,48622266600,00000000700,a2f,recvmsg
0,48622267400,48622267600,00000000200,a2f,recvmsg
0,48622268000,48622268100,00000000100,a2f,recvmsg
0,48622261700,48622293800,00000032100,a17,select
0,48622302000,48622302500,00000000500,a14,writev
0,48622302700,48622302900,00000000200,a2f,recvmsg
0,48622307800,48622308500,00000000700,a2f,recvmsg
0,48622309300,48622309500,00000000200,a2f,recvmsg
0,48622309800,48622310000,00000000200,a2f,recvmsg
0,48622303600,48622336400,00000032800,a17,select
0,48622344500,48622344900,00000000400,a14,writev
0,48622345200,48622345400,00000000200,a2f,recvmsg
0,48622350200,48622350900,00000000700,a2f,recvmsg
0,48622351700,48622351900,00000000200,a2f,recvmsg
0,48622352100,48622352300,00000000200,a2f,recvmsg
0,48622346100,48622378500,00000032400,a17,select
0,48622386500,48622387000,00000000500,a14,writev
0,48622387400,48622387500,00000000100,a2f,recvmsg
0,48622392300,48622393100,00000000800,a2f,recvmsg
0,48622393900,48622394000,00000000100,a2f,recvmsg
0,48622394400,48622394500,00000000100,a2f,recvmsg
0,48622388200,48622420200,00000032000,a17,select
0,48622428200,48622428700,00000000500,a14,writev
0,48622429000,48622429200,00000000200,a2f,recvmsg
0,48622434100,48622434900,00000000800,a2f,recvmsg
0,48622435700,48622435800,00000000100,a2f,recvmsg
0,48622436100,48622436300,00000000200,a2f,recvmsg
0,48622429900,48622462900,00000033000,a17,select
0,48622471100,48622471600,00000000500,a14,writev
0,48622471900,48622472000,00000000100,a2f,recvmsg
0,48622476900,48622477600,00000000700,a2f,recvmsg
0,48622478400,48622478600,00000000200,a2f,recvmsg
0,48622478900,48622479100,00000000200,a2f,recvmsg
0,48622472700,48622505200,00000032500,a17,select
0,48622513300,48622513700,00000000400,a14,writev
0,48622514000,48622514200,00000000200,a2f,recvmsg
0,48622519100,48622519800,00000000700,a2f,recvmsg
0,48622520600,48622520700,00000000100,a2f,recvmsg
0,48622521100,48622521200,00000000100,a2f,recvmsg
0,48622514900,48622546800,00000031900,a17,select
0,48622554900,48622555400,00000000500,a14,writev
0,48622555600,48622555800,00000000200,a2f,recvmsg
0,48622560700,48622561400,00000000700,a2f,recvmsg
0,48622562200,48622562300,00000000100,a2f,recvmsg
0,48622562700,48622562900,00000000200,a2f,recvmsg
0,48622556500,48622589400,00000032900,a17,select
0,48622597400,48622597900,00000000500,a14,writev
0,48622598200,48622598400,00000000200,a2f,recvmsg
0,48622603200,48622604000,00000000800,a2f,recvmsg
0,48622604800,48622604900,00000000100,a2f,recvmsg
0,48622605200,48622605400,00000000200,a2f,recvmsg
0,48622599100,48622632000,00000032900,a17,select
0,48622640100,48622640600,00000000500,a14,writev
0,48622640900,48622641000,00000000100,a2f,recvmsg
0,48622645800,48622646600,00000000800,a2f,recvmsg
0,48622647300,48622647500,00000000200,a2f,recvmsg
0,48622647800,48622648000,00000000200,a2f,recvmsg
0,48622641700,48622674600,00000032900,a17,select
0,48622682700,48622683200,00000000500,a14,writev
0,48622683500,48622683700,00000000200,a2f,recvmsg
0,48622688400,48622689200,00000000800,a2f,recvmsg
0,48622690000,48622690100,00000000100,a2f,recvmsg
0,48622690400,48622690600,00000000200,a2f,recvmsg
0,48622711200,48622711500,00000000300,a2f,recvmsg
0,48623354700,48623355400,00000000700,a2f,recvmsg
0,48623409200,48623409600,00000000400,a2f,recvmsg
0,48623410600,48623410900,00000000300,a00,read
0,48623410300,48623468300,00000058000,a07,poll
0,48623470800,48623472200,00000001400,aca,futex
0,48623474600,48623475500,00000000900,aca,futex
0,48623477000,48623477900,00000000900,aca,futex
0,48623481500,48623485400,00000003900,a2e,sendmsg
0,48623488200,48623488300,00000000100,a00,read
0,48623497800,48623498200,00000000400,a2f,recvmsg
0,48623499400,48624995000,00001495600,a07,poll
0,48624997000,48624998100,00000001100,a00,read
0,48625002100,48625004300,00000002200,afe,inotify_add_watch
0,48625004800,48625005100,00000000300,afe,inotify_add_watch
0,48625005400,48625005700,00000000300,afe,inotify_add_watch
0,48625007500,48638134300,00013126800,a07,poll
0,48638135800,48638136800,00000001000,a00,read
0,48638160100,48638161100,00000001000,a2f,recvmsg
0,48638164000,48650991900,00012827900,a07,poll
0,48638164000,48650998800,00012834800,a07,poll
0,48622684300,48652561000,00029876700,a17,select
0,48652563300,48652582800,00000019500,a00,read
0,48652576900,48652598400,00000021500,a17,select
0,48606035100,48668198300,00062163200,a4a,fsync
0,48668259600,48668265400,00000005800,a09,mmap
0,48668317000,48668320200,00000003200,a01,write
0,48668359400,48668361300,00000001900,a01,write
0,48668371000,48668371500,00000000500,aca,futex
0,48668510200,48668519100,00000008900,a01,write
0,48668374800,48668547900,00000173100,a07,poll
0,48668603900,48668607000,00000003100,a01,write
0,48668618100,48668619000,00000000900,a2f,recvmsg
0,48668621200,48668621300,00000000100,a00,read
0,48668624800,48668625500,00000000700,aca,futex
0,48668631300,48668640700,00000009400,aca,futex
0,48668644200,48668646800,00000002600,aca,futex
0,48668659400,48668659800,00000000400,aca,futex
0,48668660400,48668660700,00000000300,aca,futex
0,48668676600,48668730700,00000054100,a07,poll
0,48668739600,48668744900,00000005300,a2e,sendmsg
0,48668750200,48668750400,00000000200,a00,read
0,48668758800,48668794900,00000036100,a07,poll
0,48668795700,48668796300,00000000600,a00,read
0,48668806400,48668807900,00000001500,a2f,recvmsg
0,48652611600,48672184200,00019572600,a17,select
0,48672186500,48672205800,00000019300,a00,read
0,48672200000,48672221400,00000021400,a17,select
0,52008339800,52008347500,00000007700,a00,read
0,52008374500,52008508000,00000133500,a4e,getdents
0,52008518400,52008523400,00000005000,a00,read
0,52008537800,52008539900,00000002100,a00,read
0,52008548800,52008550600,00000001800,a00,read
0,52008558700,52008560500,00000001800,a00,read
0,52008568700,52008570400,00000001700,a00,read
0,52008578600,52008580300,00000001700,a00,read
0,52008588500,52008590200,00000001700,a00,read
0,52008598900,52008600500,00000001600,a00,read
0,52008608600,52008610400,00000001800,a00,read
0,52008618200,52008620000,00000001800,a00,read
0,52008627900,52008629800,00000001900,a00,read
0,52008637500,52008639300,00000001800,a00,read
0,52008647200,52008648900,00000001700,a00,read
0,52008657100,52008658800,00000001700,a00,read
0,52008666500,52008668100,00000001600,a00,read
0,52008675800,52008677500,00000001700,a00,read
0,52008685400,52008686900,00000001500,a00,read
0,52008694800,52008696600,00000001800,a00,read
0,52008704600,52008706100,00000001500,a00,read
0,52008714000,52008715600,00000001600,a00,read
0,52008723400,52008724900,00000001500,a00,read
0,52008732600,52008734200,00000001600,a00,read
0,52008742100,52008743800,00000001700,a00,read
0,52008752000,52008753600,00000001600,a00,read
0,52008761600,52008763200,00000001600,a00,read
0,52008771100,52008773000,00000001900,a00,read
0,52008780600,52008782400,00000001800,a00,read
0,52008790400,52008792200,00000001800,a00,read
0,52008800000,52008801900,00000001900,a00,read
0,52008810400,52008812300,00000001900,a00,read
0,52008820400,52008822400,00000002000,a00,read
0,52008830300,52008832200,00000001900,a00,read
0,52008840300,52008842000,00000001700,a00,read
0,52008849700,52008851300,00000001600,a00,read
0,52008860000,52008861600,00000001600,a00,read
0,52008870000,52008871500,00000001500,a00,read
0,52008879400,52008880900,00000001500,a00,read
0,52008888700,52008890200,00000001500,a00,read
0,52008898500,52008900300,00000001800,a00,read
0,52008908600,52008910200,00000001600,a00,read
0,52008918100,52008919600,00000001500,a00,read
0,52008928200,52008929800,00000001600,a00,read
0,52008937800,52008939600,00000001800,a00,read
0,52008947700,52008949400,00000001700,a00,read
0,52008957700,52008959400,00000001700,a00,read
0,52008967800,52008969400,00000001600,a00,read
0,52008977000,52008978900,00000001900,a00,read
0,52008986600,52008988100,00000001500,a00,read
0,52008996000,52008997800,00000001800,a00,read
0,52009005300,52009006800,00000001500,a00,read
0,52009014700,52009016300,00000001600,a00,read
0,52009024600,52009026200,00000001600,a00,read
0,52009034000,52009035600,00000001600,a00,read
0,52009043200,52009044800,00000001600,a00,read
0,52009052800,52009054400,00000001600,a00,read
0,52009062200,52009063900,00000001700,a00,read
0,52009072000,52009073700,00000001700,a00,read
0,52009081400,52009083000,00000001600,a00,read
0,52009090800,52009092500,00000001700,a00,read
0,52009100700,52009102800,00000002100,a00,read
0,52009110500,52009112300,00000001800,a00,read
0,52009120300,52009122100,00000001800,a00,read
0,52009130500,52009132400,00000001900,a00,read
0,52009140400,52009142300,00000001900,a00,read
0,52009150100,52009151900,00000001800,a00,read
0,52009159900,52009161500,00000001600,a00,read
0,52009169600,52009171300,00000001700,a00,read
0,52009179000,52009180900,00000001900,a00,read
0,52009204400,52009206700,00000002300,a00,read
0,52009215200,52009216900,00000001700,a00,read
0,52009224900,52009226500,00000001600,a00,read
0,52009234500,52009236500,00000002000,a00,read
0,52009244200,52009245900,00000001700,a00,read
0,52009254000,52009255600,00000001600,a00,read
0,52009264000,52009265900,00000001900,a00,read
0,52009273900,52009275600,00000001700,a00,read
0,52009283500,52009285400,00000001900,a00,read
0,52009293400,52009295400,00000002000,a00,read
0,52009303400,52009306000,00000002600,a00,read
0,52009315200,52009317500,00000002300,a00,read
0,52009326200,52009328200,00000002000,a00,read
0,52009336600,52009338600,00000002000,a00,read
0,52009346400,52009348300,00000001900,a00,read
0,52009356200,52009358000,00000001800,a00,read
0,52009366600,52009369100,00000002500,a00,read
0,52009378400,52009380500,00000002100,a00,read
0,52009389200,52009392600,00000003400,a00,read
0,52009401800,52009403800,00000002000,a00,read
0,52009412600,52009414900,00000002300,a00,read
0,52009423700,52009425600,00000001900,a00,read
0,52009433900,52009436200,00000002300,a00,read
0,52009444900,52009447000,00000002100,a00,read
0,52009456000,52009458400,00000002400,a00,read
0,52009467200,52009469500,00000002300,a00,read
0,52009478000,52009480200,00000002200,a00,read
0,52009488800,52009490900,00000002100,a00,read
0,52009499400,52009501700,00000002300,a00,read
0,52009510300,52009512300,00000002000,a00,read
0,52009521000,52009523100,00000002100,a00,read
0,52009531900,52009534300,00000002400,a00,read
0,52009543500,52009545400,00000001900,a00,read
0,52009553700,52009556000,00000002300,a00,read
0,52009564400,52009566700,00000002300,a00,read
0,52009575500,52009578000,00000002500,a00,read
0,52009587600,52009590000,00000002400,a00,read
0,52009599100,52009601400,00000002300,a00,read
0,52009610100,52009612400,00000002300,a00,read
0,52009621100,52009623200,00000002100,a00,read
0,52009632000,52009634000,00000002000,a00,read
0,52009642700,52009644700,00000002000,a00,read
0,52009653300,52009655400,00000002100,a00,read
0,52009664100,52009666700,00000002600,a00,read
0,52009676000,52009678300,00000002300,a00,read
0,52009686800,52009688700,00000001900,a00,read
0,52009697700,52009699800,00000002100,a00,read
0,52009708700,52009710900,00000002200,a00,read
0,52009719500,52009721900,00000002400,a00,read
0,52009730600,52009733200,00000002600,a00,read
0,52009741500,52009743500,00000002000,a00,read
0,52009752100,52009754400,00000002300,a00,read
0,52009763200,52009765300,00000002100,a00,read
0,52009774000,52009776100,00000002100,a00,read
0,52009784900,52009787300,00000002400,a00,read
0,52009796400,52009798700,00000002300,a00,read
0,52009807600,52009809700,00000002100,a00,read
0,52009819000,52009821300,00000002300,a00,read
0,52009829800,52009832300,00000002500,a00,read
0,52009841500,52009843900,00000002400,a00,read
0,52009852500,52009855200,00000002700,a00,read
0,52009863700,52009865900,00000002200,a00,read
0,52009874500,52009876600,00000002100,a00,read
0,52009885200,52009887500,00000002300,a00,read
0,52009896600,52009899300,00000002700,a00,read
0,52009908300,52009910600,00000002300,a00,read
0,52009919900,52009922300,00000002400,a00,read
0,52009931300,52009933500,00000002200,a00,read
0,52009942800,52009944900,00000002100,a00,read
0,52009954000,52009956300,00000002300,a00,read
0,52009966200,52009968300,00000002100,a00,read
0,52009977400,52009979400,00000002000,a00,read
0,52009988400,52009991200,00000002800,a00,read
0,52010000900,52010003200,00000002300,a00,read
0,52010012300,52010014200,00000001900,a00,read
0,52010022900,52010025200,00000002300,a00,read
0,52010036000,52010038300,00000002300,a00,read
0,52010047000,52010049000,00000002000,a00,read
0,52010057400,52010059300,00000001900,a00,read
0,52010068100,52010070000,00000001900,a00,read
0,52010078500,52010081000,00000002500,a00,read
0,52010089700,52010091600,00000001900,a00,read
0,52010100000,52010101900,00000001900,a00,read
0,52010110400,52010112600,00000002200,a00,read
0,52010122000,52010124000,00000002000,a00,read
0,52010132700,52010134600,00000001900,a00,read
0,52010143200,52010145400,00000002200,a00,read
0,52010154300,52010156400,00000002100,a00,read
0,52010165000,52010167000,00000002000,a00,read
0,52010175400,52010177300,00000001900,a00,read
0,52010185900,52010187900,00000002000,a00,read
0,52010196600,52010198800,00000002200,a00,read
0,52010207700,52010209800,00000002100,a00,read
0,52010218500,52010220700,00000002200,a00,read
0,52010229500,52010231400,00000001900,a00,read
0,52010239700,52010241300,00000001600,a00,read
0,52010249600,52010251500,00000001900,a00,read
0,52010259700,52010261400,00000001700,a00,read
0,52010269300,52010271300,00000002000,a00,read
0,52010279200,52010280900,00000001700,a00,read
0,52010289400,52010291600,00000002200,a00,read
0,52010300100,52010304700,00000004600,a00,read
0,52010314400,52010316600,00000002200,a00,read
0,52010325300,52010327300,00000002000,a00,read
0,52010335900,52010339200,00000003300,a00,read
0,52010348300,52010350100,00000001800,a00,read
0,52010358100,52010360200,00000002100,a00,read
0,52010368700,52010370700,00000002000,a00,read
0,52010379700,52010382800,00000003100,a00,read
0,52010391800,52010395000,00000003200,a00,read
0,52010403900,52010407600,00000003700,a00,read
0,52010416800,52010418700,00000001900,a00,read
0,52010427400,52010429300,00000001900,a00,read
0,52010437800,52010440700,00000002900,a00,read
0,52010449600,52010452100,00000002500,a00,read
0,52010483000,52010488000,00000005000,a15,access
0,52010496700,52010498700,00000002000,a00,read
0,52010501300,52010501600,00000000300,a00,read
0,52010503200,52010503500,00000000300,a00,read
0,52010505100,52010505300,00000000200,a00,read
0,52010506900,52010507000,00000000100,a00,read
0,52010508700,52010508900,00000000200,a00,read
0,52010510500,52010510700,00000000200,a00,read
0,52010512200,52010512500,00000000300,a00,read
0,52010514000,52010514200,00000000200,a00,read
0,52010515700,52010516000,00000000300,a00,read
0,52010517500,52010518200,00000000700,a00,read
0,52010519800,52010520100,00000000300,a00,read
0,52010547000,52010567300,00000020300,a00,read
0,48672234700,52010706300,03338471600,a17,select
0,52010725200,52010740200,00000015000,a01,write
0,52010741100,52010749000,00000007900,a17,select
0,52010756600,52010761900,00000005300,a17,select
0,52010762900,52010763300,00000000400,a00,read
0,52010768600,52010769100,00000000500,a01,write
0,52010769500,52010773300,00000003800,a17,select
0,52010778200,52010783400,00000005200,a17,select
0,52010784400,52010785200,00000000800,a00,read
0,52010789900,52010790300,00000000400,a01,write
0,52010790700,52010794500,00000003800,a17,select
0,52010799100,52010803400,00000004300,a17,select
0,52010804300,52010804700,00000000400,a00,read
0,52010808600,52010809000,00000000400,a01,write
0,52010809300,52010812900,00000003600,a17,select
0,52010817500,52010821800,00000004300,a17,select
0,52010822900,52010823300,00000000400,a00,read
0,52010827000,52010830200,00000003200,a01,write
0,52010830700,52010834600,00000003900,a17,select
0,52010839500,52010842800,00000003300,a17,select
0,52010847400,52010850700,00000003300,a17,select
0,52010863200,52010866500,00000003300,a17,select
0,52010871000,52010874500,00000003500,a17,select
0,52010878600,52010879000,00000000400,a01,write
0,52010879400,52010882400,00000003000,a17,select
0,52010887000,52010890100,00000003100,a17,select
0,52010894600,52010897600,00000003000,a17,select
0,52010902100,52010905400,00000003300,a17,select
0,52010910400,52010913600,00000003200,a17,select
0,52010918000,52010921000,00000003000,a17,select
0,52010925300,52010928300,00000003000,a17,select
0,52010932600,52010935600,00000003000,a17,select
0,52010940000,52010943000,00000003000,a17,select
0,52010947400,52010950300,00000002900,a17,select
0,52010954800,52010957800,00000003000,a17,select
0,52010962200,52010965000,00000002800,a17,select
0,52010969400,52010972300,00000002900,a17,select
0,52010976600,52010979600,00000003000,a17,select
0,52010983900,52010986800,00000002900,a17,select
0,52010990600,52010993200,00000002600,a01,write
0,52010991300,52010994900,00000003600,a17,select
0,52010999300,52036726300,00025727000,a17,select
0,52036728700,52036747300,00000018600,a00,read
0,52036787200,52036789300,00000002100,a04,stat
0,52036790100,52036790900,00000000800,a04,stat
0,52036791300,52036792100,00000000800,a04,stat
0,52036794500,52036794800,00000000300,a6b,geteuid
0,52036794800,52036794900,00000000100,a6c,getegid
0,52036795000,52036795200,00000000200,a66,getuid
0,52036795300,52036795300,00000000000,a68,getgid
0,52036797800,52036797900,00000000100,a6b,geteuid
0,52036797900,52036798000,00000000100,a6c,getegid
0,52036798000,52036798100,00000000100,a66,getuid
0,52036798100,52036798200,00000000100,a68,getgid
0,52036797800,52036799800,00000002000,a6b,geteuid
0,52036799900,52036799900,00000000000,a6c,getegid
0,52036800000,52036800000,00000000000,a66,getuid
0,52036798100,52036800100,00000002000,a68,getgid
0,52036801700,52036801800,00000000100,a6b,geteuid
0,52036800000,52036801900,00000001900,a66,getuid
0,52036801800,52036801900,00000000100,a6c,getegid
0,52036802000,52036802000,00000000000,a68,getgid
0,52036810400,52036881700,00000071300,a38,clone
0,52037167800,52037167900,00000000100,a0c,brk
0,52037177500,52037179300,00000001800,a15,access
0,52037179900,52037180900,00000001000,a09,mmap
0,52037184900,52037185700,00000000800,a15,access
0,52037192400,52037193400,00000001000,a09,mmap
0,52037197200,52037197700,00000000500,a15,access
0,52037202100,52037203200,00000001100,a00,read
0,52037204600,52037205300,00000000700,a09,mmap
0,52037208600,52037211100,00000002500,a09,mmap
0,52037213200,52037214300,00000001100,a09,mmap
0,52037221100,52037221800,00000000700,a15,access
0,52037225200,52037225600,00000000400,a00,read
0,52037226300,52037227800,00000001500,a09,mmap
0,52037240300,52037240900,00000000600,a15,access
0,52037244900,52037245400,00000000500,a00,read
0,52037245900,52037246700,00000000800,a09,mmap
0,52037247900,52037249600,00000001700,a09,mmap
0,52037253600,52037256100,00000002500,a09,mmap
0,52037261800,52037262400,00000000600,a15,access
0,52037264900,52037265600,00000000700,a00,read
0,52037266600,52037268300,00000001700,a09,mmap
0,52037273000,52037276000,00000003000,a09,mmap
0,52037278000,52037278900,00000000900,a09,mmap
0,52037287600,52037288300,00000000700,a15,access
0,52037290700,52037291300,00000000600,a00,read
0,52037292100,52037294300,00000002200,a09,mmap
0,52037294400,52037299000,00000004600,a09,mmap
0,52037300800,52037302400,00000001600,a09,mmap
0,52037311200,52037312000,00000000800,a15,access
0,52037313900,52037314500,00000000600,a00,read
0,52037315000,52037315800,00000000800,a09,mmap
0,52037317000,52037318800,00000001800,a09,mmap
0,52037322700,52037325300,00000002600,a09,mmap
0,52037327200,52037328100,00000000900,a09,mmap
0,52037334600,52037335100,00000000500,a15,access
0,52037337400,52037338000,00000000600,a00,read
0,52037338700,52037340700,00000002000,a09,mmap
0,52037344500,52037346500,00000002000,a09,mmap
0,52037353600,52037354000,00000000400,a15,access
0,52037356500,52037357400,00000000900,a00,read
0,52037358000,52037359700,00000001700,a09,mmap
0,52037362600,52037364700,00000002100,a09,mmap
0,52037372900,52037373300,00000000400,a15,access
0,52037375700,52037376500,00000000800,a00,read
0,52037376800,52037377700,00000000900,a09,mmap
0,52037379100,52037380600,00000001500,a09,mmap
0,52037384100,52037386500,00000002400,a09,mmap
0,52037388300,52037389300,00000001000,a09,mmap
0,52037396900,52037397400,00000000500,a15,access
0,52037399500,52037400200,00000000700,a00,read
0,52037400900,52037402400,00000001500,a09,mmap
0,52037405700,52037408400,00000002700,a09,mmap
0,52037410400,52037411200,00000000800,a09,mmap
0,52037418800,52037419800,00000001000,a15,access
0,52037422100,52037422600,00000000500,a00,read
0,52037423300,52037425000,00000001700,a09,mmap
0,52037428900,52037430200,00000001300,a09,mmap
0,52037440100,52037440800,00000000700,a15,access
0,52037441700,52037442400,00000000700,a09,mmap
0,52037445300,52037445900,00000000600,a00,read
0,52037446600,52037448600,00000002000,a09,mmap
0,52037453300,52037454700,00000001400,a09,mmap
0,52037476700,52037477200,00000000500,a09,mmap
0,52037486000,52037486500,00000000500,a09,mmap
0,52037717200,52037717600,00000000400,ada,set_tid_address
0,52037770900,52037771000,00000000100,a0c,brk
0,52037771100,52037772000,00000000900,a0c,brk
0,52037787000,52037794700,00000007700,a89,statfs
0,52037795800,52037796300,00000000500,a89,statfs
0,52037811200,52037821400,00000010200,a00,read
0,52037874200,52037880100,00000005900,a00,read
0,52037918100,52037920700,00000002600,a09,mmap
0,52037958900,52037960100,00000001200,a00,read
0,52038000700,52038002000,00000001300,a02,open
0,52038002100,52038003300,00000001200,a02,open
0,52038003400,52038004500,00000001100,a02,open
0,52038004600,52038005600,00000001000,a02,open
0,52038005700,52038006700,00000001000,a02,open
0,52038006800,52038008400,00000001600,a02,open
0,52038008500,52038009600,00000001100,a02,open
0,52038009700,52038010400,00000000700,a02,open
0,52038010500,52038012000,00000001500,a02,open
0,52038012100,52038013800,00000001700,a02,open
0,52038013900,52038014900,00000001000,a02,open
0,52038015000,52038016300,00000001300,a02,open
0,52038115000,52038116100,00000001100,a09,mmap
0,52038119300,52038120300,00000001000,a15,access
0,52038121500,52038122600,00000001100,a02,open
0,52038122800,52038123300,00000000500,a04,stat
0,52038123400,52038123900,00000000500,a02,open
0,52038124000,52038124300,00000000300,a04,stat
0,52038124400,52038125200,00000000800,a02,open
0,52038125300,52038125500,00000000200,a04,stat
0,52038125600,52038126400,00000000800,a02,open
0,52038127300,52038128300,00000001000,a02,open
0,52038128400,52038128800,00000000400,a04,stat
0,52038128900,52038129400,00000000500,a02,open
0,52038129500,52038129800,00000000300,a04,stat
0,52038129900,52038131100,00000001200,a02,open
0,52038131100,52038131500,00000000400,a04,stat
0,52038131600,52038132500,00000000900,a02,open
0,52038133200,52038134100,00000000900,a02,open
0,52038134200,52038134400,00000000200,a04,stat
0,52038134500,52038135000,00000000500,a02,open
0,52038135100,52038135300,00000000200,a04,stat
0,52038135400,52038136100,00000000700,a02,open
0,52038136200,52038136400,00000000200,a04,stat
0,52038136500,52038137100,00000000600,a02,open
0,52038137800,52038138600,00000000800,a02,open
0,52038138700,52038138900,00000000200,a04,stat
0,52038139000,52038139600,00000000600,a02,open
0,52038139700,52038140000,00000000300,a04,stat
0,52038140100,52038140700,00000000600,a02,open
0,52038140800,52038141100,00000000300,a04,stat
0,52038141300,52038142000,00000000700,a02,open
0,52038151700,52038152100,00000000400,a09,mmap
0,52038154200,52038154800,00000000600,a15,access
0,52038163800,52038165400,00000001600,a00,read
0,52038167600,52038169200,00000001600,a09,mmap
0,52038200600,52038213400,00000012800,a00,read
0,52038225700,52038228400,00000002700,a4e,getdents
0,52038236600,52038243100,00000006500,a00,read
0,52038261200,52038264900,00000003700,a4e,getdents
0,52038269800,52038279300,00000009500,a00,read
0,52038308300,52038309500,00000001200,a02,open
0,52038309800,52038316500,00000006700,a02,open
0,52038317300,52038317400,00000000100,a66,getuid
0,52038339200,52038340100,00000000900,a04,stat
0,52038345500,52038346400,00000000900,a15,access
0,52038352500,52038353500,00000001000,a00,read
0,52038443200,52038446100,00000002900,a00,read
0,52038463200,52038465100,00000001900,a09,mmap
0,52038466300,52038466600,00000000300,a09,mmap
0,52038469200,52038631300,00000162100,a4e,getdents
0,52038641900,52038646900,00000005000,a00,read
0,52038667300,52038675400,00000008100,a2a,connect
0,52038678800,52038680400,00000001600,a2a,connect
0,52038690500,52038691600,00000001100,a00,read
0,52038703000,52038704700,00000001700,a09,mmap
0,52038707300,52038708200,00000000900,a15,access
0,52038711400,52038712200,00000000800,a00,read
0,52038714100,52038716800,00000002700,a09,mmap
0,52038721000,52038724500,00000003500,a09,mmap
0,52038735000,52038736000,00000001000,a15,access
0,52038738400,52038739100,00000000700,a00,read
0,52038740200,52038742000,00000001800,a09,mmap
0,52038745100,52038748300,00000003200,a09,mmap
0,52038750500,52038752300,00000001800,a09,mmap
0,52038788500,52038789300,00000000800,a09,mmap
0,52038791500,52038792200,00000000700,a15,access
0,52038795000,52038795600,00000000600,a00,read
0,52038796800,52038799100,00000002300,a09,mmap
0,52038802900,52038805300,00000002400,a09,mmap
0,52038815300,52038816000,00000000700,a15,access
0,52038818600,52038819100,00000000500,a00,read
0,52038820100,52038822100,00000002000,a09,mmap
0,52038825500,52038828100,00000002600,a09,mmap
0,52038829800,52038831000,00000001200,a09,mmap
0,52038866400,52038867400,00000001000,a09,mmap
0,52038867400,52038867600,00000000200,a08,lseek
0,52038880500,52038883900,00000003400,a00,read
0,52038896100,52038898300,00000002200,a00,read
0,52038906900,52038908800,00000001900,a00,read
0,52038917400,52038919200,00000001800,a00,read
0,52038928000,52038929900,00000001900,a00,read
0,52038939000,52038940900,00000001900,a00,read
0,52038949500,52038951500,00000002000,a00,read
0,52038959800,52038961700,00000001900,a00,read
0,52038969700,52038971300,00000001600,a00,read
0,52038980800,52038982900,00000002100,a00,read
0,52038990900,52038992700,00000001800,a00,read
0,52039001300,52039003200,00000001900,a00,read
0,52039011400,52039013100,00000001700,a00,read
0,52039019200,52039020500,00000001300,a0c,brk
0,52039024200,52039026100,00000001900,a00,read
0,52039034200,52039035900,00000001700,a00,read
0,52039044300,52039046300,00000002000,a00,read
0,52039054300,52039055900,00000001600,a00,read
0,52039064000,52039065600,00000001600,a00,read
0,52039074600,52039076500,00000001900,a00,read
0,52039084500,52039086400,00000001900,a00,read
0,52039094300,52039095800,00000001500,a00,read
0,52039104100,52039105700,00000001600,a00,read
0,52039114800,52039116700,00000001900,a00,read
0,52039124800,52039126700,00000001900,a00,read
0,52039134800,52039136600,00000001800,a00,read
0,52039144100,52039146100,00000002000,a00,read
0,52039155800,52039157600,00000001800,a00,read
0,52039165700,52039167600,00000001900,a00,read
0,52039176000,52039178000,00000002000,a00,read
0,52039186000,52039188000,00000002000,a00,read
0,52039197100,52039198900,00000001800,a00,read
0,52039207600,52039209500,00000001900,a00,read
0,52039217400,52039219100,00000001700,a00,read
0,52039227400,52039229000,00000001600,a00,read
0,52039238200,52039240300,00000002100,a00,read
0,52039248600,52039250300,00000001700,a00,read
0,52039258500,52039260200,00000001700,a00,read
0,52039268300,52039270000,00000001700,a00,read
0,52039279400,52039281300,00000001900,a00,read
0,52039289300,52039291000,00000001700,a00,read
0,52039299000,52039300800,00000001800,a00,read
0,52039308600,52039310600,00000002000,a00,read
0,52039319600,52039321400,00000001800,a00,read
0,52039329700,52039331700,00000002000,a00,read
0,52039340300,52039342300,00000002000,a00,read
0,52039350500,52039352300,00000001800,a00,read
0,52039360500,52039362100,00000001600,a00,read
0,52039371400,52039373400,00000002000,a00,read
0,52039382000,52039384000,00000002000,a00,read
0,52039392100,52039393800,00000001700,a00,read
0,52039401600,52039403100,00000001500,a00,read
0,52039412200,52039414100,00000001900,a00,read
0,52039422100,52039423700,00000001600,a00,read
0,52039426800,52039428200,00000001400,a02,open
0,52039432400,52039434200,00000001800,a00,read
0,52039442200,52039444100,00000001900,a00,read
0,52039454400,52039456400,00000002000,a00,read
0,52039464400,52039466600,00000002200,a00,read
0,52039474800,52039476700,00000001900,a00,read
0,52039485400,52039487500,00000002100,a00,read
0,52039496600,52039498400,00000001800,a00,read
0,52039506700,52039508600,00000001900,a00,read
0,52039516500,52039518200,00000001700,a00,read
0,52039526100,52039527700,00000001600,a00,read
0,52039537100,52039539000,00000001900,a00,read
0,52039547000,52039548600,00000001600,a00,read
0,52039557100,52039558700,00000001600,a00,read
0,52039566600,52039568400,00000001800,a00,read
0,52039578100,52039580000,00000001900,a00,read
0,52039588000,52039589800,00000001800,a00,read
0,52039597900,52039599900,00000002000,a00,read
0,52039608600,52039610300,00000001700,a00,read
0,52039618400,52039620500,00000002100,a00,read
0,52039629800,52039631900,00000002100,a00,read
0,52039639900,52039641700,00000001800,a00,read
0,52039649600,52039651500,00000001900,a00,read
0,52039659700,52039661500,00000001800,a00,read
0,52039671500,52039673500,00000002000,a00,read
0,52039682300,52039685300,00000003000,a00,read
0,52039694800,52039697100,00000002300,a00,read
0,52039707700,52039710000,00000002300,a00,read
0,52039719100,52039721000,00000001900,a00,read
0,52039729400,52039731400,00000002000,a00,read
0,52039739700,52039741500,00000001800,a00,read
0,52039751200,52039753500,00000002300,a00,read
0,52039762900,52039764100,00000001200,a09,mmap
0,52039764100,52039764200,00000000100,a08,lseek
0,52039776300,52039778800,00000002500,a00,read
0,52039787100,52039787600,00000000500,a09,mmap
0,52039787700,52039787800,00000000100,a08,lseek
0,52039798300,52039801700,00000003400,a00,read
0,52039811300,52039813700,00000002400,a00,read
0,52039822600,52039825100,00000002500,a00,read
0,52039835000,52039837200,00000002200,a00,read
0,52039845700,52039848100,00000002400,a00,read
0,52039855900,52039856300,00000000400,a09,mmap
0,52039856400,52039856400,00000000000,a08,lseek
0,52039867100,52039869500,00000002400,a00,read
0,52039878800,52039881400,00000002600,a00,read
0,52039889100,52039889600,00000000500,a09,mmap
0,52039889700,52039889700,00000000000,a08,lseek
0,52039899500,52039902100,00000002600,a00,read
0,52039911800,52039914100,00000002300,a00,read
0,52039923400,52039925600,00000002200,a00,read
0,52039933300,52039933800,00000000500,a09,mmap
0,52039933900,52039934000,00000000100,a08,lseek
0,52039943600,52039946100,00000002500,a00,read
0,52039956500,52039958900,00000002400,a00,read
0,52039968600,52039970700,00000002100,a00,read
0,52039980300,52039983000,00000002700,a00,read
0,52039997400,52039999500,00000002100,a00,read
0,52040008800,52040011100,00000002300,a00,read
0,52040020300,52040022600,00000002300,a00,read
0,52040032300,52040035100,00000002800,a00,read
0,52040044700,52040047000,00000002300,a00,read
0,52040055900,52040058300,00000002400,a00,read
0,52040067300,52040070100,00000002800,a00,read
0,52040078900,52040081200,00000002300,a00,read
0,52040089000,52040089700,00000000700,a09,mmap
0,52040089700,52040089800,00000000100,a08,lseek
0,52040099700,52040102200,00000002500,a00,read
0,52040110900,52040113000,00000002100,a00,read
0,52040123300,52040125600,00000002300,a00,read
0,52040135400,52040137900,00000002500,a00,read
0,52040146900,52040149300,00000002400,a00,read
0,52040159200,52040161100,00000001900,a00,read
0,52040169800,52040172100,00000002300,a00,read
0,52040180900,52040183100,00000002200,a00,read
0,52040191800,52040194200,00000002400,a00,read
0,52040204000,52040206900,00000002900,a00,read
0,52040215700,52040218100,00000002400,a00,read
0,52040226400,52040226900,00000000500,a09,mmap
0,52040227000,52040227000,00000000000,a08,lseek
0,52040235300,52040237900,00000002600,a00,read
0,52040246700,52040249100,00000002400,a00,read
0,52040262200,52040264700,00000002500,a00,read
0,52040273800,52040276200,00000002400,a00,read
0,52040285200,52040287600,00000002400,a00,read
0,52040296500,52040298900,00000002400,a00,read
0,52040308900,52040311400,00000002500,a00,read
0,52040321000,52040323700,00000002700,a00,read
0,52040332500,52040335000,00000002500,a00,read
0,52040343800,52040346400,00000002600,a00,read
0,52040355100,52040357800,00000002700,a00,read
0,52040367400,52040369500,00000002100,a00,read
0,52040378200,52040380600,00000002400,a00,read
0,52040389100,52040391900,00000002800,a00,read
0,52040401200,52040403400,00000002200,a00,read
0,52040412000,52040412800,00000000800,a09,mmap
0,52040412800,52040412900,00000000100,a08,lseek
0,52040426000,52040428900,00000002900,a00,read
0,52040438600,52040441000,00000002400,a00,read
0,52040451400,52040452000,00000000600,a09,mmap
0,52040452000,52040452100,00000000100,a08,lseek
0,52040466600,52040469300,00000002700,a00,read
0,52040479300,52040481600,00000002300,a00,read
0,52040492200,52040494500,00000002300,a00,read
0,52040504100,52040506300,00000002200,a00,read
0,52040515900,52040518800,00000002900,a00,read
0,52040529400,52040531700,00000002300,a00,read
0,52040541700,52040542700,00000001000,a0c,brk
0,52040546600,52040548800,00000002200,a00,read
0,52040558000,52040560400,00000002400,a00,read
0,52040569500,52040571700,00000002200,a00,read
0,52040580600,52040582600,00000002000,a00,read
0,52040591700,52040594000,00000002300,a00,read
0,52040604600,52040606700,00000002100,a00,read
0,52040618300,52040620800,00000002500,a00,read
0,52040630500,52040632700,00000002200,a00,read
0,52040642900,52040645000,00000002100,a00,read
0,52040654400,52040656600,00000002200,a00,read
0,52040664900,52040665700,00000000800,a09,mmap
0,52040665700,52040665700,00000000000,a08,lseek
0,52040679400,52040681700,00000002300,a00,read
0,52040691400,52040693400,00000002000,a00,read
0,52040702500,52040705000,00000002500,a00,read
0,52040715600,52040718100,00000002500,a00,read
0,52040727500,52040729500,00000002000,a00,read
0,52040739400,52040741500,00000002100,a00,read
0,52040750400,52040752500,00000002100,a00,read
0,52040763100,52040765200,00000002100,a00,read
0,52040776600,52040778600,00000002000,a00,read
0,52040788100,52040790500,00000002400,a00,read
0,52040799700,52040801800,00000002100,a00,read
0,52040812000,52040813900,00000001900,a00,read
0,52040822700,52040824600,00000001900,a00,read
0,52040833700,52040835800,00000002100,a00,read
0,52040846100,52040848100,00000002000,a00,read
0,52040857700,52040859500,00000001800,a00,read
0,52040868300,52040870500,00000002200,a00,read
0,52040879700,52040884200,00000004500,a00,read
0,52040893500,52040894200,00000000700,a09,mmap
0,52040894200,52040894300,00000000100,a08,lseek
0,52040908900,52040911400,00000002500,a00,read
0,52040921500,52040923600,00000002100,a00,read
0,52040935400,52040939400,00000004000,a00,read
0,52040951000,52040953300,00000002300,a00,read
0,52040962400,52040964500,00000002100,a00,read
0,52040973500,52040975700,00000002200,a00,read
0,52040985900,52040989200,00000003300,a00,read
0,52040999000,52041002300,00000003300,a00,read
0,52041012000,52041016800,00000004800,a00,read
0,52041027100,52041029100,00000002000,a00,read
0,52041043000,52041045200,00000002200,a00,read
0,52041054300,52041057100,00000002800,a00,read
0,52041066500,52041069400,00000002900,a00,read
0,52036741400,52041108600,00004367200,a17,select
0,48668865700,52061545800,03392680100,a07,poll
0,52061639900,52065083800,00003443900,a07,poll
0,52065090900,52065093000,00000002100,afe,inotify_add_watch
0,52065093700,52065094000,00000000300,afe,inotify_add_watch
0,52065094400,52065094700,00000000300,afe,inotify_add_watch
0,52038108800,52067071900,00028963100,aca,futex
0,52041085700,52091489800,00050404100,a23,nanosleep
0,52091503800,52091513800,00000010000,a00,read
0,52091547800,52091668300,00000120500,a4e,getdents
0,52091677600,52091682000,00000004400,a00,read
0,52091695900,52091697800,00000001900,a00,read
0,52091706900,52091708600,00000001700,a00,read
0,52091716900,52091718900,00000002000,a00,read
0,52091727100,52091728900,00000001800,a00,read
0,52091737100,52091738600,00000001500,a00,read
0,52091746500,52091748100,00000001600,a00,read
0,52091756500,52091758300,00000001800,a00,read
0,52091766400,52091768100,00000001700,a00,read
0,52091776000,52091777500,00000001500,a00,read
0,52091785200,52091787100,00000001900,a00,read
0,52091794700,52091796700,00000002000,a00,read
0,52091804900,52091806700,00000001800,a00,read
0,52091814800,52091816200,00000001400,a00,read
0,52091824100,52091825700,00000001600,a00,read
0,52091833400,52091835200,00000001800,a00,read
0,52091842900,52091844700,00000001800,a00,read
0,52091852500,52091854000,00000001500,a00,read
0,52091861900,52091863300,00000001400,a00,read
0,52091871200,52091872700,00000001500,a00,read
0,52091880400,52091882100,00000001700,a00,read
0,52091889800,52091891400,00000001600,a00,read
0,52091899200,52091900800,00000001600,a00,read
0,52091908700,52091910400,00000001700,a00,read
0,52091918200,52091919700,00000001500,a00,read
0,52091927600,52091929600,00000002000,a00,read
0,52091937200,52091939100,00000001900,a00,read
0,52091947000,52091948600,00000001600,a00,read
0,52091956200,52091958100,00000001900,a00,read
0,52091965900,52091967800,00000001900,a00,read
0,52091975600,52091977400,00000001800,a00,read
0,52091985600,52091987300,00000001700,a00,read
0,52091995100,52091996900,00000001800,a00,read
0,52092004600,52092006300,00000001700,a00,read
0,52092014100,52092015700,00000001600,a00,read
0,52092023300,52092025100,00000001800,a00,read
0,52092032700,52092034100,00000001400,a00,read
0,52092041700,52092043200,00000001500,a00,read
0,52092051000,52092052500,00000001500,a00,read
0,52092060600,52092062400,00000001800,a00,read
0,52092069900,52092071900,00000002000,a00,read
0,52092079700,52092081300,00000001600,a00,read
0,52092089100,52092090800,00000001700,a00,read
0,52092098500,52092100200,00000001700,a00,read
0,52092108100,52092110100,00000002000,a00,read
0,52092117700,52092119400,00000001700,a00,read
0,52092127000,52092128500,00000001500,a00,read
0,52092136200,52092137800,00000001600,a00,read
0,52092145500,52092147300,00000001800,a00,read
0,52092154600,52092156300,00000001700,a00,read
0,52092164100,52092165700,00000001600,a00,read
0,52092173500,52092174900,00000001400,a00,read
0,52092182600,52092184200,00000001600,a00,read
0,52092191800,52092193200,00000001400,a00,read
0,52092200800,52092202300,00000001500,a00,read
0,52092210100,52092212000,00000001900,a00,read
0,52092219700,52092221400,00000001700,a00,read
0,52092229100,52092230600,00000001500,a00,read
0,52092238200,52092239900,00000001700,a00,read
0,52092247900,52092249600,00000001700,a00,read
0,52092257200,52092259000,00000001800,a00,read
0,52092267100,52092268900,00000001800,a00,read
0,52092276700,52092278400,00000001700,a00,read
0,52092286200,52092287700,00000001500,a00,read
0,52092295500,52092297300,00000001800,a00,read
0,52092305000,52092306700,00000001700,a00,read
0,52092314600,52092316400,00000001800,a00,read
0,52092323900,52092325400,00000001500,a00,read
0,52092333500,52092335200,00000001700,a00,read
0,52092343000,52092344700,00000001700,a00,read
0,52092352400,52092354200,00000001800,a00,read
0,52092362100,52092363700,00000001600,a00,read
0,52092371400,52092373000,00000001600,a00,read
0,52092380700,52092382600,00000001900,a00,read
0,52092390400,52092392200,00000001800,a00,read
0,52092399900,52092401700,00000001800,a00,read
0,52092409600,52092411600,00000002000,a00,read
0,52092419500,52092421300,00000001800,a00,read
0,52092429300,52092431900,00000002600,a00,read
0,52092441500,52092443600,00000002100,a00,read
0,52092452300,52092454200,00000001900,a00,read
0,52092462400,52092464100,00000001700,a00,read
0,52092471800,52092473600,00000001800,a00,read
0,52092481400,52092483200,00000001800,a00,read
0,52092491300,52092493900,00000002600,a00,read
0,52092502900,52092505200,00000002300,a00,read
0,52092513600,52092516700,00000003100,a00,read
0,52092526000,52092528100,00000002100,a00,read
0,52092536700,52092539000,00000002300,a00,read
0,52092547600,52092549700,00000002100,a00,read
0,52092557900,52092560200,00000002300,a00,read
0,52092568300,52092570400,00000002100,a00,read
0,52092579100,52092581500,00000002400,a00,read
0,52092590100,52092592400,00000002300,a00,read
0,52092600800,52092603100,00000002300,a00,read
0,52092611800,52092614000,00000002200,a00,read
0,52092622700,52092625000,00000002300,a00,read
0,52092633300,52092635500,00000002200,a00,read
0,52092644000,52092646000,00000002000,a00,read
0,52092654800,52092657100,00000002300,a00,read
0,52092665800,52092667800,00000002000,a00,read
0,52092676300,52092678500,00000002200,a00,read
0,52092687100,52092689300,00000002200,a00,read
0,52092697700,52092700200,00000002500,a00,read
0,52092709400,52092711700,00000002300,a00,read
0,52092720400,52092722800,00000002400,a00,read
0,52092731400,52092733400,00000002000,a00,read
0,52092742200,52092744400,00000002200,a00,read
0,52092752800,52092754700,00000001900,a00,read
0,52092763200,52092765200,00000002000,a00,read
0,52092773400,52092775700,00000002300,a00,read
0,52092784600,52092787000,00000002400,a00,read
0,52092795600,52092797900,00000002300,a00,read
0,52092806900,52092808700,00000001800,a00,read
0,52092817500,52092819600,00000002100,a00,read
0,52092828200,52092830300,00000002100,a00,read
0,52092838600,52092840900,00000002300,a00,read
0,52092849500,52092852100,00000002600,a00,read
0,52092861000,52092862900,00000001900,a00,read
0,52092871700,52092873700,00000002000,a00,read
0,52092882200,52092884500,00000002300,a00,read
0,52092893400,52092895400,00000002000,a00,read
0,52092904200,52092906500,00000002300,a00,read
0,52092915600,52092917600,00000002000,a00,read
0,52092926000,52092928200,00000002200,a00,read
0,52092937300,52092939700,00000002400,a00,read
0,52092948200,52092950400,00000002200,a00,read
0,52092958900,52092961200,00000002300,a00,read
0,52092969700,52092972000,00000002300,a00,read
0,52092980300,52092982600,00000002300,a00,read
0,52092991000,52092993100,00000002100,a00,read
0,52093001600,52093003900,00000002300,a00,read
0,52093012900,52093015500,00000002600,a00,read
0,52093024100,52093026600,00000002500,a00,read
0,52093035700,52093038000,00000002300,a00,read
0,52093046700,52093048800,00000002100,a00,read
0,52093058300,52093060200,00000001900,a00,read
0,52093068800,52093070900,00000002100,a00,read
0,52093079500,52093081700,00000002200,a00,read
0,52093090600,52093092800,00000002200,a00,read
0,52093101000,52093103400,00000002400,a00,read
0,52093112200,52093114200,00000002000,a00,read
0,52093122800,52093124700,00000001900,a00,read
0,52093133000,52093135200,00000002200,a00,read
0,52093143800,52093146000,00000002200,a00,read
0,52093154400,52093156200,00000001800,a00,read
0,52093164400,52093166500,00000002100,a00,read
0,52093175100,52093177000,00000001900,a00,read
0,52093185300,52093187400,00000002100,a00,read
0,52093196400,52093198300,00000001900,a00,read
0,52093206700,52093208500,00000001800,a00,read
0,52093216900,52093218900,00000002000,a00,read
0,52093228000,52093229900,00000001900,a00,read
0,52093238600,52093240600,00000002000,a00,read
0,52093249200,52093251700,00000002500,a00,read
0,52093260100,52093262100,00000002000,a00,read
0,52093270700,52093272500,00000001800,a00,read
0,52093280500,52093282400,00000001900,a00,read
0,52093291200,52093293200,00000002000,a00,read
0,52093301500,52093303300,00000001800,a00,read
0,52093311500,52093313500,00000002000,a00,read
0,52093321700,52093323600,00000001900,a00,read
0,52093332100,52093333800,00000001700,a00,read
0,52093342200,52093343800,00000001600,a00,read
0,52093351900,52093353900,00000002000,a00,read
0,52093362000,52093363600,00000001600,a00,read
0,52093371600,52093373500,00000001900,a00,read
0,52093381200,52093382800,00000001600,a00,read
0,52093390700,52093392800,00000002100,a00,read
0,52093401800,52093406000,00000004200,a00,read
0,52093415600,52093417700,00000002100,a00,read
0,52093426500,52093428400,00000001900,a00,read
0,52093437000,52093440200,00000003200,a00,read
0,52093449400,52093451100,00000001700,a00,read
0,52093459400,52093461400,00000002000,a00,read
0,52093470600,52093472500,00000001900,a00,read
0,52093480900,52093483800,00000002900,a00,read
0,52093492800,52093495800,00000003000,a00,read
0,52093504900,52093508900,00000004000,a00,read
0,52093518600,52093520400,00000001800,a00,read
0,52093529500,52093531400,00000001900,a00,read
0,52093540000,52093542700,00000002700,a00,read
0,52093551700,52093554500,00000002800,a00,read
0,52093582200,52093583700,00000001500,a00,read
0,52093584500,52093584900,00000000400,a08,lseek
0,52093585000,52093585300,00000000300,a00,read
0,52093604600,52093609200,00000004600,a15,access
0,52093618100,52093620900,00000002800,a00,read
0,52093623800,52093624200,00000000400,a00,read
0,52093625800,52093626000,00000000200,a00,read
0,52093627600,52093627800,00000000200,a00,read
0,52093629300,52093629600,00000000300,a00,read
0,52093631100,52093631400,00000000300,a00,read
0,52093632900,52093633200,00000000300,a00,read
0,52093634700,52093634900,00000000200,a00,read
0,52093636400,52093636700,00000000300,a00,read
0,52093638200,52093638400,00000000200,a00,read
0,52093639900,52093640600,00000000700,a00,read
0,52093642200,52093642500,00000000300,a00,read
0,52041147400,52093701700,00052554300,a17,select
0,52093720100,52093734400,00000014300,a01,write
0,52093735200,52093742000,00000006800,a17,select
0,52093748800,52093753900,00000005100,a17,select
0,52093754800,52093755200,00000000400,a00,read
0,52093764300,52093764800,00000000500,a01,write
0,52093764300,52093767300,00000003000,a01,write
0,52093765200,52093769300,00000004100,a17,select
0,52093795300,52093816000,00000020700,a00,read
0,52093816600,52093816800,00000000200,a00,read
0,52093774200,52093938800,00000164600,a17,select
0,52093940300,52093941100,00000000800,a00,read
0,52093947700,52093949300,00000001600,a01,write
0,52093949900,52093953800,00000003900,a17,select
0,52093958700,52093962700,00000004000,a17,select
0,52093963600,52093963900,00000000300,a00,read
0,52093967700,52093968100,00000000400,a01,write
0,52093968400,52093971600,00000003200,a17,select
0,52093976100,52093980000,00000003900,a17,select
0,52093980900,52093981300,00000000400,a00,read
0,52093984900,52093985200,00000000300,a01,write
0,52093985500,52093988500,00000003000,a17,select
0,52093993000,52093996000,00000003000,a17,select
0,52094000500,52094003300,00000002800,a17,select
0,52094007700,52094011000,00000003300,a17,select
0,52094015200,52094015500,00000000300,a01,write
0,52094015800,52094018700,00000002900,a17,select
0,52094023200,52094026700,00000003500,a17,select
0,52094031000,52094035100,00000004100,a01,write
0,52094035600,52094039000,00000003400,a17,select
0,52094043900,52094047200,00000003300,a17,select
0,52094051400,52094051800,00000000400,a01,write
0,52094052100,52094055100,00000003000,a17,select
0,52094059500,52094062700,00000003200,a17,select
0,52094069700,52094070900,00000001200,a01,write
0,52094071200,52094074400,00000003200,a17,select
0,52094080700,52094084200,00000003500,a17,select
0,52094088300,52094088600,00000000300,a01,write
0,52094089100,52094091900,00000002800,a17,select
0,52094096400,52094099800,00000003400,a17,select
0,52094104000,52094104300,00000000300,a01,write
0,52094104700,52094107600,00000002900,a17,select
0,52094112000,52094115200,00000003200,a17,select
0,52094119800,52094120100,00000000300,a01,write
0,52094120400,52094123500,00000003100,a17,select
0,52094127900,52094131100,00000003200,a17,select
0,52094135300,52094135500,00000000200,a01,write
0,52094135900,52094138800,00000002900,a17,select
0,52094143100,52094146500,00000003400,a17,select
0,52094150700,52094151000,00000000300,a01,write
0,52094151400,52094154400,00000003000,a17,select
0,52094158700,52094162100,00000003400,a17,select
0,52094166200,52094166500,00000000300,a01,write
0,52094166900,52094169700,00000002800,a17,select
0,52094174100,52094177300,00000003200,a17,select
0,52094181400,52094184400,00000003000,a01,write
0,52094184900,52094188100,00000003200,a17,select
0,52094192100,52094194600,00000002500,a01,write
0,52094192800,52094196300,00000003500,a17,select
0,52094201400,52094257400,00000056000,a17,select
0,52094264400,52094267500,00000003100,a17,select
0,52094272100,52094275300,00000003200,a17,select
0,52094279600,52094279900,00000000300,a01,write
0,52094280300,52094283200,00000002900,a17,select
0,52094287500,52094290900,00000003400,a17,select
0,52094295100,52094295400,00000000300,a01,write
0,52094295800,52094298800,00000003000,a17,select
0,52094304800,52094308200,00000003400,a17,select
0,52094312300,52094312600,00000000300,a01,write
0,52094313000,52094316000,00000003000,a17,select
0,52094320300,52094323600,00000003300,a17,select
0,52094327700,52094328000,00000000300,a01,write
0,52094328400,52094331400,00000003000,a17,select
0,52094335800,52094338900,00000003100,a17,select
0,52094343300,52094343600,00000000300,a01,write
0,52094344000,52094346900,00000002900,a17,select
0,52094350600,52094353200,00000002600,a01,write
0,52094351300,52094354900,00000003600,a17,select
0,52094359000,52094359400,00000000400,a01,write
0,55646016100,55646019600,00000003500,a07,poll
0,55646024800,55646026900,00000002100,a2e,sendmsg
0,55646029800,55646029900,00000000100,a00,read
0,55646053100,55646053200,00000000100,a0c,brk
0,55646067700,55646070600,00000002900,a15,access
0,55646071400,55646073200,00000001800,a09,mmap
0,55646075100,55646075900,00000000800,a15,access
0,55646082000,55646083700,00000001700,a09,mmap
0,55646088000,55646088700,00000000700,a15,access
0,55646093200,55646094600,00000001400,a00,read
0,55646096400,55646098900,00000002500,a09,mmap
0,55646112900,55646114400,00000001500,a09,mmap
0,55646122700,55646123300,00000000600,a15,access
0,55646126200,55646126900,00000000700,a00,read
0,55646127800,55646130100,00000002300,a09,mmap
0,55646145400,55646146300,00000000900,a15,access
0,55646148800,55646149700,00000000900,a00,read
0,55646150200,55646151000,00000000800,a09,mmap
0,55646152800,55646154900,00000002100,a09,mmap
0,55646159200,55646162400,00000003200,a09,mmap
0,55646164400,55646165500,00000001100,a09,mmap
0,55646172400,55646173100,00000000700,a15,access
0,55646177900,55646178600,00000000700,a00,read
0,55646179500,55646181500,00000002000,a09,mmap
0,55646186200,55646189000,00000002800,a09,mmap
0,55646191300,55646192400,00000001100,a09,mmap
0,55646203600,55646204600,00000001000,a15,access
0,55646207100,55646207900,00000000800,a00,read
0,55646208600,55646210500,00000001900,a09,mmap
0,55646215600,55646217200,00000001600,a09,mmap
0,55646226700,55646227300,00000000600,a15,access
0,55646230400,55646231000,00000000600,a00,read
0,55646231400,55646232600,00000001200,a09,mmap
0,55646239000,55646241400,00000002400,a09,mmap
0,55646269300,55646269600,00000000300,a09,mmap
0,55646456300,55646456800,00000000500,ada,set_tid_address
0,55646489600,55646498000,00000008400,a89,statfs
0,55646498800,55646499400,00000000600,a89,statfs
0,55646529800,55646530000,00000000200,a0c,brk
0,55646530100,55646531300,00000001200,a0c,brk
0,55646543800,55646555100,00000011300,a00,read
0,55646584700,55646591100,00000006400,a00,read
0,55646593000,55646594300,00000001300,a03,close
0,55646033100,55646597800,00000564700,a07,poll
0,55646616600,55646616700,00000000100,a00,read
0,55646644600,55646647900,00000003300,a15,access
0,55646648600,55646651300,00000002700,a02,open
0,55646663200,55646668500,00000005300,a00,read
0,55646679800,55646680700,00000000900,a15,access
0,55646683700,55646683900,00000000200,a10,ioctl
0,55646692400,55646696500,00000004100,a2a,connect
0,55646625400,55646698500,00000073100,a07,poll
0,55646704000,55646705800,00000001800,a2e,sendmsg
0,55646721800,55646726200,00000004400,a02,open
0,55646726800,55646750500,00000023700,60e,page_fault
0,48621575200,55646780300,07025205100,ae8,epoll_wait
0,55646802000,55646802400,00000000400,a48,fcntl
0,55646808000,55646808700,00000000700,a2f,recvmsg
0,55646713200,55647620600,00000907400,a07,poll
0,55646713200,55647627900,00000914700,a07,poll
0,55647683000,55647684400,00000001400,a2f,recvmsg
0,55647728700,55647730000,00000001300,a2e,sendmsg
0,55647736000,55647736800,00000000800,a2e,sendmsg
0,55647632000,55647747000,00000115000,a07,poll
0,55647832100,55647832300,00000000200,a00,read
0,55647863300,55647866200,00000002900,a07,poll
0,55647874700,55647878700,00000004000,a07,poll
0,55647878800,55647885900,00000007100,a2e,sendmsg
0,55647891200,55647891400,00000000200,a00,read
0,55647951300,55647954600,00000003300,a07,poll
0,55647960300,55647962300,00000002000,a2e,sendmsg
0,55647964800,55647965000,00000000200,a00,read
0,55647967900,55647971200,00000003300,a07,poll
0,55647972500,55647972700,00000000200,a00,read
0,55647742100,55648047200,00000305100,ae8,epoll_wait
0,55648055100,55648057900,00000002800,a2f,recvmsg
0,55648098900,55648112600,00000013700,a00,read
0,55648149700,55648164300,00000014600,a00,read
0,55648181300,55648189100,00000007800,a00,read
0,55648042900,55648190300,00000147400,a07,poll
0,55648192200,55648193300,00000001100,a00,read
0,55648210600,55648212300,00000001700,a2f,recvmsg
0,52094359700,55648243300,03553883600,a17,select
0,55648265600,55648273300,00000007700,aca,futex
0,55648302300,55648307800,00000005500,a07,poll
0,55648309600,55648310000,00000000400,a00,read
0,55648302300,55648313500,00000011200,a07,poll
0,55648325400,55648326700,00000001300,a2f,recvmsg
0,55648326800,55648328100,00000001300,a2f,recvmsg
0,55648391100,55648391300,00000000200,a00,read
0,55648423800,55648424600,00000000800,a07,poll
0,55648423800,55648426000,00000002200,a07,poll
0,55648464800,55648465100,00000000300,a48,fcntl
0,55648423800,55648481900,00000058100,a07,poll
0,55648484300,55648485700,00000001400,aca,futex
0,55648485900,55648488500,00000002600,a00,read
0,55648488300,55648489300,00000001000,aca,futex
0,55648492400,55648493400,00000001000,aca,futex
0,55648496600,55648499600,00000003000,a2e,sendmsg
0,55648502300,55648502500,00000000200,a00,read
0,55648509600,55648514700,00000005100,a07,poll
0,55648516200,55648516800,00000000600,a00,read
0,55648532500,55648534100,00000001600,a2f,recvmsg
0,55648547700,55648591400,00000043700,a07,poll
0,55648593300,55648594500,00000001200,aca,futex
0,55648606400,55648608000,00000001600,aca,futex
0,55648645400,55648657600,00000012200,aca,futex
0,55648653400,55648668000,00000014600,a07,poll
0,55648748100,55648752400,00000004300,a2e,sendmsg
0,55648754700,55648754900,00000000200,a00,read
0,55648759800,55648764800,00000005000,a07,poll
0,55648766400,55648766800,00000000400,a00,read
0,55648782000,55648783400,00000001400,a2f,recvmsg
0,55648797400,55648841600,00000044200,a07,poll
0,55648854900,55648856000,00000001100,aca,futex
0,55648874000,55648875300,00000001300,aca,futex
0,55648959500,55648963400,00000003900,a2e,sendmsg
0,55648965500,55648965600,00000000100,a00,read
0,55648970000,55648974900,00000004900,a07,poll
0,55648976700,55648977300,00000000600,a00,read
0,55648991600,55648993100,00000001500,a2f,recvmsg
0,55649035600,55649044300,00000008700,a07,poll
0,55649049700,55649052800,00000003100,a2e,sendmsg
0,55649060300,55649060500,00000000200,a00,read
0,55649062200,55649063000,00000000800,a2e,sendmsg
0,55649062200,55649065800,00000003600,a07,poll
0,55649074500,55649075500,00000001000,a2e,sendmsg
0,55649084300,55649085300,00000001000,a2e,sendmsg
0,55649093900,55649094900,00000001000,a2e,sendmsg
0,55649103000,55649104400,00000001400,a2e,sendmsg
0,55649113700,55649114500,00000000800,a2e,sendmsg
0,55649111900,55649120700,00000008800,a07,poll
0,55649122400,55649123500,00000001100,aca,futex
0,55649123700,55649124600,00000000900,a2e,sendmsg
0,55649125800,55649126700,00000000900,aca,futex
0,55649130000,55649130900,00000000900,aca,futex
0,55649132200,55649132700,00000000500,a2e,sendmsg
0,55649134400,55649138000,00000003600,a2e,sendmsg
0,55649140300,55649141400,00000001100,a2e,sendmsg
0,55649141300,55649141600,00000000300,a00,read
0,55649148400,55649149700,00000001300,a2e,sendmsg
0,55649148500,55649154500,00000006000,a07,poll
0,55649165000,55649166500,00000001500,a2e,sendmsg
0,55649170700,55649170800,00000000100,a00,read
0,55649033600,55649182800,00000149200,ae8,epoll_wait
0,55649180200,55649183600,00000003400,a07,poll
0,55649195400,55649197100,00000001700,a2f,recvmsg
0,55649211000,55649211900,00000000900,a2e,sendmsg
0,55649214800,55649225800,00000011000,a07,poll
0,55649236600,55649238400,00000001800,a2e,sendmsg
0,55649213200,55649239700,00000026500,ae8,epoll_wait
0,55649250600,55649251700,00000001100,a2e,sendmsg
0,55649253500,55649254200,00000000700,a2e,sendmsg
0,55649258600,55649259100,00000000500,a2f,recvmsg
0,55649245600,55649278100,00000032500,a07,poll
0,55649279800,55649280900,00000001100,aca,futex
0,55649299600,55649300900,00000001300,aca,futex
0,55649307400,55649310700,00000003300,a4e,getdents
0,55649327000,55649329800,00000002800,a2e,sendmsg
0,55649333500,55649346400,00000012900,ae8,epoll_wait
0,55649349100,55649349500,00000000400,a2f,recvmsg
0,55649349500,55649351300,00000001800,a2e,sendmsg
0,55649353300,55649353500,00000000200,a00,read
0,55649358100,55649500300,00000142200,a07,poll
0,55649513500,55649515200,00000001700,a2f,recvmsg
0,55649527200,55649577400,00000050200,a07,poll
0,55649580200,55649581700,00000001500,aca,futex
0,55649593200,55649594200,00000001000,aca,futex
0,55649676300,55649680500,00000004200,a2e,sendmsg
0,55649682700,55649683000,00000000300,a00,read
0,55649688000,55649688500,00000000500,a07,poll
0,55649688000,55649691600,00000003600,a07,poll
0,55649703600,55649704900,00000001300,a2f,recvmsg
0,55649708700,55649708900,00000000200,a00,read
0,55649711000,55649711800,00000000800,a2e,sendmsg
0,55649765100,55649768800,00000003700,a07,poll
0,55649781800,55649782800,00000001000,a2f,recvmsg
0,55649594500,55649865000,00000270500,aca,futex
0,55649684000,55649882800,00000198800,ae8,epoll_wait
0,55649891600,55649892700,00000001100,a2f,recvmsg
0,55649925100,55649927100,00000002000,a2e,sendmsg
0,55649933400,55649934000,00000000600,a2f,recvmsg
0,55649934500,55649938300,00000003800,a2e,sendmsg
0,55649944900,55649945500,00000000600,a00,read
0,55649947500,55649948300,00000000800,a2e,sendmsg
0,55649947700,55649948700,00000001000,a2f,recvmsg
0,55649952100,55649953300,00000001200,a2e,sendmsg
0,55649956800,55649958300,00000001500,a07,poll
0,55649969400,55649970400,00000001000,a2f,recvmsg
0,55649989600,55649990600,00000001000,a2e,sendmsg
0,55649995700,55649996400,00000000700,a2f,recvmsg
0,55649999100,55649999700,00000000600,a2e,sendmsg
0,55650031100,55650031900,00000000800,a2e,sendmsg
0,55650036700,55650037200,00000000500,a2f,recvmsg
0,55650050900,55650051900,00000001000,a2f,recvmsg
0,55650054300,55650054500,00000000200,a00,read
0,55650070100,55650070700,00000000600,a2f,recvmsg
0,55650097200,55650097800,00000000600,a2f,recvmsg
0,55650100500,55650101300,00000000800,a2f,recvmsg
0,55649867700,55650132800,00000265100,aca,futex
0,55650143500,55650144200,00000000700,a2f,recvmsg
0,55650184800,55650185600,00000000800,a2f,recvmsg
0,55650187400,55650196200,00000008800,a07,poll
0,55650224300,55650225000,00000000700,a2f,recvmsg
0,55650261800,55650262500,00000000700,a2f,recvmsg
0,55650275700,55650279900,00000004200,a07,poll
0,55650285100,55650287600,00000002500,a2e,sendmsg
0,55650290200,55650290500,00000000300,a00,read
0,55650301400,55650302000,00000000600,a2f,recvmsg
0,55650341600,55650342300,00000000700,a2f,recvmsg
0,55650379600,55650380400,00000000800,a2f,recvmsg
0,55650418700,55650419200,00000000500,a2f,recvmsg
0,55650462700,55650466500,00000003800,a07,poll
0,55650462700,55650482300,00000019600,a07,poll
0,55650483600,55650484700,00000001100,a00,read
0,55650491000,55650494200,00000003200,a07,poll
0,55650496900,55650498600,00000001700,a2f,recvmsg
0,55650562700,55650565200,00000002500,a07,poll
0,55650566300,55650566600,00000000300,a00,read
0,55650569900,55650570700,00000000800,a2f,recvmsg
0,55650573100,55650573200,00000000100,a00,read
0,55650578600,55650579500,00000000900,a2f,recvmsg
0,55650604600,55650613600,00000009000,a07,poll
0,55650656500,55650659600,00000003100,a07,poll
0,55650667900,55650668700,00000000800,a2f,recvmsg
0,55650677400,55650692600,00000015200,a07,poll
0,55650695000,55650696500,00000001500,aca,futex
0,55650699100,55650700100,00000001000,aca,futex
0,55650701800,55650702900,00000001100,aca,futex
0,55650706600,55650709000,00000002400,a2e,sendmsg
0,55650711600,55650711800,00000000200,a00,read
0,55650714700,55650715200,00000000500,a07,poll
0,55650717500,55650719000,00000001500,aca,futex
0,55650731700,55650732700,00000001000,aca,futex
0,55650801800,55650804900,00000003100,a07,poll
0,55650805600,55650807500,00000001900,a2e,sendmsg
0,55650807000,55650808700,00000001700,aca,futex
0,55650811000,55650812000,00000001000,a2f,recvmsg
0,55650810900,55650812000,00000001100,aca,futex
0,55650814600,55650814700,00000000100,a00,read
0,55650815800,55650817000,00000001200,aca,futex
0,55650819900,55650821400,00000001500,a2e,sendmsg
0,55650826900,55650846800,00000019900,a07,poll
0,55650848300,55650849300,00000001000,aca,futex
0,55650857600,55650858500,00000000900,aca,futex
0,55650826900,55650880700,00000053800,a07,poll
0,55650882100,55650883000,00000000900,aca,futex
0,55650884700,55650885700,00000001000,aca,futex
0,55650888600,55650889600,00000001000,aca,futex
0,55650891800,55650892800,00000001000,a2e,sendmsg
0,55650896300,55650896500,00000000200,a00,read
0,55650912300,55650913700,00000001400,a2e,sendmsg
0,55650915900,55650916900,00000001000,a2f,recvmsg
0,55650917200,55650917400,00000000200,a00,read
0,55650925200,55650932300,00000007100,a07,poll
0,55650939800,55650941400,00000001600,a2e,sendmsg
0,55650945100,55650945200,00000000100,a00,read
0,55650948900,55650949500,00000000600,a07,poll
0,55650950800,55650951900,00000001100,aca,futex
0,55650958700,55650959600,00000000900,aca,futex
0,55650998600,55650999100,00000000500,a07,poll
0,55651000100,55651001000,00000000900,a00,read
0,55651011700,55651013100,00000001400,a2e,sendmsg
0,55651012400,55651014200,00000001800,a2f,recvmsg
0,55651015000,55651015100,00000000100,a00,read
0,55651018800,55651021500,00000002700,a07,poll
0,55651022600,55651022700,00000000100,a00,read
0,55651031900,55651033100,00000001200,a2f,recvmsg
0,55651084700,55651085400,00000000700,a2f,recvmsg
0,55651087800,55651087900,00000000100,a00,read
0,55651087600,55651088300,00000000700,a07,poll
0,55651090800,55651092300,00000001500,aca,futex
0,55651118800,55651119700,00000000900,a2f,recvmsg
0,55651152200,55651155400,00000003200,a07,poll
0,55651158000,55651162400,00000004400,a07,poll
0,55651165700,55651166600,00000000900,a2f,recvmsg
0,55651179100,55651180700,00000001600,a2f,recvmsg
0,55651196500,55651220300,00000023800,a07,poll
0,55651222500,55651223700,00000001200,aca,futex
0,55651237700,55651238700,00000001000,aca,futex
0,55651250000,55651253600,00000003600,a07,poll
0,55651282900,55651283500,00000000600,a2f,recvmsg
0,55651286800,55651291200,00000004400,a07,poll
0,55651313800,55651315500,00000001700,a2e,sendmsg
0,55651318000,55651318900,00000000900,a2f,recvmsg
0,55651321400,55651321500,00000000100,a00,read
0,55651350500,55651351400,00000000900,a2f,recvmsg
0,55651353800,55651354000,00000000200,a00,read
0,55651353600,55651354500,00000000900,a07,poll
0,55651355800,55651356900,00000001100,aca,futex
0,55651365900,55651366900,00000001000,aca,futex
0,55651403900,55651404700,00000000800,a2f,recvmsg
0,55651422000,55651423300,00000001300,a2e,sendmsg
0,55651425500,55651426100,00000000600,a2f,recvmsg
0,55651454500,55651458600,00000004100,a07,poll
0,55651459900,55651460900,00000001000,aca,futex
0,55651467600,55651468600,00000001000,aca,futex
0,55651519100,55651520400,00000001300,a2e,sendmsg
0,55651522700,55651523500,00000000800,a2f,recvmsg
0,55651525900,55651526000,00000000100,a00,read
0,55651525600,55651553300,00000027700,a07,poll
0,55651554500,55651555400,00000000900,aca,futex
0,55651561900,55651562900,00000001000,aca,futex
0,55651612500,55651615600,00000003100,a2e,sendmsg
0,55651617700,55651618500,00000000800,a2f,recvmsg
0,55651620600,55651646600,00000026000,a07,poll
0,55651648000,55651648900,00000000900,aca,futex
0,55651656700,55651657800,00000001100,aca,futex
0,55651707300,55651709100,00000001800,a2e,sendmsg
0,55651711000,55651711000,00000000000,a00,read
0,55651714800,55651717400,00000002600,a07,poll
0,55651718400,55651718600,00000000200,a00,read
0,55651728900,55651729900,00000001000,a2f,recvmsg
0,55651801200,55651802100,00000000900,a2f,recvmsg
0,55651804300,55651804500,00000000200,a00,read
0,55651844300,55651845100,00000000800,a2f,recvmsg
0,55651882900,55651883900,00000001000,a2f,recvmsg
0,55651922100,55651926400,00000004300,a07,poll
0,55651927600,55651928000,00000000400,a00,read
0,55651938600,55651939700,00000001100,a2f,recvmsg
0,55652002700,55652003600,00000000900,a2f,recvmsg
0,55652006000,55652006100,00000000100,a00,read
0,55652040100,55652040800,00000000700,a2f,recvmsg
0,55652042600,55652062500,00000019900,a07,poll
0,55652070600,55652071300,00000000700,a2f,recvmsg
0,55652082300,55652082500,00000000200,a00,read
0,55652100100,55652100700,00000000600,a2f,recvmsg
0,55652128100,55652128700,00000000600,a2f,recvmsg
0,55652130500,55652151100,00000020600,a07,poll
0,55652157200,55652158000,00000000800,a2f,recvmsg
0,55652158300,55652160600,00000002300,a2e,sendmsg
0,55652186500,55652187100,00000000600,a2f,recvmsg
0,55652217400,55652217700,00000000300,a07,poll
0,55652089200,55652222900,00000133700,aca,futex
0,55652230400,55652236000,00000005600,a07,poll
0,55652237500,55652237900,00000000400,a00,read
0,55652248900,55652249800,00000000900,a2f,recvmsg
0,55652296200,55652298600,00000002400,a07,poll
0,55652299200,55652299400,00000000200,a00,read
0,55652232500,55652308100,00000075600,aca,futex
0,55652314300,55652317100,00000002800,a01,write
0,55652316700,55652327500,00000010800,a07,poll
0,55652338500,55652339500,00000001000,a2f,recvmsg
0,55652354800,55652386400,00000031600,a07,poll
0,55652388300,55652389500,00000001200,aca,futex
0,55652401100,55652402200,00000001100,aca,futex
0,55652470000,55652472000,00000002000,a2e,sendmsg
0,55652474700,55652475500,00000000800,a2f,recvmsg
0,55652478000,55652478200,00000000200,a00,read
0,55652477700,55652506400,00000028700,a07,poll
0,55652507900,55652509000,00000001100,aca,futex
0,55652519400,55652520500,00000001100,aca,futex
0,55652573600,55652575300,00000001700,a2e,sendmsg
0,55652520800,55652583700,00000062900,aca,futex
0,55652587900,55652588400,00000000500,aca,futex
0,55652590200,55652592200,00000002000,a01,write
0,55652598300,55652600000,00000001700,aca,futex
0,55652604600,55652618100,00000013500,aca,futex
0,55652581500,55652678800,00000097300,a07,poll
0,55652680700,55652681700,00000001000,aca,futex
0,55652684400,55652685400,00000001000,aca,futex
0,55652687200,55652687900,00000000700,aca,futex
0,55652692100,55652694000,00000001900,a2e,sendmsg
0,55652697100,55652697300,00000000200,a00,read
0,55652700600,55652756000,00000055400,a07,poll
0,55652757500,55652758500,00000001000,aca,futex
0,55652760000,55652760900,00000000900,aca,futex
0,55652762200,55652763000,00000000800,aca,futex
0,55652765300,55652766700,00000001400,a2e,sendmsg
0,55652771500,55652815400,00000043900,a07,poll
0,55652869100,55652878000,00000008900,a4e,getdents
0,55652893200,55652899200,00000006000,a09,mmap
0,55652899400,55652899600,00000000200,a08,lseek
0,55652930500,55652931500,00000001000,a09,mmap
0,55652931600,55652931700,00000000100,a08,lseek
0,55652947500,55652947900,00000000400,a09,mmap
0,55652948000,55652948100,00000000100,a08,lseek
0,55652966400,55652967800,00000001400,a02,open
0,55652971300,55652972200,00000000900,a02,open
0,55652974200,55652975000,00000000800,a02,open
0,55652771500,55652977400,00000205900,a07,poll
0,55652976700,55652978300,00000001600,a02,open
0,55652980000,55652981000,00000001000,a02,open
0,55652982600,55652983600,00000001000,a02,open
0,55652985200,55652986000,00000000800,a02,open
0,55652987800,55652988600,00000000800,a02,open
0,55652990400,55652991200,00000000800,a02,open
0,55652992900,55652993700,00000000800,a02,open
0,55652996300,55652996500,00000000200,a00,read
0,55652995400,55652996500,00000001100,a02,open
0,55652998200,55652999100,00000000900,a02,open
0,55653000700,55653001600,00000000900,a02,open
0,55653003300,55653004300,00000001000,a02,open
0,55653005900,55653006800,00000000900,a02,open
0,55653008300,55653009300,00000001000,a02,open
0,55653010800,55653011700,00000000900,a02,open
0,55653013200,55653014100,00000000900,a02,open
0,55653015600,55653016600,00000001000,a02,open
0,55653018000,55653019200,00000001200,a02,open
0,55653020700,55653021700,00000001000,a02,open
0,55653023200,55653023900,00000000700,a02,open
0,55653025800,55653026600,00000000800,a02,open
0,55653028000,55653028900,00000000900,a02,open
0,55653030400,55653031200,00000000800,a02,open
0,55653032600,55653033400,00000000800,a02,open
0,55653034800,55653035600,00000000800,a02,open
0,55653037100,55653037800,00000000700,a02,open
0,55653039300,55653040200,00000000900,a02,open
0,55653041600,55653042500,00000000900,a02,open
0,55653043900,55653044800,00000000900,a02,open
0,55653048900,55653050500,00000001600,a00,read
0,55653005000,55653062500,00000057500,a07,poll
0,55653069700,55653072000,00000002300,a2e,sendmsg
0,55653102300,55653103900,00000001600,a02,open
0,55653105800,55653107100,00000001300,a02,open
0,55653111200,55653111800,00000000600,a00,read
0,55653081300,55653130700,00000049400,a07,poll
0,55653131500,55653132200,00000000700,a00,read
0,55653144300,55653145500,00000001200,a02,open
0,55653147100,55653147900,00000000800,a02,open
0,55653149300,55653150200,00000000900,a02,open
0,55653151500,55653152400,00000000900,a02,open
0,55653153700,55653154700,00000001000,a02,open
0,55653156100,55653157300,00000001200,a02,open
0,55653158700,55653160200,00000001500,a02,open
0,55653161600,55653162600,00000001000,a02,open
0,55653164100,55653165100,00000001000,a02,open
0,55653166500,55653167400,00000000900,a02,open
0,55653201400,55653204600,00000003200,a07,poll
0,55653205100,55653205300,00000000200,a00,read
0,55653257500,55653258100,00000000600,aca,futex
0,55653258800,55653259100,00000000300,aca,futex
0,55653621800,55653622100,00000000300,aca,futex
0,55653709000,55653709300,00000000300,aca,futex
0,55653723100,55653723200,00000000100,aca,futex
0,55653732600,55653732700,00000000100,aca,futex
0,55653262600,55653855700,00000593100,a07,poll
0,55653868200,55653868400,00000000200,a00,read
0,55653938500,55653938700,00000000200,aca,futex
0,55653875200,55653942700,00000067500,a07,poll
0,55650918400,55653945100,00003026700,ae8,epoll_wait
0,55653949900,55653952300,00000002400,a2e,sendmsg
0,55653954600,55653957900,00000003300,a2f,recvmsg
0,55653975300,55653975500,00000000200,a2f,recvmsg
0,55653978000,55653982400,00000004400,a2f,recvmsg
0,55653962100,55654007800,00000045700,a07,poll
0,55654008400,55654008800,00000000400,a00,read
0,55654011500,55654011800,00000000300,a2f,recvmsg
0,55654012600,55654013800,00000001200,a2f,recvmsg
0,55654023600,55654023800,00000000200,a2f,recvmsg
0,55654025000,55654027600,00000002600,a2f,recvmsg
0,55654056500,55654058000,00000001500,a2f,recvmsg
0,55654077500,55654080300,00000002800,a07,poll
0,55654080800,55654081000,00000000200,a00,read
0,55654129400,55654130000,00000000600,aca,futex
0,55654148700,55654152000,00000003300,a2e,sendmsg
0,55654184800,55654185800,00000001000,a2e,sendmsg
0,55654233000,55654236100,00000003100,a2e,sendmsg
0,55654423900,55654424700,00000000800,a2e,sendmsg
0,55654450200,55654450900,00000000700,a2e,sendmsg
0,55654673300,55654676600,00000003300,a2e,sendmsg
0,55654678100,55654679700,00000001600,a2e,sendmsg
0,55654680900,55654681500,00000000600,a2e,sendmsg
0,55654682500,55654683800,00000001300,a2e,sendmsg
0,55654684900,55654686900,00000002000,a2e,sendmsg
0,55654688200,55654690400,00000002200,a2e,sendmsg
0,55654691600,55654693800,00000002200,a2e,sendmsg
0,55654133400,55654695700,00000562300,a07,poll
0,55654706000,55654706200,00000000200,a00,read
0,55654712500,55654813600,00000101100,a07,poll
0,55654817100,55654818600,00000001500,a2e,sendmsg
0,55654823400,55654880100,00000056700,a07,poll
0,55654880400,55654880700,00000000300,a00,read
0,55654893300,55654894400,00000001100,a2e,sendmsg
0,55654895500,55654896600,00000001100,a2e,sendmsg
0,55654897400,55654899000,00000001600,a2e,sendmsg
0,55654899800,55654900600,00000000800,a2e,sendmsg
0,55654901500,55654902900,00000001400,a2e,sendmsg
0,55654903800,55654904800,00000001000,a2e,sendmsg
0,55654905700,55654906700,00000001000,a2e,sendmsg
0,55654939100,55654946100,00000007000,a07,poll
0,55654970100,55654975900,00000005800,a07,poll
0,55654976400,55654976700,00000000300,a00,read
0,55655105300,55655106400,00000001100,a2e,sendmsg
0,55655107500,55655108400,00000000900,a2e,sendmsg
0,55655109300,55655110000,00000000700,a2e,sendmsg
0,55655110800,55655111700,00000000900,a2e,sendmsg
0,55655112700,55655114300,00000001600,a2e,sendmsg
0,55655115400,55655116800,00000001400,a2e,sendmsg
0,55655117700,55655119200,00000001500,a2e,sendmsg
0,55655142200,55655143500,00000001300,a2e,sendmsg
0,55655162400,55655163900,00000001500,a2e,sendmsg
0,55655181500,55655182500,00000001000,a2e,sendmsg
0,55655200400,55655201500,00000001100,a2e,sendmsg
0,55655208200,55655211300,00000003100,a2f,recvmsg
0,55655237900,55655238200,00000000300,a2f,recvmsg
0,55655239400,55655241000,00000001600,a2f,recvmsg
0,55655270700,55655270900,00000000200,a2f,recvmsg
0,55655468000,55655469000,00000001000,a2e,sendmsg
0,55655486200,55655487000,00000000800,a2e,sendmsg
0,55655491000,55655492100,00000001100,a2f,recvmsg
0,55655502100,55655502800,00000000700,a2f,recvmsg
0,55655507100,55655507200,00000000100,a2f,recvmsg
0,55655024100,55655586600,00000562500,a07,poll
0,55655590300,55655593500,00000003200,a2e,sendmsg
0,55655595700,55655595900,00000000200,a00,read
0,55655597500,55655598500,00000001000,a2e,sendmsg
0,55655602100,55655603100,00000001000,a2f,recvmsg
0,55655612300,55655612500,00000000200,a2f,recvmsg
0,55655602000,55655648600,00000046600,a07,poll
0,55655649100,55655649300,00000000200,a00,read
0,55655668400,55655669400,00000001000,a2e,sendmsg
0,55655672400,55655673000,00000000600,a2f,recvmsg
0,55655678000,55655678200,00000000200,a2f,recvmsg
0,55655701300,55655702300,00000001000,a2e,sendmsg
0,55655702700,55655707900,00000005200,a07,poll
0,55655702700,55655713900,00000011200,a07,poll
0,55655715800,55655716400,00000000600,a00,read
0,55655729800,55655730900,00000001100,a2f,recvmsg
0,55655729200,55655736900,00000007700,a07,poll
0,55655741500,55655744700,00000003200,a2e,sendmsg
0,55655791900,55655792700,00000000800,a2f,recvmsg
0,55655795300,55655795500,00000000200,a00,read
0,55655795100,55655810200,00000015100,a07,poll
0,55655810400,55655810500,00000000100,a00,read
0,55655825200,55655826200,00000001000,a2f,recvmsg
0,55655854600,55655855300,00000000700,a2f,recvmsg
0,55655944700,55655947600,00000002900,a07,poll
0,55655944700,55656098400,00000153700,a07,poll
0,55656101800,55656104300,00000002500,a2e,sendmsg
0,55656106300,55656106400,00000000100,a00,read
0,55656111500,55656155800,00000044300,a07,poll
0,55656156200,55656156400,00000000200,a00,read
0,55656172900,55656176700,00000003800,a09,mmap
0,55656183700,55656186900,00000003200,a09,mmap
0,55656209200,55656213700,00000004500,a07,poll
0,55656232700,55656242200,00000009500,a07,poll
0,55656247000,55656249400,00000002400,a2e,sendmsg
0,55656304900,55656306200,00000001300,a2f,recvmsg
0,55656312700,55656313500,00000000800,a07,poll
0,55656313600,55656313800,00000000200,a00,read
0,55656352700,55656362400,00000009700,a07,poll
0,55656364900,55656366500,00000001600,aca,futex
0,55656368900,55656369900,00000001000,aca,futex
0,55656373000,55656373900,00000000900,aca,futex
0,55656377300,55656380100,00000002800,a2e,sendmsg
0,55656383800,55656384000,00000000200,a00,read
0,55656391100,55656396500,00000005400,a07,poll
0,55656398300,55656398700,00000000400,a00,read
0,55656413400,55656414700,00000001300,a2f,recvmsg
0,55656495100,55656496000,00000000900,a2f,recvmsg
0,55656500300,55656500500,00000000200,a00,read
0,55656540000,55656540900,00000000900,a2f,recvmsg
0,55656580900,55656582300,00000001400,a2f,recvmsg
0,55656673300,55656676500,00000003200,a07,poll
0,55656673300,55656886500,00000213200,a07,poll
0,55656890100,55656892400,00000002300,a2e,sendmsg
0,55656894500,55656894700,00000000200,a00,read
0,55656900000,55656944700,00000044700,a07,poll
0,55656945200,55656945300,00000000100,a00,read
0,55656995100,55656999900,00000004800,a07,poll
0,55657009100,55657012300,00000003200,a09,mmap
0,55657018200,55657030500,00000012300,a07,poll
0,55657035100,55657037500,00000002400,a2e,sendmsg
0,55657039200,55657042800,00000003600,a01,write
0,55657043500,55657100600,00000057100,a07,poll
0,55657100800,55657100900,00000000100,a00,read
0,55657043500,55657104000,00000060500,a07,poll
0,55657110500,55657115900,00000005400,a2e,sendmsg
0,55657119800,55657120000,00000000200,a00,read
0,55657180600,55657186100,00000005500,a02,open
0,55657204100,55657206200,00000002100,a00,read
0,55657269200,55657270200,00000001000,a00,read
0,55657327000,55657327900,00000000900,a00,read
0,55657383900,55657384700,00000000800,a00,read
0,55657440000,55657441100,00000001100,a00,read
0,55657495100,55657496100,00000001000,a00,read
0,55657547600,55657548400,00000000800,a00,read
0,55657602300,55657603200,00000000900,a00,read
0,55657658900,55657659700,00000000800,a00,read
0,55657138900,55657686500,00000547600,a07,poll
0,55657690200,55657692600,00000002400,a2e,sendmsg
0,55657694700,55657694900,00000000200,a00,read
0,55657712900,55657713600,00000000700,a00,read
0,55657700000,55657745200,00000045200,a07,poll
0,55657745600,55657745700,00000000100,a00,read
0,55657765000,55657765600,00000000600,a00,read
0,55657794200,55657797000,00000002800,a02,open
0,55657794400,55657798800,00000004400,a07,poll
0,55657800600,55657801600,00000001000,a00,read
0,55657818600,55657831200,00000012600,a07,poll
0,55657835800,55657838500,00000002700,a2e,sendmsg
0,55657858600,55657859400,00000000800,a00,read
0,55657844300,55657903100,00000058800,a07,poll
0,55657903200,55657903400,00000000200,a00,read
0,55657946900,55657947800,00000000900,a00,read
0,55658022800,55658023600,00000000800,a00,read
0,55658103800,55658104600,00000000800,a00,read
0,55658186400,55658187100,00000000700,a00,read
0,55658266800,55658267600,00000000800,a00,read
0,55658355200,55658355900,00000000700,a00,read
0,55658422900,55658423600,00000000700,a00,read
0,55658482400,55658483100,00000000700,a00,read
0,55657941500,55658486400,00000544900,a07,poll
0,55658489700,55658492100,00000002400,a2e,sendmsg
0,55658494200,55658494300,00000000100,a00,read
0,55658499500,55658544000,00000044500,a07,poll
0,55658544600,55658544700,00000000100,a00,read
0,55658573200,55658577500,00000004300,a07,poll
0,55658593200,55658597600,00000004400,a07,poll
0,55658615700,55658631200,00000015500,a07,poll
0,55658635700,55658638000,00000002300,a2e,sendmsg
0,55658643800,55658701500,00000057700,a07,poll
0,55658701700,55658701900,00000000200,a00,read
0,55658724800,55658749400,00000024600,a02,open
0,55658762600,55658772000,00000009400,a01,write
0,55658786900,55658816500,00000029600,a07,poll
0,55658834000,55658835400,00000001400,a2f,recvmsg
0,55658916500,55658917700,00000001200,a2f,recvmsg
0,55658920300,55658920700,00000000400,a00,read
0,55658931600,55658932600,00000001000,aca,futex
0,55658955400,55658983700,00000028300,a07,poll
0,55658985200,55658985800,00000000600,a00,read
0,55659001300,55659002600,00000001300,a2f,recvmsg
0,55659016200,55659071200,00000055000,a07,poll
0,55659073500,55659074900,00000001400,aca,futex
0,55659084800,55659086200,00000001400,aca,futex
0,55659168200,55659170900,00000002700,a2e,sendmsg
0,55659173900,55659174800,00000000900,a2f,recvmsg
0,55659177700,55659177900,00000000200,a00,read
0,55659221700,55659222600,00000000900,a2f,recvmsg
0,55659254800,55659255300,00000000500,aca,futex
0,55659256400,55659257600,00000001200,a2f,recvmsg
0,55659285000,55659285200,00000000200,aca,futex
0,55659285300,55659285500,00000000200,aca,futex
0,55659301300,55659301500,00000000200,aca,futex
0,55659333500,55659333800,00000000300,aca,futex
0,55659259500,55659342300,00000082800,a07,poll
0,55659346500,55659349400,00000002900,a2e,sendmsg
0,55659351700,55659351900,00000000200,a00,read
0,55659336500,55659380100,00000043600,aca,futex
0,55659392100,55659393800,00000001700,a2f,recvmsg
0,55659400300,55659402500,00000002200,a2e,sendmsg
0,55659391200,55659404100,00000012900,a07,poll
0,55659404600,55659404800,00000000200,a00,read
0,55659453200,55659454500,00000001300,a2e,sendmsg
0,55659459900,55659460100,00000000200,a00,read
0,55659461500,55659462700,00000001200,a2f,recvmsg
0,55659461200,55659462900,00000001700,a07,poll
0,55659465600,55659466700,00000001100,a2e,sendmsg
0,55659483100,55659491100,00000008000,a07,poll
0,55659495500,55659498000,00000002500,a2e,sendmsg
0,55659515200,55659515700,00000000500,aca,futex
0,55659465300,55659528700,00000063400,ae8,epoll_wait
0,55659540300,55659545400,00000005100,a2f,recvmsg
0,55659503900,55659563300,00000059400,a07,poll
0,55659563500,55659563600,00000000100,a00,read
0,55659584200,55659584600,00000000400,a2f,recvmsg
0,55659586900,55659588300,00000001400,a2f,recvmsg
0,55659593800,55659594000,00000000200,a2f,recvmsg
0,55659595600,55659596800,00000001200,a2f,recvmsg
0,55659602800,55659603000,00000000200,a2f,recvmsg
0,55659604200,55659606000,00000001800,a2f,recvmsg
0,55659620800,55659621100,00000000300,a2f,recvmsg
0,55659622300,55659624000,00000001700,a2f,recvmsg
0,55659637800,55659638000,00000000200,a2f,recvmsg
0,55659693300,55659698100,00000004800,a2e,sendmsg
0,55659735400,55659736400,00000001000,a2e,sendmsg
0,55659766300,55659767200,00000000900,a2e,sendmsg
0,55659909200,55659910300,00000001100,a2e,sendmsg
0,55659943200,55659944400,00000001200,a2e,sendmsg
0,55659970300,55659971700,00000001400,a2e,sendmsg
0,55659996500,55659997300,00000000800,a2e,sendmsg
0,55660021600,55660022300,00000000700,a2e,sendmsg
0,55660046900,55660048200,00000001300,a2e,sendmsg
0,55660072200,55660073100,00000000900,a2e,sendmsg
0,55660096300,55660097500,00000001200,a2e,sendmsg
0,55660104400,55660105800,00000001400,a2f,recvmsg
0,55660115500,55660115700,00000000200,a2f,recvmsg
0,55660139100,55660139800,00000000700,a2e,sendmsg
0,55659601600,55660142800,00000541200,a07,poll
0,55660146200,55660148500,00000002300,a2e,sendmsg
0,55660150500,55660150600,00000000100,a00,read
0,55660162900,55660163500,00000000600,a2e,sendmsg
0,55660166900,55660167900,00000001000,a2f,recvmsg
0,55660172500,55660172600,00000000100,a2f,recvmsg
0,55660195800,55660196400,00000000600,a2e,sendmsg
0,55660155600,55660200900,00000045300,a07,poll
0,55660201300,55660201500,00000000200,a00,read
0,55659523300,55660202500,00000679200,aca,futex
0,55660233900,55660236500,00000002600,a01,write
0,55660249500,55660251500,00000002000,a2e,sendmsg
0,55660253000,55660257300,00000004300,a07,poll
0,55660259700,55660260700,00000001000,a2f,recvmsg
0,55660278400,55660278500,00000000100,a00,read
0,55660335100,55660335600,00000000500,aca,futex
0,55660357200,55660358800,00000001600,a01,write
0,55660335900,55660374400,00000038500,aca,futex
0,55660380600,55660386800,00000006200,a07,poll
0,55660392200,55660394100,00000001900,a2e,sendmsg
0,55660400600,55660464000,00000063400,a07,poll
0,55660465500,55660466000,00000000500,a00,read
0,55660479100,55660480400,00000001300,a2f,recvmsg
0,55660535700,55660536200,00000000500,aca,futex
0,55660563700,55660566400,00000002700,a07,poll
0,55660566900,55660567100,00000000200,a00,read
0,55660668300,55660668600,00000000300,aca,futex
0,55660700700,55660700900,00000000200,aca,futex
0,55660279400,55660863000,00000583600,ae8,epoll_wait
0,55660869700,55660872100,00000002400,a2f,recvmsg
0,55660881200,55660881400,00000000200,a2f,recvmsg
0,55660883200,55660885100,00000001900,a2f,recvmsg
0,55660917800,55660918500,00000000700,a2f,recvmsg
0,55660976500,55660978100,00000001600,a2e,sendmsg
0,55661001100,55661003200,00000002100,a2e,sendmsg
0,55661022900,55661025400,00000002500,a2e,sendmsg
0,55661042900,55661043900,00000001000,a2e,sendmsg
0,55660613000,55661198100,00000585100,a07,poll
0,55661202000,55661205100,00000003100,a2e,sendmsg
0,55661207200,55661207300,00000000100,a00,read
0,55661212900,55661260300,00000047400,a07,poll
0,55661317900,55661323200,00000005300,a07,poll
0,55661348700,55661353400,00000004700,a07,poll
0,55661358200,55661360700,00000002500,a2e,sendmsg
0,55661366700,55661426000,00000059300,a07,poll
0,55661426200,55661426400,00000000200,a00,read
0,55661760500,55661760700,00000000200,aca,futex
0,55661771900,55661772100,00000000200,aca,futex
0,55661795100,55661795200,00000000100,aca,futex
0,55661798700,55661798800,00000000100,aca,futex
0,55661347300,55661838500,00000491200,ae8,epoll_wait
0,55661843900,55661846300,00000002400,a2f,recvmsg
0,55661878200,55661879200,00000001000,a2f,recvmsg
0,55661926900,55661930300,00000003400,a2e,sendmsg
0,55661951400,55661952300,00000000900,a2e,sendmsg
0,55661971000,55661973500,00000002500,a2e,sendmsg
0,55661977800,55661979000,00000001200,a2f,recvmsg
0,55662005400,55662005600,00000000200,a2f,recvmsg
0,55661522500,55662013800,00000491300,a07,poll
0,55662017100,55662019700,00000002600,a2e,sendmsg
0,55662021600,55662021700,00000000100,a00,read
0,55662023100,55662024100,00000001000,a2e,sendmsg
0,55662041200,55662041900,00000000700,a2e,sendmsg
0,55662027100,55662047000,00000019900,a07,poll
0,55662047800,55662048300,00000000500,a00,read
0,55662057900,55662058900,00000001000,a2f,recvmsg
0,55662068600,55662073200,00000004600,a07,poll
0,55662073600,55662073800,00000000200,a00,read
0,55662193600,55662194500,00000000900,a2f,recvmsg
0,55662196700,55662196800,00000000100,a00,read
0,55662278400,55662279000,00000000600,a2f,recvmsg
0,55662294800,55662295100,00000000300,aca,futex
0,55662338300,55662338600,00000000300,aca,futex
0,55662374700,55662378800,00000004100,a07,poll
0,55662386000,55662386300,00000000300,a2f,recvmsg
0,55662387400,55662387600,00000000200,a2f,recvmsg
0,55662345400,55662396700,00000051300,aca,futex
0,55662587300,55662587600,00000000300,aca,futex
0,55662594500,55662594700,00000000200,aca,futex
0,55662681700,55662682000,00000000300,aca,futex
0,55662395100,55662767700,00000372600,a07,poll
0,55662772000,55662772200,00000000200,a2f,recvmsg
0,55662773000,55662773100,00000000100,a2f,recvmsg
0,55662783800,55662792400,00000008600,a06,lstat
0,55662793400,55662794800,00000001400,a06,lstat
0,55662796900,55662821200,00000024300,a02,open
0,55662827300,55662841700,00000014400,a01,write
0,55662847000,55662850800,00000003800,a14,writev
0,55662043700,55662854800,00000811100,ae8,epoll_wait
0,55662860700,55662862500,00000001800,a2f,recvmsg
0,55662897500,55662898600,00000001100,a2f,recvmsg
0,55662955600,55662958300,00000002700,a2e,sendmsg
0,55662980200,55662981300,00000001100,a2e,sendmsg
0,55662999800,55663002300,00000002500,a2e,sendmsg
0,55663019600,55663020700,00000001100,a2e,sendmsg
0,55663025200,55663026300,00000001100,a2f,recvmsg
0,55663078300,55663080600,00000002300,a2e,sendmsg
0,55663097600,55663098500,00000000900,a2e,sendmsg
0,55662851700,55663103900,00000252200,a07,poll
0,55663104800,55663105300,00000000500,a00,read
0,55663114500,55663115300,00000000800,a2f,recvmsg
0,55663209400,55663210100,00000000700,a2f,recvmsg
0,55663213700,55663213900,00000000200,a00,read
0,55663282000,55663284800,00000002800,a07,poll
0,55663289700,55663290000,00000000300,a2f,recvmsg
0,55663290600,55663290800,00000000200,a2f,recvmsg
0,55663293400,55663652400,00000359000,a38,clone
0,55662764900,55663685900,00000921000,aca,futex
0,55663687300,55665348900,00001661600,aca,futex
0,55665343300,55665375800,00000032500,a07,poll
0,55665388700,55665395500,00000006800,a2e,sendmsg
0,55665405600,55665405800,00000000200,a00,read
0,55665408600,55665409900,00000001300,a2e,sendmsg
0,55665433400,55665434500,00000001100,a2e,sendmsg
0,55665454800,55665455700,00000000900,a2e,sendmsg
0,55665473900,55665475100,00000001200,a2e,sendmsg
0,55665491700,55665492700,00000001000,a2e,sendmsg
0,55665510400,55665511500,00000001100,a2e,sendmsg
0,55665527800,55665528800,00000001000,a2e,sendmsg
0,55665544200,55665545400,00000001200,a2e,sendmsg
0,55665560500,55665561900,00000001400,a2e,sendmsg
0,55665576900,55665578100,00000001200,a2e,sendmsg
0,55665594800,55665596000,00000001200,a2e,sendmsg
0,55665610500,55665611400,00000000900,a2e,sendmsg
0,55665625600,55665626600,00000001000,a2e,sendmsg
0,55665640000,55665641000,00000001000,a2e,sendmsg
0,55665654300,55665655300,00000001000,a2e,sendmsg
0,55663100600,55665683900,00002583300,ae8,epoll_wait
0,55665696700,55665700600,00000003900,a2f,recvmsg
0,55665739100,55665740500,00000001400,a2f,recvmsg
0,55665815100,55665818700,00000003600,a2e,sendmsg
0,55665847100,55665848200,00000001100,a2e,sendmsg
0,55665869700,55665870800,00000001100,a2e,sendmsg
0,55665891100,55665892200,00000001100,a2e,sendmsg
0,55665898300,55665900200,00000001900,a2f,recvmsg
0,55665928700,55665930000,00000001300,a2f,recvmsg
0,55665977200,55665981000,00000003800,a2e,sendmsg
0,55666004500,55666008300,00000003800,a2e,sendmsg
0,55666028200,55666031000,00000002800,a2e,sendmsg
0,55666049000,55666049700,00000000700,a2e,sendmsg
0,55666054100,55666056000,00000001900,a2f,recvmsg
0,55666082300,55666083900,00000001600,a2f,recvmsg
0,55666138900,55666139800,00000000900,a2e,sendmsg
0,55666158600,55666161400,00000002800,a2e,sendmsg
0,55666178300,55666179500,00000001200,a2e,sendmsg
0,55666196200,55666197000,00000000800,a2e,sendmsg
0,55666214100,55666215200,00000001100,a2e,sendmsg
0,55666219000,55666220700,00000001700,a2f,recvmsg
0,55666246400,55666247300,00000000900,a2f,recvmsg
0,55666276000,55666276700,00000000700,a2e,sendmsg
0,55666293400,55666294100,00000000700,a2e,sendmsg
0,55666310300,55666311000,00000000700,a2e,sendmsg
0,55665680000,55666318100,00000638100,a07,poll
0,55665680000,55666512200,00000832200,a07,poll
0,55666514600,55666516300,00000001700,aca,futex
0,55666563200,55666567100,00000003900,a07,poll
0,55666573000,55666578400,00000005400,a2e,sendmsg
0,55666581400,55666581700,00000000300,a00,read
0,55666587000,55666608100,00000021100,a07,poll
0,55666609600,55666610600,00000001000,aca,futex
0,55666642500,55666644600,00000002100,a07,poll
0,55666647200,55666649200,00000002000,a2e,sendmsg
0,55666655900,55666675800,00000019900,a07,poll
0,55666677100,55666678100,00000001000,aca,futex
0,55666705300,55666707300,00000002000,a07,poll
0,55666709600,55666711400,00000001800,a2e,sendmsg
0,55666713200,55666713300,00000000100,a00,read
0,55666717200,55666731700,00000014500,a07,poll
0,55666732800,55666733800,00000001000,aca,futex
0,55666758900,55666760600,00000001700,a07,poll
0,55666762500,55666763700,00000001200,a2e,sendmsg
0,55666769200,55666850200,00000081000,a07,poll
0,52094362600,55669598200,03575235600,b0e,pselect6
0,55669602500,55669611500,00000009000,a00,read
0,55669643300,55669787000,00000143700,a4e,getdents
0,55669798400,55669803700,00000005300,a00,read
0,55669818600,55669820600,00000002000,a00,read
0,55669830000,55669832000,00000002000,a00,read
0,55669840500,55669842400,00000001900,a00,read
0,55669851000,55669852700,00000001700,a00,read
0,55669861200,55669862600,00000001400,a00,read
0,55669870900,55669872700,00000001800,a00,read
0,55669881600,55669883200,00000001600,a00,read
0,55669892600,55669894200,00000001600,a00,read
0,55669903200,55669904900,00000001700,a00,read
0,55669913300,55669915100,00000001800,a00,read
0,55669923500,55669925500,00000002000,a00,read
0,55669933900,55669935800,00000001900,a00,read
0,55669944700,55669946400,00000001700,a00,read
0,55669954800,55669956700,00000001900,a00,read
0,55669964800,55669966800,00000002000,a00,read
0,55669975200,55669976700,00000001500,a00,read
0,55669984800,55669986500,00000001700,a00,read
0,55669994900,55669996600,00000001700,a00,read
0,55670004600,55670006100,00000001500,a00,read
0,55670014300,55670016000,00000001700,a00,read
0,55670024100,55670025600,00000001500,a00,read
0,55670034200,55670035800,00000001600,a00,read
0,55670043800,55670045400,00000001600,a00,read
0,55670053600,55670055100,00000001500,a00,read
0,55670063100,55670065100,00000002000,a00,read
0,55670073500,55670075500,00000002000,a00,read
0,55670083800,55670085600,00000001800,a00,read
0,55670093600,55670095500,00000001900,a00,read
0,55670103700,55670105600,00000001900,a00,read
0,55670113600,55670115400,00000001800,a00,read
0,55670124400,55670126200,00000001800,a00,read
0,55670134500,55670136100,00000001600,a00,read
0,55670144300,55670146300,00000002000,a00,read
0,55670154500,55670156200,00000001700,a00,read
0,55670164300,55670165900,00000001600,a00,read
0,55670174200,55670175800,00000001600,a00,read
0,55670184300,55670186100,00000001800,a00,read
0,55670194300,55670196200,00000001900,a00,read
0,55670204300,55670205900,00000001600,a00,read
0,55670214000,55670216000,00000002000,a00,read
0,55670224900,55670226500,00000001600,a00,read
0,55670234900,55670236700,00000001800,a00,read
0,55670244900,55670247100,00000002200,a00,read
0,55670255300,55670257100,00000001800,a00,read
0,55670265400,55670267300,00000001900,a00,read
0,55670275400,55670277300,00000001900,a00,read
0,55670285300,55670287100,00000001800,a00,read
0,55670295400,55670297300,00000001900,a00,read
0,55670305200,55670306800,00000001600,a00,read
0,55670315100,55670317000,00000001900,a00,read
0,55670325200,55670326700,00000001500,a00,read
0,55670334900,55670336700,00000001800,a00,read
0,55670344600,55670346300,00000001700,a00,read
0,55670354500,55670356300,00000001800,a00,read
0,55670364500,55670366200,00000001700,a00,read
0,55670374500,55670376300,00000001800,a00,read
0,55670384200,55670386000,00000001800,a00,read
0,55670394000,55670395900,00000001900,a00,read
0,55670404400,55670406400,00000002000,a00,read
0,55670414400,55670416100,00000001700,a00,read
0,55670425200,55670427100,00000001900,a00,read
0,55670435600,55670437500,00000001900,a00,read
0,55670445900,55670447500,00000001600,a00,read
0,55670455700,55670457500,00000001800,a00,read
0,55670466400,55670468000,00000001600,a00,read
0,55670476200,55670477900,00000001700,a00,read
0,55670485800,55670487500,00000001700,a00,read
0,55670495900,55670498000,00000002100,a00,read
0,55670506900,55670508600,00000001700,a00,read
0,55670516600,55670518400,00000001800,a00,read
0,55670526200,55670527900,00000001700,a00,read
0,55670535900,55670537700,00000001800,a00,read
0,55670546100,55670547700,00000001600,a00,read
0,55670556200,55670558000,00000001800,a00,read
0,55670566300,55670568200,00000001900,a00,read
0,55670577000,55670578800,00000001800,a00,read
0,55670586900,55670588800,00000001900,a00,read
0,55670597100,55670599900,00000002800,a00,read
0,55670609500,55670611800,00000002300,a00,read
0,55670620700,55670622800,00000002100,a00,read
0,55670631200,55670633200,00000002000,a00,read
0,55670641300,55670643100,00000001800,a00,read
0,55670651300,55670653300,00000002000,a00,read
0,55670661700,55670664000,00000002300,a00,read
0,55670673300,55670675500,00000002200,a00,read
0,55670684600,55670687700,00000003100,a00,read
0,55670697300,55670699500,00000002200,a00,read
0,55670708700,55670711000,00000002300,a00,read
0,55670720100,55670722100,00000002000,a00,read
0,55670730700,55670733600,00000002900,a00,read
0,55670742100,55670744300,00000002200,a00,read
0,55670753200,55670756000,00000002800,a00,read
0,55670764600,55670767000,00000002400,a00,read
0,55670775700,55670777900,00000002200,a00,read
0,55670786800,55670788900,00000002100,a00,read
0,55670797600,55670799800,00000002200,a00,read
0,55670808800,55670811100,00000002300,a00,read
0,55670820000,55670822100,00000002100,a00,read
0,55670831000,55670833100,00000002100,a00,read
0,55670842400,55670844300,00000001900,a00,read
0,55670853300,55670855500,00000002200,a00,read
0,55670864700,55670866800,00000002100,a00,read
0,55670875800,55670878300,00000002500,a00,read
0,55670887900,55670890200,00000002300,a00,read
0,55670900100,55670902500,00000002400,a00,read
0,55670911500,55670913900,00000002400,a00,read
0,55670922800,55670925000,00000002200,a00,read
0,55670933900,55670936000,00000002100,a00,read
0,55670944900,55670947000,00000002100,a00,read
0,55670955900,55670958100,00000002200,a00,read
0,55670967400,55670969600,00000002200,a00,read
0,55670979000,55670981600,00000002600,a00,read
0,55670990900,55670992800,00000001900,a00,read
0,55671001500,55671003500,00000002000,a00,read
0,55671012100,55671014400,00000002300,a00,read
0,55671023100,55671025400,00000002300,a00,read
0,55671034300,55671037200,00000002900,a00,read
0,55671046000,55671048000,00000002000,a00,read
0,55671057200,55671059700,00000002500,a00,read
0,55671068700,55671070900,00000002200,a00,read
0,55671080000,55671082200,00000002200,a00,read
0,55671091000,55671093500,00000002500,a00,read
0,55671102900,55671105100,00000002200,a00,read
0,55671114000,55671116500,00000002500,a00,read
0,55671125300,55671127500,00000002200,a00,read
0,55671136400,55671138800,00000002400,a00,read
0,55671147700,55671150000,00000002300,a00,read
0,55671158800,55671161200,00000002400,a00,read
0,55671170600,55671172700,00000002100,a00,read
0,55671181600,55671183600,00000002000,a00,read
0,55671192100,55671194400,00000002300,a00,read
0,55671203300,55671205900,00000002600,a00,read
0,55671214900,55671217400,00000002500,a00,read
0,55671226600,55671229100,00000002500,a00,read
0,55671238000,55671240300,00000002300,a00,read
0,55671249600,55671251700,00000002100,a00,read
0,55671260700,55671263100,00000002400,a00,read
0,55671272300,55671274500,00000002200,a00,read
0,55671283800,55671285900,00000002100,a00,read
0,55671294600,55671297400,00000002800,a00,read
0,55671307000,55671309100,00000002100,a00,read
0,55671318500,55671320400,00000001900,a00,read
0,55671330200,55671332300,00000002100,a00,read
0,55671341600,55671343700,00000002100,a00,read
0,55671352900,55671354900,00000002000,a00,read
0,55671364200,55671366200,00000002000,a00,read
0,55671374800,55671376800,00000002000,a00,read
0,55671385700,55671388600,00000002900,a00,read
0,55671397800,55671399900,00000002100,a00,read
0,55671408800,55671410700,00000001900,a00,read
0,55671419900,55671422100,00000002200,a00,read
0,55671431200,55671433300,00000002100,a00,read
0,55671443800,55671446100,00000002300,a00,read
0,55671455000,55671457200,00000002200,a00,read
0,55671466300,55671468500,00000002200,a00,read
0,55671477300,55671479100,00000001800,a00,read
0,55671487800,55671490000,00000002200,a00,read
0,55671498600,55671500600,00000002000,a00,read
0,55671509500,55671511500,00000002000,a00,read
0,55671520300,55671522300,00000002000,a00,read
0,55671531300,55671533500,00000002200,a00,read
0,55671542200,55671544100,00000001900,a00,read
0,55671552300,55671554000,00000001700,a00,read
0,55671562300,55671564100,00000001800,a00,read
0,55671572600,55671574300,00000001700,a00,read
0,55671582400,55671584200,00000001800,a00,read
0,55671592100,55671593700,00000001600,a00,read
0,55671601600,55671603800,00000002200,a00,read
0,55671612900,55671617500,00000004600,a00,read
0,55671627600,55671629900,00000002300,a00,read
0,55671638900,55671641100,00000002200,a00,read
0,55671649600,55671653100,00000003500,a00,read
0,55671662100,55671663900,00000001800,a00,read
0,55671671800,55671673800,00000002000,a00,read
0,55671682300,55671684300,00000002000,a00,read
0,55671692900,55671695700,00000002800,a00,read
0,55671705500,55671708900,00000003400,a00,read
0,55671718400,55671720400,00000002000,a00,read
0,55671729100,55671731300,00000002200,a00,read
0,55671739800,55671743000,00000003200,a00,read
0,55671752000,55671755100,00000003100,a00,read
0,55671784500,55671789200,00000004700,a15,access
0,55671796600,55671798300,00000001700,a00,read
0,55671800800,55671801100,00000000300,a00,read
0,55671802700,55671803000,00000000300,a00,read
0,55671804500,55671804800,00000000300,a00,read
0,55671806300,55671806500,00000000200,a00,read
0,55671808000,55671808300,00000000300,a00,read
0,55671809800,55671810100,00000000300,a00,read
0,55671811600,55671811800,00000000200,a00,read
0,55671813300,55671813600,00000000300,a00,read
0,55671815100,55671815300,00000000200,a00,read
0,55671816800,55671817500,00000000700,a00,read
0,55671819000,55671819300,00000000300,a00,read
0,55671846900,55671866400,00000019500,a00,read
0,55671989500,55672002800,00000013300,a01,write
0,55648270000,55672040400,00023770400,a17,select
0,55672055900,55672061000,00000005100,a00,read
0,55672077300,55672089100,00000011800,a01,write
0,55666769200,55713546800,00046777600,a07,poll
0,55713582400,55713589600,00000007200,a2e,sendmsg
0,55713610300,55713691700,00000081400,a07,poll
0,55713703300,55713704700,00000001400,a00,read
0,55713733100,55713735100,00000002000,a2f,recvmsg
0,55672090100,55714479900,00042389800,a17,select
0,55714491600,55714494800,00000003200,a2f,recvmsg
0,55714650400,55714650800,00000000400,a2f,recvmsg
0,55713851700,55724997100,00011145400,a07,poll
0,55725003300,55725005400,00000002100,afe,inotify_add_watch
0,55725006200,55725006600,00000000400,afe,inotify_add_watch
0,55725006900,55725007300,00000000400,afe,inotify_add_watch
0,55725010300,55725456900,00000446600,a07,poll
0,55725547800,55736021600,00010473800,a07,poll
0,55736022200,55736023100,00000000900,a00,read
0,55736025400,55736028300,00000002900,afe,inotify_add_watch
0,55736028900,55736029200,00000000300,afe,inotify_add_watch
0,55736029600,55736030000,00000000400,afe,inotify_add_watch
0,55714663000,55740516300,00025853300,a17,select
0,55666850500,55740942200,00074091700,aca,futex
0,55740961800,55740986200,00000024400,a01,write
0,55736031500,55740996000,00004964500,a07,poll
0,55666313200,55741185100,00074871900,ae8,epoll_wait
0,55741217100,55741229600,00000012500,a00,read
0,55741259700,55741272900,00000013200,a00,read
0,55741287300,55741293300,00000006000,a00,read
0,55741338200,55741343500,00000005300,ae8,epoll_wait
0,55714663000,55741440600,00026777600,a17,select
0,55741455300,55741461400,00000006100,aca,futex
0,55741435300,55741484800,00000049500,ae8,epoll_wait
0,55741490700,55741492000,00000001300,a2f,recvmsg
0,55741503100,55741503300,00000000200,a2f,recvmsg
0,55741017500,55741505100,00000487600,a07,poll
0,55741506900,55741508000,00000001100,a00,read
0,55741512500,55741514100,00000001600,a00,read
0,55741562600,55741566400,00000003800,a02,open
0,55741694800,55741699600,00000004800,a2e,sendmsg
0,55741701700,55741704400,00000002700,a2e,sendmsg
0,55741705500,55741708300,00000002800,a2e,sendmsg
0,55741709500,55741711700,00000002200,a2e,sendmsg
0,55741715600,55741716400,00000000800,a2e,sendmsg
0,55741538600,55741724500,00000185900,a07,poll
0,55741745500,55741747000,00000001500,a2f,recvmsg
0,55741836900,55741846600,00000009700,a07,poll
0,55741853400,55741855500,00000002100,a2f,recvmsg
0,55741865600,55741865900,00000000300,a2f,recvmsg
0,55741719400,55741887400,00000168000,ae8,epoll_wait
0,55741891900,55741892900,00000001000,a2f,recvmsg
0,55741901200,55741901400,00000000200,a2f,recvmsg
0,55741948200,55741952100,00000003900,a2e,sendmsg
0,55741956900,55742018200,00000061300,ae8,epoll_wait
0,55742034100,55742038500,00000004400,a2f,recvmsg
0,55742057000,55742057300,00000000300,a2f,recvmsg
0,55742112600,55742183000,00000070400,ae8,epoll_wait
0,55742196400,55742196600,00000000200,a2f,recvmsg
0,55742234700,55742297200,00000062500,ae8,epoll_wait
0,55742415200,55742420800,00000005600,a2e,sendmsg
0,55742422800,55742425300,00000002500,a2e,sendmsg
0,55742426500,55742428600,00000002100,a2e,sendmsg
0,55742430000,55742432200,00000002200,a2e,sendmsg
0,55741882000,55742464000,00000582000,a07,poll
0,55742465900,55742467000,00000001100,a00,read
0,55742474500,55742476500,00000002000,a2f,recvmsg
0,55742486900,55742487300,00000000400,a2f,recvmsg
0,55742499000,55742506900,00000007900,a07,poll
0,55742511700,55742513000,00000001300,a2f,recvmsg
0,55742522400,55742522700,00000000300,a2f,recvmsg
0,55742537400,55742543600,00000006200,a07,poll
0,55742545200,55742545700,00000000500,a00,read
0,55742559400,55742560600,00000001200,a2f,recvmsg
0,55663681700,55742853700,00079172000,a3d,wait4
0,55742910300,55742911000,00000000700,a10,ioctl
0,55742911500,55742912100,00000000600,a6d,setpgid
0,55742458700,55743136800,00000678100,ae8,epoll_wait
0,55743145700,55743147600,00000001900,a00,read
0,55743243100,55743244100,00000001000,a00,read
0,55743250700,55743251000,00000000300,a00,read
0,55743266900,55743277100,00000010200,a00,read
0,55743310600,55743316300,00000005700,a00,read
0,55672003100,55743347000,00071343900,b0e,pselect6
0,55743354300,55743354700,00000000400,a10,ioctl
0,55742635800,55743371300,00000735500,a07,poll
0,55743414500,55743424000,00000009500,ae8,epoll_wait
0,55743432600,55743436000,00000003400,a2f,recvmsg
0,55743445800,55743446200,00000000400,a2f,recvmsg
0,55743505900,55743511300,00000005400,a2e,sendmsg
0,55743416300,55743521600,00000105300,a07,poll
0,55743535400,55743538200,00000002800,a2e,sendmsg
0,55743543700,55743543800,00000000100,a00,read
0,55743517900,55743553800,00000035900,ae8,epoll_wait
0,55743562000,55743563100,00000001100,a2f,recvmsg
0,55743590800,55743592000,00000001200,a2e,sendmsg
0,55743592900,55743593100,00000000200,a2f,recvmsg
0,55743599500,55743600200,00000000700,a10,ioctl
0,55743599500,55743600600,00000001100,a10,ioctl
0,55743609300,55743610100,00000000800,a01,write
0,55743660500,55743660800,00000000300,a01,write
0,55743664800,55743693100,00000028300,7ef,local_timer_vector
0,55743551000,55743699400,00000148400,a07,poll
0,55743717200,55743718500,00000001300,a2f,recvmsg
0,55743789600,55743797000,00000007400,a07,poll
0,55743992900,55744001200,00000008300,a07,poll
0,55744006800,55744010400,00000003600,a2e,sendmsg
0,55744014100,55744014300,00000000200,a00,read
0,55744016700,55744017900,00000001200,a2e,sendmsg
0,55744025300,55744026200,00000000900,a2e,sendmsg
0,55744040200,55744043700,00000003500,a07,poll
0,55743594100,55744072100,00000478000,b0f,ppoll
0,55744089300,55744089800,00000000500,a3e,kill
0,55744128600,55744132100,00000003500,a4e,getdents
0,55744175400,55744176400,00000001000,a2e,sendmsg
0,55744197600,55744198700,00000001100,a2e,sendmsg
0,55744068200,55744218100,00000149900,a07,poll
0,55744231000,55744232300,00000001300,a2f,recvmsg
0,55744322700,55744323700,00000001000,a2f,recvmsg
0,55744326100,55744326300,00000000200,a00,read
0,55744201600,55744583000,00000381400,ae8,epoll_wait
0,55744587300,55744588900,00000001600,a00,read
0,55744610200,55744610400,00000000200,a00,read
0,55744625600,55744633800,00000008200,a00,read
0,55744659900,55744661700,00000001800,a4e,getdents
0,55744673600,55744674500,00000000900,a4e,getdents
0,55744727200,55744729200,00000002000,a54,rmdir
0,55744732900,55744733500,00000000600,a54,rmdir
0,55744737300,55744738000,00000000700,a54,rmdir
0,55744740800,55744741500,00000000700,a54,rmdir
0,55744744300,55744744900,00000000600,a54,rmdir
0,55744756300,55744760900,00000004600,a2e,sendmsg
0,55744381200,55744851000,00000469800,a07,poll
0,55744860300,55744862100,00000001800,a2e,sendmsg
0,55744866400,55744866600,00000000200,a00,read
0,55743594100,55744929300,00001335200,b0f,ppoll
0,55744949300,55744950800,00000001500,a00,read
0,55744966200,55744967000,00000000800,a00,read
0,55744935700,55745144700,00000209000,a07,poll
0,55744935700,55745233400,00000297700,a07,poll
0,55745236700,55745238700,00000002000,aca,futex
0,55745241900,55745242800,00000000900,aca,futex
0,55745249500,55745250800,00000001300,aca,futex
0,55745254900,55745257200,00000002300,a2e,sendmsg
0,55745261000,55745261300,00000000300,a00,read
0,55745280900,55745281900,00000001000,a2f,recvmsg
0,55745288200,55745288400,00000000200,a2f,recvmsg
0,55745139400,55745293500,00000154100,60e,page_fault
0,55745288800,55745306900,00000018100,a07,poll
0,55744784000,55745376200,00000592200,ae8,epoll_wait
0,55745385000,55745386400,00000001400,a2f,recvmsg
0,55745432500,55745433500,00000001000,a2e,sendmsg
0,55745436100,55745437000,00000000900,a2e,sendmsg
0,55745372700,55745447600,00000074900,a07,poll
0,55745462700,55745464300,00000001600,a2f,recvmsg
0,55745545000,55745554100,00000009100,a07,poll
1,55869974200,55869974700,00000000500,a09,mmap
1,55869974800,55869974800,00000000000,a08,lseek
1,55869976000,55869982800,00000006800,a00,read
1,55869989100,55869989400,00000000300,a09,mmap
1,55869988700,55869989500,00000000800,a08,lseek
1,55870000600,55870002100,00000001500,a00,read
1,55870003300,55870003700,00000000400,a09,mmap
1,55870003800,55870003900,00000000100,a08,lseek
1,55870015500,55870015700,00000000200,a00,read
1,55870018800,55870018900,00000000100,a08,lseek
1,55870021400,55870021900,00000000500,a09,mmap
1,55870021900,55870022000,00000000100,a08,lseek
1,55870027100,55870027500,00000000400,a09,mmap
1,55870027600,55870027600,00000000000,a08,lseek
1,55870028500,55870029000,00000000500,a00,read
1,55870037000,55870037500,00000000500,a09,mmap
1,55870037500,55870037600,00000000100,a08,lseek
1,55870041600,55870043500,00000001900,a09,mmap
1,55870043600,55870043700,00000000100,a08,lseek
1,55870051800,55870052200,00000000400,a09,mmap
1,55870052300,55870052400,00000000100,a08,lseek
1,55870058600,55870059200,00000000600,a09,mmap
1,55870059300,55870059400,00000000100,a08,lseek
1,55870066300,55870066800,00000000500,a09,mmap
1,55870066800,55870066900,00000000100,a08,lseek
1,55870082000,55870082100,00000000100,a08,lseek
1,55870084400,55870084900,00000000500,a09,mmap
1,55870085000,55870085100,00000000100,a08,lseek
1,55870086300,55870086800,00000000500,a09,mmap
1,55870086900,55870087000,00000000100,a08,lseek
1,55870090000,55870090400,00000000400,a09,mmap
1,55870090500,55870090600,00000000100,a08,lseek
1,55870100000,55870100400,00000000400,a09,mmap
1,55870100500,55870100600,00000000100,a08,lseek
1,55870105500,55870106100,00000000600,a09,mmap
1,55870106200,55870106300,00000000100,a08,lseek
1,55870114800,55870115200,00000000400,a09,mmap
1,55870115300,55870115300,00000000000,a08,lseek
1,55870129400,55870129800,00000000400,a09,mmap
1,55870129800,55870129900,00000000100,a08,lseek
1,55870145100,55870145200,00000000100,a08,lseek
1,55870147500,55870147900,00000000400,a09,mmap
1,55870148000,55870148100,00000000100,a08,lseek
1,55870153000,55870153500,00000000500,a09,mmap
1,55870153500,55870153600,00000000100,a08,lseek
1,55870163000,55870163400,00000000400,a09,mmap
1,55870163500,55870163600,00000000100,a08,lseek
1,55870177800,55870178300,00000000500,a09,mmap
1,55870178300,55870178400,00000000100,a08,lseek
1,55870192100,55870192500,00000000400,a09,mmap
1,55870192500,55870192600,00000000100,a08,lseek
1,55870207900,55870208000,00000000100,a08,lseek
1,55870210200,55870210600,00000000400,a09,mmap
1,55870210700,55870210800,00000000100,a08,lseek
1,55870215700,55870216100,00000000400,a09,mmap
1,55870216200,55870216300,00000000100,a08,lseek
1,55870225600,55870226100,00000000500,a09,mmap
1,55870226100,55870226200,00000000100,a08,lseek
1,55870240400,55870240800,00000000400,a09,mmap
1,55870240900,55870241000,00000000100,a08,lseek
1,55870254500,55870254900,00000000400,a09,mmap
1,55870255000,55870255100,00000000100,a08,lseek
1,55870272100,55870272200,00000000100,a08,lseek
1,55870274500,55870275000,00000000500,a09,mmap
1,55870275100,55870275200,00000000100,a08,lseek
1,55870280100,55870280500,00000000400,a09,mmap
1,55870280600,55870280700,00000000100,a08,lseek
1,55870290000,55870290500,00000000500,a09,mmap
1,55870290600,55870290600,00000000000,a08,lseek
1,55870304700,55870305100,00000000400,a09,mmap
1,55870305200,55870305300,00000000100,a08,lseek
1,55870319300,55870319700,00000000400,a09,mmap
1,55870319700,55870319800,00000000100,a08,lseek
1,55870335700,55870335800,00000000100,a08,lseek
1,55870338300,55870338700,00000000400,a09,mmap
1,55870337900,55870338800,00000000900,a08,lseek
1,55870344000,55870344400,00000000400,a09,mmap
1,55870344500,55870344500,00000000000,a08,lseek
1,55870353900,55870354400,00000000500,a09,mmap
1,55870354500,55870354500,00000000000,a08,lseek
1,55870369000,55870369300,00000000300,a09,mmap
1,55870369400,55870369500,00000000100,a08,lseek
1,55870383100,55870383600,00000000500,a09,mmap
1,55870383600,55870383700,00000000100,a08,lseek
1,55870399600,55870399700,00000000100,a08,lseek
1,55870401800,55870402300,00000000500,a09,mmap
1,55870402400,55870402400,00000000000,a08,lseek
1,55870407300,55870407700,00000000400,a09,mmap
1,55870407800,55870407900,00000000100,a08,lseek
1,55870417300,55870417700,00000000400,a09,mmap
1,55870417800,55870417900,00000000100,a08,lseek
1,55870432200,55870432600,00000000400,a09,mmap
1,55870432700,55870432800,00000000100,a08,lseek
1,55870446500,55870447000,00000000500,a09,mmap
1,55870447000,55870447000,00000000000,a08,lseek
1,55870463200,55870463300,00000000100,a08,lseek
1,55870465500,55870466000,00000000500,a09,mmap
1,55870466000,55870466100,00000000100,a08,lseek
1,55870471100,55870471600,00000000500,a09,mmap
1,55870471700,55870471700,00000000000,a08,lseek
1,55870481100,55870481500,00000000400,a09,mmap
1,55870481500,55870481600,00000000100,a08,lseek
1,55870495800,55870496200,00000000400,a09,mmap
1,55870496300,55870496400,00000000100,a08,lseek
1,55870509900,55870510300,00000000400,a09,mmap
1,55870510300,55870510400,00000000100,a08,lseek
1,55870526700,55870526800,00000000100,a08,lseek
1,55870529000,55870529500,00000000500,a09,mmap
1,55870529600,55870529700,00000000100,a08,lseek
1,55870534500,55870535000,00000000500,a09,mmap
1,55870535100,55870535100,00000000000,a08,lseek
1,55870544400,55870544900,00000000500,a09,mmap
1,55870544900,55870545000,00000000100,a08,lseek
1,55870559100,55870559600,00000000500,a09,mmap
1,55870559600,55870559700,00000000100,a08,lseek
1,55870573300,55870573700,00000000400,a09,mmap
1,55870573800,55870573800,00000000000,a08,lseek
1,55870590300,55870590400,00000000100,a08,lseek
1,55870586800,55870592300,00000005500,a01,write
1,55870592800,55870593300,00000000500,a09,mmap
1,55870593300,55870593400,00000000100,a08,lseek
1,55870598400,55870598800,00000000400,a09,mmap
1,55870598900,55870599000,00000000100,a08,lseek
1,55870608600,55870609100,00000000500,a09,mmap
1,55870609100,55870609200,00000000100,a08,lseek
1,55870623600,55870623900,00000000300,a09,mmap
1,55870624000,55870624000,00000000000,a08,lseek
1,55870637900,55870638300,00000000400,a09,mmap
1,55870638400,55870638500,00000000100,a08,lseek
1,55870655100,55870655200,00000000100,a08,lseek
1,55870657400,55870657900,00000000500,a09,mmap
1,55870657900,55870657900,00000000000,a08,lseek
1,55870662900,55870663400,00000000500,a09,mmap
1,55870662500,55870663500,00000001000,a08,lseek
1,55870672900,55870673300,00000000400,a09,mmap
1,55870673400,55870673500,00000000100,a08,lseek
1,55870687700,55870688200,00000000500,a09,mmap
1,55870688200,55870688300,00000000100,a08,lseek
1,55870691000,55870693000,00000002000,a01,write
1,55870701800,55870702200,00000000400,a09,mmap
1,55870702200,55870702300,00000000100,a08,lseek
1,47199499200,55870704800,08671205600,b0f,ppoll
1,55870710200,55870712000,00000001800,a2f,recvmsg
1,55870718400,55870718700,00000000300,a2f,recvmsg
1,55870719200,55870719300,00000000100,a08,lseek
1,55870719600,55870720500,00000000900,a00,read
1,55870722900,55870723300,00000000400,a09,mmap
1,55870723400,55870723500,00000000100,a08,lseek
1,48555626200,55870725100,07315098900,ae8,epoll_wait
1,55870728500,55870729000,00000000500,a09,mmap
1,55870729000,55870729100,00000000100,a08,lseek
1,55870738400,55870738900,00000000500,a09,mmap
1,55870738900,55870739000,00000000100,a08,lseek
1,55870753300,55870753700,00000000400,a09,mmap
1,55870753800,55870753900,00000000100,a08,lseek
1,55870756700,55870760100,00000003400,a2f,recvmsg
1,55870767700,55870768100,00000000400,a09,mmap
1,55870768100,55870768100,00000000000,a08,lseek
1,55870781100,55870781400,00000000300,a2f,recvmsg
1,55870783300,55870784500,00000001200,a2f,recvmsg
1,55870785200,55870785200,00000000000,a08,lseek
1,55870789500,55870789700,00000000200,a2f,recvmsg
1,55870788000,55870791000,00000003000,a2a,connect
1,55870791000,55870792900,00000001900,a2f,recvmsg
1,55870794400,55870795000,00000000600,a09,mmap
1,55870795000,55870795100,00000000100,a08,lseek
1,55870800400,55870800900,00000000500,a09,mmap
1,55870800900,55870801000,00000000100,a08,lseek
1,55870805500,55870805800,00000000300,a2f,recvmsg
1,55870810400,55870810900,00000000500,a09,mmap
1,55870810900,55870811000,00000000100,a08,lseek
1,55870826200,55870826600,00000000400,a09,mmap
1,55870826700,55870826800,00000000100,a08,lseek
1,55870840900,55870841300,00000000400,a09,mmap
1,55870841400,55870841500,00000000100,a08,lseek
1,55870859000,55870859100,00000000100,a08,lseek
1,55870861400,55870861900,00000000500,a09,mmap
1,55870861900,55870862000,00000000100,a08,lseek
1,55870866900,55870867400,00000000500,a09,mmap
1,55870867400,55870867500,00000000100,a08,lseek
1,55870877000,55870877500,00000000500,a09,mmap
1,55870876700,55870877600,00000000900,a08,lseek
1,55870892000,55870892500,00000000500,a09,mmap
1,55870892500,55870892600,00000000100,a08,lseek
1,55870903600,55870905000,00000001400,a2e,sendmsg
1,55870906400,55870906800,00000000400,a09,mmap
1,55870906800,55870906800,00000000000,a08,lseek
1,55870924200,55870924300,00000000100,a08,lseek
1,55870927100,55870927600,00000000500,a09,mmap
1,55870927700,55870927700,00000000000,a08,lseek
1,55870932700,55870933200,00000000500,a09,mmap
1,55870933200,55870933300,00000000100,a08,lseek
1,55870942700,55870943100,00000000400,a09,mmap
1,55870943100,55870943200,00000000100,a08,lseek
1,55870957700,55870958100,00000000400,a09,mmap
1,55870958100,55870958200,00000000100,a08,lseek
1,55870971800,55870972200,00000000400,a09,mmap
1,55870972200,55870972300,00000000100,a08,lseek
1,55870990000,55870990100,00000000100,a08,lseek
1,55870992300,55870992700,00000000400,a09,mmap
1,55870992800,55870992900,00000000100,a08,lseek
1,55870997900,55870998300,00000000400,a09,mmap
1,55870998300,55870998400,00000000100,a08,lseek
1,55871007800,55871008300,00000000500,a09,mmap
1,55871008300,55871008400,00000000100,a08,lseek
1,55871022700,55871023000,00000000300,a09,mmap
1,55871023100,55871023200,00000000100,a08,lseek
1,55870720300,55871032300,00000312000,b0f,ppoll
1,55871036700,55871037100,00000000400,a09,mmap
1,55871036300,55871037200,00000000900,a08,lseek
1,55871054900,55871055000,00000000100,a08,lseek
1,55871057000,55871057500,00000000500,a09,mmap
1,55871057600,55871057700,00000000100,a08,lseek
1,55871055500,55871057900,00000002400,a2e,sendmsg
1,55871059200,55871059800,00000000600,a2f,recvmsg
1,55871061900,55871062100,00000000200,a2f,recvmsg
1,55871062600,55871063000,00000000400,a09,mmap
1,55871063100,55871063100,00000000000,a08,lseek
1,55871021400,55871065600,00000044200,ae8,epoll_wait
1,55871069500,55871070500,00000001000,a2f,recvmsg
1,55871072600,55871073000,00000000400,a09,mmap
1,55871073100,55871073200,00000000100,a08,lseek
1,55871077800,55871078000,00000000200,a2f,recvmsg
1,55871087300,55871087700,00000000400,a09,mmap
1,55871087800,55871087800,00000000000,a08,lseek
1,55871101300,55871101800,00000000500,a09,mmap
1,55871101800,55871101900,00000000100,a08,lseek
1,55871117900,55871119800,00000001900,a2e,sendmsg
1,55871119700,55871119800,00000000100,a08,lseek
1,55871122200,55871122600,00000000400,a09,mmap
1,55871122700,55871122800,00000000100,a08,lseek
1,55871128400,55871128800,00000000400,a09,mmap
1,55871128900,55871129000,00000000100,a08,lseek
1,55871138500,55871138900,00000000400,a09,mmap
1,55871138900,55871139000,00000000100,a08,lseek
1,55871153300,55871153700,00000000400,a09,mmap
1,55871153700,55871153800,00000000100,a08,lseek
1,55871167400,55871167800,00000000400,a09,mmap
1,55871167900,55871167900,00000000000,a08,lseek
1,55871186100,55871186100,00000000000,a08,lseek
1,55871194200,55871196300,00000002100,a15,access
1,55871204200,55871210800,00000006600,a00,read
1,55871215000,55871215800,00000000800,a09,mmap
1,55871214600,55871215900,00000001300,a08,lseek
1,55871231700,55871232300,00000000600,a00,read
1,55871234600,55871235200,00000000600,a00,read
1,55871237900,55871238400,00000000500,a09,mmap
1,55871238500,55871238600,00000000100,a08,lseek
1,55871253300,55871253800,00000000500,a00,read
1,55871255600,55871256000,00000000400,a00,read
1,55871258500,55871258900,00000000400,a09,mmap
1,55871259000,55871259100,00000000100,a08,lseek
1,55871272200,55871272600,00000000400,a00,read
1,55871275100,55871275500,00000000400,a09,mmap
1,55871275500,55871275600,00000000100,a08,lseek
1,55871288100,55871288500,00000000400,a00,read
1,55871290300,55871290500,00000000200,a00,read
1,55871292700,55871293200,00000000500,a09,mmap
1,55871293200,55871293300,00000000100,a08,lseek
1,55871305200,55871305600,00000000400,a00,read
1,55871308400,55871312200,00000003800,a2a,connect
1,55871315600,55871316300,00000000700,a09,mmap
1,55871316300,55871316400,00000000100,a08,lseek
1,55871329600,55871330100,00000000500,a00,read
1,55871332100,55871332600,00000000500,a00,read
1,55871334300,55871334700,00000000400,a00,read
1,55871337100,55871337600,00000000500,a09,mmap
1,55871337700,55871337800,00000000100,a08,lseek
1,55871349600,55871350000,00000000400,a00,read
1,55871352400,55871352900,00000000500,a09,mmap
1,55871352900,55871353000,00000000100,a08,lseek
1,55871364400,55871364700,00000000300,a00,read
1,55871366600,55871366900,00000000300,a00,read
1,55871369300,55871369800,00000000500,a09,mmap
1,55871369800,55871369900,00000000100,a08,lseek
1,55871380800,55871381200,00000000400,a00,read
1,55871383500,55871383800,00000000300,a09,mmap
1,55871383900,55871384000,00000000100,a08,lseek
1,55871394500,55871394900,00000000400,a00,read
1,55871396700,55871396900,00000000200,a00,read
1,55871399000,55871399500,00000000500,a09,mmap
1,55871399600,55871399600,00000000000,a08,lseek
1,55871410800,55871411100,00000000300,a00,read
1,55871412900,55871413100,00000000200,a00,read
1,55871415400,55871415800,00000000400,a09,mmap
1,55871415900,55871416000,00000000100,a08,lseek
1,55871427900,55871428300,00000000400,a00,read
1,55871431100,55871431400,00000000300,a09,mmap
1,55871431500,55871431600,00000000100,a08,lseek
1,55871442600,55871443100,00000000500,a00,read
1,55871445500,55871446000,00000000500,a09,mmap
1,55871446100,55871446100,00000000000,a08,lseek
1,55871459200,55871459600,00000000400,a00,read
1,55871461900,55871462400,00000000500,a09,mmap
1,55871462400,55871462500,00000000100,a08,lseek
1,55871476000,55871476400,00000000400,a00,read
1,55871478100,55871478400,00000000300,a00,read
1,55871480100,55871480400,00000000300,a00,read
1,55871482200,55871482500,00000000300,a00,read
1,55871485000,55871485500,00000000500,a09,mmap
1,55871485600,55871485700,00000000100,a08,lseek
1,55871496600,55871496900,00000000300,a00,read
1,55871498600,55871498900,00000000300,a00,read
1,55871501200,55871501700,00000000500,a09,mmap
1,55871501700,55871501800,00000000100,a08,lseek
1,55871512200,55871512600,00000000400,a00,read
1,55871514300,55871514600,00000000300,a00,read
1,55871516800,55871517300,00000000500,a09,mmap
1,55871517300,55871517400,00000000100,a08,lseek
1,55871527600,55871528000,00000000400,a00,read
1,55871529700,55871530100,00000000400,a00,read
1,55871532200,55871532600,00000000400,a00,read
1,55871534200,55871534500,00000000300,a00,read
1,55871536200,55871536400,00000000200,a00,read
1,55871538100,55871538400,00000000300,a00,read
1,55871540900,55871541400,00000000500,a09,mmap
1,55871540500,55871541400,00000000900,a08,lseek
1,55871552400,55871552800,00000000400,a00,read
1,55871554400,55871554700,00000000300,a00,read
1,55871557000,55871557400,00000000400,a09,mmap
1,55871557500,55871557600,00000000100,a08,lseek
1,55871572600,55871573000,00000000400,a00,read
1,55871574700,55871575000,00000000300,a00,read
1,55871577800,55871578200,00000000400,a09,mmap
1,55871578300,55871578400,00000000100,a08,lseek
1,55871592600,55871592800,00000000200,a00,read
1,55871594600,55871595100,00000000500,a00,read
1,55871596700,55871597000,00000000300,a00,read
1,55871599400,55871599800,00000000400,a09,mmap
1,55871599900,55871600000,00000000100,a08,lseek
1,55871611400,55871611800,00000000400,a00,read
1,55871614200,55871614600,00000000400,a09,mmap
1,55871614700,55871614800,00000000100,a08,lseek
1,55871625800,55871626200,00000000400,a00,read
1,55871627900,55871628100,00000000200,a00,read
1,55871630400,55871630700,00000000300,a09,mmap
1,55871630800,55871630900,00000000100,a08,lseek
1,55871641900,55871642100,00000000200,a00,read
1,55871643900,55871644100,00000000200,a00,read
1,55871645800,55871646000,00000000200,a00,read
1,55871648200,55871648700,00000000500,a09,mmap
1,55871648700,55871648800,00000000100,a08,lseek
1,55871659500,55871659800,00000000300,a00,read
1,55871662100,55871662600,00000000500,a09,mmap
1,55871662600,55871662700,00000000100,a08,lseek
1,55871673600,55871674000,00000000400,a00,read
1,55871676300,55871676700,00000000400,a09,mmap
1,55871676700,55871676800,00000000100,a08,lseek
1,55871687700,55871688100,00000000400,a00,read
1,55871690300,55871690800,00000000500,a09,mmap
1,55871690800,55871690900,00000000100,a08,lseek
1,55871700300,55871700900,00000000600,a00,read
1,55871703000,55871703500,00000000500,a09,mmap
1,55871703600,55871703600,00000000000,a08,lseek
1,55871713100,55871713500,00000000400,a00,read
1,55871715800,55871716200,00000000400,a09,mmap
1,55871716200,55871716300,00000000100,a08,lseek
1,55871124100,55871721400,00000597300,ae8,epoll_wait
1,55871726900,55871727400,00000000500,a00,read
1,55871729100,55871729400,00000000300,a00,read
1,55871728500,55871729500,00000001000,a2f,recvmsg
1,55871731600,55871732100,00000000500,a09,mmap
1,55871732100,55871732200,00000000100,a08,lseek
1,55871734100,55871734200,00000000100,a2f,recvmsg
1,55871742500,55871742800,00000000300,a00,read
1,55871745200,55871745600,00000000400,a09,mmap
1,55871745700,55871745800,00000000100,a08,lseek
1,55871755900,55871756200,00000000300,a00,read
1,55871758700,55871759200,00000000500,a09,mmap
1,55871759200,55871759300,00000000100,a08,lseek
1,55871767900,55871769000,00000001100,a2f,recvmsg
1,55871770000,55871770400,00000000400,a00,read
1,55871773800,55871773900,00000000100,a2f,recvmsg
1,55871802900,55871803800,00000000900,a2e,sendmsg
1,55871062600,55871808700,00000746100,b0f,ppoll
1,55871829500,55871836100,00000006600,a2e,sendmsg
1,55871860600,55871862100,00000001500,a2e,sendmsg
1,55871863500,55871864600,00000001100,a53,mkdir
1,55871876800,55871877200,00000000400,a48,fcntl
1,55871805700,55871888900,00000083200,ae8,epoll_wait
1,55871888000,55871895300,00000007300,a01,write
1,55871896400,55871899300,00000002900,a2f,recvmsg
1,55871910100,55871910500,00000000400,a2f,recvmsg
1,55871927900,55871929500,00000001600,a2e,sendmsg
1,55871062600,55871955400,00000892800,b0f,ppoll
1,55871977600,55871978800,00000001200,a00,read
1,55871994200,55871995000,00000000800,a00,read
1,55871940200,55872004300,00000064100,ae8,epoll_wait
1,55872017700,55872022200,00000004500,ae8,epoll_wait
1,55872027400,55872030100,00000002700,a2f,recvmsg
1,55872046200,55872046400,00000000200,a2f,recvmsg
1,55872048100,55872049100,00000001000,a2f,recvmsg
1,55872054200,55872054400,00000000200,a2f,recvmsg
1,55872141800,55872145900,00000004100,a2e,sendmsg
1,55872147800,55872149600,00000001800,a2e,sendmsg
1,55872150700,55872153700,00000003000,a2e,sendmsg
1,55872167000,55872171800,00000004800,a2e,sendmsg
1,55872174100,55872176700,00000002600,a2e,sendmsg
1,55872177900,55872179900,00000002000,a2e,sendmsg
1,55872181200,55872183400,00000002200,a2e,sendmsg
1,55872184900,55872187800,00000002900,a2e,sendmsg
1,55872189100,55872191300,00000002200,a2e,sendmsg
1,55872192600,55872195000,00000002400,a2e,sendmsg
1,55871963000,55872203800,00000240800,a07,poll
1,55872206000,55872206900,00000000900,a00,read
1,55872222800,55872224300,00000001500,a2f,recvmsg
1,55872294100,55872298500,00000004400,a07,poll
1,55872295200,55872299500,00000004300,a2e,sendmsg
1,55872300100,55872300600,00000000500,a00,read
1,55872316500,55872318000,00000001500,a2f,recvmsg
1,55872333200,55872354200,00000021000,a07,poll
1,55872355700,55872356700,00000001000,a00,read
1,55872374000,55872375800,00000001800,a2f,recvmsg
1,55872373500,55872377400,00000003900,a07,poll
1,55872391100,55872440200,00000049100,a07,poll
1,55872443200,55872445100,00000001900,aca,futex
1,55872454100,55872455000,00000000900,aca,futex
1,55872584600,55872588000,00000003400,a2e,sendmsg
1,55872590800,55872590900,00000000100,a00,read
1,55872593000,55872594000,00000001000,a2e,sendmsg
1,55872603200,55872607500,00000004300,a07,poll
1,55872609200,55872609700,00000000500,a00,read
1,55872625700,55872627000,00000001300,a2f,recvmsg
1,55872640700,55872687700,00000047000,a07,poll
1,55872690200,55872691300,00000001100,aca,futex
1,55872698500,55872699400,00000000900,aca,futex
1,55872718900,55872724500,00000005600,a07,poll
1,55872736800,55872738700,00000001900,a2f,recvmsg
1,55872754800,55872755200,00000000400,a2f,recvmsg
1,55872761500,55872762000,00000000500,a2f,recvmsg
1,55872773500,55872773900,00000000400,a2f,recvmsg
1,55872777700,55872777900,00000000200,a2f,recvmsg
1,55872348500,55872783300,00000434800,ae8,epoll_wait
1,55872778700,55872807900,00000029200,a07,poll
1,55872856000,55872862600,00000006600,a09,mmap
1,55872862700,55872862900,00000000200,a08,lseek
1,55872885200,55872886400,00000001200,a09,mmap
1,55872886500,55872886600,00000000100,a08,lseek
1,55872953500,55872966500,00000013000,a00,read
1,55872977100,55872984200,00000007100,a00,read
1,55873003000,55873004700,00000001700,a00,read
1,55873017900,55873018300,00000000400,a00,read
1,55873030900,55873031500,00000000600,a00,read
1,55873044200,55873046100,00000001900,a09,mmap
1,55873046200,55873046200,00000000000,a08,lseek
1,55873063300,55873070500,00000007200,a2a,connect
1,55873077000,55873077900,00000000900,a09,mmap
1,55873077900,55873078000,00000000100,a08,lseek
1,55873105800,55873106400,00000000600,a09,mmap
1,55873106500,55873106600,00000000100,a08,lseek
1,55873124400,55873125000,00000000600,a09,mmap
1,55873125100,55873125200,00000000100,a08,lseek
1,55873612800,55873613300,00000000500,a00,read
1,55873638000,55873639300,00000001300,a00,read
1,55872801100,55873648500,00000847400,ae8,epoll_wait
1,55873671300,55873672800,00000001500,a2f,recvmsg
1,55873679800,55873684000,00000004200,ae8,epoll_wait
1,55873693900,55873696300,00000002400,a2f,recvmsg
1,55873712400,55873712700,00000000300,a2f,recvmsg
1,55873714600,55873718900,00000004300,a2f,recvmsg
1,55873759800,55873763800,00000004000,a2f,recvmsg
1,55873810600,55873813100,00000002500,a2f,recvmsg
1,55873818500,55873818800,00000000300,a2f,recvmsg
1,55873873600,55873878100,00000004500,a2e,sendmsg
1,55873914000,55873915200,00000001200,a2e,sendmsg
1,55873952200,55873954900,00000002700,a2e,sendmsg
1,55873986000,55873987000,00000001000,a2e,sendmsg
1,55874014800,55874015500,00000000700,a2e,sendmsg
1,55874043300,55874044100,00000000800,a2e,sendmsg
1,55874071500,55874072300,00000000800,a2e,sendmsg
1,55874098600,55874099500,00000000900,a2e,sendmsg
1,55874125200,55874126100,00000000900,a2e,sendmsg
1,55874151900,55874152800,00000000900,a2e,sendmsg
1,55874177700,55874178600,00000000900,a2e,sendmsg
1,55874203400,55874204300,00000000900,a2e,sendmsg
1,55874228900,55874229700,00000000800,a2e,sendmsg
1,55874242300,55874244000,00000001700,a2f,recvmsg
1,55874253000,55874253200,00000000200,a2f,recvmsg
1,55874254200,55874255800,00000001600,a2f,recvmsg
1,55874275300,55874275500,00000000200,a2f,recvmsg
1,55874372800,55874373900,00000001100,a2e,sendmsg
1,55874375000,55874378100,00000003100,a2e,sendmsg
1,55873643600,55874381700,00000738100,a07,poll
1,55874383600,55874384500,00000000900,a00,read
1,55874399400,55874400600,00000001200,a2f,recvmsg
1,55874460600,55874464800,00000004200,a07,poll
1,55874580500,55874584500,00000004000,a2e,sendmsg
1,55874571200,55874587500,00000016300,a07,poll
1,55874589200,55874589800,00000000600,a00,read
1,55874604000,55874605200,00000001200,a2f,recvmsg
1,55874618900,55874656800,00000037900,a07,poll
1,55874660300,55874661900,00000001600,aca,futex
1,55874668500,55874669300,00000000800,aca,futex
1,55874754300,55874758100,00000003800,a2e,sendmsg
1,55874695400,55874761400,00000066000,a07,poll
1,55874777800,55874779200,00000001400,a2f,recvmsg
1,55874793600,55874867200,00000073600,a07,poll
1,55874869300,55874870600,00000001300,aca,futex
1,55874978100,55874981900,00000003800,a2e,sendmsg
1,55874988700,55874990100,00000001400,a2f,recvmsg
1,55874997600,55874997800,00000000200,a2f,recvmsg
1,55874999800,55875001600,00000001800,a2f,recvmsg
1,55875021000,55875021200,00000000200,a2f,recvmsg
1,55875088000,55875096700,00000008700,a01,write
1,55875152900,55875156500,00000003600,a2e,sendmsg
1,55875158300,55875161000,00000002700,a2e,sendmsg
1,55874945800,55875164700,00000218900,a07,poll
1,55875166600,55875167600,00000001000,a00,read
1,55875182900,55875184300,00000001400,a2f,recvmsg
1,55875244500,55875248200,00000003700,a07,poll
1,55875300600,55875302400,00000001800,a2e,sendmsg
1,55875328200,55875329100,00000000900,a2e,sendmsg
1,55875260700,55875351800,00000091100,a07,poll
1,55875394200,55875400200,00000006000,a09,mmap
1,55875400300,55875400500,00000000200,a08,lseek
1,55875406200,55875413500,00000007300,a0b,munmap
1,55875424100,55875425100,00000001000,a09,mmap
1,55875425100,55875425200,00000000100,a08,lseek
1,55875432400,55875434600,00000002200,a0b,munmap
1,55875446100,55875447200,00000001100,aca,futex
1,55875487700,55875501100,00000013400,a00,read
1,55875511300,55875517700,00000006400,a00,read
1,55875535800,55875537700,00000001900,a00,read
1,55875550700,55875551100,00000000400,a00,read
1,55875563200,55875563700,00000000500,a00,read
1,55875575400,55875577000,00000001600,a09,mmap
1,55875577000,55875577100,00000000100,a08,lseek
1,55875584500,55875587900,00000003400,a0b,munmap
1,55875592600,55875593100,00000000500,a09,mmap
1,55875593200,55875593300,00000000100,a08,lseek
1,55875618600,55875619100,00000000500,a09,mmap
1,55875619200,55875619300,00000000100,a08,lseek
1,55875635900,55875636600,00000000700,a09,mmap
1,55875636700,55875636700,00000000000,a08,lseek
1,55876087900,55876088400,00000000500,aca,futex
1,55875333800,55876144600,00000810800,ae8,epoll_wait
1,55876161600,55876162200,00000000600,a2f,recvmsg
1,55876167800,55876167900,00000000100,a2f,recvmsg
1,55876140300,55876304000,00000163700,a07,poll
1,55876349000,55876356000,00000007000,a07,poll
1,55876388100,55876392100,00000004000,a09,mmap
1,55876392100,55876392300,00000000200,a08,lseek
1,55876407100,55876407900,00000000800,a09,mmap
1,55876408000,55876408100,00000000100,a08,lseek
1,55876449300,55876460600,00000011300,a00,read
1,55876468900,55876474500,00000005600,a00,read
1,55876489600,55876490900,00000001300,a00,read
1,55876502600,55876503000,00000000400,a00,read
1,55876514300,55876514800,00000000500,a00,read
1,55876525300,55876526900,00000001600,a09,mmap
1,55876527000,55876527000,00000000000,a08,lseek
1,55876539300,55876539800,00000000500,a09,mmap
1,55876539800,55876539900,00000000100,a08,lseek
1,55876563300,55876563800,00000000500,a09,mmap
1,55876563900,55876564000,00000000100,a08,lseek
1,55876580000,55876580400,00000000400,a09,mmap
1,55876580500,55876580600,00000000100,a08,lseek
1,55876347000,55877055400,00000708400,ae8,epoll_wait
1,55877072700,55877073500,00000000800,a2f,recvmsg
1,55877079300,55877079500,00000000200,a2f,recvmsg
1,55877051300,55877208200,00000156900,a07,poll
1,55877242400,55877251600,00000009200,a07,poll
1,55877284000,55877287600,00000003600,a09,mmap
1,55877287800,55877287900,00000000100,a08,lseek
1,55877302600,55877303300,00000000700,a09,mmap
1,55877303400,55877303500,00000000100,a08,lseek
1,55877344400,55877354700,00000010300,a00,read
1,55877362900,55877368700,00000005800,a00,read
1,55877383700,55877384800,00000001100,a00,read
1,55877397200,55877397500,00000000300,a00,read
1,55877409000,55877409500,00000000500,a00,read
1,55877420300,55877421700,00000001400,a09,mmap
1,55877421800,55877421900,00000000100,a08,lseek
1,55877434200,55877434600,00000000400,a09,mmap
1,55877434700,55877434800,00000000100,a08,lseek
1,55877458200,55877458700,00000000500,a09,mmap
1,55877458800,55877458900,00000000100,a08,lseek
1,55877473600,55877474100,00000000500,a09,mmap
1,55877474200,55877474300,00000000100,a08,lseek
1,55877213500,55877935800,00000722300,ae8,epoll_wait
1,55877953300,55877954100,00000000800,a2f,recvmsg
1,55877960000,55877960200,00000000200,a2f,recvmsg
1,55877931700,55878071000,00000139300,a07,poll
1,55878101900,55878123200,00000021300,a07,poll
1,55878152500,55878155400,00000002900,a09,mmap
1,55878155500,55878155600,00000000100,a08,lseek
1,55878158600,55878164100,00000005500,a0b,munmap
1,55878172100,55878172800,00000000700,a09,mmap
1,55878172900,55878173000,00000000100,a08,lseek
1,55878212100,55878221300,00000009200,a00,read
1,55878229300,55878234100,00000004800,a00,read
1,55878247700,55878248600,00000000900,a00,read
1,55878260200,55878260600,00000000400,a00,read
1,55878271500,55878272000,00000000500,a00,read
1,55878283100,55878284500,00000001400,a09,mmap
1,55878284500,55878284600,00000000100,a08,lseek
1,55878296200,55878296700,00000000500,a09,mmap
1,55878296700,55878296800,00000000100,a08,lseek
1,55878319100,55878319500,00000000400,a09,mmap
1,55878319600,55878319700,00000000100,a08,lseek
1,55878334000,55878334500,00000000500,a09,mmap
1,55878334600,55878334700,00000000100,a08,lseek
1,55878075100,55878819300,00000744200,ae8,epoll_wait
1,55878824100,55878826600,00000002500,a2f,recvmsg
1,55878841200,55878841400,00000000200,a2f,recvmsg
1,55878815500,55879016700,00000201200,a07,poll
1,55879045400,55879048100,00000002700,a09,mmap
1,55879048200,55879048300,00000000100,a08,lseek
1,55879051400,55879055900,00000004500,a0b,munmap
1,55879063300,55879063900,00000000600,a09,mmap
1,55879064000,55879064100,00000000100,a08,lseek
1,55879103900,55879113600,00000009700,a00,read
1,55879121400,55879126400,00000005000,a00,read
1,55879140000,55879141300,00000001300,a00,read
1,55879153000,55879153300,00000000300,a00,read
1,55879164400,55879164900,00000000500,a00,read
1,55879175100,55879176400,00000001300,a09,mmap
1,55879176500,55879176700,00000000200,a08,lseek
1,55879188300,55879188800,00000000500,a09,mmap
1,55879188900,55879188900,00000000000,a08,lseek
1,55879211100,55879211600,00000000500,a09,mmap
1,55879211700,55879211700,00000000000,a08,lseek
1,55879226300,55879226700,00000000400,a09,mmap
1,55879226700,55879226800,00000000100,a08,lseek
1,55878927900,55879596100,00000668200,ae8,epoll_wait
1,55879612000,55879612300,00000000300,a2f,recvmsg
1,55879649400,55879745600,00000096200,ae8,epoll_wait
1,55879749400,55879751100,00000001700,a2f,recvmsg
1,55879759200,55879759400,00000000200,a2f,recvmsg
1,55879738800,55879843100,00000104300,a07,poll
1,55879870900,55879873600,00000002700,a09,mmap
1,55879873700,55879873800,00000000100,a08,lseek
1,55879876700,55879881200,00000004500,a0b,munmap
1,55879888700,55879889400,00000000700,a09,mmap
1,55879889500,55879889600,00000000100,a08,lseek
1,55879927300,55879936100,00000008800,a00,read
1,55879943800,55879948800,00000005000,a00,read
1,55879962000,55879963100,00000001100,a00,read
1,55879975000,55879975500,00000000500,a00,read
1,55879986500,55879986900,00000000400,a00,read
1,55879997600,55879999100,00000001500,a09,mmap
1,55879999200,55879999300,00000000100,a08,lseek
1,55880010600,55880011000,00000000400,a09,mmap
1,55880011100,55880011200,00000000100,a08,lseek
1,55880032800,55880033300,00000000500,a09,mmap
1,55880033400,55880033500,00000000100,a08,lseek
1,55880048100,55880048800,00000000700,a09,mmap
1,55880048900,55880049000,00000000100,a08,lseek
1,55879810900,55880106600,00000295700,ae8,epoll_wait
1,55880120200,55880120500,00000000300,a2f,recvmsg
1,55880156600,55880250400,00000093800,ae8,epoll_wait
1,55880254000,55880255600,00000001600,a2f,recvmsg
1,55880263300,55880263500,00000000200,a2f,recvmsg
1,55880244100,55880345600,00000101500,a07,poll
1,55880372800,55880374700,00000001900,a09,mmap
1,55880374800,55880374900,00000000100,a08,lseek
1,55880377600,55880381800,00000004200,a0b,munmap
1,55880389000,55880389700,00000000700,a09,mmap
1,55880389700,55880389800,00000000100,a08,lseek
1,55880412300,55880420200,00000007900,a00,read
1,55880427000,55880431500,00000004500,a00,read
1,55880444600,55880445500,00000000900,a00,read
1,55880456500,55880456900,00000000400,a00,read
1,55880467900,55880468400,00000000500,a00,read
1,55880478900,55880480100,00000001200,a09,mmap
1,55880480200,55880480300,00000000100,a08,lseek
1,55880491000,55880491400,00000000400,a09,mmap
1,55880491500,55880491600,00000000100,a08,lseek
1,55880512800,55880513200,00000000400,a09,mmap
1,55880513300,55880513400,00000000100,a08,lseek
1,55880526900,55880527400,00000000500,a09,mmap
1,55880527500,55880527600,00000000100,a08,lseek
1,55880314300,55880895200,00000580900,ae8,epoll_wait
1,55880909600,55880909900,00000000300,a2f,recvmsg
1,55880945400,55881038500,00000093100,ae8,epoll_wait
1,55881042000,55881043500,00000001500,a2f,recvmsg
1,55881051400,55881051600,00000000200,a2f,recvmsg
1,55881032400,55881132100,00000099700,a07,poll
1,55881159200,55881161600,00000002400,a09,mmap
1,55881161700,55881161800,00000000100,a08,lseek
1,55881164600,55881168900,00000004300,a0b,munmap
1,55881176300,55881177000,00000000700,a09,mmap
1,55881177000,55881177100,00000000100,a08,lseek
1,55881214300,55881223000,00000008700,a00,read
1,55881230200,55881234900,00000004700,a00,read
1,55881248400,55881249400,00000001000,a00,read
1,55881261200,55881261500,00000000300,a00,read
1,55881272700,55881273200,00000000500,a00,read
1,55881283700,55881285000,00000001300,a09,mmap
1,55881285100,55881285200,00000000100,a08,lseek
1,55881296400,55881296900,00000000500,a09,mmap
1,55881296900,55881297000,00000000100,a08,lseek
1,55881318900,55881319400,00000000500,a09,mmap
1,55881319400,55881319500,00000000100,a08,lseek
1,55881333700,55881334000,00000000300,a09,mmap
1,55881334100,55881334200,00000000100,a08,lseek
1,55881101300,55881695600,00000594300,ae8,epoll_wait
1,55881710200,55881710500,00000000300,a2f,recvmsg
1,55881746100,55881839600,00000093500,ae8,epoll_wait
1,55881843400,55881844900,00000001500,a2f,recvmsg
1,55881852900,55881853100,00000000200,a2f,recvmsg
1,55881833200,55881934600,00000101400,a07,poll
1,55881961700,55881964300,00000002600,a09,mmap
1,55881964400,55881964500,00000000100,a08,lseek
1,55881967500,55881972000,00000004500,a0b,munmap
1,55881979500,55881980100,00000000600,a09,mmap
1,55881980200,55881980300,00000000100,a08,lseek
1,55882018600,55882027500,00000008900,a00,read
1,55882034700,55882039200,00000004500,a00,read
1,55882052500,55882053500,00000001000,a00,read
1,55882065000,55882065400,00000000400,a00,read
1,55882075900,55882076400,00000000500,a00,read
1,55882086500,55882088000,00000001500,a09,mmap
1,55882088100,55882088200,00000000100,a08,lseek
1,55882099400,55882099800,00000000400,a09,mmap
1,55882099900,55882099900,00000000000,a08,lseek
1,55882121700,55882122100,00000000400,a09,mmap
1,55882122200,55882122300,00000000100,a08,lseek
1,55882136500,55882137000,00000000500,a09,mmap
1,55882137000,55882137100,00000000100,a08,lseek
1,55881904000,55882494700,00000590700,ae8,epoll_wait
1,55882508700,55882508900,00000000200,a2f,recvmsg
1,55882544600,55882639200,00000094600,ae8,epoll_wait
1,55882642500,55882644100,00000001600,a2f,recvmsg
1,55882652000,55882652300,00000000300,a2f,recvmsg
1,55882633400,55882779500,00000146100,a07,poll
1,55882808500,55882811300,00000002800,a09,mmap
1,55882811400,55882811500,00000000100,a08,lseek
1,55882814800,55882818900,00000004100,a0b,munmap
1,55882826500,55882827300,00000000800,a09,mmap
1,55882827300,55882827400,00000000100,a08,lseek
1,55882866900,55882875800,00000008900,a00,read
1,55882883500,55882888200,00000004700,a00,read
1,55882901300,55882902300,00000001000,a00,read
1,55882914200,55882914600,00000000400,a00,read
1,55882925500,55882925900,00000000400,a00,read
1,55882936500,55882937900,00000001400,a09,mmap
1,55882938000,55882938100,00000000100,a08,lseek
1,55882949700,55882950200,00000000500,a09,mmap
1,55882950300,55882950400,00000000100,a08,lseek
1,55882972300,55882972800,00000000500,a09,mmap
1,55882972800,55882972900,00000000100,a08,lseek
1,55882987100,55882987600,00000000500,a09,mmap
1,55882987600,55882987700,00000000100,a08,lseek
1,55882702100,55883352200,00000650100,ae8,epoll_wait
1,55883367000,55883367200,00000000200,a2f,recvmsg
1,55883405000,55883499400,00000094400,ae8,epoll_wait
1,55883502800,55883504800,00000002000,a2f,recvmsg
1,55883512700,55883513000,00000000300,a2f,recvmsg
1,55883493000,55883594800,00000101800,a07,poll
1,55883621900,55883624100,00000002200,a09,mmap
1,55883624200,55883624300,00000000100,a08,lseek
1,55883627100,55883631600,00000004500,a0b,munmap
1,55883638800,55883639600,00000000800,a09,mmap
1,55883639700,55883639800,00000000100,a08,lseek
1,55883676800,55883685300,00000008500,a00,read
1,55883692600,55883697400,00000004800,a00,read
1,55883710000,55883711100,00000001100,a00,read
1,55883722500,55883722900,00000000400,a00,read
1,55883733700,55883734100,00000000400,a00,read
1,55883744500,55883745800,00000001300,a09,mmap
1,55883745900,55883746000,00000000100,a08,lseek
1,55883757300,55883757700,00000000400,a09,mmap
1,55883757800,55883757900,00000000100,a08,lseek
1,55883779500,55883779900,00000000400,a09,mmap
1,55883780000,55883780100,00000000100,a08,lseek
1,55883794500,55883794800,00000000300,a09,mmap
1,55883794900,55883795000,00000000100,a08,lseek
1,55883564000,55884151200,00000587200,ae8,epoll_wait
1,55884165000,55884165200,00000000200,a2f,recvmsg
1,55884296100,55884372000,00000075900,a07,poll
1,55884381200,55884384300,00000003100,a2e,sendmsg
1,55884388700,55884388900,00000000200,a00,read
1,55884201500,55884404500,00000203000,ae8,epoll_wait
1,55884408300,55884409800,00000001500,a2f,recvmsg
1,55884419100,55884419300,00000000200,a2f,recvmsg
1,55884420500,55884421400,00000000900,a2f,recvmsg
1,55884426900,55884427100,00000000200,a2f,recvmsg
1,55884455500,55884459400,00000003900,a2e,sendmsg
1,55884402000,55884551500,00000149500,a07,poll
1,55884618300,55884619000,00000000700,a2f,recvmsg
1,55884622100,55884625400,00000003300,a07,poll
1,55884655100,55884658000,00000002900,a09,mmap
1,55884658100,55884658200,00000000100,a08,lseek
1,55884661600,55884666900,00000005300,a0b,munmap
1,55884675300,55884676100,00000000800,a09,mmap
1,55884676100,55884676200,00000000100,a08,lseek
1,55884717100,55884726500,00000009400,a00,read
1,55884734500,55884739300,00000004800,a00,read
1,55884752700,55884753800,00000001100,a00,read
1,55884765400,55884765700,00000000300,a00,read
1,55884776600,55884777000,00000000400,a00,read
1,55884788200,55884789700,00000001500,a09,mmap
1,55884789800,55884789900,00000000100,a08,lseek
1,55884801900,55884802500,00000000600,a09,mmap
1,55884802600,55884802700,00000000100,a08,lseek
1,55884825100,55884825600,00000000500,a09,mmap
1,55884825700,55884825800,00000000100,a08,lseek
1,55884840200,55884840800,00000000600,a09,mmap
1,55884840800,55884840900,00000000100,a08,lseek
1,55884507000,55885207800,00000700800,ae8,epoll_wait
1,55885222400,55885222600,00000000200,a2f,recvmsg
1,55885261000,55885361900,00000100900,ae8,epoll_wait
1,55885365600,55885367300,00000001700,a2f,recvmsg
1,55885375300,55885375400,00000000100,a2f,recvmsg
1,55885352500,55885458400,00000105900,a07,poll
1,55885486000,55885488400,00000002400,a09,mmap
1,55885488500,55885488600,00000000100,a08,lseek
1,55885491600,55885496000,00000004400,a0b,munmap
1,55885503600,55885504300,00000000700,a09,mmap
1,55885504400,55885504500,00000000100,a08,lseek
1,55885542100,55885551400,00000009300,a00,read
1,55885559500,55885564600,00000005100,a00,read
1,55885578200,55885579200,00000001000,a00,read
1,55885590900,55885591300,00000000400,a00,read
1,55885602200,55885602700,00000000500,a00,read
1,55885613100,55885614300,00000001200,a09,mmap
1,55885614400,55885614500,00000000100,a08,lseek
1,55885625700,55885626100,00000000400,a09,mmap
1,55885626100,55885626200,00000000100,a08,lseek
1,55885648000,55885648800,00000000800,a09,mmap
1,55885648800,55885648900,00000000100,a08,lseek
1,55885663600,55885664200,00000000600,a09,mmap
1,55885664300,55885664400,00000000100,a08,lseek
1,55885426400,55886022400,00000596000,ae8,epoll_wait
1,55886037200,55886037500,00000000300,a2f,recvmsg
1,55886086500,55886121200,00000034700,a07,poll
1,55886156100,55886156300,00000000200,a00,read
1,55892746200,55892773500,00000027300,7ef,local_timer_vector
1,33521915000,55921339800,22399424800,a23,nanosleep
1,55886157200,55922588200,00036431000,ae8,epoll_wait
1,55886163200,55937275800,00051112600,a07,poll
1,55937278200,55937279300,00000001100,a00,read
1,55922605300,55937604700,00014999400,ae8,epoll_wait
1,55937615800,55937620300,00000004500,a2f,recvmsg
1,55937645400,55937645700,00000000300,a2f,recvmsg
1,55937669100,55937674400,00000005300,a2e,sendmsg
1,55937534000,55937851500,00000317500,a07,poll
1,55938032200,55938033600,00000001400,a2f,recvmsg
1,55938424200,55938430900,00000006700,a14,writev
1,55938432200,55938523400,00000091200,a07,poll
1,55938530400,55938631100,00000100700,a07,poll
1,55938635800,55938668400,00000032600,a07,poll
1,55938675300,55938675600,00000000300,a2f,recvmsg
1,55938691800,55938692900,00000001100,a00,read
1,55938704400,55938704600,00000000200,a2f,recvmsg
1,55938705800,55938706000,00000000200,a2f,recvmsg
1,55937678400,55964600100,00026921700,ae8,epoll_wait
1,55964650900,55964665100,00000014200,a00,read
1,55964686800,55964692700,00000005900,b0b,readlinkat
1,55964704700,55964718200,00000013500,a00,read
1,55964744500,55964751900,00000007400,a00,read
1,55964817100,55964822900,00000005800,a00,read
1,55964832000,55964834100,00000002100,b0b,readlinkat
1,55964839800,55964849800,00000010000,a00,read
1,55964863700,55964867900,00000004200,a00,read
1,48528768100,55964896300,07436128200,a17,select
1,55938706900,55964931100,00026224200,a07,poll
1,55965063000,55965067100,00000004100,a01,write
1,55965123000,55965125000,00000002000,a00,read
1,55965135300,55965136100,00000000800,a00,read
1,55965146200,55965146900,00000000700,a00,read
1,55965175700,55965180700,00000005000,a02,open
1,55965217600,55965218200,00000000600,a2f,recvmsg
1,55965219000,55965434900,00000215900,b0f,ppoll
1,55965443100,55965447200,00000004100,a2e,sendmsg
1,55965449600,55965450000,00000000400,a2f,recvmsg
1,55938706900,55965544900,00026838000,a07,poll
1,55965563400,55965716100,00000152700,a07,poll
1,55965718300,55965719700,00000001400,a00,read
1,55965728200,55965732200,00000004000,a2f,recvmsg
1,55965743400,55965743600,00000000200,a2f,recvmsg
1,55965757600,55965763600,00000006000,a07,poll
1,55965765900,55965766600,00000000700,a00,read
1,55965773300,55965774800,00000001500,a2f,recvmsg
1,55965785700,55965786000,00000000300,a2f,recvmsg
1,55965450600,55965812600,00000362000,b0f,ppoll
1,55965828400,55965832800,00000004400,a2e,sendmsg
1,55965834300,55965835000,00000000700,a2f,recvmsg
1,55965837100,55965837300,00000000200,a2f,recvmsg
1,55965809000,55965842600,00000033600,a07,poll
1,55964890100,55965966800,00001076700,ae8,epoll_wait
1,55965976500,55965978100,00000001600,a2f,recvmsg
1,55965998200,55966002000,00000003800,a2e,sendmsg
1,55966002600,55966002900,00000000300,a2f,recvmsg
1,55966003700,55966124900,00000121200,b0f,ppoll
1,55966003700,55966245800,00000242100,b0f,ppoll
1,55966299900,55966305400,00000005500,a09,mmap
1,55966305500,55966305600,00000000100,a08,lseek
1,55966339000,55966357100,00000018100,a29,socket
1,55966372400,55966377400,00000005000,a2f,recvmsg
1,55966378700,55966380100,00000001400,a2f,recvmsg
1,55966390200,55966393000,00000002800,a2c,sendto
1,55966415700,55966417500,00000001800,a00,read
1,55966513300,55966516100,00000002800,a2f,recvmsg
1,55966520200,55966521500,00000001300,a2f,recvmsg
1,55966527800,55966529700,00000001900,a2c,sendto
1,55966754100,55966756800,00000002700,a09,mmap
1,55966756900,55966757100,00000000200,a08,lseek
1,55966775500,55966780700,00000005200,a15,access
1,55966792400,55966794100,00000001700,a00,read
1,55966794200,55966794500,00000000300,a00,read
1,55966794600,55966794800,00000000200,a00,read
1,55966795000,55966795200,00000000200,a00,read
1,55966795300,55966795500,00000000200,a00,read
1,55966795600,55966795800,00000000200,a00,read
1,55966795900,55966796000,00000000100,a00,read
1,55966796100,55966796300,00000000200,a00,read
1,55966796400,55966796600,00000000200,a00,read
1,55966796700,55966796900,00000000200,a00,read
1,55966797000,55966797800,00000000800,a00,read
1,55966797900,55966798100,00000000200,a00,read
1,55966802400,55966803600,00000001200,a15,access
1,55966805100,55966805200,00000000100,a08,lseek
1,55966805300,55966805400,00000000100,a08,lseek
1,55966807800,55966807900,00000000100,a08,lseek
1,55966808000,55966810100,00000002100,a01,write
1,55966812100,55966813300,00000001200,a15,access
1,55966816600,55966816700,00000000100,a08,lseek
1,55966816800,55966830500,00000013700,a01,write
1,55964927000,55967187300,00002260300,a17,select
1,55967191200,55967216100,00000024900,a3d,wait4
1,55966529800,55967228900,00000699100,a07,poll
1,55967259200,55967267500,00000008300,a07,poll
1,55967269400,55967270000,00000000600,a00,read
1,55967277800,55967280900,00000003100,a2f,recvmsg
1,55967294600,55967295000,00000000400,a2f,recvmsg
1,55966172600,55967332400,00001159800,ae8,epoll_wait
1,55967344600,55967360100,00000015500,a57,unlink
1,55967369900,55967374800,00000004900,a2e,sendmsg
1,55967376100,55967376600,00000000500,a2f,recvmsg
1,55967377300,55967392800,00000015500,b0f,ppoll
1,55967416000,55967417300,00000001300,a00,read
1,55967434000,55967434800,00000000800,a00,read
1,55967400200,55967444300,00000044100,a07,poll
1,55967446000,55967446200,00000000200,a00,read
1,55966172600,55967559400,00001386800,ae8,epoll_wait
1,55967566300,55967569600,00000003300,a2f,recvmsg
1,55967578300,55967578500,00000000200,a2f,recvmsg
1,55967686100,55967693200,00000007100,a2e,sendmsg
1,55967695500,55967699200,00000003700,a2e,sendmsg
1,55967700700,55967704400,00000003700,a2e,sendmsg
1,55967710700,55967712400,00000001700,a2f,recvmsg
1,55967719500,55967719700,00000000200,a2f,recvmsg
1,55967511100,55967777900,00000266800,a07,poll
1,55967779900,55967781000,00000001100,a00,read
1,55967796200,55967797600,00000001400,a2f,recvmsg
1,55967812500,55967853100,00000040600,a07,poll
1,55967856600,55967858300,00000001700,aca,futex
1,55967812500,55967859400,00000046900,a07,poll
1,55967860100,55967860900,00000000800,a00,read
1,55967865800,55967866800,00000001000,aca,futex
1,55967886000,55967888000,00000002000,a00,read
1,55967892300,55967892500,00000000200,a08,lseek
1,55967893700,55967893800,00000000100,a08,lseek
1,55967894500,55967894600,00000000100,a08,lseek
1,55967895300,55967895400,00000000100,a08,lseek
1,55967896100,55967896200,00000000100,a08,lseek
1,55967897000,55967897100,00000000100,a08,lseek
1,55967897000,55967897900,00000000900,a08,lseek
1,55967894800,55967898700,00000003900,a07,poll
1,55967898600,55967898700,00000000100,a08,lseek
1,55967899500,55967899500,00000000000,a08,lseek
1,55967900100,55967900200,00000000100,a08,lseek
1,55967900900,55967901000,00000000100,a08,lseek
1,55967901700,55967901800,00000000100,a08,lseek
1,55967902500,55967902600,00000000100,a08,lseek
1,55967903500,55967903600,00000000100,a08,lseek
1,55967904300,55967904400,00000000100,a08,lseek
1,55967905200,55967905300,00000000100,a08,lseek
1,55967906000,55967906100,00000000100,a08,lseek
1,55967906900,55967907000,00000000100,a08,lseek
1,55967907900,55967908000,00000000100,a08,lseek
1,55967908800,55967908900,00000000100,a08,lseek
1,55967909500,55967909600,00000000100,a08,lseek
1,55967910400,55967910500,00000000100,a08,lseek
1,55967911200,55967911300,00000000100,a08,lseek
1,55967912000,55967912100,00000000100,a08,lseek
1,55967912900,55967913000,00000000100,a08,lseek
1,55967913600,55967913600,00000000000,a08,lseek
1,55967914500,55967914600,00000000100,a08,lseek
1,55967915200,55967915300,00000000100,a08,lseek
1,55967916100,55967916200,00000000100,a08,lseek
1,55967917000,55967917000,00000000000,a08,lseek
1,55967916300,55967917600,00000001300,a2f,recvmsg
1,55967917700,55967917800,00000000100,a08,lseek
1,55967918600,55967918700,00000000100,a08,lseek
1,55967918600,55967919400,00000000800,a08,lseek
1,55967919400,55967920300,00000000900,a08,lseek
1,55967921100,55967921200,00000000100,a08,lseek
1,55967922100,55967922200,00000000100,a08,lseek
1,55967922800,55967922900,00000000100,a08,lseek
1,55967923700,55967923800,00000000100,a08,lseek
1,55967924500,55967924600,00000000100,a08,lseek
1,55967934200,55967937900,00000003700,a09,mmap
1,55967938000,55967938100,00000000100,a08,lseek
1,55967951100,55967951700,00000000600,a09,mmap
1,55967951700,55967951800,00000000100,a08,lseek
1,55967964900,55967965300,00000000400,a09,mmap
1,55967965400,55967965500,00000000100,a08,lseek
1,55967984100,55967984600,00000000500,a09,mmap
1,55967984700,55967984800,00000000100,a08,lseek
1,55968001900,55968002400,00000000500,a09,mmap
1,55968002500,55968002500,00000000000,a08,lseek
1,55968016100,55968016200,00000000100,a08,lseek
1,55968017200,55968017300,00000000100,a08,lseek
1,55968017200,55968018100,00000000900,a08,lseek
1,55968021100,55968021600,00000000500,a09,mmap
1,55968021600,55968021700,00000000100,a08,lseek
1,55967772600,55968025000,00000252400,ae8,epoll_wait
1,55968027400,55968027900,00000000500,a09,mmap
1,55968028000,55968028100,00000000100,a08,lseek
1,55968030300,55968034100,00000003800,a2f,recvmsg
1,55968038600,55968038900,00000000300,a09,mmap
1,55968039000,55968039100,00000000100,a08,lseek
1,55968054700,55968055100,00000000400,a09,mmap
1,55968055200,55968055300,00000000100,a08,lseek
1,55968060100,55968060400,00000000300,a2f,recvmsg
1,55968069500,55968069900,00000000400,a09,mmap
1,55968070000,55968070100,00000000100,a08,lseek
1,55968082000,55968082100,00000000100,a08,lseek
1,55968084700,55968085200,00000000500,a09,mmap
1,55968085300,55968085400,00000000100,a08,lseek
1,55968090600,55968091000,00000000400,a09,mmap
1,55968091100,55968091200,00000000100,a08,lseek
1,55968086200,55968095400,00000009200,a01,write
1,55968101000,55968101400,00000000400,a09,mmap
1,55968101500,55968101600,00000000100,a08,lseek
1,55968116500,55968116900,00000000400,a09,mmap
1,55968117000,55968117100,00000000100,a08,lseek
1,55968131300,55968131700,00000000400,a09,mmap
1,55968131700,55968131800,00000000100,a08,lseek
1,55968143300,55968143400,00000000100,a08,lseek
1,55968146100,55968146700,00000000600,a09,mmap
1,55968146700,55968146800,00000000100,a08,lseek
1,55968151800,55968152300,00000000500,a09,mmap
1,55968152400,55968152400,00000000000,a08,lseek
1,55968162200,55968162600,00000000400,a09,mmap
1,55968162700,55968162800,00000000100,a08,lseek
1,55968162500,55968169200,00000006700,a2e,sendmsg
1,55968171400,55968175400,00000004000,a2e,sendmsg
1,55968177500,55968178000,00000000500,a09,mmap
1,55968178000,55968178100,00000000100,a08,lseek
1,55968192300,55968192600,00000000300,a09,mmap
1,55968192700,55968192800,00000000100,a08,lseek
1,55968204400,55968204500,00000000100,a08,lseek
1,55968206900,55968207500,00000000600,a09,mmap
1,55968207500,55968207600,00000000100,a08,lseek
1,55968208900,55968213100,00000004200,a2e,sendmsg
1,55968212900,55968213300,00000000400,a09,mmap
1,55968213400,55968213400,00000000000,a08,lseek
1,55968223300,55968223700,00000000400,a09,mmap
1,55968223800,55968223900,00000000100,a08,lseek
1,55968238200,55968238600,00000000400,a09,mmap
1,55968238700,55968238800,00000000100,a08,lseek
1,55968240600,55968241800,00000001200,a2e,sendmsg
1,55968247000,55968250000,00000003000,a2f,recvmsg
1,55968252400,55968252900,00000000500,a09,mmap
1,55968252900,55968253000,00000000100,a08,lseek
1,55968264500,55968264600,00000000100,a08,lseek
1,55968267400,55968267900,00000000500,a09,mmap
1,55968268000,55968268100,00000000100,a08,lseek
1,55968273100,55968273600,00000000500,a09,mmap
1,55968273600,55968273700,00000000100,a08,lseek
1,55968283400,55968283700,00000000300,a09,mmap
1,55968283800,55968283900,00000000100,a08,lseek
1,55968296800,55968297100,00000000300,a2f,recvmsg
1,55968298600,55968299000,00000000400,a09,mmap
1,55968299000,55968299100,00000000100,a08,lseek
1,55968312900,55968313400,00000000500,a09,mmap
1,55968313500,55968313600,00000000100,a08,lseek
1,55968325100,55968325200,00000000100,a08,lseek
1,55968327500,55968328000,00000000500,a09,mmap
1,55968328100,55968328200,00000000100,a08,lseek
1,55968333400,55968333900,00000000500,a09,mmap
1,55968334000,55968334000,00000000000,a08,lseek
1,55968343600,55968344100,00000000500,a09,mmap
1,55968344200,55968344300,00000000100,a08,lseek
1,55968358400,55968358900,00000000500,a09,mmap
1,55968358900,55968359000,00000000100,a08,lseek
1,55968372700,55968373000,00000000300,a09,mmap
1,55968373100,55968373200,00000000100,a08,lseek
1,55968384900,55968385000,00000000100,a08,lseek
1,55968387400,55968387900,00000000500,a09,mmap
1,55968387900,55968388000,00000000100,a08,lseek
1,55968392900,55968393400,00000000500,a09,mmap
1,55968393400,55968393500,00000000100,a08,lseek
1,55968403100,55968403400,00000000300,a09,mmap
1,55968403500,55968403600,00000000100,a08,lseek
1,55968417700,55968418200,00000000500,a09,mmap
1,55968418200,55968418300,00000000100,a08,lseek
1,55968431900,55968432200,00000000300,a09,mmap
1,55968432300,55968432400,00000000100,a08,lseek
1,55968445000,55968445100,00000000100,a08,lseek
1,55968447400,55968448100,00000000700,a09,mmap
1,55968448100,55968448200,00000000100,a08,lseek
1,55968453300,55968453800,00000000500,a09,mmap
1,55968453900,55968454000,00000000100,a08,lseek
1,55968469700,55968470200,00000000500,a09,mmap
1,55968470300,55968470300,00000000000,a08,lseek
1,55968468300,55968470900,00000002600,a2e,sendmsg
1,55968484900,55968485200,00000000300,a09,mmap
1,55968485300,55968485400,00000000100,a08,lseek
1,55968499200,55968499600,00000000400,a09,mmap
1,55968499600,55968499700,00000000100,a08,lseek
1,55968511900,55968512000,00000000100,a08,lseek
1,55968514400,55968515000,00000000600,a09,mmap
1,55968515000,55968515100,00000000100,a08,lseek
1,55968520100,55968520600,00000000500,a09,mmap
1,55968520600,55968520700,00000000100,a08,lseek
1,55968530500,55968530800,00000000300,a09,mmap
1,55968530900,55968531000,00000000100,a08,lseek
1,55968545400,55968545900,00000000500,a09,mmap
1,55968545900,55968545900,00000000000,a08,lseek
1,55968559600,55968560100,00000000500,a09,mmap
1,55968560100,55968560200,00000000100,a08,lseek
1,55968572300,55968572400,00000000100,a08,lseek
1,55968574600,55968575100,00000000500,a09,mmap
1,55968575200,55968575300,00000000100,a08,lseek
1,55968580200,55968580600,00000000400,a09,mmap
1,55968580700,55968580800,00000000100,a08,lseek
1,55968590100,55968590600,00000000500,a09,mmap
1,55968590600,55968590700,00000000100,a08,lseek
1,55968596600,55968599100,00000002500,a2e,sendmsg
1,55968604900,55968605400,00000000500,a09,mmap
1,55968605400,55968605500,00000000100,a08,lseek
1,55967980800,55968608500,00000627700,a07,poll
1,55968610100,55968611400,00000001300,a00,read
1,55968619300,55968619700,00000000400,a09,mmap
1,55968619800,55968619900,00000000100,a08,lseek
1,55968628000,55968629500,00000001500,a2f,recvmsg
1,55968632200,55968632300,00000000100,a08,lseek
1,55968634800,55968635200,00000000400,a09,mmap
1,55968635300,55968635400,00000000100,a08,lseek
1,55968640400,55968640900,00000000500,a09,mmap
1,55968640900,55968640900,00000000000,a08,lseek
1,55968650400,55968650800,00000000400,a09,mmap
1,55968650800,55968650900,00000000100,a08,lseek
1,55968666000,55968666400,00000000400,a09,mmap
1,55968666500,55968666600,00000000100,a08,lseek
1,55968680500,55968680800,00000000300,a09,mmap
1,55968680800,55968680900,00000000100,a08,lseek
1,55968693600,55968693700,00000000100,a08,lseek
1,55968696200,55968696800,00000000600,a09,mmap
1,55968696800,55968696900,00000000100,a08,lseek
1,55968696600,55968701900,00000005300,a07,poll
1,55968701800,55968702300,00000000500,a09,mmap
1,55968702400,55968702500,00000000100,a08,lseek
1,55968711800,55968712200,00000000400,a09,mmap
1,55968712300,55968712400,00000000100,a08,lseek
1,55968717900,55968724500,00000006600,a07,poll
1,55968726600,55968727000,00000000400,a09,mmap
1,55968727100,55968727200,00000000100,a08,lseek
1,55968740900,55968741300,00000000400,a09,mmap
1,55968741300,55968741400,00000000100,a08,lseek
1,55968754000,55968754200,00000000200,a08,lseek
1,55968756400,55968756800,00000000400,a09,mmap
1,55968756000,55968756900,00000000900,a08,lseek
1,55968762000,55968762400,00000000400,a09,mmap
1,55968762500,55968762500,00000000000,a08,lseek
1,55968772000,55968772300,00000000300,a09,mmap
1,55968772400,55968772500,00000000100,a08,lseek
1,55968786600,55968787100,00000000500,a09,mmap
1,55968787100,55968787200,00000000100,a08,lseek
1,55968800700,55968801100,00000000400,a09,mmap
1,55968801200,55968801200,00000000000,a08,lseek
1,55968814000,55968814100,00000000100,a08,lseek
1,55968821300,55968828400,00000007100,a2a,connect
1,55968833600,55968834300,00000000700,a09,mmap
1,55968834400,55968834400,00000000000,a08,lseek
1,55968840100,55968840500,00000000400,a09,mmap
1,55968840500,55968840600,00000000100,a08,lseek
1,55968850100,55968850500,00000000400,a09,mmap
1,55968850600,55968850700,00000000100,a08,lseek
1,55967435600,55968857100,00001421500,b0f,ppoll
1,55968865600,55968866000,00000000400,a09,mmap
1,55968865200,55968866100,00000000900,a08,lseek
1,55968872700,55968876100,00000003400,a53,mkdir
1,55968880000,55968880300,00000000300,a09,mmap
1,55968880400,55968880500,00000000100,a08,lseek
1,55968889200,55968889600,00000000400,a48,fcntl
1,55968894000,55968894100,00000000100,a08,lseek
1,55968896500,55968897000,00000000500,a09,mmap
1,55968897100,55968897200,00000000100,a08,lseek
1,55968902100,55968902600,00000000500,a09,mmap
1,55968902600,55968902700,00000000100,a08,lseek
1,55968901300,55968908300,00000007000,a01,write
1,55968912100,55968912600,00000000500,a09,mmap
1,55968912600,55968912600,00000000000,a08,lseek
1,55968926700,55968927100,00000000400,a09,mmap
1,55968927200,55968927300,00000000100,a08,lseek
1,55968926600,55968927500,00000000900,a53,mkdir
1,55968933500,55968933500,00000000000,a48,fcntl
1,55968941100,55968941500,00000000400,a09,mmap
1,55968940700,55968941600,00000000900,a08,lseek
1,55968939800,55968942000,00000002200,a01,write
1,55968954800,55968954900,00000000100,a08,lseek
1,55968957200,55968957700,00000000500,a09,mmap
1,55968957700,55968957800,00000000100,a08,lseek
1,55968960200,55968961200,00000001000,a2f,recvmsg
1,55968962700,55968963200,00000000500,a09,mmap
1,55968963300,55968963300,00000000000,a08,lseek
1,55968972700,55968973200,00000000500,a09,mmap
1,55968972400,55968973300,00000000900,a08,lseek
1,55968981000,55968982800,00000001800,a2e,sendmsg
1,55968983900,55968984700,00000000800,a2f,recvmsg
1,55968986400,55968986600,00000000200,a2f,recvmsg
1,55968987400,55968987900,00000000500,a09,mmap
1,55968987900,55968988000,00000000100,a08,lseek
1,55968851700,55968997300,00000145600,a07,poll
1,55968999100,55968999800,00000000700,a00,read
1,55969001800,55969002100,00000000300,a09,mmap
1,55969002100,55969002200,00000000100,a08,lseek
1,55969015400,55969015500,00000000100,a08,lseek
1,55969017800,55969018300,00000000500,a09,mmap
1,55969018400,55969018500,00000000100,a08,lseek
1,55969023400,55969023800,00000000400,a09,mmap
1,55969023900,55969024000,00000000100,a08,lseek
1,55969033700,55969034200,00000000500,a09,mmap
1,55969034200,55969034200,00000000000,a08,lseek
1,55969048500,55969048900,00000000400,a09,mmap
1,55969049000,55969049100,00000000100,a08,lseek
1,55969033200,55969057500,00000024300,a07,poll
1,55969059300,55969059900,00000000600,a00,read
1,55969062700,55969063100,00000000400,a09,mmap
1,55969063200,55969063300,00000000100,a08,lseek
1,55969076700,55969076800,00000000100,a08,lseek
1,55969076300,55969077800,00000001500,a2f,recvmsg
1,55969079100,55969079600,00000000500,a09,mmap
1,55969079700,55969079800,00000000100,a08,lseek
1,55969084900,55969085300,00000000400,a09,mmap
1,55969085400,55969085500,00000000100,a08,lseek
1,55969094800,55969095200,00000000400,a09,mmap
1,55969094400,55969095300,00000000900,a08,lseek
1,55969109700,55969110100,00000000400,a09,mmap
1,55969110200,55969110200,00000000000,a08,lseek
1,55969123700,55969124100,00000000400,a09,mmap
1,55969124200,55969124300,00000000100,a08,lseek
1,55969137900,55969138000,00000000100,a08,lseek
1,55969134600,55969138400,00000003800,a01,write
1,55969140200,55969140600,00000000400,a09,mmap
1,55969140700,55969140700,00000000000,a08,lseek
1,55969145700,55969146100,00000000400,a09,mmap
1,55969146200,55969146300,00000000100,a08,lseek
1,55969155600,55969156000,00000000400,a09,mmap
1,55969156000,55969156100,00000000100,a08,lseek
1,55969031900,55969158900,00000127000,ae8,epoll_wait
1,55969167500,55969169600,00000002100,a2f,recvmsg
1,55969170200,55969170700,00000000500,a09,mmap
1,55969170700,55969170800,00000000100,a08,lseek
1,55969181200,55969181400,00000000200,a2f,recvmsg
1,55969183200,55969184300,00000001100,a2f,recvmsg
1,55969184300,55969184800,00000000500,a09,mmap
1,55969184800,55969184900,00000000100,a08,lseek
1,55969190100,55969190200,00000000100,a2f,recvmsg
1,55969191300,55969192500,00000001200,a2f,recvmsg
1,55969197800,55969197900,00000000100,a2f,recvmsg
1,55969198600,55969198700,00000000100,a08,lseek
1,55969201000,55969201400,00000000400,a09,mmap
1,55969201500,55969201600,00000000100,a08,lseek
1,55969206600,55969207000,00000000400,a09,mmap
1,55969207100,55969207100,00000000000,a08,lseek
1,55969216700,55969217200,00000000500,a09,mmap
1,55969217300,55969217300,00000000000,a08,lseek
1,55969231500,55969231900,00000000400,a09,mmap
1,55969231900,55969232000,00000000100,a08,lseek
1,55969245800,55969246200,00000000400,a09,mmap
1,55969246200,55969246300,00000000100,a08,lseek
1,55969247300,55969250800,00000003500,a2e,sendmsg
1,55969260200,55969260300,00000000100,a08,lseek
1,55969262500,55969263000,00000000500,a09,mmap
1,55969263100,55969263100,00000000000,a08,lseek
1,55969268000,55969268500,00000000500,a09,mmap
1,55969268500,55969268600,00000000100,a08,lseek
1,55969277900,55969278400,00000000500,a09,mmap
1,55969278400,55969278500,00000000100,a08,lseek
1,55969292600,55969292900,00000000300,a09,mmap
1,55969293000,55969293100,00000000100,a08,lseek
1,55969306600,55969307100,00000000500,a09,mmap
1,55969307100,55969307200,00000000100,a08,lseek
1,55969321300,55969321400,00000000100,a08,lseek
1,55969323800,55969324300,00000000500,a09,mmap
1,55969323400,55969324400,00000001000,a08,lseek
1,55969329300,55969329700,00000000400,a09,mmap
1,55969329800,55969329900,00000000100,a08,lseek
1,55969339200,55969339700,00000000500,a09,mmap
1,55969339700,55969339800,00000000100,a08,lseek
1,55969342000,55969344600,00000002600,a2e,sendmsg
1,55969351100,55969352200,00000001100,a2f,recvmsg
1,55969354000,55969354400,00000000400,a09,mmap
1,55969353600,55969354500,00000000900,a08,lseek
1,55969358300,55969358600,00000000300,a2f,recvmsg
1,55969368200,55969368600,00000000400,a09,mmap
1,55969368600,55969368700,00000000100,a08,lseek
1,55969383100,55969383200,00000000100,a08,lseek
1,55969385400,55969385800,00000000400,a09,mmap
1,55969385900,55969386000,00000000100,a08,lseek
1,55969385100,55969388100,00000003000,a2e,sendmsg
1,55969391400,55969391800,00000000400,a09,mmap
1,55969391900,55969392000,00000000100,a08,lseek
1,55969154300,55969395200,00000240900,a07,poll
1,55969401600,55969402000,00000000400,a09,mmap
1,55969402100,55969402200,00000000100,a08,lseek
1,55969416400,55969416800,00000000400,a09,mmap
1,55969416900,55969417000,00000000100,a08,lseek
1,55969430700,55969431100,00000000400,a09,mmap
1,55969431200,55969431200,00000000000,a08,lseek
1,55969440500,55969445500,00000005000,a09,mmap
1,55969445600,55969445700,00000000100,a08,lseek
1,55969445600,55969445800,00000000200,a08,lseek
1,55969448300,55969448700,00000000400,a09,mmap
1,55969448800,55969448800,00000000000,a08,lseek
1,55969453900,55969454300,00000000400,a09,mmap
1,55969454400,55969454400,00000000000,a08,lseek
1,55969464200,55969464600,00000000400,a09,mmap
1,55969464700,55969464800,00000000100,a08,lseek
1,55969471900,55969479300,00000007400,a2a,connect
1,55969479100,55969479500,00000000400,a09,mmap
1,55969478800,55969479600,00000000800,a08,lseek
1,55969485700,55969487400,00000001700,a09,mmap
1,55969487500,55969487500,00000000000,a08,lseek
1,55969493500,55969494000,00000000500,a09,mmap
1,55969494000,55969494000,00000000000,a08,lseek
1,55969508600,55969508700,00000000100,a08,lseek
1,55969510900,55969511300,00000000400,a09,mmap
1,55969511400,55969511500,00000000100,a08,lseek
1,55969516500,55969516800,00000000300,a09,mmap
1,55969516900,55969517000,00000000100,a08,lseek
1,55969526300,55969526800,00000000500,a09,mmap
1,55969526900,55969526900,00000000000,a08,lseek
1,55969541200,55969541500,00000000300,a09,mmap
1,55969541600,55969541600,00000000000,a08,lseek
1,55969555300,55969555700,00000000400,a09,mmap
1,55969554900,55969555800,00000000900,a08,lseek
1,55969570600,55969570700,00000000100,a08,lseek
1,55969573000,55969573500,00000000500,a09,mmap
1,55969573600,55969573700,00000000100,a08,lseek
1,55969579000,55969579500,00000000500,a09,mmap
1,55969579500,55969579500,00000000000,a08,lseek
1,55969564800,55969580700,00000015900,a00,read
1,01531889000,01531890800,00000001800,aca,futex
1,01531905200,01531906400,00000001200,aca,futex
1,01531978500,01531982100,00000003600,a2e,sendmsg
1,01531984400,01531984600,00000000200,a00,read
1,01531987200,01531991900,00000004700,a07,poll
1,55969391500,01532090800,-54437300700,ae8,epoll_wait
1,01532096000,01532097600,00000001600,a2f,recvmsg
1,01532107300,01532107500,00000000200,a2f,recvmsg
1,01532109400,01532110700,00000001300,a2f,recvmsg
1,01532116200,01532116500,00000000300,a2f,recvmsg
1,01532159200,01532162800,00000003600,a2e,sendmsg
1,01532192300,01532193500,00000001200,a2e,sendmsg
1,01532198400,01532262500,00000064100,ae8,epoll_wait
1,01532266200,01532268000,00000001800,a2f,recvmsg
1,01532276000,01532276200,00000000200,a2f,recvmsg
1,01532333000,01532473600,00000140600,ae8,epoll_wait
1,01532477600,01532479700,00000002100,a2f,recvmsg
1,01532487400,01532487700,00000000300,a2f,recvmsg
1,01532519900,01532521800,00000001900,a2e,sendmsg
1,01532525800,01532647700,00000121900,ae8,epoll_wait
1,01532651100,01532652900,00000001800,a2f,recvmsg
1,01532660600,01532660800,00000000200,a2f,recvmsg
1,01532695800,01532697200,00000001400,a2e,sendmsg
1,01532702300,01532703400,00000001100,a2f,recvmsg
1,01532709500,01532709600,00000000100,a2f,recvmsg
1,01532738100,01532739200,00000001100,a2e,sendmsg
1,01532742400,01532743200,00000000800,a2f,recvmsg
1,01532747900,01532748000,00000000100,a2f,recvmsg
1,01532988300,01532991200,00000002900,a2e,sendmsg
1,01532992600,01532994300,00000001700,a2e,sendmsg
1,01532995500,01532996900,00000001400,a2e,sendmsg
1,01532997900,01532999900,00000002000,a2e,sendmsg
1,01533001000,01533002400,00000001400,a2e,sendmsg
1,01533003300,01533005300,00000002000,a2e,sendmsg
1,01533006400,01533008000,00000001600,a2e,sendmsg
1,01533011300,01533012200,00000000900,a2f,recvmsg
1,01533018100,01533018300,00000000200,a2f,recvmsg
1,01532085300,01533061500,00000976200,a07,poll
1,01533063400,01533064100,00000000700,a00,read
1,01533077500,01533078700,00000001200,a2f,recvmsg
1,01533156000,01533159300,00000003300,a07,poll
1,01533173300,01533174300,00000001000,a2f,recvmsg
1,01533057800,01533237800,00000180000,ae8,epoll_wait
1,01533241900,01533243400,00000001500,a2f,recvmsg
1,01533251700,01533252000,00000000300,a2f,recvmsg
1,01533285300,01533287100,00000001800,a2e,sendmsg
1,01533235300,01533385800,00000150500,a07,poll
1,01533397600,01533398700,00000001100,a2f,recvmsg
1,01533408700,01533450100,00000041400,a07,poll
1,01533452400,01533453700,00000001300,aca,futex
1,01533461500,01533462400,00000000900,aca,futex
1,01533517500,01533517700,00000000200,a00,read
1,01533517200,01533541400,00000024200,a07,poll
1,01533542600,01533543500,00000000900,aca,futex
1,01533562100,01533563400,00000001300,aca,futex
1,01533606300,01533608300,00000002000,a2e,sendmsg
1,01533615100,01533618200,00000003100,a07,poll
1,01533630200,01533631100,00000000900,a2f,recvmsg
1,01533291200,01533705900,00000414700,ae8,epoll_wait
1,01533710000,01533713200,00000003200,a2f,recvmsg
1,01533735100,01533735300,00000000200,a2f,recvmsg
1,01533736600,01533737400,00000000800,a2f,recvmsg
1,01533743400,01533743600,00000000200,a2f,recvmsg
1,01533970400,01533973200,00000002800,a2e,sendmsg
1,01533975200,01533976700,00000001500,a2e,sendmsg
1,01533977600,01533979100,00000001500,a2e,sendmsg
1,01533980000,01533981100,00000001100,a2e,sendmsg
1,01533982300,01533983600,00000001300,a2e,sendmsg
1,01533984700,01533986500,00000001800,a2e,sendmsg
1,01533987500,01533988700,00000001200,a2e,sendmsg
1,01534190500,01534191800,00000001300,a2e,sendmsg
1,01534192900,01534194500,00000001600,a2e,sendmsg
1,01534195500,01534196000,00000000500,a2e,sendmsg
1,01534197000,01534197700,00000000700,a2e,sendmsg
1,01534198700,01534200200,00000001500,a2e,sendmsg
1,01534201300,01534202100,00000000800,a2e,sendmsg
1,01534203100,01534203700,00000000600,a2e,sendmsg
1,01534402900,01534403900,00000001000,a2e,sendmsg
1,01534404900,01534405600,00000000700,a2e,sendmsg
1,01534406500,01534408000,00000001500,a2e,sendmsg
1,01534408800,01534409800,00000001000,a2e,sendmsg
1,01534410700,01534411800,00000001100,a2e,sendmsg
1,01534412700,01534413700,00000001000,a2e,sendmsg
1,01534414600,01534415300,00000000700,a2e,sendmsg
1,01534610200,01534611300,00000001100,a2e,sendmsg
1,01534612200,01534613200,00000001000,a2e,sendmsg
1,01534614000,01534615100,00000001100,a2e,sendmsg
1,01534615900,01534617700,00000001800,a2e,sendmsg
1,01534618700,01534619600,00000000900,a2e,sendmsg
1,01534620500,01534621400,00000000900,a2e,sendmsg
1,01534622300,01534623000,00000000700,a2e,sendmsg
1,01534815900,01534816800,00000000900,a2e,sendmsg
1,01534817700,01534818300,00000000600,a2e,sendmsg
1,01534819100,01534819800,00000000700,a2e,sendmsg
1,01534820800,01534821600,00000000800,a2e,sendmsg
1,01534822500,01534823900,00000001400,a2e,sendmsg
1,01534824800,01534825600,00000000800,a2e,sendmsg
1,01534826600,01534827200,00000000600,a2e,sendmsg
1,01534856000,01534858400,00000002400,a2e,sendmsg
1,01534863600,01534866200,00000002600,a2f,recvmsg
1,01534884400,01534884600,00000000200,a2f,recvmsg
1,01534885500,01534886200,00000000700,a2f,recvmsg
1,01534890100,01534890300,00000000200,a2f,recvmsg
1,01534914700,01534916200,00000001500,a2e,sendmsg
1,01534939100,01534939900,00000000800,a2e,sendmsg
1,01534962200,01534962900,00000000700,a2e,sendmsg
1,01534984900,01534985700,00000000800,a2e,sendmsg
1,01535007900,01535008500,00000000600,a2e,sendmsg
1,01535011700,01535012500,00000000800,a2f,recvmsg
1,01535017100,01535017300,00000000200,a2f,recvmsg
1,01535039600,01535040500,00000000900,a2e,sendmsg
1,01535043200,01535044000,00000000800,a2f,recvmsg
1,01535048500,01535048700,00000000200,a2f,recvmsg
1,01535070900,01535071700,00000000800,a2e,sendmsg
1,01533703400,01535077600,00001374200,a07,poll
1,01535079300,01535079800,00000000500,a00,read
1,01535091600,01535092800,00000001200,a2f,recvmsg
1,01535147400,01535148100,00000000700,a2f,recvmsg
1,01535150500,01535150600,00000000100,a00,read
1,01535176200,01535176800,00000000600,a2f,recvmsg
1,01535218000,01535218600,00000000600,a2f,recvmsg
1,01535242700,01535243300,00000000600,a2f,recvmsg
1,01535270500,01535274200,00000003700,a07,poll
1,01535275700,01535276000,00000000300,a00,read
1,01535288100,01535289300,00000001200,a2f,recvmsg
1,01535349800,01535350700,00000000900,a2f,recvmsg
1,01535353100,01535353300,00000000200,a00,read
1,01535383400,01535384200,00000000800,a2f,recvmsg
1,01535411800,01535412600,00000000800,a2f,recvmsg
1,01535440600,01535441200,00000000600,a2f,recvmsg
1,01535470900,01535474400,00000003500,a07,poll
1,01535549600,01535553400,00000003800,a07,poll
1,01535560200,01535561400,00000001200,a2f,recvmsg
1,01535570500,01535572300,00000001800,a2e,sendmsg
1,01535575300,01535609000,00000033700,a07,poll
1,01535610900,01535612200,00000001300,aca,futex
1,01535620600,01535621500,00000000900,aca,futex
1,01535672600,01535672900,00000000300,a00,read
1,01535674700,01535675600,00000000900,a2f,recvmsg
1,01535677700,01535704700,00000027000,a07,poll
1,01535706100,01535706900,00000000800,aca,futex
1,01535712800,01535713700,00000000900,aca,futex
1,01535736600,01535750700,00000014100,a38,clone
1,01535821800,01535823600,00000001800,a2e,sendmsg
1,01535818900,01535826200,00000007300,a07,poll
1,01535872300,01535873800,00000001500,a2f,recvmsg
1,01535879200,01535880500,00000001300,a2e,sendmsg
1,01535876400,01535912100,00000035700,a07,poll
1,01535913500,01535914500,00000001000,aca,futex
1,01535920300,01535921200,00000000900,aca,futex
1,01535953800,01535954100,00000000300,a00,read
1,01535960200,01535961000,00000000800,a2f,recvmsg
1,01535963100,01535987300,00000024200,a07,poll
1,01535988500,01535989500,00000001000,aca,futex
1,01535994800,01535995800,00000001000,aca,futex
1,01536026400,01536027300,00000000900,a2f,recvmsg
1,01536029300,01536051400,00000022100,a07,poll
1,01536052600,01536053600,00000001000,aca,futex
1,01536059500,01536060400,00000000900,aca,futex
1,01536077000,01536084400,00000007400,a38,clone
1,01536093100,01536100600,00000007500,a07,poll
1,01536102600,01536102900,00000000300,aca,futex
1,01536144200,01536145900,00000001700,aca,futex
1,01536292600,01536294600,00000002000,a2e,sendmsg
1,01536299100,01536299900,00000000800,a2e,sendmsg
1,01536304800,01536305000,00000000200,a00,read
1,01536306500,01536307300,00000000800,a2e,sendmsg
1,01536147300,01536327500,00000180200,aca,futex
1,01536337800,01536339500,00000001700,a2e,sendmsg
1,01536344100,01536344200,00000000100,a00,read
1,01536360700,01536394100,00000033400,aca,futex
1,01536402700,01536874100,00000471400,a07,poll
1,01536882800,01536886800,00000004000,a2e,sendmsg
1,01536924400,01536988000,00000063600,a07,poll
1,01536996500,01537000100,00000003600,a2e,sendmsg
1,01537004500,01537004700,00000000200,a00,read
1,01537035400,01537093700,00000058300,a07,poll
1,01537100900,01537103700,00000002800,a2e,sendmsg
1,01537140100,01537196200,00000056100,a07,poll
1,01537204500,01537207300,00000002800,a2e,sendmsg
1,01537211800,01537211900,00000000100,a00,read
1,01537243400,01537298300,00000054900,a07,poll
1,01537305500,01537308800,00000003300,a2e,sendmsg
1,01537317500,01537318000,00000000500,aca,futex
1,01537334300,01537334500,00000000200,aca,futex
1,01537345000,01537402200,00000057200,a07,poll
1,01537410500,01537413200,00000002700,a2e,sendmsg
1,01537417700,01537417900,00000000200,a00,read
1,01537454500,01537660200,00000205700,a07,poll
1,01537666000,01537667200,00000001200,a2f,recvmsg
1,01537714900,01537715800,00000000900,a2f,recvmsg
1,01537717900,01537718100,00000000200,a00,read
1,01537741500,01537746700,00000005200,a07,poll
1,01537768000,01537799800,00000031800,a07,poll
1,01537802000,01537803400,00000001400,aca,futex
1,01537821200,01537822600,00000001400,aca,futex
1,01537866200,01537867900,00000001700,a2e,sendmsg
1,01537873900,01537874100,00000000200,a00,read
1,01537873600,01537898200,00000024600,a07,poll
1,01537899400,01537900400,00000001000,aca,futex
1,01537913900,01537915100,00000001200,aca,futex
1,01537950000,01537951200,00000001200,a2e,sendmsg
1,01537956500,01537980400,00000023900,a07,poll
1,01537981700,01537982600,00000000900,aca,futex
1,01537995200,01537996300,00000001100,aca,futex
1,01538032500,01538034100,00000001600,a2e,sendmsg
1,01538039700,01538039800,00000000100,a00,read
1,01538039400,01538062200,00000022800,a07,poll
1,01538063300,01538064300,00000001000,aca,futex
1,01538076100,01538077400,00000001300,aca,futex
1,01538108400,01538109700,00000001300,a2e,sendmsg
1,01538114400,01538136300,00000021900,a07,poll
1,01538137500,01538138400,00000000900,aca,futex
1,01538149700,01538150900,00000001200,aca,futex
1,01538181800,01538183100,00000001300,a2e,sendmsg
1,01538188400,01538188500,00000000100,a00,read
1,01538188100,01538209500,00000021400,a07,poll
1,01538210800,01538211800,00000001000,aca,futex
1,01538222700,01538223900,00000001200,aca,futex
1,01538254500,01538255700,00000001200,a2e,sendmsg
1,01538257900,01538258700,00000000800,a2f,recvmsg
1,01538260700,01538290800,00000030100,a07,poll
1,01538292100,01538292900,00000000800,aca,futex
1,01538297800,01538298700,00000000900,aca,futex
1,01538343500,01538347200,00000003700,a07,poll
1,01538348900,01538349500,00000000600,a00,read
1,01538360800,01538362500,00000001700,a2f,recvmsg
1,01538435100,01538436300,00000001200,a2f,recvmsg
1,01538438700,01538438900,00000000200,a00,read
1,01538469500,01538474300,00000004800,a07,poll
1,01538475900,01538476400,00000000500,a00,read
1,01538490700,01538491900,00000001200,a2f,recvmsg
1,01538552400,01538553100,00000000700,a2f,recvmsg
1,01538555600,01538555700,00000000100,a00,read
1,01538586300,01538589200,00000002900,a07,poll
1,01538589800,01538589900,00000000100,a00,read
1,01538597100,01538597800,00000000700,a2f,recvmsg
1,01538605500,01538637400,00000031900,a07,poll
1,01538639000,01538640100,00000001100,aca,futex
1,01538645800,01538646800,00000001000,aca,futex
1,01538670600,01538678800,00000008200,aca,futex
1,01538676400,01538689800,00000013400,a07,poll
1,01538790800,01538792700,00000001900,a2e,sendmsg
1,01538795600,01538796400,00000000800,a2f,recvmsg
1,01538799100,01538799200,00000000100,a00,read
1,01538801000,01538801700,00000000700,a2e,sendmsg
1,01538798800,01538831100,00000032300,a07,poll
1,01538832300,01538833400,00000001100,aca,futex
1,01538837900,01538838900,00000001000,aca,futex
1,01538881200,01538902300,00000021100,a07,poll
1,01538902500,01538904100,00000001600,aca,futex
1,01538911500,01538912500,00000001000,aca,futex
1,01538926900,01538927900,00000001000,aca,futex
1,01538932500,01538933900,00000001400,aca,futex
1,01539008000,01539009600,00000001600,a2e,sendmsg
1,01539017600,01539018400,00000000800,a2e,sendmsg
1,01539015500,01539041600,00000026100,a07,poll
1,01539042800,01539043800,00000001000,aca,futex
1,01539057900,01539059100,00000001200,aca,futex
1,01539088400,01539088700,00000000300,a00,read
1,01539090900,01539092200,00000001300,a2e,sendmsg
1,01539099700,01539121400,00000021700,a07,poll
1,01539122500,01539123400,00000000900,aca,futex
1,01539136400,01539137600,00000001200,aca,futex
1,01539168100,01539169300,00000001200,a2e,sendmsg
1,01539174200,01539195700,00000021500,a07,poll
1,01539196800,01539197800,00000001000,aca,futex
1,01539209900,01539211100,00000001200,aca,futex
1,01539241900,01539244800,00000002900,a2e,sendmsg
1,01539250100,01539250200,00000000100,a00,read
1,01539249800,01539271200,00000021400,a07,poll
1,01539272400,01539273300,00000000900,aca,futex
1,01539285700,01539286800,00000001100,aca,futex
1,01539317100,01539318400,00000001300,a2e,sendmsg
1,01539323900,01539346900,00000023000,a07,poll
1,01539348100,01539349000,00000000900,aca,futex
1,01539361100,01539362300,00000001200,aca,futex
1,01539392700,01539394100,00000001400,a2e,sendmsg
1,01539399300,01539399400,00000000100,a00,read
1,01539399000,01539420700,00000021700,a07,poll
1,01539421800,01539422700,00000000900,aca,futex
1,01539434600,01539435900,00000001300,aca,futex
1,01539466500,01539467700,00000001200,a2e,sendmsg
1,01539472600,01539494200,00000021600,a07,poll
1,01539495300,01539496300,00000001000,aca,futex
1,01539507500,01539508600,00000001100,aca,futex
1,01539539000,01539540300,00000001300,a2e,sendmsg
1,01539545400,01539545500,00000000100,a00,read
1,01539545100,01539566400,00000021300,a07,poll
1,01539567500,01539568400,00000000900,aca,futex
1,01539579300,01539580500,00000001200,aca,futex
1,01539612000,01539613500,00000001500,a2e,sendmsg
1,01539619100,01539622100,00000003000,a07,poll
1,01539623600,01539624100,00000000500,a00,read
1,01539635300,01539636800,00000001500,a2f,recvmsg
1,01539705800,01539709100,00000003300,a07,poll
1,01539710400,01539710600,00000000200,a00,read
1,01539722500,01539723700,00000001200,a2f,recvmsg
1,01539785000,01539786200,00000001200,a2f,recvmsg
1,01539788500,01539788700,00000000200,a00,read
1,01539788300,01539872600,00000084300,a07,poll
1,01539874700,01539875800,00000001100,aca,futex
1,01539985700,01539987400,00000001700,aca,futex
1,01540048100,01540050900,00000002800,a2e,sendmsg
1,01540055300,01540058200,00000002900,a07,poll
1,01540178900,01540182300,00000003400,a07,poll
1,01540186800,01540191100,00000004300,a2e,sendmsg
1,01540196800,01540197900,00000001100,a2e,sendmsg
1,01540204200,01540204400,00000000200,a00,read
1,01540205800,01540206600,00000000800,a2e,sendmsg
1,01540212400,01540213100,00000000700,a2e,sendmsg
1,01535074100,01540223300,00005149200,ae8,epoll_wait
1,01540232200,01540235200,00000003000,a2f,recvmsg
1,01540260300,01540260600,00000000300,a2f,recvmsg
1,01540219900,01540399000,00000179100,a07,poll
1,01540450900,01540451000,00000000100,a00,read
1,01540512000,01540514600,00000002600,a07,poll
1,01540538200,01540553100,00000014900,a07,poll
1,01540593200,01540593800,00000000600,aca,futex
1,01540595900,01540596000,00000000100,aca,futex
1,01540604700,01540607600,00000002900,a01,write
1,01540395800,01540625800,00000230000,ae8,epoll_wait
1,01540632600,01540634700,00000002100,a2f,recvmsg
1,01540644100,01540644300,00000000200,a2f,recvmsg
1,01540658200,01540662700,00000004500,a2e,sendmsg
1,01540611800,01540665600,00000053800,a07,poll
1,01540667200,01540667900,00000000700,a00,read
1,01540682500,01540684100,00000001600,a2f,recvmsg
1,01540794600,01540796100,00000001500,a2f,recvmsg
1,01540852900,01540853200,00000000300,a00,read
1,01540854600,01540855700,00000001100,a2f,recvmsg
1,01540889100,01540889900,00000000800,a2f,recvmsg
1,01540921100,01540921900,00000000800,a2f,recvmsg
1,01540951800,01540952600,00000000800,a2f,recvmsg
1,55967221600,01542094100,-54425127500,a17,select
1,01542119800,01542120100,00000000300,a2f,recvmsg
1,01540985500,01542428300,00001442800,a07,poll
1,01542644800,01542735000,00000090200,a07,poll
1,01542779100,01542779500,00000000400,aca,futex
1,01542853900,01542866600,00000012700,aca,futex
1,01542863000,01542871900,00000008900,a07,poll
1,01542873100,01542874400,00000001300,aca,futex
1,01542966200,01542969300,00000003100,a2e,sendmsg
1,01542973800,01542974500,00000000700,a2e,sendmsg
1,01542979000,01542979200,00000000200,a00,read
1,01542982900,01542986900,00000004000,a07,poll
1,01543059700,01543221400,00000161700,a07,poll
1,01543222800,01543223900,00000001100,a00,read
1,01543239900,01543242100,00000002200,a2f,recvmsg
1,01543254200,01543330300,00000076100,a07,poll
1,01543331800,01543332600,00000000800,a00,read
1,01543363200,01543402300,00000039100,a07,poll
1,01543405000,01543406500,00000001500,aca,futex
1,01543432200,01543433700,00000001500,aca,futex
1,01543485100,01543487500,00000002400,a2e,sendmsg
1,01543494500,01543494600,00000000100,a00,read
1,01543494300,01543520600,00000026300,a07,poll
1,01543521800,01543522900,00000001100,aca,futex
1,01543539400,01543540700,00000001300,aca,futex
1,01543576400,01543578000,00000001600,a2e,sendmsg
1,01543583500,01543608300,00000024800,a07,poll
1,01543609500,01543610400,00000000900,aca,futex
1,01543624500,01543625700,00000001200,aca,futex
1,01543661900,01543663500,00000001600,a2e,sendmsg
1,01543665200,01543665300,00000000100,a00,read
1,01543715000,01543717000,00000002000,a2f,recvmsg
1,01543719500,01543719700,00000000200,a00,read
1,01543719300,01543747500,00000028200,a07,poll
1,01543829200,01543829600,00000000400,aca,futex
1,01543863600,01543868200,00000004600,a07,poll
1,01543961600,01543963100,00000001500,a2f,recvmsg
1,01544005100,01544007400,00000002300,a2e,sendmsg
1,01544010200,01544011000,00000000800,a2f,recvmsg
1,01544073200,01544073400,00000000200,a00,read
1,01544074500,01544075200,00000000700,a2f,recvmsg
1,01544082700,01544083100,00000000400,aca,futex
1,01544095900,01544132800,00000036900,aca,futex
1,01544160500,01544163200,00000002700,a2e,sendmsg
1,01544166300,01544167500,00000001200,a2f,recvmsg
1,01544196100,01544196400,00000000300,aca,futex
1,01544224100,01544270500,00000046400,aca,futex
1,01544286600,01544288700,00000002100,a2e,sendmsg
1,01544291200,01544292100,00000000900,a2f,recvmsg
1,01544294500,01544294700,00000000200,a00,read
1,01544332500,01544335800,00000003300,aca,futex
1,01544294300,01544522400,00000228100,a07,poll
1,01544534800,01544536300,00000001500,a2f,recvmsg
1,01544547100,01544633300,00000086200,a07,poll
1,01544635300,01544636500,00000001200,aca,futex
1,01544714000,01544715600,00000001600,aca,futex
1,01544751700,01544752100,00000000400,a00,read
1,01544776500,01544779500,00000003000,a07,poll
1,01544792100,01544793900,00000001800,a2f,recvmsg
1,01544805600,01544898100,00000092500,a07,poll
1,01544900200,01544901300,00000001100,aca,futex
1,01544999500,01545001000,00000001500,a2f,recvmsg
1,01545003300,01545003500,00000000200,a00,read
1,01545003000,01545109600,00000106600,a07,poll
1,01545111100,01545112000,00000000900,aca,futex
1,01545112500,01545206700,00000094200,aca,futex
1,01545207100,01545233900,00000026800,aca,futex
1,01545260400,01545264900,00000004500,a2e,sendmsg
1,01545267900,01545268200,00000000300,aca,futex
1,01545268600,01545271500,00000002900,aca,futex
1,01545277000,01545278000,00000001000,a2f,recvmsg
1,01545283100,01545284200,00000001100,a2e,sendmsg
1,01545287700,01545287900,00000000200,aca,futex
1,01545292600,01545292800,00000000200,aca,futex
1,01545296700,01545296800,00000000100,aca,futex
1,01545306600,01545306800,00000000200,aca,futex
1,01545337000,01545341500,00000004500,aca,futex
1,01545357500,01545357700,00000000200,a00,read
1,01545359600,01545361200,00000001600,a2e,sendmsg
1,01545379200,01545380300,00000001100,a2f,recvmsg
1,01545383800,01545384700,00000000900,a2e,sendmsg
1,01545427500,01545428600,00000001100,a2e,sendmsg
1,01545425800,01545441100,00000015300,a07,poll
1,01545441900,01545442200,00000000300,a00,read
1,01545449700,01545450900,00000001200,a2f,recvmsg
1,01545459000,01545528700,00000069700,a07,poll
1,01545530200,01545531200,00000001000,aca,futex
1,01545600600,01545601600,00000001000,a2f,recvmsg
1,01545603900,01545604000,00000000100,a00,read
1,01545603600,01545664500,00000060900,a07,poll
1,01545665800,01545666700,00000000900,aca,futex
1,01545731800,01545735100,00000003300,a07,poll
1,01545796500,01545796900,00000000400,aca,futex
1,01545803900,01545804100,00000000200,aca,futex
1,01545852300,01545852600,00000000300,aca,futex
1,01542160500,01545990000,00003829500,a17,select
1,01546012900,01546013100,00000000200,a2f,recvmsg
1,01546059000,01546060500,00000001500,a2f,recvmsg
1,01546067600,01546070500,00000002900,a2e,sendmsg
1,01546086000,01546086300,00000000300,aca,futex
1,01546121600,01546149300,00000027700,aca,futex
1,01546167400,01546169200,00000001800,a2e,sendmsg
1,01546193100,01546194100,00000001000,a2f,recvmsg
1,01546197200,01546198100,00000000900,a2e,sendmsg
1,01546209200,01546212300,00000003100,aca,futex
1,01546216000,01546218300,00000002300,aca,futex
1,01546246500,01546269800,00000023300,aca,futex
1,01546283400,01546284400,00000001000,a2e,sendmsg
1,01546301000,01546301900,00000000900,a2f,recvmsg
1,01546305100,01546305800,00000000700,a2e,sendmsg
1,01546347200,01546348200,00000001000,a2e,sendmsg
1,01546031100,01546369100,00000338000,a17,select
1,01546382600,01546382800,00000000200,a2f,recvmsg
1,01546400500,01546401400,00000000900,a2f,recvmsg
1,01546446300,01546447000,00000000700,a2f,recvmsg
1,01546474300,01546475000,00000000700,a2f,recvmsg
1,01546506600,01546511800,00000005200,a07,poll
1,01546512600,01546513100,00000000500,a00,read
1,01546522100,01546523200,00000001100,a2f,recvmsg
1,01546533100,01546613600,00000080500,a07,poll
1,01546616100,01546617300,00000001200,aca,futex
1,01546694600,01546695700,00000001100,a2f,recvmsg
1,01546698000,01546698200,00000000200,a00,read
1,01546697700,01546756700,00000059000,a07,poll
1,01546758000,01546759100,00000001100,aca,futex
1,01546826100,01546829900,00000003800,a07,poll
1,01546967400,01546973600,00000006200,a07,poll
1,01546975000,01546975600,00000000600,a00,read
1,01546989600,01546991100,00000001500,a2f,recvmsg
1,01547003900,01547113500,00000109600,a07,poll
1,01547115900,01547117200,00000001300,aca,futex
1,01547221200,01547223100,00000001900,aca,futex
1,01547294900,01547296000,00000001100,a2f,recvmsg
1,01547298500,01547298600,00000000100,a00,read
1,01547298200,01547408900,00000110700,a07,poll
1,01547410400,01547411400,00000001000,aca,futex
1,01547473900,01547475200,00000001300,aca,futex
1,01547527700,01547528000,00000000300,a00,read
1,01548150200,01548150300,00000000100,a0c,brk
1,01548161000,01548164300,00000003300,a15,access
1,01548165000,01548166400,00000001400,a09,mmap
1,01548170300,01548171300,00000001000,a15,access
1,01548178700,01548179900,00000001200,a09,mmap
1,01548184100,01548184800,00000000700,a15,access
1,01548192000,01548193100,00000001100,a00,read
1,01548195000,01548197100,00000002100,a09,mmap
1,01548216800,01548217800,00000001000,a15,access
1,01548221500,01548222100,00000000600,a00,read
1,01548222900,01548223900,00000001000,a09,mmap
1,01548226300,01548228100,00000001800,a09,mmap
1,01548237200,01548238000,00000000800,a15,access
1,01548241100,01548241700,00000000600,a00,read
1,01548242500,01548243400,00000000900,a09,mmap
1,01548245100,01548247100,00000002000,a09,mmap
1,01548251500,01548254700,00000003200,a09,mmap
1,01548256900,01548258000,00000001100,a09,mmap
1,01548268700,01548269400,00000000700,a15,access
1,01548272600,01548273300,00000000700,a00,read
1,01548274000,01548275600,00000001600,a09,mmap
1,01548278400,01548280300,00000001900,a09,mmap
1,01548289000,01548289700,00000000700,a15,access
1,01548293500,01548294100,00000000600,a00,read
1,01548294700,01548296300,00000001600,a09,mmap
1,01548299600,01548301900,00000002300,a09,mmap
1,01548310800,01548311500,00000000700,a15,access
1,01548314600,01548315200,00000000600,a00,read
1,01548315600,01548316800,00000001200,a09,mmap
1,01548318200,01548319600,00000001400,a09,mmap
1,01548322400,01548323800,00000001400,a09,mmap
1,01548330300,01548331100,00000000800,a15,access
1,01548333500,01548334300,00000000800,a00,read
1,01548334900,01548336400,00000001500,a09,mmap
1,01548343200,01548366600,00000023400,60e,page_fault
1,01548377700,01548378500,00000000800,a09,mmap
1,01548384200,01548384600,00000000400,a09,mmap
1,01548590200,01548590200,00000000000,a0c,brk
1,01548590300,01548591300,00000001000,a0c,brk
1,01548626500,01548633500,00000007000,a00,read
1,01548645800,01548647400,00000001600,a00,read
1,01548690800,01548691700,00000000900,a00,read
1,01548817600,01548818400,00000000800,a00,read
1,01548890500,01548891100,00000000600,a00,read
1,01548980600,01548981400,00000000800,a00,read
1,01549113400,01549114400,00000001000,a00,read
1,01549244200,01549245300,00000001100,a00,read
1,01549405000,01549405900,00000000900,a00,read
1,01547551300,01549493900,00001942600,a07,poll
1,01549495900,01549496500,00000000600,a00,read
1,01549516000,01549517900,00000001900,a2f,recvmsg
1,01549651400,01549656100,00000004700,a07,poll
1,01549657800,01549658100,00000000300,a00,read
1,01549672500,01549674300,00000001800,a2f,recvmsg
1,01549686400,01549791400,00000105000,a07,poll
1,01549794400,01549796200,00000001800,aca,futex
1,01549908400,01549910100,00000001700,aca,futex
1,01549978500,01549984100,00000005600,a2e,sendmsg
1,01549986500,01549986700,00000000200,a00,read
1,01549989400,01549994300,00000004900,a07,poll
1,01549996000,01549996600,00000000600,a00,read
1,01550012600,01550014300,00000001700,a2f,recvmsg
1,01550028500,01550125800,00000097300,a07,poll
1,01550128100,01550129200,00000001100,aca,futex
1,01550223000,01550224200,00000001200,a2f,recvmsg
1,01550226600,01550226700,00000000100,a00,read
1,01550226200,01550295600,00000069400,a07,poll
1,01550296900,01550298000,00000001100,aca,futex
1,01550367900,01550368900,00000001000,a2f,recvmsg
1,01550371000,01550432700,00000061700,a07,poll
1,01550433800,01550434800,00000001000,aca,futex
1,01540774300,01550506500,00009732200,ae8,epoll_wait
1,01550515300,01550519700,00000004400,a2f,recvmsg
1,01550546300,01550546600,00000000300,a2f,recvmsg
1,01550502600,01550660200,00000157600,a07,poll
1,01550756200,01550756500,00000000300,aca,futex
1,01550934700,01550938700,00000004000,a07,poll
1,01550995800,01550996000,00000000200,a00,read
1,01551057100,01551059600,00000002500,a07,poll
1,01551082800,01551086900,00000004100,a07,poll
1,01551088400,01551088800,00000000400,a00,read
1,01551102800,01551104300,00000001500,a2f,recvmsg
1,01551117700,01551217700,00000100000,a07,poll
1,01551220100,01551221700,00000001600,aca,futex
1,01551307900,01551309800,00000001900,aca,futex
1,01551374500,01551375900,00000001400,a2f,recvmsg
1,01551378600,01551378700,00000000100,a00,read
1,01551378300,01551445500,00000067200,a07,poll
1,01551446900,01551447800,00000000900,aca,futex
1,01551509300,01551510800,00000001500,aca,futex
1,01551542200,01551542500,00000000300,a00,read
1,01551566400,01551567500,00000001100,a2f,recvmsg
1,01551570000,01551637000,00000067000,a07,poll
1,01551638300,01551639300,00000001000,aca,futex
1,01551696100,01551697400,00000001300,aca,futex
1,01551750800,01551751900,00000001100,a2f,recvmsg
1,01551754000,01551809800,00000055800,a07,poll
1,01551811000,01551812100,00000001100,aca,futex
1,01551866500,01551867700,00000001200,aca,futex
1,01551892500,01551892800,00000000300,a00,read
1,01551911100,01551912000,00000000900,a2f,recvmsg
1,01551914100,01551970900,00000056800,a07,poll
1,01551972200,01551973100,00000000900,aca,futex
1,01552024900,01552026100,00000001200,aca,futex
1,01552071900,01552072800,00000000900,a2f,recvmsg
1,01552074800,01552135100,00000060300,a07,poll
1,01552136200,01552137200,00000001000,aca,futex
1,01552189800,01552190900,00000001100,aca,futex
1,01552219200,01552219400,00000000200,a00,read
1,01552238300,01552239100,00000000800,a2f,recvmsg
1,01552242300,01552301100,00000058800,a07,poll
1,01552302400,01552302600,00000000200,a00,read
1,01552312300,01552313500,00000001200,a2f,recvmsg
1,01552467500,01552469900,00000002400,a07,poll
1,01552467500,01552651000,00000183500,a07,poll
1,01552652900,01552654100,00000001200,aca,futex
1,01552692700,01552695700,00000003000,a07,poll
1,01552700300,01552704400,00000004100,a2e,sendmsg
1,01552706800,01552707000,00000000200,a00,read
1,01552711800,01552729900,00000018100,a07,poll
1,01552731100,01552732200,00000001100,aca,futex
1,01552760700,01552762900,00000002200,a07,poll
1,01552765400,01552766900,00000001500,a2e,sendmsg
1,01552773100,01552792200,00000019100,a07,poll
1,01552793500,01552794500,00000001000,aca,futex
1,01552821300,01552823100,00000001800,a07,poll
1,01552825700,01552827300,00000001600,a2e,sendmsg
1,01552829200,01552829400,00000000200,a00,read
1,01552833500,01552847300,00000013800,a07,poll
1,01552848300,01552849400,00000001100,aca,futex
1,01552874300,01552875900,00000001600,a07,poll
1,01552877900,01552879000,00000001100,a2e,sendmsg
1,01552884500,01552965200,00000080700,a07,poll
1,01552966800,01552967800,00000001000,aca,futex
1,01552969900,01552970800,00000000900,aca,futex
1,01552973300,01552974300,00000001000,aca,futex
1,01552976400,01552979800,00000003400,a2e,sendmsg
1,01552982300,01552982400,00000000100,a00,read
1,01550654200,01552991700,00002337500,ae8,epoll_wait
1,01552999800,01553003100,00000003300,a2f,recvmsg
1,01553028000,01553028300,00000000300,a2f,recvmsg
1,01552988200,01553131400,00000143200,a07,poll
1,01553181100,01553181200,00000000100,a00,read
1,01553239500,01553241500,00000002000,a07,poll
1,01553262300,01553265000,00000002700,a07,poll
1,01553268000,01553269900,00000001900,aca,futex
1,01553353700,01553355400,00000001700,aca,futex
1,01553481100,01556526500,00003045400,a07,poll
1,01556713600,01556716500,00000002900,a07,poll
1,01556721400,01556724700,00000003300,a2e,sendmsg
1,01556727400,01556727500,00000000100,a00,read
1,01553128400,01560368000,00007239600,ae8,epoll_wait
1,01560382900,01560386200,00000003300,a2f,recvmsg
1,01560401800,01560402100,00000000300,a2f,recvmsg
1,01560404600,01560405600,00000001000,a2f,recvmsg
1,01560412300,01560412500,00000000200,a2f,recvmsg
1,01560482600,01560489000,00000006400,a2e,sendmsg
1,01560539800,01560540900,00000001100,a2e,sendmsg
1,01556730400,01560598100,00003867700,a07,poll
1,01546384600,01560716900,00014332300,a17,select
1,01560739700,01560740000,00000000300,a2f,recvmsg
1,01560743300,01560782200,00000038900,a17,select
1,01560792000,01560792300,00000000300,a2f,recvmsg
1,01560793600,01560812900,00000019300,a17,select
1,01560818500,01560818800,00000000300,a2f,recvmsg
1,01560819600,01560834700,00000015100,a17,select
1,01560840100,01560840300,00000000200,a2f,recvmsg
1,01560841000,01560856800,00000015800,a17,select
1,01560862400,01560862600,00000000200,a2f,recvmsg
1,01560863200,01560871000,00000007800,a17,select
1,01560875600,01560875800,00000000200,a2f,recvmsg
1,01560876300,01560897100,00000020800,a17,select
1,01560902000,01560902200,00000000200,a2f,recvmsg
1,01560902700,01560913800,00000011100,a17,select
1,01560918100,01560918300,00000000200,a2f,recvmsg
1,01560918800,01560927000,00000008200,a17,select
1,01560931200,01560931400,00000000200,a2f,recvmsg
1,01560932000,01560940200,00000008200,a17,select
1,01560944300,01560944500,00000000200,a2f,recvmsg
1,01560945000,01560955400,00000010400,a17,select
1,01560959800,01560960000,00000000200,a2f,recvmsg
1,01560964200,01560966500,00000002300,aca,futex
1,01560548100,01560985200,00000437100,ae8,epoll_wait
1,01560992900,01560994400,00000001500,a2f,recvmsg
1,01561014900,01561015200,00000000300,a2f,recvmsg
1,01561051700,01561056100,00000004400,a2e,sendmsg
1,01560960600,01561066600,00000106000,a17,select
1,01561073500,01561073700,00000000200,a2f,recvmsg
1,01561199400,01561367200,00000167800,a07,poll
1,01561370000,01561370400,00000000400,aca,futex
1,01561370700,01561370800,00000000100,aca,futex
1,01561419800,01561422000,00000002200,a01,write
1,01561447100,01561447400,00000000300,aca,futex
1,01561447800,01561448100,00000000300,aca,futex
1,01561449400,01561449600,00000000200,aca,futex
1,01561450500,01561451600,00000001100,aca,futex
1,01561059900,01561460000,00000400100,ae8,epoll_wait
1,01561465700,01561467700,00000002000,a2f,recvmsg
1,01561486800,01561487100,00000000300,a2f,recvmsg
1,01561525300,01561529800,00000004500,a2e,sendmsg
1,01561533400,01561537200,00000003800,ae8,epoll_wait
1,01561545600,01561547500,00000001900,a2f,recvmsg
1,01561562800,01561563100,00000000300,a2f,recvmsg
1,01561074900,01561638300,00000563400,a17,select
1,01561648800,01561648900,00000000100,a2f,recvmsg
1,01561658900,01561659100,00000000200,a2f,recvmsg
1,01561628300,01561664500,00000036200,ae8,epoll_wait
1,01561668900,01561669900,00000001000,a2f,recvmsg
1,01561678700,01561678900,00000000200,a2f,recvmsg
1,01561717300,01561719300,00000002000,a2e,sendmsg
1,01561659900,01561728500,00000068600,a17,select
1,01561735100,01561735300,00000000200,a2f,recvmsg
1,01561455900,01561742000,00000286100,a07,poll
1,01561756300,01561757500,00000001200,a2f,recvmsg
1,01561736300,01561875100,00000138800,a17,select
1,01561883400,01561883600,00000000200,a2f,recvmsg
1,01561869700,01561890200,00000020500,a07,poll
1,01561955900,01561959300,00000003400,a07,poll
1,01561975300,01561978000,00000002700,a2e,sendmsg
1,01562003800,01562004800,00000001000,a2e,sendmsg
1,01562009400,01562009600,00000000200,a00,read
1,01562037800,01562040100,00000002300,a07,poll
1,01561884900,01562058700,00000173800,a17,select
1,01562066600,01562066800,00000000200,a2f,recvmsg
1,01561723600,01562072600,00000349000,ae8,epoll_wait
1,01562078000,01562079400,00000001400,a2f,recvmsg
1,01562092700,01562093000,00000000300,a2f,recvmsg
1,01562068000,01562153300,00000085300,a17,select
1,01562160500,01562160700,00000000200,a2f,recvmsg
1,01562148100,01562166200,00000018100,ae8,epoll_wait
1,01562170800,01562171600,00000000800,a2f,recvmsg
1,01562180600,01562180800,00000000200,a2f,recvmsg
1,01562224600,01562227000,00000002400,a2e,sendmsg
1,01562161900,01562236100,00000074200,a17,select
1,01562243000,01562243200,00000000200,a2f,recvmsg
1,01562053300,01562248000,00000194700,a07,poll
1,01562266400,01562268500,00000002100,a07,poll
1,01562244200,01562305100,00000060900,a17,select
1,01562312800,01562313000,00000000200,a2f,recvmsg
1,01562314000,01562321900,00000007900,a17,select
1,01562327000,01562327100,00000000100,a2f,recvmsg
1,01562327700,01562335200,00000007500,a17,select
1,01562339800,01562340000,00000000200,a2f,recvmsg
1,01562340500,01562352000,00000011500,a17,select
1,01562356900,01562357100,00000000200,a2f,recvmsg
1,01562357600,01562364800,00000007200,a17,select
1,01562368900,01562369000,00000000100,a2f,recvmsg
1,01562369500,01562376900,00000007400,a17,select
1,01562381200,01562381300,00000000100,a2f,recvmsg
1,01562381900,01562389200,00000007300,a17,select
1,01562393400,01562393500,00000000100,a2f,recvmsg
1,01562394000,01562401500,00000007500,a17,select
1,01562405500,01562405700,00000000200,a2f,recvmsg
1,01562406300,01562413400,00000007100,a17,select
1,01562417500,01562417600,00000000100,a2f,recvmsg
1,01562418200,01562426000,00000007800,a17,select
1,01562430300,01562430500,00000000200,a2f,recvmsg
1,01562431100,01562440900,00000009800,a17,select
1,01562445100,01562445300,00000000200,a2f,recvmsg
1,01562445900,01562454500,00000008600,a17,select
1,01562459000,01562459200,00000000200,a2f,recvmsg
1,01562459800,01562467800,00000008000,a17,select
1,01562471900,01562472100,00000000200,a2f,recvmsg
1,01562472600,01562480700,00000008100,a17,select
1,01562484900,01562485000,00000000100,a2f,recvmsg
1,01562485600,01562495700,00000010100,a17,select
1,01562500100,01562500200,00000000100,a2f,recvmsg
1,01562500900,01562508600,00000007700,a17,select
1,01562512900,01562513100,00000000200,a2f,recvmsg
1,01562513600,01562521300,00000007700,a17,select
1,01562525400,01562525600,00000000200,a2f,recvmsg
1,01562526200,01562534700,00000008500,a17,select
1,01562539000,01562539200,00000000200,a2f,recvmsg
1,01562539800,01562548500,00000008700,a17,select
1,01562552900,01562553100,00000000200,a2f,recvmsg
1,01562553600,01562562100,00000008500,a17,select
1,01562566600,01562566700,00000000100,a2f,recvmsg
1,01562567300,01562575100,00000007800,a17,select
1,01562579200,01562579400,00000000200,a2f,recvmsg
1,01562579900,01562587500,00000007600,a17,select
1,01562591700,01562591900,00000000200,a2f,recvmsg
1,01562592500,01562599800,00000007300,a17,select
1,01562604000,01562604100,00000000100,a2f,recvmsg
1,01562604600,01562612500,00000007900,a17,select
1,01562616600,01562616800,00000000200,a2f,recvmsg
1,01562617400,01562636900,00000019500,a17,select
1,01562641700,01562641900,00000000200,a2f,recvmsg
1,01562642600,01562673200,00000030600,a17,select
1,01562678600,01562678700,00000000100,a2f,recvmsg
1,01562679400,01562698800,00000019400,a17,select
1,01562703800,01562704000,00000000200,a2f,recvmsg
1,01562704700,01562711900,00000007200,a17,select
1,01562715900,01562716100,00000000200,a2f,recvmsg
1,01562716700,01562723900,00000007200,a17,select
1,01562727900,01562728100,00000000200,a2f,recvmsg
1,01562728600,01562735700,00000007100,a17,select
1,01562739900,01562740000,00000000100,a2f,recvmsg
1,01562740600,01562748100,00000007500,a17,select
1,01562752400,01562752500,00000000100,a2f,recvmsg
1,01562753000,01562760600,00000007600,a17,select
1,01562764600,01562764800,00000000200,a2f,recvmsg
1,01562765400,01562772500,00000007100,a17,select
1,01562776500,01562776600,00000000100,a2f,recvmsg
1,01562777200,01562785100,00000007900,a17,select
1,01562789300,01562789500,00000000200,a2f,recvmsg
1,01562790000,01562797400,00000007400,a17,select
1,01562801500,01562801700,00000000200,a2f,recvmsg
1,01562802200,01562811500,00000009300,a17,select
1,01562815500,01562815600,00000000100,a2f,recvmsg
1,01562816200,01562826100,00000009900,a17,select
1,01562830100,01562830300,00000000200,a2f,recvmsg
1,01562830800,01562838700,00000007900,a17,select
1,01562842700,01562842800,00000000100,a2f,recvmsg
1,01562843400,01562850900,00000007500,a17,select
1,01562854900,01562855100,00000000200,a2f,recvmsg
1,01562855500,01562863000,00000007500,a17,select
1,01562866800,01562867000,00000000200,a2f,recvmsg
1,01562867500,01562875100,00000007600,a17,select
1,01562879100,01562879300,00000000200,a2f,recvmsg
1,01562879900,01562888200,00000008300,a17,select
1,01562892400,01562892600,00000000200,a2f,recvmsg
1,01562893200,01562900800,00000007600,a17,select
1,01562904700,01562904800,00000000100,a2f,recvmsg
1,01562905300,01562912800,00000007500,a17,select
1,01562916800,01562916900,00000000100,a2f,recvmsg
1,01562917500,01562924900,00000007400,a17,select
1,01562928800,01562929000,00000000200,a2f,recvmsg
1,01562929500,01562937100,00000007600,a17,select
1,01562941000,01562941100,00000000100,a2f,recvmsg
1,01562941700,01562949300,00000007600,a17,select
1,01562953300,01562953500,00000000200,a2f,recvmsg
1,01562954100,01562962300,00000008200,a17,select
1,01562966300,01562966500,00000000200,a2f,recvmsg
1,01562967100,01562974600,00000007500,a17,select
1,01562978600,01562978800,00000000200,a2f,recvmsg
1,01562979300,01562986800,00000007500,a17,select
1,01562990900,01562991100,00000000200,a2f,recvmsg
1,01562991600,01562999100,00000007500,a17,select
1,01563003300,01563003500,00000000200,a2f,recvmsg
1,01563004000,01563017200,00000013200,a17,select
1,01563021500,01563021600,00000000100,a2f,recvmsg
1,01563022300,01563029900,00000007600,a17,select
1,01563034000,01563034100,00000000100,a2f,recvmsg
1,01563034700,01563042100,00000007400,a17,select
1,01563046100,01563046300,00000000200,a2f,recvmsg
1,01563050300,01563052900,00000002600,a01,write
1,01563046900,01563055500,00000008600,a17,select
1,01563059600,01563059800,00000000200,a2f,recvmsg
1,01563063800,01563065100,00000001300,aca,futex
1,01563060400,01563069600,00000009200,a17,select
1,01563072800,01563073000,00000000200,a2f,recvmsg
1,01562231600,01563079400,00000847800,ae8,epoll_wait
1,01563083300,01563084400,00000001100,a2f,recvmsg
1,01563103600,01563103800,00000000200,a2f,recvmsg
1,01563135400,01563138700,00000003300,a2e,sendmsg
1,01563266400,01563392500,00000126100,a07,poll
1,01563435100,01563437400,00000002300,a01,write
1,01563462400,01563463500,00000001100,a01,write
1,01563487800,01563488800,00000001000,a01,write
1,01563510800,01563511800,00000001000,a01,write
1,01563142200,01563518500,00000376300,ae8,epoll_wait
1,01563523900,01563527600,00000003700,a2f,recvmsg
1,01563549900,01563550300,00000000400,a2f,recvmsg
1,01563642200,01563645400,00000003200,ae8,epoll_wait
1,01563649800,01563651100,00000001300,a2f,recvmsg
1,01563659700,01563659900,00000000200,a2f,recvmsg
1,01563661000,01563662000,00000001000,a2f,recvmsg
1,01563678100,01563678200,00000000100,a2f,recvmsg
1,01563717400,01563720400,00000003000,a2e,sendmsg
1,01563746700,01563749700,00000003000,a2e,sendmsg
1,01563514000,01563756200,00000242200,a07,poll
1,01563785900,01563788000,00000002100,a07,poll
1,01563473300,01564006500,00000533200,aca,futex
1,01564062900,01564066100,00000003200,a07,poll
1,01564070500,01564072800,00000002300,a2e,sendmsg
1,01564075500,01564075600,00000000100,a00,read
1,01563753900,01564081000,00000327100,ae8,epoll_wait
1,01564085200,01564087000,00000001800,a2f,recvmsg
1,01564106300,01564106600,00000000300,a2f,recvmsg
1,01564108000,01564108800,00000000800,a2f,recvmsg
1,01564114200,01564114300,00000000100,a2f,recvmsg
1,01564143000,01564146000,00000003000,a2e,sendmsg
1,01564183100,01564184700,00000001600,a2e,sendmsg
1,01563073600,01564198200,00001124600,a17,select
1,01564204900,01564206500,00000001600,a2f,recvmsg
1,01564630000,01564631100,00000001100,a2f,recvmsg
1,01564928100,01564930200,00000002100,a2f,recvmsg
1,01565044300,01565044500,00000000200,a2f,recvmsg
1,01565045300,01565045800,00000000500,a14,writev
1,01564078800,01565060900,00000982100,a07,poll
1,01565068800,01565078400,00000009600,a2f,recvmsg
1,01565093200,01565093500,00000000300,a2f,recvmsg
1,01565123700,01565129200,00000005500,a07,poll
1,01565130900,01565131900,00000001000,a00,read
1,01565136700,01565145100,00000008400,a2f,recvmsg
1,01565157600,01565157900,00000000300,a2f,recvmsg
1,01564188300,01565188400,00001000100,ae8,epoll_wait
1,01565194300,01565195700,00000001400,a2f,recvmsg
1,01565205800,01565206000,00000000200,a2f,recvmsg
1,01565246500,01565249800,00000003300,a2e,sendmsg
1,01565181700,01565258900,00000077200,a07,poll
1,01565264200,01565268400,00000004200,a2f,recvmsg
1,01565273400,01565273600,00000000200,a2f,recvmsg
1,01565276700,01565277000,00000000300,a2f,recvmsg
1,01565277300,01565277400,00000000100,a2f,recvmsg
1,01565280400,01565280500,00000000100,a2f,recvmsg
1,01565280800,01565280900,00000000100,a2f,recvmsg
1,01565281500,01565284100,00000002600,a07,poll
1,01565368100,01565368400,00000000300,aca,futex
1,01565407100,01565412200,00000005100,a07,poll
1,01565414200,01565414900,00000000700,a00,read
1,01565417700,01565426400,00000008700,a2f,recvmsg
1,01565437600,01565437800,00000000200,a2f,recvmsg
1,01565255000,01565466800,00000211800,ae8,epoll_wait
1,01565473100,01565475700,00000002600,a2f,recvmsg
1,01565498300,01565498600,00000000300,a2f,recvmsg
1,01565463400,01565596200,00000132800,a07,poll
1,01565049200,01565634000,00000584800,a17,select
1,01565662900,01565664700,00000001800,a14,writev
1,01565665500,01565665800,00000000300,a2f,recvmsg
1,01565684300,01565685700,00000001400,a14,writev
1,01565686100,01565686300,00000000200,a2f,recvmsg
1,01565700500,01565701400,00000000900,a14,writev
1,01565701600,01565701800,00000000200,a2f,recvmsg
1,01565719300,01565719500,00000000200,a2f,recvmsg
1,01565625600,01565725000,00000099400,a07,poll
1,01565726300,01565727500,00000001200,a2f,recvmsg
1,01565738600,01565739700,00000001100,a2d,recvfrom
1,01565741400,01565741600,00000000200,a2f,recvmsg
1,01565742400,01565742700,00000000300,a2f,recvmsg
1,01565780200,01565780500,00000000300,a2f,recvmsg
1,01565783500,01565783800,00000000300,a2f,recvmsg
1,01565788600,01565794700,00000006100,a07,poll
1,01565801800,01565802000,00000000200,a2f,recvmsg
1,01565804500,01565804800,00000000300,a2f,recvmsg
1,01565805100,01565805300,00000000200,a2f,recvmsg
1,01565807400,01565807600,00000000200,a2f,recvmsg
1,01565807800,01565808000,00000000200,a2f,recvmsg
1,01565808400,01565810800,00000002400,a07,poll
1,01565822800,01565825100,00000002300,a07,poll
1,01565826800,01565828500,00000001700,a2f,recvmsg
1,01565840100,01565841000,00000000900,a2d,recvfrom
1,01565842800,01565843000,00000000200,a2f,recvmsg
1,01565843800,01565843900,00000000100,a2f,recvmsg
1,01565896000,01565896400,00000000400,a2f,recvmsg
1,01565899400,01565899500,00000000100,a2f,recvmsg
1,01565902300,01565906800,00000004500,a07,poll
1,01566060900,01566065100,00000004200,a01,write
1,01565592800,01566085300,00000492500,ae8,epoll_wait
1,01566091100,01566093000,00000001900,a2f,recvmsg
1,01566114600,01566114900,00000000300,a2f,recvmsg
1,01566153600,01566158000,00000004400,a2e,sendmsg
1,01565902300,01566166200,00000263900,a07,poll
1,01566181200,01566182500,00000001300,a2f,recvmsg
1,01566194400,01566295600,00000101200,a07,poll
1,01566298700,01566300400,00000001700,aca,futex
1,01566410900,01566412500,00000001600,aca,futex
1,01566475100,01566478700,00000003600,a2e,sendmsg
1,01566480800,01566480900,00000000100,a00,read
1,01566162000,01566487600,00000325600,ae8,epoll_wait
1,01566493200,01566494600,00000001400,a2f,recvmsg
1,01566504900,01566505200,00000000300,a2f,recvmsg
1,01566554700,01566558000,00000003300,a2e,sendmsg
1,01566485200,01566566700,00000081500,a07,poll
1,01566770900,01566773200,00000002300,a01,write
1,01566563400,01566789900,00000226500,ae8,epoll_wait
1,01566794100,01566796400,00000002300,a2f,recvmsg
1,01566815200,01566815400,00000000200,a2f,recvmsg
1,01566847600,01566851600,00000004000,a2e,sendmsg
1,01566854700,01566858400,00000003700,ae8,epoll_wait
1,01566865300,01566867300,00000002000,a2f,recvmsg
1,01566883300,01566883400,00000000100,a2f,recvmsg
1,01566898700,01566901800,00000003100,a2e,sendmsg
1,01566778800,01566904900,00000126100,a07,poll
1,01566906600,01566907300,00000000700,a00,read
1,01566921200,01566922400,00000001200,a2f,recvmsg
1,01567017800,01567021700,00000003900,a2e,sendmsg
1,01567147300,01567193300,00000046000,a07,poll
1,01567234600,01567235100,00000000500,aca,futex
1,01567237600,01567240100,00000002500,a01,write
1,01567266000,01567267200,00000001200,a01,write
1,01567291100,01567292200,00000001100,a01,write
1,01567314700,01567315900,00000001200,a01,write
1,01567026600,01567321700,00000295100,ae8,epoll_wait
1,01567327000,01567331000,00000004000,a2f,recvmsg
1,01567353000,01567353300,00000000300,a2f,recvmsg
1,01567447000,01567450400,00000003400,ae8,epoll_wait
1,01567455000,01567456400,00000001400,a2f,recvmsg
1,01567465300,01567465500,00000000200,a2f,recvmsg
1,01567466700,01567467700,00000001000,a2f,recvmsg
1,01567483500,01567483700,00000000200,a2f,recvmsg
1,01567523800,01567526900,00000003100,a2e,sendmsg
1,01567552700,01567555400,00000002700,a2e,sendmsg
1,01567317800,01567562500,00000244700,a07,poll
1,01567574800,01567576000,00000001200,a2f,recvmsg
1,01567586500,01567666400,00000079900,a07,poll
1,01567668900,01567670400,00000001500,aca,futex
1,01567769900,01567772100,00000002200,aca,futex
1,01567831300,01567834800,00000003500,a2e,sendmsg
1,01567836900,01567837100,00000000200,a00,read
1,01567559800,01567841500,00000281700,ae8,epoll_wait
1,01567845800,01567847100,00000001300,a2f,recvmsg
1,01567855800,01567856100,00000000300,a2f,recvmsg
1,01567898700,01567901800,00000003100,a2e,sendmsg
1,01567839300,01567908800,00000069500,a07,poll
1,01567939200,01567941600,00000002400,a07,poll
1,01567906200,01567987000,00000080800,ae8,epoll_wait
1,01567992300,01567994000,00000001700,a2f,recvmsg
1,01568008500,01568008800,00000000300,a2f,recvmsg
1,01568023600,01568027200,00000003600,a2e,sendmsg
1,01568122300,01568124800,00000002500,a01,write
1,01568030400,01568138900,00000108500,ae8,epoll_wait
1,01568142800,01568144400,00000001600,a2f,recvmsg
1,01568163500,01568163700,00000000200,a2f,recvmsg
1,01568193100,01568196600,00000003500,a2e,sendmsg
1,01568311300,01568456900,00000145600,a07,poll
1,01568497900,01568500300,00000002400,a01,write
1,01568524700,01568525700,00000001000,a01,write
1,01568549800,01568551000,00000001200,a01,write
1,01568572800,01568573900,00000001100,a01,write
1,01568199800,01568579800,00000380000,ae8,epoll_wait
1,01568584800,01568588800,00000004000,a2f,recvmsg
1,01568610800,01568611100,00000000300,a2f,recvmsg
1,01568700100,01568703500,00000003400,ae8,epoll_wait
1,01568707500,01568709000,00000001500,a2f,recvmsg
1,01568717800,01568718000,00000000200,a2f,recvmsg
1,01568756500,01568757900,00000001400,a2e,sendmsg
1,01568575700,01568764400,00000188700,a07,poll
1,01568762100,01568794600,00000032500,ae8,epoll_wait
1,01568796900,01568798200,00000001300,a2f,recvmsg
1,01568815300,01568815500,00000000200,a2f,recvmsg
1,01568842200,01568845900,00000003700,a2e,sendmsg
1,01568792500,01568851000,00000058500,a07,poll
1,01568862900,01568864100,00000001200,a2f,recvmsg
1,01568874600,01568954400,00000079800,a07,poll
1,01568956600,01568958000,00000001400,aca,futex
1,01569053700,01569055500,00000001800,aca,futex
1,01569112900,01569115900,00000003000,a2e,sendmsg
1,01569118000,01569118200,00000000200,a00,read
1,01568848300,01569122400,00000274100,ae8,epoll_wait
1,01569126300,01569127600,00000001300,a2f,recvmsg
1,01569136000,01569136300,00000000300,a2f,recvmsg
1,01569177200,01569180500,00000003300,a2e,sendmsg
1,01569120400,01569186900,00000066500,a07,poll
1,01569210400,01569210900,00000000500,aca,futex
1,01569216500,01569216600,00000000100,aca,futex
1,01569316700,01569319100,00000002400,a01,write
1,01569184700,01569333700,00000149000,ae8,epoll_wait
1,01569337000,01569338700,00000001700,a2f,recvmsg
1,01569357200,01569357400,00000000200,a2f,recvmsg
1,01569384000,01569387300,00000003300,a2e,sendmsg
1,01569500800,01569630700,00000129900,a07,poll
1,01569671300,01569673500,00000002200,a01,write
1,01569700800,01569701900,00000001100,aca,futex
1,01569712900,01569713200,00000000300,aca,futex
1,01569727000,01569728100,00000001100,a01,write
1,01569749400,01569750500,00000001100,a01,write
1,01569390000,01569756700,00000366700,ae8,epoll_wait
1,01569761900,01569765800,00000003900,a2f,recvmsg
1,01569788100,01569788400,00000000300,a2f,recvmsg
1,01569819700,01569823000,00000003300,a2e,sendmsg
1,01569881700,01569885100,00000003400,ae8,epoll_wait
1,01569888900,01569890100,00000001200,a2f,recvmsg
1,01569898700,01569898900,00000000200,a2f,recvmsg
1,01569934800,01569936100,00000001300,a2e,sendmsg
1,01569940700,01569941800,00000001100,a2f,recvmsg
1,01569958100,01569958300,00000000200,a2f,recvmsg
1,01569980500,01569984100,00000003600,a2e,sendmsg
1,01569752400,01569989300,00000236900,a07,poll
1,01570000600,01570001700,00000001100,a2f,recvmsg
1,01570011500,01570090600,00000079100,a07,poll
1,01570092900,01570094300,00000001400,aca,futex
1,01570189900,01570191500,00000001600,aca,futex
1,01570249100,01570252200,00000003100,a2e,sendmsg
1,01570254500,01570254700,00000000200,a00,read
1,01569986300,01570259400,00000273100,ae8,epoll_wait
1,01570263200,01570264500,00000001300,a2f,recvmsg
1,01570273000,01570273200,00000000200,a2f,recvmsg
1,01570312700,01570315500,00000002800,a2e,sendmsg
1,01570257100,01570322200,00000065100,a07,poll
1,01570351000,01570353100,00000002100,a07,poll
1,01570355700,01570370200,00000014500,aca,futex
1,01570490900,01570494100,00000003200,a01,write
1,01570319800,01570506700,00000186900,ae8,epoll_wait
1,01570510300,01570512300,00000002000,a2f,recvmsg
1,01570530800,01570531100,00000000300,a2f,recvmsg
1,01570557400,01570561100,00000003700,a2e,sendmsg
1,01570676500,01570789500,00000113000,a07,poll
1,01570855400,01570855900,00000000500,aca,futex
1,01570860400,01570861800,00000001400,aca,futex
1,01570865000,01570865300,00000000300,aca,futex
1,01570884100,01570885200,00000001100,aca,futex
1,01570887700,01570887900,00000000200,aca,futex
1,01570907200,01570908200,00000001000,aca,futex
1,01570564100,01570913000,00000348900,ae8,epoll_wait
1,01570916300,01570918400,00000002100,a2f,recvmsg
1,01570936800,01570937000,00000000200,a2f,recvmsg
1,01570964500,01570967900,00000003400,a2e,sendmsg
1,01570971100,01570973900,00000002800,ae8,epoll_wait
1,01570979300,01570981900,00000002600,a2f,recvmsg
1,01571004500,01571004700,00000000200,a2f,recvmsg
1,01571035000,01571037700,00000002700,a2e,sendmsg
1,01570909300,01571099500,00000190200,a07,poll
1,01571110300,01571111600,00000001300,a2f,recvmsg
1,01571120600,01571197300,00000076700,a07,poll
1,01571199500,01571200700,00000001200,aca,futex
1,01565720200,01571325800,00005605600,a17,select
1,01571354600,01571358400,00000003800,a14,writev
1,01571359200,01571362100,00000002900,a14,writev
1,01571363600,01571364100,00000000500,a2f,recvmsg
1,01571310900,01571377100,00000066200,a07,poll
1,01571395300,01571395700,00000000400,aca,futex
1,01571396400,01571396600,00000000200,aca,futex
1,01571397200,01571397500,00000000300,aca,futex
1,01571409300,01571409400,00000000100,aca,futex
1,01571410700,01571410900,00000000200,aca,futex
1,01571368400,01576356800,00004988400,a17,select
1,01576376500,01576380900,00000004400,a2f,recvmsg
1,01576541800,01576583600,00000041800,aca,futex
1,01576605800,01576750900,00000145100,aca,futex
1,01576757200,01576769100,00000011900,aca,futex
1,01571412600,01576881800,00005469200,a07,poll
1,01576886800,01576913300,00000026500,a07,poll
1,01576919200,01576919300,00000000100,a2f,recvmsg
1,01576974400,01576974900,00000000500,a2f,recvmsg
1,01576976800,01576977100,00000000300,a2f,recvmsg
1,01577151900,01577152800,00000000900,a2f,recvmsg
1,01578183100,01578183300,00000000200,a0c,brk
1,01578195400,01578199000,00000003600,a15,access
1,01578199900,01578200900,00000001000,a09,mmap
1,01578205500,01578208500,00000003000,a15,access
1,01578216300,01578217300,00000001000,a09,mmap
1,01578221300,01578222100,00000000800,a15,access
1,01578230200,01578231600,00000001400,a00,read
1,01578233900,01578235800,00000001900,a09,mmap
1,01578241600,01578244300,00000002700,a09,mmap
1,01578258700,01578259500,00000000800,a15,access
1,01578263700,01578264400,00000000700,a00,read
1,01578269100,01578270600,00000001500,a09,mmap
1,01578279500,01578280100,00000000600,a15,access
1,01578283800,01578284700,00000000900,a00,read
1,01578285400,01578286300,00000000900,a09,mmap
1,01578288000,01578290500,00000002500,a09,mmap
1,01578294900,01578298500,00000003600,a09,mmap
1,01578301000,01578302300,00000001300,a09,mmap
1,01578313500,01578314100,00000000600,a15,access
1,01578317200,01578317900,00000000700,a00,read
1,01578318700,01578320600,00000001900,a09,mmap
1,01578323600,01578325700,00000002100,a09,mmap
1,01578335900,01578336500,00000000600,a15,access
1,01578340400,01578341000,00000000600,a00,read
1,01578341800,01578343600,00000001800,a09,mmap
1,01578347400,01578349700,00000002300,a09,mmap
1,01578359400,01578360000,00000000600,a15,access
1,01578362900,01578363500,00000000600,a00,read
1,01578364000,01578365100,00000001100,a09,mmap
1,01578366400,01578368000,00000001600,a09,mmap
1,01578370900,01578372400,00000001500,a09,mmap
1,01578379600,01578380200,00000000600,a15,access
1,01578383600,01578384100,00000000500,a00,read
1,01578384800,01578386300,00000001500,a09,mmap
1,01578388700,01578390600,00000001900,a09,mmap
1,01578406100,01578406700,00000000600,a09,mmap
1,01578411100,01578411400,00000000300,a09,mmap
1,01578412500,01578412700,00000000200,a09,mmap
1,01578634300,01578634400,00000000100,a0c,brk
1,01578634500,01578635200,00000000700,a0c,brk
1,01578676700,01578678000,00000001300,a00,read
1,01578692000,01578693700,00000001700,a00,read
1,01578736800,01578737900,00000001100,a00,read
1,01578869100,01578870100,00000001000,a00,read
1,01578944500,01578945000,00000000500,a00,read
1,01579033900,01579034500,00000000600,a00,read
1,01579166600,01579167400,00000000800,a00,read
1,01579297100,01579298000,00000000900,a00,read
1,01579454300,01579454900,00000000600,a00,read
1,01579605800,01579606400,00000000600,a00,read
1,01579643100,01579644800,00000001700,a0c,brk
1,01579761300,01579761900,00000000600,a00,read
1,01579913300,01579913900,00000000600,a00,read
1,01580069700,01580070400,00000000700,a00,read
1,01580230400,01580231000,00000000600,a00,read
1,01580371700,01580372600,00000000900,a00,read
1,01580403300,01580404100,00000000800,a0c,brk
1,01580516400,01580517300,00000000900,a00,read
1,01580766600,01580767300,00000000700,a00,read
1,01580779400,01580779800,00000000400,a00,read
1,01580824300,01580824700,00000000400,a00,read
1,01580844600,01580845700,00000001100,a00,read
1,01581051700,01581052000,00000000300,a00,read
1,01581081600,01581082300,00000000700,a00,read
1,01581178900,01581179700,00000000800,a00,read
1,01581203500,01581204700,00000001200,a0c,brk
1,01581251000,01581251300,00000000300,a00,read
1,01581331000,01581331900,00000000900,a00,read
1,01581484500,01581485000,00000000500,a00,read
1,01581597800,01581598500,00000000700,a00,read
1,01581692400,01581692900,00000000500,a00,read
1,01581705000,01581705400,00000000400,a00,read
1,01581786600,01581787000,00000000400,a00,read
1,01581811000,01581811400,00000000400,a00,read
1,01581833200,01581833700,00000000500,a00,read
1,01581935200,01581936200,00000001000,a0c,brk
1,01581940800,01581941900,00000001100,a00,read
1,01582141200,01582141600,00000000400,a00,read
1,01582225600,01582226100,00000000500,a00,read
1,01582290700,01582291500,00000000800,a00,read
1,01582418800,01582419500,00000000700,a00,read
1,01582452500,01582453200,00000000700,a00,read
1,01582470600,01582472700,00000002100,a02,open
1,01582584000,01582584600,00000000600,a00,read
1,01582655500,01582655900,00000000400,a00,read
1,01582710400,01582711500,00000001100,a0c,brk
1,01582718100,01582718900,00000000800,a00,read
1,01582826400,01582827100,00000000700,a00,read
1,01582978300,01582979100,00000000800,a00,read
1,01583109800,01583110500,00000000700,a00,read
1,01583168600,01583169400,00000000800,a00,read
1,01583225200,01583225800,00000000600,a00,read
1,01583295700,01583296400,00000000700,a00,read
1,01583349200,01583350000,00000000800,a00,read
1,01583438000,01583438700,00000000700,a0c,brk
1,01583474300,01583477700,00000003400,a0c,brk
1,01583491900,01583492700,00000000800,a00,read
1,01583643700,01583645000,00000001300,a00,read
1,01577156700,01583762700,00006606000,a07,poll
1,01583796400,01583796700,00000000300,a00,read
1,01571096300,01583812000,00012715700,ae8,epoll_wait
1,01583806700,01583813100,00000006400,aca,futex
1,01583817600,01583819100,00000001500,a2e,sendmsg
1,01583843000,01583847500,00000004500,a2f,recvmsg
1,01583867600,01583867800,00000000200,a2f,recvmsg
1,01583919200,01583920100,00000000900,a2e,sendmsg
1,01583980700,01583982200,00000001500,a00,read
1,01584104300,01584105500,00000001200,a00,read
1,01583827300,01584192700,00000365400,a07,poll
1,01584226700,01584290500,00000063800,a07,poll
1,01584361300,01584362600,00000001300,a00,read
1,01584482500,01584483100,00000000600,a00,read
1,01584660200,01584661000,00000000800,a00,read
1,01584666400,01584668700,00000002300,a0c,brk
1,01584785600,01584786300,00000000700,a00,read
1,01584904800,01584905400,00000000600,a00,read
1,01585046400,01585047200,00000000800,a00,read
1,01585179100,01585179800,00000000700,a00,read
1,01585272600,01585273300,00000000700,a00,read
1,01585385800,01585386600,00000000800,a00,read
1,01585510500,01585511200,00000000700,a00,read
1,01585626300,01585627100,00000000800,a0c,brk
1,01585649800,01585650500,00000000700,a00,read
1,01585818800,01585819500,00000000700,a00,read
1,01585969500,01585970200,00000000700,a00,read
1,01586081000,01586081700,00000000700,a00,read
1,01586271200,01586272200,00000001000,a00,read
1,01586349200,01586349900,00000000700,a00,read
1,01586431000,01586431800,00000000800,a00,read
1,01586498200,01586499000,00000000800,a0c,brk
1,01586512400,01586513100,00000000700,a00,read
1,01586585500,01586586300,00000000800,a00,read
1,01586686800,01586687500,00000000700,a00,read
1,01586789200,01586789800,00000000600,a00,read
1,01586878800,01586879400,00000000600,a00,read
1,01586959500,01586960200,00000000700,a00,read
1,01587062600,01587063300,00000000700,a00,read
1,01587143400,01587144000,00000000600,a0c,brk
1,01587146500,01587147100,00000000600,a00,read
1,01587253300,01587253900,00000000600,a00,read
1,01587346500,01587347200,00000000700,a00,read
1,01587465200,01587465900,00000000700,a00,read
1,01587578700,01587579400,00000000700,a00,read
1,01587683100,01587683700,00000000600,a00,read
1,01587785000,01587785500,00000000500,a0c,brk
1,01588158100,01588161300,00000003200,a57,unlink
1,01588182400,01588183000,00000000600,a48,fcntl
1,01588235800,01588246200,00000010400,a01,write
1,01588264200,01588266900,00000002700,a01,write
1,01588284400,01588286800,00000002400,a01,write
1,01571368400,01588612500,00017244100,a17,select
1,01588636600,01588636800,00000000200,a2f,recvmsg
1,01588654700,01588680300,00000025600,a10,ioctl
1,01588700200,01588700400,00000000200,a2f,recvmsg
1,01588702000,01588860600,00000158600,a17,select
1,01588892800,01588893000,00000000200,a2f,recvmsg
1,01588896900,01588988500,00000091600,a17,select
1,01589001800,01589002100,00000000300,a2f,recvmsg
1,01589006100,01589062400,00000056300,a17,select
1,01589077100,01589077300,00000000200,a2f,recvmsg
1,01589098000,01589185500,00000087500,a17,select
1,01589197500,01589197700,00000000200,a2f,recvmsg
1,01584311100,01589214500,00004903400,a07,poll
1,01590252200,01590260800,00000008600,a14,writev
1,01589201800,01590276500,00001074700,a17,select
1,01590285500,01590289500,00000004000,a2f,recvmsg
1,01590367700,01590398700,00000031000,a10,ioctl
1,01590455700,01590476500,00000020800,aca,futex
1,01590489300,01590519400,00000030100,aca,futex
1,01590578800,01590579700,00000000900,a2f,recvmsg
1,01590607300,01590607600,00000000300,a2f,recvmsg
1,01590609500,01590682000,00000072500,a17,select
1,01590697100,01590697400,00000000300,a2f,recvmsg
1,01590718300,01590785900,00000067600,a17,select
1,01590804600,01590804800,00000000200,a2f,recvmsg
1,01590807300,01590840300,00000033000,a17,select
1,01590843800,01590844000,00000000200,a2f,recvmsg
1,01590845400,01590860000,00000014600,a17,select
1,01590863600,01590863800,00000000200,a2f,recvmsg
1,01590865300,01590878700,00000013400,a17,select
1,01590882400,01590882500,00000000100,a2f,recvmsg
1,01590884000,01590891000,00000007000,a17,select
1,01590895100,01590895300,00000000200,a2f,recvmsg
1,01590896600,01590903200,00000006600,a17,select
1,01590907300,01590907400,00000000100,a2f,recvmsg
1,01590908900,01590917100,00000008200,a17,select
1,01590921200,01590921400,00000000200,a2f,recvmsg
1,01590922700,01590929700,00000007000,a17,select
1,01590933800,01590934000,00000000200,a2f,recvmsg
1,01590935500,01590945300,00000009800,a17,select
1,01590949200,01590949300,00000000100,a2f,recvmsg
1,01590951000,01590957600,00000006600,a17,select
1,01590961700,01590961800,00000000100,a2f,recvmsg
1,01590963100,01590969800,00000006700,a17,select
1,01590974000,01590974200,00000000200,a2f,recvmsg
1,01590975600,01590982300,00000006700,a17,select
1,01590986200,01590986400,00000000200,a2f,recvmsg
1,01590987700,01590994300,00000006600,a17,select
1,01590998400,01590998600,00000000200,a2f,recvmsg
1,01591000000,01591006000,00000006000,a17,select
1,01591009800,01591010000,00000000200,a2f,recvmsg
1,01591011400,01591022200,00000010800,a17,select
1,01591025900,01591026100,00000000200,a2f,recvmsg
1,01591027400,01591033500,00000006100,a17,select
1,01591037300,01591037500,00000000200,a2f,recvmsg
1,01591038800,01591044900,00000006100,a17,select
1,01591048500,01591048700,00000000200,a2f,recvmsg
1,01591050000,01591056000,00000006000,a17,select
1,01591059700,01591059800,00000000100,a2f,recvmsg
1,01591061100,01591067500,00000006400,a17,select
1,01591071200,01591071400,00000000200,a2f,recvmsg
1,01591072700,01591078800,00000006100,a17,select
1,01591082700,01591082900,00000000200,a2f,recvmsg
1,01591084200,01591091000,00000006800,a17,select
1,01591094700,01591094900,00000000200,a2f,recvmsg
1,01591096200,01591102800,00000006600,a17,select
1,01591106500,01591106700,00000000200,a2f,recvmsg
1,01591108100,01591115200,00000007100,a17,select
1,01591119200,01591119300,00000000100,a2f,recvmsg
1,01591120700,01591128500,00000007800,a17,select
1,01591132200,01591132400,00000000200,a2f,recvmsg
1,01591133700,01591140400,00000006700,a17,select
1,01591144100,01591144300,00000000200,a2f,recvmsg
1,01591145700,01591154800,00000009100,a17,select
1,01591159000,01591159200,00000000200,a2f,recvmsg
1,01591160500,01591167100,00000006600,a17,select
1,01591170800,01591171000,00000000200,a2f,recvmsg
1,01591172300,01591178700,00000006400,a17,select
1,01591182400,01591182500,00000000100,a2f,recvmsg
1,01591183900,01591191000,00000007100,a17,select
1,01591194800,01591195000,00000000200,a2f,recvmsg
1,01591196300,01591203300,00000007000,a17,select
1,01591207200,01591207300,00000000100,a2f,recvmsg
1,01591208700,01591216400,00000007700,a17,select
1,01591220100,01591220300,00000000200,a2f,recvmsg
1,01591221600,01591229100,00000007500,a17,select
1,01591233000,01591233200,00000000200,a2f,recvmsg
1,01591234500,01591241300,00000006800,a17,select
1,01591245000,01591245200,00000000200,a2f,recvmsg
1,01591246500,01591252700,00000006200,a17,select
1,01591256400,01591256500,00000000100,a2f,recvmsg
1,01591257800,01591264700,00000006900,a17,select
1,01591268600,01591268800,00000000200,a2f,recvmsg
1,01591270100,01591289700,00000019600,a17,select
1,01591293400,01591293600,00000000200,a2f,recvmsg
1,01591294900,01591324900,00000030000,a17,select
1,01591328600,01591328700,00000000100,a2f,recvmsg
1,01591330100,01591347500,00000017400,a17,select
1,01591351300,01591351500,00000000200,a2f,recvmsg
1,01591352800,01591359100,00000006300,a17,select
1,01591362800,01591362900,00000000100,a2f,recvmsg
1,01591364200,01591370300,00000006100,a17,select
1,01591374000,01591374200,00000000200,a2f,recvmsg
1,01591375500,01591381600,00000006100,a17,select
1,01591385600,01591385700,00000000100,a2f,recvmsg
1,01591387000,01591393100,00000006100,a17,select
1,01591397000,01591397100,00000000100,a2f,recvmsg
1,01591398400,01591404600,00000006200,a17,select
1,01591408200,01591408400,00000000200,a2f,recvmsg
1,01591409700,01591415800,00000006100,a17,select
1,01591419600,01591419700,00000000100,a2f,recvmsg
1,01591421000,01591427700,00000006700,a17,select
1,01591431400,01591431600,00000000200,a2f,recvmsg
1,01591433000,01591439000,00000006000,a17,select
1,01591442800,01591442900,00000000100,a2f,recvmsg
1,01591444300,01591454100,00000009800,a17,select
1,01591457800,01591457900,00000000100,a2f,recvmsg
1,01591459300,01591468300,00000009000,a17,select
1,01591472300,01591472500,00000000200,a2f,recvmsg
1,01591473800,01591480600,00000006800,a17,select
1,01591484100,01591484300,00000000200,a2f,recvmsg
1,01591485600,01591492000,00000006400,a17,select
1,01591495800,01591496000,00000000200,a2f,recvmsg
1,01591497300,01591503700,00000006400,a17,select
1,01591507400,01591507600,00000000200,a2f,recvmsg
1,01591509000,01591515300,00000006300,a17,select
1,01591519300,01591519500,00000000200,a2f,recvmsg
1,01591520700,01591527800,00000007100,a17,select
1,01591531700,01591531900,00000000200,a2f,recvmsg
1,01591533200,01591539500,00000006300,a17,select
1,01591543100,01591543300,00000000200,a2f,recvmsg
1,01591544500,01591551100,00000006600,a17,select
1,01591554600,01591554800,00000000200,a2f,recvmsg
1,01591556100,01591562400,00000006300,a17,select
1,01591566100,01591566300,00000000200,a2f,recvmsg
1,01591567600,01591574000,00000006400,a17,select
1,01591577700,01591577800,00000000100,a2f,recvmsg
1,01591579200,01591585600,00000006400,a17,select
1,01591589100,01591589300,00000000200,a2f,recvmsg
1,01591590700,01591597700,00000007000,a17,select
1,01591601400,01591601600,00000000200,a2f,recvmsg
1,01591602900,01591609100,00000006200,a17,select
1,01591612800,01591613000,00000000200,a2f,recvmsg
1,01591614300,01591621000,00000006700,a17,select
1,01591624700,01591624800,00000000100,a2f,recvmsg
1,01591626200,01591632400,00000006200,a17,select
1,01591636400,01591636600,00000000200,a2f,recvmsg
1,01591637800,01591650100,00000012300,a17,select
1,01591653700,01591653900,00000000200,a2f,recvmsg
1,01591655300,01591662000,00000006700,a17,select
1,01591665600,01591665700,00000000100,a2f,recvmsg
1,01591667000,01591673300,00000006300,a17,select
1,01591677000,01591677200,00000000200,a2f,recvmsg
1,01591678500,01591685000,00000006500,a17,select
1,01591688500,01591688700,00000000200,a2f,recvmsg
1,01591690000,01591696700,00000006700,a17,select
1,01591700200,01591700400,00000000200,a2f,recvmsg
1,01591701700,01591778100,00000076400,a17,select
1,01591779200,01591780500,00000001300,a2f,recvmsg
1,01592201100,01592202000,00000000900,a2f,recvmsg
1,01592517300,01592519600,00000002300,a2f,recvmsg
1,01592635400,01592635600,00000000200,a2f,recvmsg
1,01592636200,01592636700,00000000500,a14,writev
1,01592659600,01592661300,00000001700,a14,writev
1,01592661900,01592662100,00000000200,a2f,recvmsg
1,01590261900,01592672400,00002410500,a07,poll
1,01592678700,01592687300,00000008600,a2f,recvmsg
1,01592702700,01592703100,00000000400,a2f,recvmsg
1,01592730900,01592736600,00000005700,a07,poll
1,01592742700,01592752000,00000009300,a2f,recvmsg
1,01592766100,01592766500,00000000400,a2f,recvmsg
1,01592791900,01592796100,00000004200,a07,poll
1,01592801800,01592805300,00000003500,a2f,recvmsg
1,01592810700,01592810800,00000000100,a2f,recvmsg
1,01592814600,01592814800,00000000200,a2f,recvmsg
1,01592815100,01592815300,00000000200,a2f,recvmsg
1,01592818400,01592818500,00000000100,a2f,recvmsg
1,01592818700,01592818800,00000000100,a2f,recvmsg
1,01592819400,01592823600,00000004200,a07,poll
1,01592827800,01592835700,00000007900,a2f,recvmsg
1,01592847900,01592848200,00000000300,a2f,recvmsg
1,01592663800,01592881100,00000217300,a17,select
1,01592899000,01592900800,00000001800,a14,writev
1,01592901400,01592901500,00000000100,a2f,recvmsg
1,01592875200,01592921400,00000046200,a07,poll
1,01592931700,01592932000,00000000300,a2d,recvfrom
1,01592934500,01592936400,00000001900,a14,writev
1,01592932200,01592937500,00000005300,a07,poll
1,01592937800,01592939100,00000001300,a2d,recvfrom
1,01592940900,01592941100,00000000200,a2f,recvmsg
1,01592941900,01592941900,00000000000,a2f,recvmsg
1,01592978900,01592979100,00000000200,a2f,recvmsg
1,01592981800,01592982000,00000000200,a2f,recvmsg
1,01592991300,01592991500,00000000200,a2f,recvmsg
1,01593009700,01593010900,00000001200,a14,writev
1,01593011200,01593011400,00000000200,a2f,recvmsg
1,01593029000,01593029200,00000000200,a2f,recvmsg
1,01592986000,01593035700,00000049700,a07,poll
1,01593042200,01593042300,00000000100,a2f,recvmsg
1,01593044300,01593044500,00000000200,a2f,recvmsg
1,01593044700,01593044800,00000000100,a2f,recvmsg
1,01593046800,01593047000,00000000200,a2f,recvmsg
1,01593047200,01593047400,00000000200,a2f,recvmsg
1,01593047800,01593776400,00000728600,a07,poll
1,01593855500,01593859600,00000004100,a01,write
1,01583923400,01593894800,00009971400,ae8,epoll_wait
1,01593913700,01593916500,00000002800,a2f,recvmsg
1,01593936400,01593936800,00000000400,a2f,recvmsg
1,01593970800,01593978500,00000007700,a2e,sendmsg
1,01593867700,01593984600,00000116900,a07,poll
1,01593986600,01593988100,00000001500,a00,read
1,01594009900,01594012300,00000002400,a2f,recvmsg
1,01593030500,01595491800,00002461300,a17,select
1,01595509700,01595510100,00000000400,a2f,recvmsg
1,01595584300,01595584500,00000000200,a2f,recvmsg
1,01595586500,01595667700,00000081200,a17,select
1,01595677300,01595677500,00000000200,a2f,recvmsg
1,55967216300,01606565900,-54360650400,a3d,wait4
1,01606587800,01606590100,00000002300,a00,read
1,01606592100,01606592400,00000000300,a00,read
1,01606613700,01606666500,00000052800,a07,poll
1,01606675000,01606675200,00000000200,a2f,recvmsg
1,01606676600,01606676800,00000000200,a2f,recvmsg
1,01606685700,01606701500,00000015800,a07,poll
1,01606704100,01606704200,00000000100,a2f,recvmsg
1,01606704700,01606704900,00000000200,a2f,recvmsg
1,01606712500,01606726200,00000013700,a07,poll
1,01606728400,01606728500,00000000100,a2f,recvmsg
1,01606729000,01606729200,00000000200,a2f,recvmsg
1,01606733500,01606747100,00000013600,a07,poll
1,01606749300,01606749500,00000000200,a2f,recvmsg
1,01606750000,01606750200,00000000200,a2f,recvmsg
1,01606754700,01606768200,00000013500,a07,poll
1,01606770500,01606770700,00000000200,a2f,recvmsg
1,01606771200,01606771400,00000000200,a2f,recvmsg
0,01568834900,01568836400,00000001500,aca,futex
0,01568838300,01568839200,00000000900,aca,futex
0,01568842100,01568843000,00000000900,aca,futex
0,01568845000,01568846900,00000001900,a2e,sendmsg
0,01568849300,01568849500,00000000200,a00,read
0,01568855100,01568859700,00000004600,a07,poll
0,01568861200,01568861700,00000000500,a00,read
0,01568875700,01568876900,00000001200,a2f,recvmsg
0,01568996200,01568997700,00000001500,a2f,recvmsg
0,01569000400,01569000600,00000000200,a00,read
0,01569083000,01569084100,00000001100,a2f,recvmsg
0,01569166500,01569167300,00000000800,a2f,recvmsg
0,55745559300,01569262700,-54176296600,ae8,epoll_wait
0,01569269900,01569271900,00000002000,a2f,recvmsg
0,01569281900,01569282300,00000000400,a2f,recvmsg
0,01569284000,01569285100,00000001100,a2f,recvmsg
0,01569290000,01569290300,00000000300,a2f,recvmsg
0,01569336200,01569339900,00000003700,a2e,sendmsg
0,01569370500,01569371500,00000001000,a2e,sendmsg
0,01569258900,01569379000,00000120100,a07,poll
0,01569392600,01569393700,00000001100,a2f,recvmsg
0,01569455600,01569456400,00000000800,a2f,recvmsg
0,01569458800,01569458900,00000000100,a00,read
0,01569492900,01569495400,00000002500,a07,poll
0,01569492900,01569700900,00000208000,a07,poll
0,01569703100,01569704400,00000001300,aca,futex
0,01569706800,01569707800,00000001000,aca,futex
0,01569709600,01569710500,00000000900,aca,futex
0,01569714400,01569717100,00000002700,a2e,sendmsg
0,01569719800,01569719900,00000000100,a00,read
0,01569723000,01569859700,00000136700,a07,poll
0,01569861100,01569862100,00000001000,aca,futex
0,01569863700,01569864600,00000000900,aca,futex
0,01569865900,01569866700,00000000800,aca,futex
0,01569869000,01569870900,00000001900,a2e,sendmsg
0,01569375900,01569892500,00000516600,ae8,epoll_wait
0,01569898800,01569900600,00000001800,a2f,recvmsg
0,01569925600,01569926200,00000000600,a2f,recvmsg
0,01569976400,01569979700,00000003300,a2e,sendmsg
0,01570002900,01570005100,00000002200,a2e,sendmsg
0,01570132100,01570135300,00000003200,a00,read
0,01570181700,01570186700,00000005000,a0c,brk
0,01570309700,01570311100,00000001400,a00,read
0,01570466000,01570467100,00000001100,a00,read
0,01570626000,01570626800,00000000800,a00,read
0,01570790600,01570791500,00000000900,a00,read
0,01570921600,01570922600,00000001000,a00,read
0,01570953600,01570955400,00000001800,a0c,brk
0,01571065100,01571066000,00000000900,a00,read
0,01571341000,01571341800,00000000800,a00,read
0,01571355100,01571355600,00000000500,a00,read
0,01571402500,01571402900,00000000400,a00,read
0,01571423100,01571423900,00000000800,a00,read
0,01571636500,01571637100,00000000600,a00,read
0,01571667000,01571668000,00000001000,a00,read
0,01571766200,01571767200,00000001000,a00,read
0,01571791500,01571794200,00000002700,a0c,brk
0,01571839600,01571840200,00000000600,a00,read
0,01571922200,01571923300,00000001100,a00,read
0,01572076500,01572077000,00000000500,a00,read
0,01572190500,01572191100,00000000600,a00,read
0,01572286100,01572286600,00000000500,a00,read
0,01572298500,01572298900,00000000400,a00,read
0,01572387400,01572387800,00000000400,a00,read
0,01572411300,01572411700,00000000400,a00,read
0,01572433800,01572434400,00000000600,a00,read
0,01572536700,01572538200,00000001500,a0c,brk
0,01572539300,01572540300,00000001000,a00,read
0,01572743500,01572744100,00000000600,a00,read
0,01572829100,01572829700,00000000600,a00,read
0,01572893500,01572894200,00000000700,a00,read
0,01573025700,01573026100,00000000400,a00,read
0,01573058200,01573058700,00000000500,a00,read
0,01573077600,01573078900,00000001300,a02,open
0,01573195200,01573195900,00000000700,a00,read
0,01573266100,01573266500,00000000400,a00,read
0,01573319300,01573320700,00000001400,a0c,brk
0,01573327200,01573327900,00000000700,a00,read
0,01573436300,01573436900,00000000600,a00,read
0,01573589600,01573590600,00000001000,a00,read
0,01573720400,01573721100,00000000700,a00,read
0,01573778700,01573779300,00000000600,a00,read
0,01573835400,01573836100,00000000700,a00,read
0,01573905100,01573905800,00000000700,a00,read
0,01573958300,01573959000,00000000700,a00,read
0,01574047100,01574048200,00000001100,a0c,brk
0,01574080800,01574085300,00000004500,a0c,brk
0,01574100800,01574101700,00000000900,a00,read
0,01574217100,01574218100,00000001000,a00,read
0,01574375500,01574376200,00000000700,a00,read
0,01574493600,01574494300,00000000700,a00,read
0,01574641900,01574642600,00000000700,a00,read
0,01574759200,01574759800,00000000600,a00,read
0,01569890100,01574831400,00004941300,a07,poll
0,01574850600,01574852900,00000002300,a2f,recvmsg
0,01575133600,01575134900,00000001300,a00,read
0,01575140100,01575141700,00000001600,a0c,brk
0,01575257900,01575258900,00000001000,a00,read
0,01575378700,01575379400,00000000700,a00,read
0,01575521400,01575522100,00000000700,a00,read
0,01575656300,01575657100,00000000800,a00,read
0,01575750400,01575751100,00000000700,a00,read
0,01575863300,01575864200,00000000900,a00,read
0,01575986800,01575987500,00000000700,a00,read
0,01576122000,01576122800,00000000800,a00,read
0,01576290700,01576291500,00000000800,a00,read
0,01576444900,01576445900,00000001000,a00,read
0,01576555400,01576556100,00000000700,a00,read
0,01576732300,01576733300,00000001000,a00,read
0,01576810100,01576810800,00000000700,a00,read
0,01576892000,01576892800,00000000800,a00,read
0,01576959500,01576960300,00000000800,a0c,brk
0,01576973900,01576974600,00000000700,a00,read
0,01577046600,01577047300,00000000700,a00,read
0,01577147700,01577148400,00000000700,a00,read
0,01577253300,01577254000,00000000700,a00,read
0,01577343200,01577343700,00000000500,a00,read
0,01577424000,01577424700,00000000700,a00,read
0,01577525600,01577526100,00000000500,a00,read
0,01577606400,01577606800,00000000400,a0c,brk
0,01577609300,01577610100,00000000800,a00,read
0,01577716700,01577717400,00000000700,a00,read
0,01577812300,01577812900,00000000600,a00,read
0,01577931100,01577932000,00000000900,a00,read
0,01578044700,01578045400,00000000700,a00,read
0,01578148000,01578148700,00000000700,a00,read
0,01578249400,01578249700,00000000300,a0c,brk
0,01578616200,01578619600,00000003400,a57,unlink
0,01578643300,01578643900,00000000600,a48,fcntl
0,01578692300,01578707000,00000014700,a01,write
0,01578725200,01578728700,00000003500,a01,write
0,01578746000,01578748700,00000002700,a01,write
0,01575011700,01578971000,00003959300,a07,poll
0,01578973000,01578973800,00000000800,a00,read
0,01578991500,01578993400,00000001900,a2f,recvmsg
0,01579070100,01579071000,00000000900,a2f,recvmsg
0,01579073700,01579073900,00000000200,a00,read
0,55663681700,01579130100,-54084551600,a3d,wait4
0,01579153000,01579157300,00000004300,a00,read
0,01579160000,01579160400,00000000400,a00,read
0,01579169200,01579174800,00000005600,a14,writev
0,01579176700,01579230600,00000053900,a07,poll
0,01579240400,01579240600,00000000200,a2f,recvmsg
0,01579241400,01579241500,00000000100,a2f,recvmsg
0,01579247300,01579252700,00000005400,a14,writev
0,01579253200,01579275600,00000022400,a07,poll
0,01579278600,01579278800,00000000200,a2f,recvmsg
0,01579279300,01579279400,00000000100,a2f,recvmsg
0,01579282600,01579284800,00000002200,a14,writev
0,01579285100,01579298900,00000013800,a07,poll
0,01579301300,01579301500,00000000200,a2f,recvmsg
0,01579301900,01579302100,00000000200,a2f,recvmsg
0,01579305400,01579307100,00000001700,a14,writev
0,01579307500,01579321400,00000013900,a07,poll
0,01579323900,01579324000,00000000100,a2f,recvmsg
0,01579324500,01579324700,00000000200,a2f,recvmsg
0,01579327900,01579329600,00000001700,a14,writev
0,01579330000,01579339300,00000009300,a07,poll
0,01579340600,01579340700,00000000100,a2f,recvmsg
0,01579341100,01579341300,00000000200,a2f,recvmsg
0,01579342300,01579343900,00000001600,a14,writev
0,01579344200,01579352500,00000008300,a07,poll
0,01579353900,01579354100,00000000200,a2f,recvmsg
0,01579354400,01579354600,00000000200,a2f,recvmsg
0,01579355400,01579356000,00000000600,a08,lseek
0,01579366900,01579367100,00000000200,a08,lseek
0,01579368200,01579369700,00000001500,a14,writev
0,01579370200,01579378800,00000008600,a07,poll
0,01579380100,01579380300,00000000200,a2f,recvmsg
0,01579380700,01579380900,00000000200,a2f,recvmsg
0,01579384800,01579386600,00000001800,a14,writev
0,01579387000,01579395000,00000008000,a07,poll
0,01579396300,01579396500,00000000200,a2f,recvmsg
0,01579396800,01579397000,00000000200,a2f,recvmsg
0,01579398500,01579400100,00000001600,a14,writev
0,01579400600,01579408100,00000007500,a07,poll
0,01579409300,01579409500,00000000200,a2f,recvmsg
0,01579409800,01579410000,00000000200,a2f,recvmsg
0,01579411700,01579413200,00000001500,a14,writev
0,01579413600,01579421200,00000007600,a07,poll
0,01579422400,01579422600,00000000200,a2f,recvmsg
0,01579422900,01579423100,00000000200,a2f,recvmsg
0,01579424700,01579426600,00000001900,a14,writev
0,01579426900,01579430700,00000003800,a07,poll
0,01579426900,01579436900,00000010000,a07,poll
0,01579438600,01579438700,00000000100,a2f,recvmsg
0,01579439000,01579439200,00000000200,a2f,recvmsg
0,01579431500,01579444600,00000013100,aca,futex
0,01579454800,01579458400,00000003600,a2e,sendmsg
0,01579463000,01579463200,00000000200,a00,read
0,01579489500,01579535600,00000046100,a07,poll
0,01579537300,01579537800,00000000500,a00,read
0,01579553000,01579554300,00000001300,a2f,recvmsg
0,01579675400,01579679000,00000003600,a07,poll
0,01579845100,01579845700,00000000600,aca,futex
0,01579675400,01579856500,00000181100,a07,poll
0,01579863400,01579867000,00000003600,a2e,sendmsg
0,01579853100,01579890200,00000037100,aca,futex
0,01579888100,01579900400,00000012300,a07,poll
0,01579907100,01579910900,00000003800,a2e,sendmsg
0,01579914800,01579915000,00000000200,a00,read
0,01579920000,01579921700,00000001700,aca,futex
0,01579925900,01579928700,00000002800,aca,futex
0,01579931800,01579932800,00000001000,a2e,sendmsg
0,01579939900,01580047300,00000107400,a07,poll
0,01580048900,01580050100,00000001200,aca,futex
0,01580052300,01580053300,00000001000,aca,futex
0,01580056200,01580057100,00000000900,aca,futex
0,01580059400,01580062200,00000002800,a2e,sendmsg
0,01580064900,01580065100,00000000200,a00,read
0,01580071700,01580074200,00000002500,a07,poll
0,01580078400,01580078700,00000000300,a2f,recvmsg
0,01580079300,01580079500,00000000200,a2f,recvmsg
0,01580086600,01580125900,00000039300,a07,poll
0,01580127200,01580127300,00000000100,a2f,recvmsg
0,01580127700,01580127900,00000000200,a2f,recvmsg
0,01580130300,01580135800,00000005500,a07,poll
0,01580136800,01580137000,00000000200,a2f,recvmsg
0,01580137300,01580137500,00000000200,a2f,recvmsg
0,01580141900,01580197100,00000055200,a07,poll
0,01580197800,01580198000,00000000200,a00,read
0,01580206600,01580207500,00000000900,a2f,recvmsg
0,01580266500,01580268700,00000002200,a07,poll
0,01580271700,01580272100,00000000400,a2f,recvmsg
0,01580272600,01580272800,00000000200,a2f,recvmsg
0,01580277900,01580335500,00000057600,a07,poll
0,01580341600,01580341900,00000000300,aca,futex
0,01580497000,01580500600,00000003600,a07,poll
0,01580505000,01580507900,00000002900,a2e,sendmsg
0,01580510400,01580510600,00000000200,a00,read
0,01580513400,01580515100,00000001700,a07,poll
0,01580518300,01580518600,00000000300,a2f,recvmsg
0,01580519200,01580519300,00000000100,a2f,recvmsg
0,01580527800,01580543500,00000015700,a07,poll
0,01580544800,01580544900,00000000100,a2f,recvmsg
0,01580545300,01580545400,00000000100,a2f,recvmsg
0,01580548900,01580602400,00000053500,a07,poll
0,01580603000,01580603300,00000000300,a00,read
0,01580652000,01580652100,00000000100,a00,read
0,01580672200,01580674500,00000002300,a07,poll
0,01580677000,01580677200,00000000200,a2f,recvmsg
0,01580677600,01580677800,00000000200,a2f,recvmsg
0,01580682800,01580704900,00000022100,a07,poll
0,01580705500,01580705600,00000000100,a00,read
0,01580713100,01580713900,00000000800,a2f,recvmsg
0,01580764900,01580767000,00000002100,a07,poll
0,01580769700,01580769900,00000000200,a2f,recvmsg
0,01580770400,01580770600,00000000200,a2f,recvmsg
0,01580773600,01580776200,00000002600,a14,writev
0,01580776600,01580789700,00000013100,a07,poll
0,01580790900,01580791000,00000000100,a2f,recvmsg
0,01580791300,01580791500,00000000200,a2f,recvmsg
0,01580793300,01580795100,00000001800,a14,writev
0,01580795500,01580803700,00000008200,a07,poll
0,01580805000,01580805100,00000000100,a2f,recvmsg
0,01580805400,01580805600,00000000200,a2f,recvmsg
0,01580806700,01580808200,00000001500,a14,writev
0,01580808600,01580816600,00000008000,a07,poll
0,01580819800,01580819900,00000000100,a2f,recvmsg
0,01580820300,01580820400,00000000100,a2f,recvmsg
0,01580823600,01580825000,00000001400,a14,writev
0,01580825300,01580833600,00000008300,a07,poll
0,01580834900,01580835100,00000000200,a2f,recvmsg
0,01580835400,01580835500,00000000100,a2f,recvmsg
0,01580836500,01580837900,00000001400,a14,writev
0,01580838300,01580845700,00000007400,a07,poll
0,01580846900,01580847100,00000000200,a2f,recvmsg
0,01580847400,01580847600,00000000200,a2f,recvmsg
0,01580848700,01580850100,00000001400,a14,writev
0,01580850500,01580858000,00000007500,a07,poll
0,01580859200,01580859400,00000000200,a2f,recvmsg
0,01580859700,01580859900,00000000200,a2f,recvmsg
0,01580860800,01580862300,00000001500,a14,writev
0,01580862700,01580870100,00000007400,a07,poll
0,01580871300,01580871500,00000000200,a2f,recvmsg
0,01580871700,01580871900,00000000200,a2f,recvmsg
0,01580873200,01580874700,00000001500,a14,writev
0,01580875000,01580882300,00000007300,a07,poll
0,01580883400,01580883500,00000000100,a2f,recvmsg
0,01580883900,01580884000,00000000100,a2f,recvmsg
0,01580885200,01580886700,00000001500,a14,writev
0,01580886900,01580894300,00000007400,a07,poll
0,01580895300,01580895500,00000000200,a2f,recvmsg
0,01580895800,01580896000,00000000200,a2f,recvmsg
0,01580897600,01580899200,00000001600,a14,writev
0,01580899600,01580907200,00000007600,a07,poll
0,01580908500,01580908600,00000000100,a2f,recvmsg
0,01580909000,01580909200,00000000200,a2f,recvmsg
0,01580912400,01580913900,00000001500,a14,writev
0,01580914300,01580921900,00000007600,a07,poll
0,01580923000,01580923200,00000000200,a2f,recvmsg
0,01580923500,01580923700,00000000200,a2f,recvmsg
0,01580926000,01580927500,00000001500,a14,writev
0,01580927900,01580935900,00000008000,a07,poll
0,01580937000,01580937100,00000000100,a2f,recvmsg
0,01580937400,01580937600,00000000200,a2f,recvmsg
0,01580939400,01580940900,00000001500,a14,writev
0,01580941200,01580948700,00000007500,a07,poll
0,01580949800,01580950000,00000000200,a2f,recvmsg
0,01580950300,01580950500,00000000200,a2f,recvmsg
0,01580952300,01580953800,00000001500,a14,writev
0,01580954100,01580961700,00000007600,a07,poll
0,01580962800,01580963000,00000000200,a2f,recvmsg
0,01580963300,01580963500,00000000200,a2f,recvmsg
0,01580967100,01580968600,00000001500,a14,writev
0,01580968900,01580976900,00000008000,a07,poll
0,01580978000,01580978200,00000000200,a2f,recvmsg
0,01580978500,01580978700,00000000200,a2f,recvmsg
0,01580980200,01580981700,00000001500,a14,writev
0,01580982000,01580989700,00000007700,a07,poll
0,01580991100,01580991300,00000000200,a2f,recvmsg
0,01580991500,01580991700,00000000200,a2f,recvmsg
0,01580993000,01580994500,00000001500,a14,writev
0,01580994900,01581002300,00000007400,a07,poll
0,01581003400,01581003500,00000000100,a2f,recvmsg
0,01581003900,01581004100,00000000200,a2f,recvmsg
0,01581006200,01581007700,00000001500,a14,writev
0,01581008100,01581015800,00000007700,a07,poll
0,01581016900,01581017100,00000000200,a2f,recvmsg
0,01581017400,01581017500,00000000100,a2f,recvmsg
0,01581020100,01581021700,00000001600,a14,writev
0,01581021900,01581029700,00000007800,a07,poll
0,01581030900,01581031000,00000000100,a2f,recvmsg
0,01581031200,01581031400,00000000200,a2f,recvmsg
0,01581033600,01581035100,00000001500,a14,writev
0,01581035500,01581043300,00000007800,a07,poll
0,01581044500,01581044600,00000000100,a2f,recvmsg
0,01581044900,01581045100,00000000200,a2f,recvmsg
0,01581046700,01581048300,00000001600,a14,writev
0,01581048500,01581055900,00000007400,a07,poll
0,01581057100,01581057300,00000000200,a2f,recvmsg
0,01581057600,01581057700,00000000100,a2f,recvmsg
0,01581059100,01581060700,00000001600,a14,writev
0,01581061000,01581068600,00000007600,a07,poll
0,01581069700,01581069800,00000000100,a2f,recvmsg
0,01581070100,01581070300,00000000200,a2f,recvmsg
0,01581071500,01581073000,00000001500,a14,writev
0,01581073300,01581080700,00000007400,a07,poll
0,01581081900,01581082100,00000000200,a2f,recvmsg
0,01581082400,01581082500,00000000100,a2f,recvmsg
0,01581084300,01581085700,00000001400,a14,writev
0,01581086100,01581093500,00000007400,a07,poll
0,01581094500,01581094700,00000000200,a2f,recvmsg
0,01581095000,01581095200,00000000200,a2f,recvmsg
0,01581096900,01581097500,00000000600,a08,lseek
0,01581101100,01581103300,00000002200,a00,read
0,01581107100,01581107200,00000000100,a08,lseek
0,01581108300,01581109800,00000001500,a14,writev
0,01581110200,01581118600,00000008400,a07,poll
0,01581119800,01581120000,00000000200,a2f,recvmsg
0,01581120300,01581120500,00000000200,a2f,recvmsg
0,01581144200,01581145800,00000001600,a14,writev
0,01581146200,01581155300,00000009100,a07,poll
0,01581156600,01581156800,00000000200,a2f,recvmsg
0,01581157100,01581157300,00000000200,a2f,recvmsg
0,01581161400,01581162600,00000001200,a00,read
0,01581168300,01581168400,00000000100,a08,lseek
0,01581170000,01581171600,00000001600,a14,writev
0,01581171900,01581180600,00000008700,a07,poll
0,01581181700,01581181900,00000000200,a2f,recvmsg
0,01581182300,01581182400,00000000100,a2f,recvmsg
0,01581183500,01581185100,00000001600,a14,writev
0,01581185300,01581192700,00000007400,a07,poll
0,01581193900,01581194100,00000000200,a2f,recvmsg
0,01581194400,01581194600,00000000200,a2f,recvmsg
0,01581195600,01581197100,00000001500,a14,writev
0,01581197400,01581204700,00000007300,a07,poll
0,01581205900,01581206000,00000000100,a2f,recvmsg
0,01581206200,01581206400,00000000200,a2f,recvmsg
0,01581207600,01581209000,00000001400,a14,writev
0,01581209400,01581216800,00000007400,a07,poll
0,01581217800,01581218000,00000000200,a2f,recvmsg
0,01581218300,01581218500,00000000200,a2f,recvmsg
0,01581219600,01581221200,00000001600,a14,writev
0,01581221400,01581229100,00000007700,a07,poll
0,01581230500,01581230700,00000000200,a2f,recvmsg
0,01581230900,01581231100,00000000200,a2f,recvmsg
0,01581232200,01581233800,00000001600,a14,writev
0,01581234100,01581241500,00000007400,a07,poll
0,01581242500,01581242700,00000000200,a2f,recvmsg
0,01581243000,01581243200,00000000200,a2f,recvmsg
0,01581244200,01581245700,00000001500,a14,writev
0,01581245900,01581253300,00000007400,a07,poll
0,01581254400,01581254500,00000000100,a2f,recvmsg
0,01581254900,01581255000,00000000100,a2f,recvmsg
0,01581256700,01581258300,00000001600,a14,writev
0,01581258600,01581266200,00000007600,a07,poll
0,01581267300,01581267400,00000000100,a2f,recvmsg
0,01581267700,01581267900,00000000200,a2f,recvmsg
0,01581269100,01581270600,00000001500,a14,writev
0,01581270900,01581278300,00000007400,a07,poll
0,01581279500,01581279600,00000000100,a2f,recvmsg
0,01581280000,01581280100,00000000100,a2f,recvmsg
0,01581280500,01581280600,00000000100,a08,lseek
0,01581283100,01581284600,00000001500,a14,writev
0,01581285000,01581292300,00000007300,a07,poll
0,01581293500,01581293700,00000000200,a2f,recvmsg
0,01581294000,01581294200,00000000200,a2f,recvmsg
0,01581297700,01581299200,00000001500,a14,writev
0,01581299600,01581306900,00000007300,a07,poll
0,01581308200,01581308300,00000000100,a2f,recvmsg
0,01581308600,01581308700,00000000100,a2f,recvmsg
0,01581310400,01581311900,00000001500,a14,writev
0,01581312300,01581319500,00000007200,a07,poll
0,01581320700,01581320800,00000000100,a2f,recvmsg
0,01581321200,01581321300,00000000100,a2f,recvmsg
0,01581322700,01581324100,00000001400,a14,writev
0,01581324500,01581331700,00000007200,a07,poll
0,01581332800,01581333000,00000000200,a2f,recvmsg
0,01581333300,01581333400,00000000100,a2f,recvmsg
0,01581334700,01581336100,00000001400,a14,writev
0,01581336500,01581343700,00000007200,a07,poll
0,01581344700,01581344900,00000000200,a2f,recvmsg
0,01581345200,01581345400,00000000200,a2f,recvmsg
0,01581346800,01581348300,00000001500,a14,writev
0,01581348600,01581356000,00000007400,a07,poll
0,01581357100,01581357300,00000000200,a2f,recvmsg
0,01581357600,01581357800,00000000200,a2f,recvmsg
0,01581359600,01581361300,00000001700,a14,writev
0,01581361600,01581369300,00000007700,a07,poll
0,01581370400,01581370600,00000000200,a2f,recvmsg
0,01581370900,01581371100,00000000200,a2f,recvmsg
0,01581372500,01581374000,00000001500,a14,writev
0,01581374300,01581381400,00000007100,a07,poll
0,01581382600,01581382700,00000000100,a2f,recvmsg
0,01581383000,01581383200,00000000200,a2f,recvmsg
0,01581384500,01581386000,00000001500,a14,writev
0,01581386400,01581393700,00000007300,a07,poll
0,01581394800,01581394900,00000000100,a2f,recvmsg
0,01581395200,01581395400,00000000200,a2f,recvmsg
0,01581396700,01581398100,00000001400,a14,writev
0,01581398500,01581405600,00000007100,a07,poll
0,01581406800,01581406900,00000000100,a2f,recvmsg
0,01581407300,01581407400,00000000100,a2f,recvmsg
0,01581408700,01581410200,00000001500,a14,writev
0,01581410600,01581417900,00000007300,a07,poll
0,01581418900,01581419100,00000000200,a2f,recvmsg
0,01581419400,01581419600,00000000200,a2f,recvmsg
0,01581420900,01581422500,00000001600,a14,writev
0,01581422700,01581430200,00000007500,a07,poll
0,01581431300,01581431400,00000000100,a2f,recvmsg
0,01581431800,01581431900,00000000100,a2f,recvmsg
0,01581434000,01581435500,00000001500,a14,writev
0,01581435800,01581443200,00000007400,a07,poll
0,01581444300,01581444400,00000000100,a2f,recvmsg
0,01581444800,01581445000,00000000200,a2f,recvmsg
0,01581446300,01581447800,00000001500,a14,writev
0,01581448100,01581455400,00000007300,a07,poll
0,01581456600,01581456700,00000000100,a2f,recvmsg
0,01581456900,01581457100,00000000200,a2f,recvmsg
0,01581458500,01581460100,00000001600,a14,writev
0,01581460400,01581467800,00000007400,a07,poll
0,01581468800,01581469000,00000000200,a2f,recvmsg
0,01581469300,01581469500,00000000200,a2f,recvmsg
0,01581470800,01581472300,00000001500,a14,writev
0,01581472600,01581480100,00000007500,a07,poll
0,01581481300,01581481400,00000000100,a2f,recvmsg
0,01581481700,01581481900,00000000200,a2f,recvmsg
0,01581488700,01581490300,00000001600,a14,writev
0,01581490700,01581498300,00000007600,a07,poll
0,01581499400,01581499600,00000000200,a2f,recvmsg
0,01581499900,01581500100,00000000200,a2f,recvmsg
0,01581501500,01581503100,00000001600,a14,writev
0,01581503400,01581510800,00000007400,a07,poll
0,01581511900,01581512000,00000000100,a2f,recvmsg
0,01581512300,01581512500,00000000200,a2f,recvmsg
0,01581513800,01581515400,00000001600,a14,writev
0,01581515700,01581523000,00000007300,a07,poll
0,01581524100,01581524300,00000000200,a2f,recvmsg
0,01581524600,01581524800,00000000200,a2f,recvmsg
0,01581526300,01581527800,00000001500,a14,writev
0,01581528200,01581530600,00000002400,a07,poll
0,01581528200,01581536700,00000008500,a07,poll
0,01581538400,01581538500,00000000100,a2f,recvmsg
0,01581538800,01581539000,00000000200,a2f,recvmsg
0,01581540800,01581542600,00000001800,a14,writev
0,01581531000,01581544200,00000013200,aca,futex
0,01581550300,01581553600,00000003300,a2e,sendmsg
0,01581556600,01581556800,00000000200,a00,read
0,01581578900,01581579100,00000000200,a2f,recvmsg
0,01581579500,01581579600,00000000100,a2f,recvmsg
0,01581576900,01581617300,00000040400,a07,poll
0,01581618000,01581618300,00000000300,a00,read
0,01581626600,01581627600,00000001000,a2f,recvmsg
0,01581723500,01581726000,00000002500,a07,poll
0,01581907700,01581908300,00000000600,aca,futex
0,01581909000,01581909300,00000000300,aca,futex
0,01581723500,01581916400,00000192900,a07,poll
0,01581921600,01581925400,00000003800,a2e,sendmsg
0,01581928700,01581928900,00000000200,a00,read
0,01581934100,01581941300,00000007200,a07,poll
0,01581943300,01581944200,00000000900,a2e,sendmsg
0,01581949200,01581949600,00000000400,aca,futex
0,01581951200,01581966200,00000015000,a07,poll
0,01581968500,01581969300,00000000800,a2e,sendmsg
0,01581971400,01581971500,00000000100,a00,read
0,01581975800,01581977600,00000001800,aca,futex
0,01581987600,01581988300,00000000700,a01,write
0,01581980300,01581989500,00000009200,a07,poll
0,01581991500,01581992400,00000000900,a2e,sendmsg
0,01581997900,01582024900,00000027000,a07,poll
0,01582026000,01582027000,00000001000,aca,futex
0,01582028800,01582029800,00000001000,aca,futex
0,01582032200,01582033100,00000000900,aca,futex
0,01582034700,01582036600,00000001900,a2e,sendmsg
0,01582038600,01582038800,00000000200,a00,read
0,01582044300,01582047200,00000002900,a07,poll
0,01582053300,01582054900,00000001600,a2e,sendmsg
0,01582075700,01582078000,00000002300,a07,poll
0,01582121700,01582121800,00000000100,a00,read
0,01582177500,01582200400,00000022900,a07,poll
0,01582200900,01582201100,00000000200,a00,read
0,01582208800,01582209600,00000000800,a2f,recvmsg
0,01582263300,01582266200,00000002900,a07,poll
0,01582277000,01582277900,00000000900,a2f,recvmsg
0,01582287600,01582366900,00000079300,a07,poll
0,01582369300,01582370700,00000001400,aca,futex
0,01582484600,01582486600,00000002000,a07,poll
0,01582492600,01582495900,00000003300,a2e,sendmsg
0,01582499300,01582499600,00000000300,a00,read
0,01581603600,01582526000,00000922400,a57,unlink
0,01582529400,01582535600,00000006200,a14,writev
0,01582536800,01582624100,00000087300,a07,poll
0,01582625100,01582625300,00000000200,a00,read
0,01582633100,01582634300,00000001200,a2f,recvmsg
0,01582728200,01582730400,00000002200,a07,poll
0,01582728200,01582979700,00000251500,a07,poll
0,01582982000,01582983100,00000001100,aca,futex
0,01582985700,01582986600,00000000900,aca,futex
0,01582989600,01582990500,00000000900,aca,futex
0,01582993300,01582996400,00000003100,a2e,sendmsg
0,01582999400,01582999600,00000000200,a00,read
0,01583006400,01583008900,00000002500,a07,poll
0,01583017600,01583018800,00000001200,a2f,recvmsg
0,01583073200,01583522700,00000449500,a07,poll
0,01583528300,01583528700,00000000400,a2f,recvmsg
0,01583529700,01583529800,00000000100,a2f,recvmsg
0,01583531400,01583556400,00000025000,a57,unlink
0,01583566800,01583727700,00000160900,a07,poll
0,01583728500,01583728800,00000000300,a00,read
0,01583736000,01583736900,00000000900,a2f,recvmsg
0,01583786300,01583808700,00000022400,a07,poll
0,01583815300,01583818900,00000003600,a2e,sendmsg
0,01583829400,01583834100,00000004700,a07,poll
0,01583835700,01583836400,00000000700,aca,futex
0,01583837500,01583838500,00000001000,a2e,sendmsg
0,01583840100,01583840300,00000000200,a00,read
0,01583845500,01583859600,00000014100,a07,poll
0,01583860600,01583860800,00000000200,aca,futex
0,01583862000,01583862900,00000000900,a2e,sendmsg
0,01583868500,01583868700,00000000200,aca,futex
0,01583870300,01583882000,00000011700,a07,poll
0,01583884100,01583884800,00000000700,a2e,sendmsg
0,01583886500,01583886600,00000000100,a00,read
0,01583890100,01584010400,00000120300,a07,poll
0,01584050800,01584051000,00000000200,a00,read
0,01584078100,01584078600,00000000500,aca,futex
0,01584114600,01584141200,00000026600,a07,poll
0,01584142600,01584144500,00000001900,a2f,recvmsg
0,01584155500,01584156800,00000001300,a2d,recvfrom
0,01584158600,01584158800,00000000200,a2f,recvmsg
0,01584159600,01584159800,00000000200,a2f,recvmsg
0,01584200900,01584201200,00000000300,a2f,recvmsg
0,01584204500,01584204700,00000000200,a2f,recvmsg
0,01584209000,01584213600,00000004600,a07,poll
0,01584217900,01584218200,00000000300,a2f,recvmsg
0,01584218900,01584219200,00000000300,a2f,recvmsg
0,01584209000,01584544000,00000335000,a07,poll
0,01584552700,01584557700,00000005000,a2e,sendmsg
0,01584561600,01584561700,00000000100,a00,read
0,01585002100,01585008100,00000006000,a04,stat
0,01585008300,01585009700,00000001400,a04,stat
0,01585012900,01585014100,00000001200,a04,stat
0,01585014300,01585016100,00000001800,a04,stat
0,01585016400,01585017900,00000001500,a04,stat
0,01585018200,01585019200,00000001000,a04,stat
0,01585019300,01585019800,00000000500,a04,stat
0,01585021200,01585021700,00000000500,a04,stat
0,01585021900,01585022500,00000000600,a04,stat
0,01585022700,01585023200,00000000500,a04,stat
0,01585023300,01585024100,00000000800,a04,stat
0,01585024300,01585024800,00000000500,a04,stat
0,01585026000,01585026500,00000000500,a04,stat
0,01585026800,01585027200,00000000400,a04,stat
0,01585027400,01585028200,00000000800,a04,stat
0,01585028500,01585028900,00000000400,a04,stat
0,01585029100,01585029700,00000000600,a04,stat
0,01585030000,01585030500,00000000500,a04,stat
0,01585031700,01585032200,00000000500,a04,stat
0,01585032400,01585033300,00000000900,a04,stat
0,01585033500,01585034900,00000001400,a04,stat
0,01584582600,01585038100,00000455500,a07,poll
0,01585047400,01585048800,00000001400,a2f,recvmsg
0,01585105000,01585106200,00000001200,a04,stat
0,01585106400,01585106900,00000000500,a04,stat
0,01585108500,01585108900,00000000400,a04,stat
0,01585109100,01585109800,00000000700,a04,stat
0,01585110200,01585110800,00000000600,a04,stat
0,01585111000,01585111400,00000000400,a04,stat
0,01585111600,01585112000,00000000400,a04,stat
0,01585113300,01585113800,00000000500,a04,stat
0,01585114000,01585114800,00000000800,a04,stat
0,01585115000,01585115600,00000000600,a04,stat
0,01585115800,01585116200,00000000400,a04,stat
0,01585116400,01585116800,00000000400,a04,stat
0,01585117600,01585118100,00000000500,a04,stat
0,01585102100,01585251900,00000149800,a07,poll
0,01585258500,01585263500,00000005000,a2e,sendmsg
0,01585267300,01585267400,00000000100,a00,read
0,01585286800,01585292000,00000005200,a07,poll
0,01585305800,01585309100,00000003300,a2e,sendmsg
0,01585318100,01585319000,00000000900,a2e,sendmsg
0,01585314700,01585330700,00000016000,a07,poll
0,01585331600,01585332000,00000000400,a00,read
0,01585342200,01585343600,00000001400,a2f,recvmsg
0,01585447900,01585450700,00000002800,a07,poll
0,01585447900,01585499500,00000051600,a07,poll
0,01585499700,01585499900,00000000200,a00,read
0,01585504100,01585505500,00000001400,a2f,recvmsg
0,01585554000,01585718700,00000164700,a07,poll
0,01585724100,01585727700,00000003600,a2e,sendmsg
0,01585731000,01585731200,00000000200,a00,read
0,01585736500,01585744700,00000008200,a07,poll
0,01585746800,01585747500,00000000700,a2e,sendmsg
0,01585751800,01585753500,00000001700,aca,futex
0,01585758900,01585769700,00000010800,a07,poll
0,01585771900,01585772700,00000000800,a2e,sendmsg
0,01585775500,01585775500,00000000000,a00,read
0,01585779300,01585779700,00000000400,aca,futex
0,01585781300,01585794200,00000012900,a07,poll
0,01585796100,01585797300,00000001200,a2e,sendmsg
0,01585790500,01585804800,00000014300,b22,eventfd2
0,01585802900,01585830900,00000028000,a07,poll
0,01585832300,01585833400,00000001100,aca,futex
0,01585835200,01585836200,00000001000,aca,futex
0,01585838600,01585839500,00000000900,aca,futex
0,01585841400,01585843900,00000002500,a2e,sendmsg
0,01585845800,01585845900,00000000100,a00,read
0,01585851500,01585855000,00000003500,a07,poll
0,01585861900,01585863300,00000001400,a2e,sendmsg
0,01585884800,01585887100,00000002300,a07,poll
0,01585929700,01585929900,00000000200,a00,read
0,01585997100,01585997500,00000000400,a00,read
0,01585996000,01586005800,00000009800,a07,poll
0,01586006300,01586006500,00000000200,a00,read
0,01586013200,01586014100,00000000900,a2f,recvmsg
0,01586215700,01586222000,00000006300,a02,open
0,01586233600,01586236100,00000002500,a00,read
0,01586297600,01586298500,00000000900,a00,read
0,01586353700,01586354700,00000001000,a00,read
0,01586077600,01586380800,00000303200,a07,poll
0,01586381500,01586381600,00000000100,a00,read
0,01586390400,01586391700,00000001300,a2f,recvmsg
0,01586443400,01586446700,00000003300,a07,poll
0,01586455700,01586460000,00000004300,a2e,sendmsg
0,01586463800,01586505500,00000041700,a07,poll
0,01586506500,01586506700,00000000200,a00,read
0,01586515000,01586516100,00000001100,a2f,recvmsg
0,01586476300,01586581200,00000104900,aca,futex
0,01586583000,01586584900,00000001900,aca,futex
0,01586590700,01586602600,00000011900,a07,poll
0,01586609000,01586612600,00000003600,a2e,sendmsg
0,01586616100,01586616400,00000000300,a00,read
0,01586639200,01586640800,00000001600,a00,read
0,01586634700,01586674300,00000039600,a07,poll
0,01586675000,01586675200,00000000200,a00,read
0,01586681800,01586683100,00000001300,a2f,recvmsg
0,01586770800,01586772900,00000002100,a07,poll
0,01586770800,01586979100,00000208300,a07,poll
0,01586984500,01586988200,00000003700,a2e,sendmsg
0,01586991600,01586991700,00000000100,a00,read
0,01586997100,01587003100,00000006000,a07,poll
0,01587004900,01587005700,00000000800,a2e,sendmsg
0,01587010200,01587011800,00000001600,aca,futex
0,01587016800,01587028500,00000011700,a07,poll
0,01587030900,01587031800,00000000900,a2e,sendmsg
0,01587033800,01587033900,00000000100,a00,read
0,01587038500,01587051400,00000012900,a07,poll
0,01587053600,01587054600,00000001000,a2e,sendmsg
0,01587061200,01587118900,00000057700,a07,poll
0,01587120400,01587121400,00000001000,aca,futex
0,01587123500,01587124400,00000000900,aca,futex
0,01587126800,01587127700,00000000900,aca,futex
0,01587129800,01587132500,00000002700,a2e,sendmsg
0,01587134900,01587135100,00000000200,a00,read
0,01587173800,01587173900,00000000100,a00,read
0,01587234500,01587237700,00000003200,a07,poll
0,01587246500,01587247300,00000000800,a2f,recvmsg
0,01587257800,01587260600,00000002800,a2e,sendmsg
0,01587353400,01587355300,00000001900,a00,read
0,01587410200,01587411200,00000001000,a00,read
0,01587463000,01587464000,00000001000,a00,read
0,01587516700,01587517600,00000000900,a00,read
0,01587572800,01587573600,00000000800,a00,read
0,01587627300,01587628000,00000000700,a00,read
0,01587322700,01587658700,00000336000,a07,poll
0,01587659400,01587659600,00000000200,a00,read
0,01587665500,01587666300,00000000800,a2f,recvmsg
0,01587709300,01587709700,00000000400,aca,futex
0,01587739400,01587740500,00000001100,a00,read
0,01587771500,01587776800,00000005300,a02,open
0,01587783400,01587784300,00000000900,a00,read
0,01587712700,01587797200,00000084500,a07,poll
0,01587802700,01587806900,00000004200,a2e,sendmsg
0,01587810100,01587810200,00000000100,a00,read
0,01587827900,01587865200,00000037300,a07,poll
0,01587866000,01587866200,00000000200,a00,read
0,01587874300,01587875400,00000001100,a2f,recvmsg
0,01587967100,01587969400,00000002300,a07,poll
0,01588121000,01588121500,00000000500,aca,futex
0,01587967100,01588152400,00000185300,a07,poll
0,01588157300,01588160900,00000003600,a2e,sendmsg
0,01588164600,01588164700,00000000100,a00,read
0,01588168000,01588169700,00000001700,aca,futex
0,01588174400,01588174700,00000000300,aca,futex
0,01588175500,01588179000,00000003500,aca,futex
0,01588182200,01588183100,00000000900,a2e,sendmsg
0,01588190500,01588205700,00000015200,a07,poll
0,01588208300,01588209300,00000001000,a2e,sendmsg
0,01588211300,01588211400,00000000100,a00,read
0,01588216300,01588227800,00000011500,a07,poll
0,01588229400,01588230200,00000000800,a2e,sendmsg
0,01588236300,01588277100,00000040800,a07,poll
0,01588278400,01588279400,00000001000,aca,futex
0,01588281400,01588282300,00000000900,aca,futex
0,01588285000,01588286100,00000001100,aca,futex
0,01588287700,01588290000,00000002300,a2e,sendmsg
0,01588292300,01588292400,00000000100,a00,read
0,01588298300,01588301000,00000002700,a07,poll
0,01588336700,01588336800,00000000100,a00,read
0,01588391800,01588394700,00000002900,a07,poll
0,01588401300,01588403100,00000001800,a2e,sendmsg
0,01588425400,01588425600,00000000200,a00,read
0,01588429800,01588430500,00000000700,a2f,recvmsg
0,01588500200,01588502200,00000002000,a00,read
0,01588590000,01588591300,00000001300,a00,read
0,01588666300,01588667400,00000001100,a00,read
0,01588748600,01588749400,00000000800,a00,read
0,01588479200,01588793900,00000314700,a07,poll
0,01588794400,01588794600,00000000200,a00,read
0,01588800100,01588800900,00000000800,a2f,recvmsg
0,01588889000,01588890200,00000001200,a00,read
0,01588845200,01588971900,00000126700,a07,poll
0,01588976500,01588979800,00000003300,a2e,sendmsg
0,01588982500,01588982700,00000000200,a00,read
0,01589004400,01589005400,00000001000,a00,read
0,01589000100,01589038800,00000038700,a07,poll
0,01589039600,01589039700,00000000100,a00,read
0,01589047300,01589048300,00000001000,a2f,recvmsg
0,01589136500,01589138700,00000002200,a07,poll
0,01589277500,01589278200,00000000700,aca,futex
0,01589136500,01589286800,00000150300,a07,poll
0,01589293000,01589296200,00000003200,a2e,sendmsg
0,01589317700,01589320000,00000002300,a07,poll
0,01589322700,01589324000,00000001300,aca,futex
0,01589330500,01589330800,00000000300,aca,futex
0,01589331400,01589339600,00000008200,aca,futex
0,01589343600,01589346200,00000002600,a2e,sendmsg
0,01589349700,01589350000,00000000300,a00,read
0,01589351100,01589362500,00000011400,aca,futex
0,01589364500,01589365500,00000001000,a2e,sendmsg
0,01589381900,01589385400,00000003500,aca,futex
0,01589386900,01589387700,00000000800,a2e,sendmsg
0,01589389700,01589391400,00000001700,aca,futex
0,01589397300,01589398000,00000000700,a2e,sendmsg
0,01589427300,01589441400,00000014100,a2f,recvmsg
0,01589450200,01589450500,00000000300,a2f,recvmsg
0,01589486000,01589515600,00000029600,a07,poll
0,01589558900,01589559100,00000000200,a00,read
0,01589657300,01589659100,00000001800,a00,read
0,01589729300,01589729900,00000000600,a00,read
0,01589788400,01589789300,00000000900,a00,read
0,01589614900,01589836100,00000221200,a07,poll
0,01589836900,01589839100,00000002200,a2f,recvmsg
0,01589854000,01589856000,00000002000,a2d,recvfrom
0,01589857400,01589857700,00000000300,a2f,recvmsg
0,01589858400,01589858600,00000000200,a2f,recvmsg
0,01589876200,01589876400,00000000200,aca,futex
0,01589924500,01589924800,00000000300,a2f,recvmsg
0,01590392500,01590393700,00000001200,a2f,recvmsg
0,01590399200,01590399800,00000000600,a00,read
0,01594790500,01594804900,00000014400,a14,writev
0,01594905900,01594908800,00000002900,a07,poll
0,01589887400,01595008800,00005121400,aca,futex
0,01595023300,01595025400,00000002100,aca,futex
0,01595033100,01595034400,00000001300,a2f,recvmsg
0,01595060900,01595083500,00000022600,aca,futex
0,01595084600,01595086400,00000001800,a2f,recvmsg
0,01595220000,01595234600,00000014600,aca,futex
0,01595244900,01595254600,00000009700,aca,futex
0,01595311800,01595318900,00000007100,a2f,recvmsg
0,01595377100,01595377500,00000000400,a2f,recvmsg
0,01595418200,01595418500,00000000300,a2f,recvmsg
0,01594915600,01595430300,00000514700,a07,poll
0,01595435900,01595436200,00000000300,a2f,recvmsg
0,01595437200,01595437400,00000000200,a2f,recvmsg
0,01595421100,01595449100,00000028000,a17,select
0,01595457000,01595457200,00000000200,a2f,recvmsg
0,01595468000,01595468200,00000000200,a2f,recvmsg
0,01595468700,01595468900,00000000200,a2f,recvmsg
0,01595488800,01595501500,00000012700,a06,lstat
0,01595503200,01595505100,00000001900,a06,lstat
0,01595508800,01595546000,00000037200,a02,open
0,01595553700,01595573200,00000019500,a01,write
0,01595458600,01595590800,00000132200,a17,select
0,01595599400,01595599600,00000000200,a2f,recvmsg
0,01595612600,01595612900,00000000300,a2f,recvmsg
0,01595613500,01595613700,00000000200,a2f,recvmsg
0,01595616200,01596005700,00000389500,a38,clone
0,55658776600,01602090600,-54056686000,a4a,fsync
0,01602152900,01602157000,00000004100,a09,mmap
0,01602229000,01602232800,00000003800,a01,write
0,01602279500,01602281000,00000001500,aca,futex
0,01602283400,01602287300,00000003900,aca,futex
0,01602457800,01602466700,00000008900,a01,write
0,01602302800,01602506100,00000203300,a07,poll
0,01602511300,01602512000,00000000700,a00,read
0,01602601100,01602602100,00000001000,60e,page_fault
0,01602660800,01602664100,00000003300,a01,write
0,01602679300,01602680400,00000001100,a2f,recvmsg
0,01602682700,01602682900,00000000200,a00,read
0,01602762600,01602764600,00000002000,a01,write
0,01596037800,01606984500,00010946700,a3d,wait4
0,01607016400,01607021100,00000004700,a00,read
0,01607023100,01607023500,00000000400,a00,read
0,01607040500,01607127200,00000086700,a07,poll
0,01607135200,01607135300,00000000100,a2f,recvmsg
0,01607136800,01607137000,00000000200,a2f,recvmsg
0,01607145500,01607198300,00000052800,a07,poll
0,01607199000,01607250800,00000051800,a2f,recvmsg
0,01607253400,01607253700,00000000300,a2f,recvmsg
0,01607254600,01607254800,00000000200,a2f,recvmsg
0,01607265500,01607392800,00000127300,a07,poll
0,01607410400,01607410700,00000000300,a2f,recvmsg
0,01607411400,01607411600,00000000200,a2f,recvmsg
0,01607420200,01607494100,00000073900,a07,poll
0,01607499000,01607499200,00000000200,a2f,recvmsg
0,01607500000,01607500100,00000000100,a2f,recvmsg
0,01607507800,01607613900,00000106100,a07,poll
0,01607616400,01607616600,00000000200,a2f,recvmsg
0,01607617100,01607617300,00000000200,a2f,recvmsg
0,01607623600,01607687800,00000064200,a07,poll
0,01607690600,01607690700,00000000100,a2f,recvmsg
0,01607691200,01607691400,00000000200,a2f,recvmsg
0,01607692900,01607693700,00000000800,a08,lseek
0,01607705800,01607705900,00000000100,a08,lseek
0,01602283400,01608938100,00006654700,aca,futex
0,01608950900,01608964500,00000013600,aca,futex
0,01607710800,01609066800,00001356000,a07,poll
0,01609074200,01609074400,00000000200,a2f,recvmsg
0,01609075600,01609075900,00000000300,a2f,recvmsg
0,01609094100,01609094400,00000000300,a2f,recvmsg
0,01609100800,01609108300,00000007500,a07,poll
0,01609113200,01609113400,00000000200,a2f,recvmsg
0,01609114200,01609114300,00000000100,a2f,recvmsg
0,01609123900,01609231000,00000107100,a07,poll
0,01609234000,01609234100,00000000100,a2f,recvmsg
0,01609234600,01609234800,00000000200,a2f,recvmsg
0,01609239500,01609305100,00000065600,a07,poll
0,01609308000,01609308100,00000000100,a2f,recvmsg
0,01609308600,01609308800,00000000200,a2f,recvmsg
0,01609313700,01609326000,00000012300,a07,poll
0,01609328000,01609328200,00000000200,a2f,recvmsg
0,01609328600,01609328800,00000000200,a2f,recvmsg
0,01609333100,01609345000,00000011900,a07,poll
0,01609347100,01609347300,00000000200,a2f,recvmsg
0,01609347600,01609347800,00000000200,a2f,recvmsg
0,01609352300,01609359200,00000006900,a07,poll
0,01609360400,01609360600,00000000200,a2f,recvmsg
0,01609360900,01609361100,00000000200,a2f,recvmsg
0,01609364700,01609371900,00000007200,a07,poll
0,01609373100,01609373300,00000000200,a2f,recvmsg
0,01609373500,01609373700,00000000200,a2f,recvmsg
0,01609376800,01609384100,00000007300,a07,poll
0,01609385300,01609385400,00000000100,a2f,recvmsg
0,01609385800,01609386000,00000000200,a2f,recvmsg
0,01609390700,01609398000,00000007300,a07,poll
0,01609399200,01609399400,00000000200,a2f,recvmsg
0,01609399700,01609399900,00000000200,a2f,recvmsg
0,01609403400,01609410700,00000007300,a07,poll
0,01609411900,01609412000,00000000100,a2f,recvmsg
0,01609412300,01609412500,00000000200,a2f,recvmsg
0,01609418900,01609426200,00000007300,a07,poll
0,01609427400,01609427600,00000000200,a2f,recvmsg
0,01609427900,01609428100,00000000200,a2f,recvmsg
0,01609431200,01609438400,00000007200,a07,poll
0,01609439600,01609439800,00000000200,a2f,recvmsg
0,01609440000,01609440200,00000000200,a2f,recvmsg
0,01609443600,01609450900,00000007300,a07,poll
0,01609452100,01609452300,00000000200,a2f,recvmsg
0,01609452600,01609452800,00000000200,a2f,recvmsg
0,01609456000,01609463000,00000007000,a07,poll
0,01609464200,01609464400,00000000200,a2f,recvmsg
0,01609464700,01609464800,00000000100,a2f,recvmsg
0,01609468000,01609475400,00000007400,a07,poll
0,01609476400,01609476600,00000000200,a2f,recvmsg
0,01609476900,01609477100,00000000200,a2f,recvmsg
0,01609479800,01609486800,00000007000,a07,poll
0,01609487800,01609488000,00000000200,a2f,recvmsg
0,01609488300,01609488500,00000000200,a2f,recvmsg
0,01609495700,01609502700,00000007000,a07,poll
0,01609503900,01609504100,00000000200,a2f,recvmsg
0,01609504400,01609504600,00000000200,a2f,recvmsg
0,01609507200,01609514100,00000006900,a07,poll
0,01609515200,01609515400,00000000200,a2f,recvmsg
0,01609515700,01609515900,00000000200,a2f,recvmsg
0,01609518500,01609525400,00000006900,a07,poll
0,01609526400,01609526600,00000000200,a2f,recvmsg
0,01609526900,01609527100,00000000200,a2f,recvmsg
0,01609529700,01609536500,00000006800,a07,poll
0,01609537500,01609537700,00000000200,a2f,recvmsg
0,01609538000,01609538200,00000000200,a2f,recvmsg
0,01609541100,01609548100,00000007000,a07,poll
0,01609549100,01609549300,00000000200,a2f,recvmsg
0,01609549600,01609549800,00000000200,a2f,recvmsg
0,01609552500,01609559600,00000007100,a07,poll
0,01609560600,01609560800,00000000200,a2f,recvmsg
0,01609561100,01609561300,00000000200,a2f,recvmsg
0,01609564600,01609571500,00000006900,a07,poll
0,01609572600,01609572800,00000000200,a2f,recvmsg
0,01609573000,01609573200,00000000200,a2f,recvmsg
0,01609576500,01609583500,00000007000,a07,poll
0,01609584500,01609584700,00000000200,a2f,recvmsg
0,01609585000,01609585200,00000000200,a2f,recvmsg
0,01609588900,01609596000,00000007100,a07,poll
0,01609597100,01609597300,00000000200,a2f,recvmsg
0,01609597600,01609597700,00000000100,a2f,recvmsg
0,01609602200,01609609100,00000006900,a07,poll
0,01609610200,01609610400,00000000200,a2f,recvmsg
0,01609610700,01609610900,00000000200,a2f,recvmsg
0,01609614100,01609620900,00000006800,a07,poll
0,01609622100,01609622300,00000000200,a2f,recvmsg
0,01609622500,01609622900,00000000400,a2f,recvmsg
0,01609628400,01609635800,00000007400,a07,poll
0,01609637000,01609637200,00000000200,a2f,recvmsg
0,01609637500,01609637600,00000000100,a2f,recvmsg
0,01609640800,01609647600,00000006800,a07,poll
0,01609648800,01609648900,00000000100,a2f,recvmsg
0,01609649100,01609649300,00000000200,a2f,recvmsg
0,01609652400,01609659200,00000006800,a07,poll
0,01609660400,01609660500,00000000100,a2f,recvmsg
0,01609660800,01609661000,00000000200,a2f,recvmsg
0,01609664700,01609671700,00000007000,a07,poll
0,01609672900,01609673100,00000000200,a2f,recvmsg
0,01609673400,01609673600,00000000200,a2f,recvmsg
0,01609677000,01609684000,00000007000,a07,poll
0,01609685100,01609685300,00000000200,a2f,recvmsg
0,01609685600,01609685800,00000000200,a2f,recvmsg
0,01609689900,01609696900,00000007000,a07,poll
0,01609698100,01609698300,00000000200,a2f,recvmsg
0,01609698500,01609698700,00000000200,a2f,recvmsg
0,01609702700,01609709800,00000007100,a07,poll
0,01609711000,01609711200,00000000200,a2f,recvmsg
0,01609711700,01609711900,00000000200,a2f,recvmsg
0,01609715000,01609721800,00000006800,a07,poll
0,01609723000,01609723100,00000000100,a2f,recvmsg
0,01609723400,01609723600,00000000200,a2f,recvmsg
0,01609726400,01609733200,00000006800,a07,poll
0,01609734300,01609734500,00000000200,a2f,recvmsg
0,01609734800,01609735000,00000000200,a2f,recvmsg
0,01609738400,01609745500,00000007100,a07,poll
0,01609746600,01609746800,00000000200,a2f,recvmsg
0,01609747100,01609747300,00000000200,a2f,recvmsg
0,01609748900,01609749700,00000000800,a08,lseek
0,01609753500,01609756400,00000002900,a00,read
0,01609760300,01609760400,00000000100,a08,lseek
0,01609763400,01609770300,00000006900,a07,poll
0,01609771600,01609771800,00000000200,a2f,recvmsg
0,01609772100,01609772300,00000000200,a2f,recvmsg
0,01609798700,01609805400,00000006700,a07,poll
0,01609806700,01609806800,00000000100,a2f,recvmsg
0,01609807100,01609807300,00000000200,a2f,recvmsg
0,01609811300,01609812300,00000001000,a00,read
0,01609817700,01609817900,00000000200,a08,lseek
0,01609821200,01609828100,00000006900,a07,poll
0,01609829400,01609829500,00000000100,a2f,recvmsg
0,01609829800,01609830000,00000000200,a2f,recvmsg
0,01609832800,01609839600,00000006800,a07,poll
0,01609840700,01609840900,00000000200,a2f,recvmsg
0,01609841100,01609841300,00000000200,a2f,recvmsg
0,01609844000,01609850700,00000006700,a07,poll
0,01609851900,01609852100,00000000200,a2f,recvmsg
0,01609852300,01609852500,00000000200,a2f,recvmsg
0,01609855200,01609862300,00000007100,a07,poll
0,01609863500,01609863700,00000000200,a2f,recvmsg
0,01609863900,01609864100,00000000200,a2f,recvmsg
0,01609866800,01609873700,00000006900,a07,poll
0,01609874800,01609875000,00000000200,a2f,recvmsg
0,01609875200,01609875400,00000000200,a2f,recvmsg
0,01609878100,01609885000,00000006900,a07,poll
0,01609886200,01609886300,00000000100,a2f,recvmsg
0,01609886600,01609886700,00000000100,a2f,recvmsg
0,01609889300,01609896400,00000007100,a07,poll
0,01609897600,01609897800,00000000200,a2f,recvmsg
0,01609898000,01609898200,00000000200,a2f,recvmsg
0,01609901500,01609908200,00000006700,a07,poll
0,01609909300,01609909400,00000000100,a2f,recvmsg
0,01609909800,01609910000,00000000200,a2f,recvmsg
0,01609912800,01609919600,00000006800,a07,poll
0,01609920700,01609920800,00000000100,a2f,recvmsg
0,01609921100,01609921300,00000000200,a2f,recvmsg
0,01609921800,01609922000,00000000200,a08,lseek
0,01609927800,01609934600,00000006800,a07,poll
0,01609935800,01609935900,00000000100,a2f,recvmsg
0,01609936200,01609936400,00000000200,a2f,recvmsg
0,01609942000,01609949200,00000007200,a07,poll
0,01609950300,01609950500,00000000200,a2f,recvmsg
0,01609950800,01609951000,00000000200,a2f,recvmsg
0,01609954400,01609960900,00000006500,a07,poll
0,01609962200,01609962400,00000000200,a2f,recvmsg
0,01609962600,01609962800,00000000200,a2f,recvmsg
0,01609965800,01609972600,00000006800,a07,poll
0,01609973800,01609973900,00000000100,a2f,recvmsg
0,01609974200,01609974400,00000000200,a2f,recvmsg
0,01609977600,01609984300,00000006700,a07,poll
0,01609985300,01609985500,00000000200,a2f,recvmsg
0,01609985800,01609986000,00000000200,a2f,recvmsg
0,01609989000,01609996200,00000007200,a07,poll
0,01609997400,01609997500,00000000100,a2f,recvmsg
0,01609997900,01609998100,00000000200,a2f,recvmsg
0,01610001500,01610008500,00000007000,a07,poll
0,01610009600,01610009800,00000000200,a2f,recvmsg
0,01610010000,01610010200,00000000200,a2f,recvmsg
0,01610013300,01610019900,00000006600,a07,poll
0,01610021100,01610021200,00000000100,a2f,recvmsg
0,01610021500,01610021700,00000000200,a2f,recvmsg
0,01610024900,01610031400,00000006500,a07,poll
0,01610032500,01610032700,00000000200,a2f,recvmsg
0,01610032900,01610033100,00000000200,a2f,recvmsg
0,01610036100,01610042900,00000006800,a07,poll
0,01610044200,01610044300,00000000100,a2f,recvmsg
0,01610044600,01610044800,00000000200,a2f,recvmsg
0,01610047800,01610054500,00000006700,a07,poll
0,01610055600,01610055800,00000000200,a2f,recvmsg
0,01610056200,01610056400,00000000200,a2f,recvmsg
0,01610059400,01610066000,00000006600,a07,poll
0,01610067200,01610067300,00000000100,a2f,recvmsg
0,01610067700,01610067900,00000000200,a2f,recvmsg
0,01610071400,01610078300,00000006900,a07,poll
0,01610079400,01610079500,00000000100,a2f,recvmsg
0,01610079900,01610080100,00000000200,a2f,recvmsg
0,01610082900,01610089700,00000006800,a07,poll
0,01610091100,01610091300,00000000200,a2f,recvmsg
0,01610091600,01610091700,00000000100,a2f,recvmsg
0,01610094700,01610101500,00000006800,a07,poll
0,01610102700,01610102900,00000000200,a2f,recvmsg
0,01610103100,01610103300,00000000200,a2f,recvmsg
0,01610106200,01610113200,00000007000,a07,poll
0,01610114400,01610114500,00000000100,a2f,recvmsg
0,01610114700,01610114900,00000000200,a2f,recvmsg
0,01610123800,01610130600,00000006800,a07,poll
0,01610131700,01610131900,00000000200,a2f,recvmsg
0,01610132200,01610132400,00000000200,a2f,recvmsg
0,01610135600,01610142400,00000006800,a07,poll
0,01610143500,01610143700,00000000200,a2f,recvmsg
0,01610144000,01610144200,00000000200,a2f,recvmsg
0,01610147000,01610153800,00000006800,a07,poll
0,01610154900,01610155100,00000000200,a2f,recvmsg
0,01610155400,01610155600,00000000200,a2f,recvmsg
0,01610158700,01610165400,00000006700,a07,poll
0,01610166400,01610166600,00000000200,a2f,recvmsg
0,01610166900,01610167100,00000000200,a2f,recvmsg
0,01610170300,01610177100,00000006800,a07,poll
0,01610178100,01610178300,00000000200,a2f,recvmsg
0,01610178600,01610178800,00000000200,a2f,recvmsg
0,01610205200,01610245400,00000040200,a57,unlink
0,01610246500,01610251200,00000004700,a14,writev
0,01610251700,01610350800,00000099100,a07,poll
0,01610361500,01610361900,00000000400,a2f,recvmsg
0,01610389700,01610389900,00000000200,a2f,recvmsg
0,01610395700,01610436000,00000040300,a07,poll
0,01610437700,01610496000,00000058300,a07,poll
0,01610497300,01610554200,00000056900,a07,poll
0,01610555400,01610613300,00000057900,a07,poll
0,01610616100,01610672000,00000055900,a07,poll
0,01610673100,01610729700,00000056600,a07,poll
0,01610730900,01610773800,00000042900,a07,poll
0,01610774900,01610837200,00000062300,a07,poll
0,01610838700,01610881100,00000042400,a07,poll
0,01610882300,01610924000,00000041700,a07,poll
0,01610925100,01610966900,00000041800,a07,poll
0,01610968000,01611023000,00000055000,a07,poll
0,01611024100,01611041800,00000017700,a07,poll
0,01611046000,01611060000,00000014000,a07,poll
0,01611061200,01611076100,00000014900,a07,poll
0,01611077300,01611091700,00000014400,a07,poll
0,01611092900,01611106400,00000013500,a07,poll
0,01611107800,01611112300,00000004500,a07,poll
0,01611115600,01611115800,00000000200,a2f,recvmsg
0,01611116300,01611116500,00000000200,a2f,recvmsg
0,01611148600,01611150700,00000002100,a07,poll
0,01611151800,01611153400,00000001600,a2f,recvmsg
0,01611158300,01611159600,00000001300,a2d,recvfrom
0,01611165900,01611166200,00000000300,a2f,recvmsg
0,01611166900,01611167100,00000000200,a2f,recvmsg
0,01611233600,01611233900,00000000300,a2f,recvmsg
0,01611237100,01611237400,00000000300,a2f,recvmsg
0,01611241200,01611377800,00000136600,a07,poll
0,01611379200,01611380800,00000001600,a2f,recvmsg
0,01611392000,01611393000,00000001000,a2d,recvfrom
0,01611394300,01611394500,00000000200,a2f,recvmsg
0,01611395400,01611395600,00000000200,a2f,recvmsg
0,01611439000,01611439400,00000000400,a2f,recvmsg
0,01611442600,01611442700,00000000100,a2f,recvmsg
0,01611446700,01611487900,00000041200,a07,poll
0,01611488900,01611490400,00000001500,a2f,recvmsg
0,01611500300,01611501400,00000001100,a2d,recvfrom
0,01611502500,01611502700,00000000200,a2f,recvmsg
0,01611503400,01611503600,00000000200,a2f,recvmsg
0,01611552500,01611552800,00000000300,a2f,recvmsg
0,01611555200,01611555300,00000000100,a2f,recvmsg
0,01611558100,01611561100,00000003000,a07,poll
0,01611564300,01611564400,00000000100,a2f,recvmsg
0,01611565100,01611565300,00000000200,a2f,recvmsg
0,01612139600,01612144400,00000004800,a09,mmap
0,01611558100,01612343300,00000785200,a07,poll
0,01612358100,01612365300,00000007200,a2e,sendmsg
0,01612371700,01612371900,00000000200,a00,read
0,01612458800,01612466500,00000007700,a02,open
0,01612530500,01612535700,00000005200,a00,read
0,01612604300,01612606200,00000001900,a00,read
0,01612663400,01612664600,00000001200,a00,read
0,01612720600,01612722200,00000001600,a00,read
0,01612778200,01612779200,00000001000,a00,read
0,01612833200,01612834500,00000001300,a00,read
0,01612887900,01612888900,00000001000,a00,read
0,01612944200,01612945700,00000001500,a00,read
0,01613002000,01613003600,00000001600,a00,read
0,01613059000,01613060700,00000001700,a00,read
0,01613112000,01613113100,00000001100,a00,read
0,01613144100,01613147300,00000003200,a02,open
0,01613152300,01613153400,00000001100,a00,read
0,01613212700,01613215000,00000002300,a00,read
0,01613304200,01613305200,00000001000,a00,read
0,01613381100,01613382100,00000001000,a00,read
0,01613463300,01613464600,00000001300,a00,read
0,01613547800,01613548600,00000000800,a00,read
0,01613631200,01613632200,00000001000,a00,read
0,01613720700,01613722200,00000001500,a00,read
0,01613791800,01613793500,00000001700,a00,read
0,01613853100,01613855100,00000002000,a00,read
0,01613960000,01613986700,00000026700,a07,poll
0,01613991400,01613991700,00000000300,a2f,recvmsg
0,01613992600,01613992800,00000000200,a2f,recvmsg
0,01613996200,01614061000,00000064800,a07,poll
0,01614062400,01614062600,00000000200,a2f,recvmsg
0,01614062800,01614063100,00000000300,a2f,recvmsg
0,01614068900,01614075000,00000006100,a06,lstat
0,01614076000,01614077200,00000001200,a06,lstat
0,01614100800,01614118800,00000018000,a01,write
0,01614125100,01614154400,00000029300,a07,poll
0,01614156300,01614156500,00000000200,a2f,recvmsg
0,01614157100,01614157300,00000000200,a2f,recvmsg
0,01614159200,01614543800,00000384600,a38,clone
0,01615201000,01615201200,00000000200,a0c,brk
0,01615212200,01615214500,00000002300,a15,access
0,01615215600,01615216300,00000000700,a09,mmap
0,01615220500,01615221500,00000001000,a15,access
0,01615228800,01615229800,00000001000,a09,mmap
0,01615233800,01615234400,00000000600,a15,access
0,01615241900,01615242900,00000001000,a00,read
0,01615244500,01615246200,00000001700,a09,mmap
0,01615251200,01615253900,00000002700,a09,mmap
0,01615265300,01615266300,00000001000,a15,access
0,01615269700,01615270400,00000000700,a00,read
0,01615271100,01615272200,00000001100,a09,mmap
0,01615274200,01615275600,00000001400,a09,mmap
0,01615285000,01615285800,00000000800,a15,access
0,01615289500,01615290300,00000000800,a00,read
0,01615291000,01615292000,00000001000,a09,mmap
0,01615293700,01615295900,00000002200,a09,mmap
0,01615300100,01615303500,00000003400,a09,mmap
0,01615305600,01615306900,00000001300,a09,mmap
0,01615318000,01615318800,00000000800,a15,access
0,01615321800,01615322400,00000000600,a00,read
0,01615323200,01615324900,00000001700,a09,mmap
0,01615327600,01615329400,00000001800,a09,mmap
0,01615338000,01615338900,00000000900,a15,access
0,01615342300,01615343000,00000000700,a00,read
0,01615343600,01615345200,00000001600,a09,mmap
0,01615348200,01615350700,00000002500,a09,mmap
0,01615359400,01615360000,00000000600,a15,access
0,01615363200,01615364000,00000000800,a00,read
0,01615364400,01615365700,00000001300,a09,mmap
0,01615367000,01615368400,00000001400,a09,mmap
0,01615371100,01615372500,00000001400,a09,mmap
0,01615378900,01615379500,00000000600,a15,access
0,01615382700,01615383300,00000000600,a00,read
0,01615383900,01615385400,00000001500,a09,mmap
0,01615387700,01615389500,00000001800,a09,mmap
0,01615404200,01615404800,00000000600,a09,mmap
0,01615409000,01615409400,00000000400,a09,mmap
0,01615614800,01615614900,00000000100,a0c,brk
0,01615615000,01615615800,00000000800,a0c,brk
0,01615645000,01615649300,00000004300,a00,read
0,01615665800,01615667600,00000001800,a00,read
0,01615707500,01615708700,00000001200,a00,read
0,01615831500,01615832400,00000000900,a00,read
0,01615903600,01615903900,00000000300,a00,read
0,01615989700,01615990400,00000000700,a00,read
0,01616122500,01616123400,00000000900,a00,read
0,01616253000,01616253700,00000000700,a00,read
0,01616410400,01616411100,00000000700,a00,read
0,01616561500,01616562200,00000000700,a00,read
0,01616599200,01616600400,00000001200,a0c,brk
0,01616716900,01616717600,00000000700,a00,read
0,01616866900,01616867400,00000000500,a00,read
0,01617024200,01617024800,00000000600,a00,read
0,01617184000,01617184700,00000000700,a00,read
0,01617293400,01617294100,00000000700,a00,read
0,01617325000,01617325600,00000000600,a0c,brk
0,01617434400,01617435100,00000000700,a00,read
0,01617682200,01617682700,00000000500,a00,read
0,01617694900,01617695300,00000000400,a00,read
0,01617739600,01617739900,00000000300,a00,read
0,01617759500,01617760200,00000000700,a00,read
0,01617968200,01617968700,00000000500,a00,read
0,01617997900,01617998700,00000000800,a00,read
0,01618096500,01618097200,00000000700,a00,read
0,01618121300,01618122600,00000001300,a0c,brk
0,01618168400,01618168700,00000000300,a00,read
0,01618246000,01618246800,00000000800,a00,read
0,01618400400,01618401000,00000000600,a00,read
0,01618517200,01618517800,00000000600,a00,read
0,01618612000,01618612500,00000000500,a00,read
0,01618624400,01618624800,00000000400,a00,read
0,01618709500,01618709900,00000000400,a00,read
0,01618734000,01618734300,00000000300,a00,read
0,01618756600,01618757400,00000000800,a00,read
0,01618870700,01618871800,00000001100,a0c,brk
0,01618873700,01618875100,00000001400,a00,read
0,01619076300,01619076800,00000000500,a00,read
0,01619159800,01619160400,00000000600,a00,read
0,01619225200,01619225900,00000000700,a00,read
0,01619354800,01619355300,00000000500,a00,read
0,01619388200,01619388700,00000000500,a00,read
0,01619406700,01619408800,00000002100,a02,open
0,01619524900,01619525400,00000000500,a00,read
0,01619596100,01619596500,00000000400,a00,read
0,01619649100,01619650200,00000001100,a0c,brk
0,01619656500,01619657200,00000000700,a00,read
0,01619764100,01619764700,00000000600,a00,read
0,01619916500,01619917400,00000000900,a00,read
0,01620048000,01620048700,00000000700,a00,read
0,01620106600,01620107100,00000000500,a00,read
0,01620162600,01620163300,00000000700,a00,read
0,01620233300,01620234000,00000000700,a00,read
0,01620287000,01620287600,00000000600,a00,read
0,01620376200,01620376900,00000000700,a0c,brk
0,01620408200,01620412100,00000003900,a0c,brk
0,01620426100,01620426900,00000000800,a00,read
0,01620543800,01620544800,00000001000,a00,read
0,01620703000,01620703600,00000000600,a00,read
0,01620820700,01620821300,00000000600,a00,read
0,01620967100,01620967700,00000000600,a00,read
0,01621085100,01621085900,00000000800,a00,read
0,01621250200,01621250800,00000000600,a00,read
0,01621255800,01621256400,00000000600,a0c,brk
0,01621373900,01621374600,00000000700,a00,read
0,01621493400,01621493900,00000000500,a00,read
0,01621634700,01621635400,00000000700,a00,read
0,01621765900,01621766700,00000000800,a00,read
0,01621859900,01621860700,00000000800,a00,read
0,01621972800,01621973600,00000000800,a00,read
0,01622099000,01622099700,00000000700,a00,read
0,01622211100,01622211800,00000000700,a0c,brk
0,01622234600,01622235300,00000000700,a00,read
0,01622405300,01622405900,00000000600,a00,read
0,01622555700,01622556600,00000000900,a00,read
0,01622667200,01622667800,00000000600,a00,read
0,01622855300,01622856200,00000000900,a00,read
0,01622933200,01622933800,00000000600,a00,read
0,01623015700,01623016500,00000000800,a00,read
0,01623083200,01623084100,00000000900,a0c,brk
0,01623097700,01623098400,00000000700,a00,read
0,01623170200,01623170900,00000000700,a00,read
0,01623271900,01623272700,00000000800,a00,read
0,01623375000,01623375700,00000000700,a00,read
0,01623465400,01623465900,00000000500,a00,read
0,01623548000,01623548700,00000000700,a00,read
0,01623649700,01623650300,00000000600,a00,read
0,01623730800,01623731200,00000000400,a0c,brk
0,01623733700,01623734300,00000000600,a00,read
0,01623841400,01623842000,00000000600,a00,read
0,01623934400,01623935100,00000000700,a00,read
0,01624053400,01624054100,00000000700,a00,read
0,01624168700,01624169400,00000000700,a00,read
0,01624272400,01624273000,00000000600,a00,read
0,01624373400,01624373800,00000000400,a0c,brk
0,01624732800,01624736100,00000003300,a57,unlink
0,01624757800,01624758300,00000000500,a48,fcntl
0,01624803800,01624818100,00000014300,a01,write
0,01624835700,01624838400,00000002700,a01,write
0,01624854700,01624857100,00000002400,a01,write
0,01595602300,01625103300,00029501000,a17,select
0,01625128500,01625128800,00000000300,a2f,recvmsg
0,01625173700,01625173900,00000000200,a2f,recvmsg
0,01625174800,01625191400,00000016600,a17,select
0,01625195900,01625196100,00000000200,a2f,recvmsg
0,01625196600,01625212100,00000015500,a17,select
0,01625216800,01625216900,00000000100,a2f,recvmsg
0,01625217500,01625233200,00000015700,a17,select
0,01625238200,01625238400,00000000200,a2f,recvmsg
0,01625238800,01625254900,00000016100,a17,select
0,01625258600,01625258700,00000000100,a2f,recvmsg
0,01625259300,01625289200,00000029900,a17,select
0,01625293300,01625293500,00000000200,a2f,recvmsg
0,01625293900,01625303400,00000009500,a17,select
0,01625307200,01625307300,00000000100,a2f,recvmsg
0,01625307900,01625315600,00000007700,a17,select
0,01625319500,01625319600,00000000100,a2f,recvmsg
0,01625320200,01625328000,00000007800,a17,select
0,01625331600,01625331700,00000000100,a2f,recvmsg
0,01625332200,01625340100,00000007900,a17,select
0,01625343900,01625344100,00000000200,a2f,recvmsg
0,01625344600,01625352400,00000007800,a17,select
0,01625356000,01625356200,00000000200,a2f,recvmsg
0,01625356700,01625364200,00000007500,a17,select
0,01625368200,01625368400,00000000200,a2f,recvmsg
0,01625368900,01625376100,00000007200,a17,select
0,01625379700,01625379900,00000000200,a2f,recvmsg
0,01625380400,01625388900,00000008500,a17,select
0,01625392700,01625392900,00000000200,a2f,recvmsg
0,01625393400,01625401000,00000007600,a17,select
0,01625404900,01625405100,00000000200,a2f,recvmsg
0,01625405700,01625413100,00000007400,a17,select
0,01625417100,01625417100,00000000000,a2f,recvmsg
0,01625417700,01625425300,00000007600,a17,select
0,01625429200,01625429400,00000000200,a2f,recvmsg
0,01625429900,01625438000,00000008100,a17,select
0,01625441800,01625441900,00000000100,a2f,recvmsg
0,01625442500,01625450100,00000007600,a17,select
0,01625453900,01625454000,00000000100,a2f,recvmsg
0,01625454600,01625462000,00000007400,a17,select
0,01625466000,01625466100,00000000100,a2f,recvmsg
0,01625466600,01625474100,00000007500,a17,select
0,01625477800,01625477900,00000000100,a2f,recvmsg
0,01625478500,01625488100,00000009600,a17,select
0,01625491700,01625491800,00000000100,a2f,recvmsg
0,01625492400,01625499500,00000007100,a17,select
0,01625503200,01625503300,00000000100,a2f,recvmsg
0,01625503900,01625510800,00000006900,a17,select
0,01625514500,01625514600,00000000100,a2f,recvmsg
0,01625515200,01625522300,00000007100,a17,select
0,01625525800,01625526000,00000000200,a2f,recvmsg
0,01625526500,01625533700,00000007200,a17,select
0,01625537300,01625537500,00000000200,a2f,recvmsg
0,01625538000,01625546000,00000008000,a17,select
0,01625549600,01625549800,00000000200,a2f,recvmsg
0,01625550200,01625557900,00000007700,a17,select
0,01625561800,01625562000,00000000200,a2f,recvmsg
0,01625562500,01625570100,00000007600,a17,select
0,01625573900,01625574100,00000000200,a2f,recvmsg
0,01625574600,01625582500,00000007900,a17,select
0,01625586300,01625586500,00000000200,a2f,recvmsg
0,01625587000,01625594800,00000007800,a17,select
0,01625598300,01625598500,00000000200,a2f,recvmsg
0,01625599000,01625606800,00000007800,a17,select
0,01625610700,01625610800,00000000100,a2f,recvmsg
0,01625611300,01625621600,00000010300,a17,select
0,01625625300,01625625500,00000000200,a2f,recvmsg
0,01625626000,01625633500,00000007500,a17,select
0,01625637000,01625637200,00000000200,a2f,recvmsg
0,01625637700,01625645100,00000007400,a17,select
0,01625648800,01625648900,00000000100,a2f,recvmsg
0,01625649500,01625658500,00000009000,a17,select
0,01625662200,01625662300,00000000100,a2f,recvmsg
0,01625662900,01625671400,00000008500,a17,select
0,01625675100,01625675200,00000000100,a2f,recvmsg
0,01625675700,01625683800,00000008100,a17,select
0,01625687500,01625687700,00000000200,a2f,recvmsg
0,01625688200,01625695800,00000007600,a17,select
0,01625699500,01625699700,00000000200,a2f,recvmsg
0,01625700200,01625707800,00000007600,a17,select
0,01625711400,01625711600,00000000200,a2f,recvmsg
0,01625712000,01625719200,00000007200,a17,select
0,01625722900,01625723000,00000000100,a2f,recvmsg
0,01625723500,01625731100,00000007600,a17,select
0,01625734600,01625734800,00000000200,a2f,recvmsg
0,01625735400,01625751900,00000016500,a17,select
0,01625755600,01625755800,00000000200,a2f,recvmsg
0,01625756400,01625786600,00000030200,a17,select
0,01625790300,01625790500,00000000200,a2f,recvmsg
0,01625791000,01625809300,00000018300,a17,select
0,01625812900,01625813100,00000000200,a2f,recvmsg
0,01625813700,01625820900,00000007200,a17,select
0,01625824500,01625824700,00000000200,a2f,recvmsg
0,01625825200,01625832100,00000006900,a17,select
0,01625835500,01625835700,00000000200,a2f,recvmsg
0,01625836200,01625843200,00000007000,a17,select
0,01625846700,01625846900,00000000200,a2f,recvmsg
0,01625847400,01625854500,00000007100,a17,select
0,01625857900,01625858000,00000000100,a2f,recvmsg
0,01625858600,01625865500,00000006900,a17,select
0,01625869100,01625869300,00000000200,a2f,recvmsg
0,01625869700,01625876800,00000007100,a17,select
0,01625880300,01625880500,00000000200,a2f,recvmsg
0,01625880900,01625888600,00000007700,a17,select
0,01625892400,01625892500,00000000100,a2f,recvmsg
0,01625893100,01625900100,00000007000,a17,select
0,01625903600,01625903800,00000000200,a2f,recvmsg
0,01625904300,01625914000,00000009700,a17,select
0,01625917500,01625917700,00000000200,a2f,recvmsg
0,01625918200,01625927800,00000009600,a17,select
0,01625931400,01625931600,00000000200,a2f,recvmsg
0,01625932000,01625939800,00000007800,a17,select
0,01625943400,01625943400,00000000000,a2f,recvmsg
0,01625944000,01625951500,00000007500,a17,select
0,01625955000,01625955200,00000000200,a2f,recvmsg
0,01625955700,01625963100,00000007400,a17,select
0,01625966700,01625966900,00000000200,a2f,recvmsg
0,01625967400,01625975100,00000007700,a17,select
0,01625978600,01625978700,00000000100,a2f,recvmsg
0,01625979300,01625987100,00000007800,a17,select
0,01625990600,01625990800,00000000200,a2f,recvmsg
0,01625991300,01625998600,00000007300,a17,select
0,01626002200,01626002300,00000000100,a2f,recvmsg
0,01626002800,01626010000,00000007200,a17,select
0,01626013600,01626013700,00000000100,a2f,recvmsg
0,01626014200,01626021400,00000007200,a17,select
0,01626025000,01626025100,00000000100,a2f,recvmsg
0,01626025700,01626032900,00000007200,a17,select
0,01626036600,01626036800,00000000200,a2f,recvmsg
0,01626037300,01626045000,00000007700,a17,select
0,01626048600,01626048700,00000000100,a2f,recvmsg
0,01626049300,01626057200,00000007900,a17,select
0,01626060900,01626061000,00000000100,a2f,recvmsg
0,01626061500,01626068800,00000007300,a17,select
0,01626072300,01626072500,00000000200,a2f,recvmsg
0,01626072900,01626080200,00000007300,a17,select
0,01626083900,01626084000,00000000100,a2f,recvmsg
0,01626084500,01626092000,00000007500,a17,select
0,01626095700,01626095900,00000000200,a2f,recvmsg
0,01626096400,01626108800,00000012400,a17,select
0,01626112500,01626112600,00000000100,a2f,recvmsg
0,01626113100,01626120600,00000007500,a17,select
0,01626124000,01626124200,00000000200,a2f,recvmsg
0,01626124800,01626132100,00000007300,a17,select
0,01626135800,01626135900,00000000100,a2f,recvmsg
0,01626136500,01626144000,00000007500,a17,select
0,01626147500,01626147700,00000000200,a2f,recvmsg
0,01626148200,01626155600,00000007400,a17,select
0,01626159100,01626159200,00000000100,a2f,recvmsg
0,01626159800,01626220800,00000061000,a17,select
0,01626221900,01626223100,00000001200,a2f,recvmsg
0,01626312900,01626317600,00000004700,a14,writev
0,01626400000,01626402000,00000002000,a14,writev
0,01626463500,01626465200,00000001700,a14,writev
0,01626522300,01626523800,00000001500,a14,writev
0,01626579300,01626580900,00000001600,a14,writev
0,01626636200,01626638100,00000001900,a14,writev
0,01626643200,01626644200,00000001000,a2f,recvmsg
0,01626960900,01626963000,00000002100,a2f,recvmsg
0,01627078700,01627078900,00000000200,a2f,recvmsg
0,01627079600,01627080000,00000000400,a14,writev
0,01627099700,01627101700,00000002000,a14,writev
0,01627101900,01627104000,00000002100,a14,writev
0,01627104400,01627104600,00000000200,a2f,recvmsg
0,01614125100,01627112900,00012987800,a07,poll
0,01627117900,01627125800,00000007900,a2f,recvmsg
0,01627138800,01627138900,00000000100,a2f,recvmsg
0,01627167900,01627172700,00000004800,a07,poll
0,01627178900,01627186900,00000008000,a2f,recvmsg
0,01627200900,01627201200,00000000300,a2f,recvmsg
0,01627224800,01627230000,00000005200,a07,poll
0,01627235800,01627243400,00000007600,a2f,recvmsg
0,01627256400,01627256600,00000000200,a2f,recvmsg
0,01627105400,01627286700,00000181300,a17,select
0,01627304500,01627306200,00000001700,a14,writev
0,01627306800,01627307000,00000000200,a2f,recvmsg
0,01627321800,01627322800,00000001000,a14,writev
0,01627323100,01627323300,00000000200,a2f,recvmsg
0,01627335700,01627336700,00000001000,a14,writev
0,01627337000,01627337200,00000000200,a2f,recvmsg
0,01627357000,01627357000,00000000000,a2f,recvmsg
0,01627280600,01627362000,00000081400,a07,poll
0,01627363100,01627364200,00000001100,a2f,recvmsg
0,01627372900,01627373900,00000001000,a2d,recvfrom
0,01627375200,01627375400,00000000200,a2f,recvmsg
0,01627376100,01627376300,00000000200,a2f,recvmsg
0,01627423100,01627423400,00000000300,a2f,recvmsg
0,01627426200,01627426400,00000000200,a2f,recvmsg
0,01627429100,01627432100,00000003000,a07,poll
0,01627433300,01627434700,00000001400,a2f,recvmsg
0,01627445400,01627446200,00000000800,a2d,recvfrom
0,01627447200,01627447600,00000000400,a2f,recvmsg
0,01627448300,01627448500,00000000200,a2f,recvmsg
0,01627483700,01627484100,00000000400,a2f,recvmsg
0,01627486800,01627487000,00000000200,a2f,recvmsg
0,01627491500,01628073300,00000581800,a07,poll
0,01628093300,01628098300,00000005000,a2e,sendmsg
0,01628113900,01628215100,00000101200,a07,poll
0,01628217400,01628218000,00000000600,a00,read
0,01628235800,01628237300,00000001500,a2f,recvmsg
0,01628306600,01628310000,00000003400,a01,write
0,01628324100,01628473700,00000149600,a07,poll
0,01628478300,01628482800,00000004500,a2e,sendmsg
0,01628485600,01628485700,00000000100,a00,read
0,01627357600,01628512600,00001155000,a17,select
0,01628532500,01628534400,00000001900,a14,writev
0,01628535000,01628535200,00000000200,a2f,recvmsg
0,01628505600,01628562800,00000057200,a07,poll
0,01628563500,01628563900,00000000400,a00,read
0,01628567400,01628569300,00000001900,a2f,recvmsg
0,01628576800,01628578100,00000001300,a2f,recvmsg
0,01628537200,01628629200,00000092000,a17,select
0,01628645300,01628646700,00000001400,a14,writev
0,01628647100,01628647200,00000000100,a2f,recvmsg
0,01628648400,01628679700,00000031300,a17,select
0,01628691400,01628692500,00000001100,a14,writev
0,01628692700,01628692900,00000000200,a2f,recvmsg
0,01628752900,01628754400,00000001500,aca,futex
0,01628802700,01628805300,00000002600,a2e,sendmsg
0,01628807300,01628807500,00000000200,a00,read
0,01628809900,01628869200,00000059300,a07,poll
0,01628878200,01628879100,00000000900,a2f,recvmsg
0,01628932900,01629057800,00000124900,a07,poll
0,01629061300,01629064700,00000003400,a2e,sendmsg
0,01629067000,01629067100,00000000100,a00,read
0,01629084300,01629124400,00000040100,a07,poll
0,01629131000,01629131900,00000000900,a2f,recvmsg
0,01629248500,01629249100,00000000600,aca,futex
0,01629249700,01629250000,00000000300,aca,futex
0,01628693700,01630985400,00002291700,a17,select
0,01630999300,01630999500,00000000200,a2f,recvmsg
0,01631001600,01631010500,00000008900,a17,select
0,01631015500,01631015600,00000000100,a2f,recvmsg
0,01631016400,01631078900,00000062500,a17,select
0,01631083500,01631083700,00000000200,a2f,recvmsg
0,01614575800,01641835000,00027259200,a3d,wait4
0,01641854900,01641856900,00000002000,a00,read
0,01641859200,01641859500,00000000300,a00,read
0,01641878100,01641927200,00000049100,a07,poll
0,01641935000,01641935200,00000000200,a2f,recvmsg
0,01641936100,01641936300,00000000200,a2f,recvmsg
0,01641943300,01641969800,00000026500,a07,poll
0,01641972200,01641972300,00000000100,a2f,recvmsg
0,01641972800,01641973000,00000000200,a2f,recvmsg
0,01641978100,01641990000,00000011900,a07,poll
0,01641992200,01641992400,00000000200,a2f,recvmsg
0,01641992700,01641992900,00000000200,a2f,recvmsg
0,01641998100,01642009900,00000011800,a07,poll
0,01642012100,01642012200,00000000100,a2f,recvmsg
0,01642012600,01642012800,00000000200,a2f,recvmsg
0,01642016900,01642028800,00000011900,a07,poll
0,01642030900,01642031100,00000000200,a2f,recvmsg
0,01642031500,01642031700,00000000200,a2f,recvmsg
0,01642036300,01642048200,00000011900,a07,poll
0,01642050400,01642050500,00000000100,a2f,recvmsg
0,01642050900,01642051100,00000000200,a2f,recvmsg
0,01642051900,01642052300,00000000400,a08,lseek
0,01642063400,01642063500,00000000100,a08,lseek
0,01642066900,01642074800,00000007900,a07,poll
0,01642076200,01642076300,00000000100,a2f,recvmsg
0,01642076600,01642076700,00000000100,a2f,recvmsg
0,01642082000,01642089300,00000007300,a07,poll
0,01642090500,01642090700,00000000200,a2f,recvmsg
0,01642091000,01642091200,00000000200,a2f,recvmsg
0,01642094500,01642101400,00000006900,a07,poll
0,01642102600,01642102700,00000000100,a2f,recvmsg
0,01642103000,01642103200,00000000200,a2f,recvmsg
0,01642106600,01642113800,00000007200,a07,poll
0,01642115000,01642115200,00000000200,a2f,recvmsg
0,01642115500,01642115700,00000000200,a2f,recvmsg
0,01642119800,01642127000,00000007200,a07,poll
0,01642128200,01642128400,00000000200,a2f,recvmsg
0,01642128700,01642128900,00000000200,a2f,recvmsg
0,01642132300,01642139000,00000006700,a07,poll
0,01642140200,01642140400,00000000200,a2f,recvmsg
0,01642140700,01642140900,00000000200,a2f,recvmsg
0,01642144700,01642151800,00000007100,a07,poll
0,01642153200,01642153400,00000000200,a2f,recvmsg
0,01642153700,01642153900,00000000200,a2f,recvmsg
0,01642157400,01642164200,00000006800,a07,poll
0,01642165400,01642165600,00000000200,a2f,recvmsg
0,01642165800,01642166000,00000000200,a2f,recvmsg
0,01642170400,01642177600,00000007200,a07,poll
0,01642178800,01642178900,00000000100,a2f,recvmsg
0,01642179100,01642179300,00000000200,a2f,recvmsg
0,01642182600,01642189500,00000006900,a07,poll
0,01642190600,01642190800,00000000200,a2f,recvmsg
0,01642191100,01642191300,00000000200,a2f,recvmsg
0,01642194500,01642201400,00000006900,a07,poll
0,01642202500,01642202600,00000000100,a2f,recvmsg
0,01642203000,01642203100,00000000100,a2f,recvmsg
0,01642207100,01642214000,00000006900,a07,poll
0,01642215100,01642215300,00000000200,a2f,recvmsg
0,01642215600,01642215800,00000000200,a2f,recvmsg
0,01642218900,01642225800,00000006900,a07,poll
0,01642226900,01642227100,00000000200,a2f,recvmsg
0,01642227400,01642227600,00000000200,a2f,recvmsg
0,01642230800,01642237900,00000007100,a07,poll
0,01642239000,01642239200,00000000200,a2f,recvmsg
0,01642239500,01642239700,00000000200,a2f,recvmsg
0,01642242800,01642249800,00000007000,a07,poll
0,01642251000,01642251100,00000000100,a2f,recvmsg
0,01642251400,01642251600,00000000200,a2f,recvmsg
0,01642254200,01642261200,00000007000,a07,poll
0,01642262400,01642262500,00000000100,a2f,recvmsg
0,01642262700,01642262900,00000000200,a2f,recvmsg
0,01642267700,01642274300,00000006600,a07,poll
0,01642275600,01642275700,00000000100,a2f,recvmsg
0,01642275900,01642276100,00000000200,a2f,recvmsg
0,01642278800,01642285600,00000006800,a07,poll
0,01642286800,01642286900,00000000100,a2f,recvmsg
0,01642287200,01642287300,00000000100,a2f,recvmsg
0,01642290100,01642296900,00000006800,a07,poll
0,01642298300,01642298500,00000000200,a2f,recvmsg
0,01642298700,01642298900,00000000200,a2f,recvmsg
0,01642301600,01642308500,00000006900,a07,poll
0,01642309700,01642309800,00000000100,a2f,recvmsg
0,01642310000,01642310200,00000000200,a2f,recvmsg
0,01642313400,01642320200,00000006800,a07,poll
0,01642321400,01642321400,00000000000,a2f,recvmsg
0,01642321700,01642321900,00000000200,a2f,recvmsg
0,01642324700,01642331400,00000006700,a07,poll
0,01642332600,01642332800,00000000200,a2f,recvmsg
0,01642333000,01642333100,00000000100,a2f,recvmsg
0,01642336500,01642343100,00000006600,a07,poll
0,01642344200,01642344300,00000000100,a2f,recvmsg
0,01642344600,01642344800,00000000200,a2f,recvmsg
0,01642348000,01642354900,00000006900,a07,poll
0,01642355900,01642356100,00000000200,a2f,recvmsg
0,01642356400,01642356600,00000000200,a2f,recvmsg
0,01642360500,01642367700,00000007200,a07,poll
0,01642368900,01642369000,00000000100,a2f,recvmsg
0,01642369300,01642369500,00000000200,a2f,recvmsg
1,48555347200,01609504900,-46945842300,a4a,fsync
1,01609567100,01609572100,00000005000,a09,mmap
1,01606754700,01609653000,00002898300,a07,poll
1,01609657300,01609658800,00000001500,aca,futex
1,01609663000,01609663800,00000000800,aca,futex
1,01609665900,01609666900,00000001000,aca,futex
1,01609686000,01609686100,00000000100,a00,read
1,01594138200,01609694800,00015556600,ae8,epoll_wait
1,01609723600,01609723800,00000000200,a2f,recvmsg
1,01609691100,01609805800,00000114700,a07,poll
1,01609807400,01609808400,00000001000,aca,futex
1,01609810100,01609811100,00000001000,aca,futex
1,01609812300,01609813100,00000000800,aca,futex
1,01609815600,01609817500,00000001900,a2e,sendmsg
1,01609751000,01609825100,00000074100,ae8,epoll_wait
1,01609828200,01609829300,00000001100,a2f,recvmsg
1,01609837700,01609837800,00000000100,a2f,recvmsg
1,01609859800,01609860900,00000001100,a2e,sendmsg
1,01610021500,01610030500,00000009000,a01,write
1,01609881300,01610068000,00000186700,a07,poll
1,01610242600,01610243600,00000001000,a2f,recvmsg
1,01610246100,01610246400,00000000300,a00,read
1,01610304200,01610308000,00000003800,a07,poll
1,01610408000,01610408300,00000000300,a00,read
1,01610445700,01610449100,00000003400,a07,poll
1,01610453400,01610457200,00000003800,a2e,sendmsg
1,01609863200,01610459100,00000595900,ae8,epoll_wait
1,01610464000,01610465200,00000001200,a2f,recvmsg
1,01610475100,01610475300,00000000200,a2f,recvmsg
1,01610489800,01610491900,00000002100,a2e,sendmsg
1,01610445700,01610493600,00000047900,a07,poll
1,01610494400,01610494800,00000000400,a00,read
1,01610503700,01610504400,00000000700,a2f,recvmsg
1,01610582500,01610582700,00000000200,a00,read
1,55967216300,01614395500,-54352820800,a3d,wait4
1,01614415800,01614417400,00000001600,a00,read
1,01614419300,01614419700,00000000400,a00,read
1,01614437300,01614482300,00000045000,a07,poll
1,01614486700,01614487000,00000000300,a2f,recvmsg
1,01614487700,01614487900,00000000200,a2f,recvmsg
1,01614492800,01614504600,00000011800,a07,poll
1,01614506800,01614507000,00000000200,a2f,recvmsg
1,01614507400,01614507600,00000000200,a2f,recvmsg
1,01614511000,01614522700,00000011700,a07,poll
1,01614524700,01614524900,00000000200,a2f,recvmsg
1,01614525300,01614525400,00000000100,a2f,recvmsg
1,01614530200,01614541900,00000011700,a07,poll
1,01614543900,01614544100,00000000200,a2f,recvmsg
1,01614544400,01614544600,00000000200,a2f,recvmsg
1,01614549500,01614561300,00000011800,a07,poll
1,01614563300,01614563400,00000000100,a2f,recvmsg
1,01614563800,01614564000,00000000200,a2f,recvmsg
1,01614567300,01614574200,00000006900,a07,poll
1,01614575400,01614575600,00000000200,a2f,recvmsg
1,01614575900,01614576100,00000000200,a2f,recvmsg
1,01614576700,01614576800,00000000100,a08,lseek
1,01614585700,01614585800,00000000100,a08,lseek
1,01614588600,01614595700,00000007100,a07,poll
1,01614597000,01614597200,00000000200,a2f,recvmsg
1,01614597600,01614597600,00000000000,a2f,recvmsg
1,01614602800,01614609500,00000006700,a07,poll
1,01614610900,01614610900,00000000000,a2f,recvmsg
1,01614611200,01614611400,00000000200,a2f,recvmsg
1,01614614600,01614621200,00000006600,a07,poll
1,01614622400,01614622600,00000000200,a2f,recvmsg
1,01614622900,01614623100,00000000200,a2f,recvmsg
1,01614626500,01614633000,00000006500,a07,poll
1,01614634200,01614634300,00000000100,a2f,recvmsg
1,01614634600,01614634800,00000000200,a2f,recvmsg
1,01614638100,01614645000,00000006900,a07,poll
1,01614646200,01614646400,00000000200,a2f,recvmsg
1,01614646700,01614646900,00000000200,a2f,recvmsg
1,01614650900,01614657600,00000006700,a07,poll
1,01614658800,01614658900,00000000100,a2f,recvmsg
1,01614659200,01614659400,00000000200,a2f,recvmsg
1,01614663400,01614670000,00000006600,a07,poll
1,01614671300,01614671400,00000000100,a2f,recvmsg
1,01614671700,01614671800,00000000100,a2f,recvmsg
1,01614674900,01614681500,00000006600,a07,poll
1,01614682700,01614682900,00000000200,a2f,recvmsg
1,01614683100,01614683300,00000000200,a2f,recvmsg
1,01614687600,01614694700,00000007100,a07,poll
1,01614696000,01614696200,00000000200,a2f,recvmsg
1,01614696400,01614696600,00000000200,a2f,recvmsg
1,01614699900,01614706600,00000006700,a07,poll
1,01614707800,01614707900,00000000100,a2f,recvmsg
1,01614708200,01614708400,00000000200,a2f,recvmsg
1,01614711600,01614718300,00000006700,a07,poll
1,01614719500,01614719600,00000000100,a2f,recvmsg
1,01614720000,01614720200,00000000200,a2f,recvmsg
1,01614723200,01614729900,00000006700,a07,poll
1,01614731000,01614731200,00000000200,a2f,recvmsg
1,01614731500,01614731700,00000000200,a2f,recvmsg
1,01614734500,01614741200,00000006700,a07,poll
1,01614742400,01614742600,00000000200,a2f,recvmsg
1,01614742900,01614743100,00000000200,a2f,recvmsg
1,01614746200,01614752900,00000006700,a07,poll
1,01614754000,01614754200,00000000200,a2f,recvmsg
1,01614754500,01614754700,00000000200,a2f,recvmsg
1,01614757600,01614764400,00000006800,a07,poll
1,01614765500,01614765700,00000000200,a2f,recvmsg
1,01614766000,01614766200,00000000200,a2f,recvmsg
1,01614768800,01614775700,00000006900,a07,poll
1,01614776700,01614776900,00000000200,a2f,recvmsg
1,01614777200,01614777400,00000000200,a2f,recvmsg
1,01614782200,01614789000,00000006800,a07,poll
1,01614790200,01614790300,00000000100,a2f,recvmsg
1,01614790600,01614790800,00000000200,a2f,recvmsg
1,01614793300,01614800200,00000006900,a07,poll
1,01614801300,01614801500,00000000200,a2f,recvmsg
1,01614801800,01614802000,00000000200,a2f,recvmsg
1,01614804700,01614811200,00000006500,a07,poll
1,01614812300,01614812400,00000000100,a2f,recvmsg
1,01614812700,01614812900,00000000200,a2f,recvmsg
1,01614815600,01614822500,00000006900,a07,poll
1,01614823700,01614823800,00000000100,a2f,recvmsg
1,01614824100,01614824200,00000000100,a2f,recvmsg
1,01614827400,01614834000,00000006600,a07,poll
1,01614835100,01614835200,00000000100,a2f,recvmsg
1,01614835500,01614835700,00000000200,a2f,recvmsg
1,01614838500,01614845100,00000006600,a07,poll
1,01614846300,01614846400,00000000100,a2f,recvmsg
1,01614846600,01614846800,00000000200,a2f,recvmsg
1,01614850300,01614857200,00000006900,a07,poll
1,01614858300,01614858500,00000000200,a2f,recvmsg
1,01614858800,01614859000,00000000200,a2f,recvmsg
1,01614862100,01614869200,00000007100,a07,poll
1,01614870300,01614870500,00000000200,a2f,recvmsg
1,01614870800,01614871000,00000000200,a2f,recvmsg
1,01614874600,01614881500,00000006900,a07,poll
1,01614882600,01614882800,00000000200,a2f,recvmsg
1,01614883100,01614883300,00000000200,a2f,recvmsg
1,01614886700,01614893500,00000006800,a07,poll
1,01614894500,01614894700,00000000200,a2f,recvmsg
1,01614895000,01614895200,00000000200,a2f,recvmsg
1,01614898500,01614905500,00000007000,a07,poll
1,01614906600,01614906800,00000000200,a2f,recvmsg
1,01614907100,01614907300,00000000200,a2f,recvmsg
1,01614912500,01614919200,00000006700,a07,poll
1,01614920600,01614920600,00000000000,a2f,recvmsg
1,01614920900,01614921100,00000000200,a2f,recvmsg
1,01614924100,01614930800,00000006700,a07,poll
1,01614932000,01614932100,00000000100,a2f,recvmsg
1,01614932400,01614932600,00000000200,a2f,recvmsg
1,01614935600,01614942400,00000006800,a07,poll
1,01614943500,01614943600,00000000100,a2f,recvmsg
1,01614943900,01614944100,00000000200,a2f,recvmsg
1,01614947800,01614954600,00000006800,a07,poll
1,01614955700,01614955900,00000000200,a2f,recvmsg
1,01614956200,01614956400,00000000200,a2f,recvmsg
1,01614960400,01614967100,00000006700,a07,poll
1,01614968200,01614968400,00000000200,a2f,recvmsg
1,01614968700,01614968900,00000000200,a2f,recvmsg
1,01614972600,01614979500,00000006900,a07,poll
1,01614980700,01614980800,00000000100,a2f,recvmsg
1,01614981100,01614981300,00000000200,a2f,recvmsg
1,01614984600,01614991400,00000006800,a07,poll
1,01614992600,01614992800,00000000200,a2f,recvmsg
1,01614993000,01614993200,00000000200,a2f,recvmsg
1,01614996300,01615002900,00000006600,a07,poll
1,01615004100,01615004200,00000000100,a2f,recvmsg
1,01615004500,01615004700,00000000200,a2f,recvmsg
1,01615007500,01615014000,00000006500,a07,poll
1,01615015200,01615015400,00000000200,a2f,recvmsg
1,01615015600,01615015800,00000000200,a2f,recvmsg
1,01615019100,01615025800,00000006700,a07,poll
1,01615027000,01615027100,00000000100,a2f,recvmsg
1,01615027400,01615027600,00000000200,a2f,recvmsg
1,01615028600,01615028700,00000000100,a08,lseek
1,01615031500,01615032500,00000001000,a00,read
1,01615036200,01615036300,00000000100,a08,lseek
1,01615039100,01615045800,00000006700,a07,poll
1,01615047200,01615047400,00000000200,a2f,recvmsg
1,01615047700,01615047900,00000000200,a2f,recvmsg
1,01615072400,01615079000,00000006600,a07,poll
1,01615080200,01615080400,00000000200,a2f,recvmsg
1,01615080700,01615080900,00000000200,a2f,recvmsg
1,01615084700,01615085600,00000000900,a00,read
1,01615091000,01615091200,00000000200,a08,lseek
1,01615094300,01615101100,00000006800,a07,poll
1,01615102300,01615102500,00000000200,a2f,recvmsg
1,01615102800,01615103000,00000000200,a2f,recvmsg
1,01615105800,01615112400,00000006600,a07,poll
1,01615113500,01615113600,00000000100,a2f,recvmsg
1,01615114000,01615114200,00000000200,a2f,recvmsg
1,01615116800,01615123500,00000006700,a07,poll
1,01615124600,01615124800,00000000200,a2f,recvmsg
1,01615125100,01615125300,00000000200,a2f,recvmsg
1,01615128000,01615134700,00000006700,a07,poll
1,01615135800,01615135900,00000000100,a2f,recvmsg
1,01615136300,01615136500,00000000200,a2f,recvmsg
1,01615139100,01615145900,00000006800,a07,poll
1,01615147000,01615147100,00000000100,a2f,recvmsg
1,01615147500,01615147700,00000000200,a2f,recvmsg
1,01615150300,01615156900,00000006600,a07,poll
1,01615158100,01615158200,00000000100,a2f,recvmsg
1,01615158500,01615158700,00000000200,a2f,recvmsg
1,01615161300,01615167800,00000006500,a07,poll
1,01615169000,01615169200,00000000200,a2f,recvmsg
1,01615169500,01615169600,00000000100,a2f,recvmsg
1,01615173100,01615179800,00000006700,a07,poll
1,01615180900,01615181100,00000000200,a2f,recvmsg
1,01615181400,01615181600,00000000200,a2f,recvmsg
1,01615184500,01615191200,00000006700,a07,poll
1,01615192300,01615192500,00000000200,a2f,recvmsg
1,01615192800,01615193000,00000000200,a2f,recvmsg
1,01615193400,01615193500,00000000100,a08,lseek
1,01615197500,01615204100,00000006600,a07,poll
1,01615205300,01615205400,00000000100,a2f,recvmsg
1,01615205700,01615205800,00000000100,a2f,recvmsg
1,01615211100,01615217800,00000006700,a07,poll
1,01615219000,01615219200,00000000200,a2f,recvmsg
1,01615219500,01615219700,00000000200,a2f,recvmsg
1,01615223300,01615229700,00000006400,a07,poll
1,01615230900,01615231100,00000000200,a2f,recvmsg
1,01615231400,01615231600,00000000200,a2f,recvmsg
1,01615234600,01615241300,00000006700,a07,poll
1,01615242400,01615242500,00000000100,a2f,recvmsg
1,01615242800,01615243000,00000000200,a2f,recvmsg
1,01615246000,01615252600,00000006600,a07,poll
1,01615253800,01615253900,00000000100,a2f,recvmsg
1,01615254300,01615254500,00000000200,a2f,recvmsg
1,01615257300,01615264100,00000006800,a07,poll
1,01615265200,01615265300,00000000100,a2f,recvmsg
1,01615265600,01615265800,00000000200,a2f,recvmsg
1,01615269100,01615275900,00000006800,a07,poll
1,01615277000,01615277200,00000000200,a2f,recvmsg
1,01615277500,01615277700,00000000200,a2f,recvmsg
1,01615280500,01615287300,00000006800,a07,poll
1,01615288400,01615288500,00000000100,a2f,recvmsg
1,01615288900,01615289100,00000000200,a2f,recvmsg
1,01615292000,01615298600,00000006600,a07,poll
1,01615299600,01615299800,00000000200,a2f,recvmsg
1,01615300100,01615300300,00000000200,a2f,recvmsg
1,01615303100,01615309900,00000006800,a07,poll
1,01615311000,01615311100,00000000100,a2f,recvmsg
1,01615311500,01615311700,00000000200,a2f,recvmsg
1,01615314600,01615321400,00000006800,a07,poll
1,01615322500,01615322700,00000000200,a2f,recvmsg
1,01615323000,01615323200,00000000200,a2f,recvmsg
1,01615326200,01615332900,00000006700,a07,poll
1,01615334000,01615334200,00000000200,a2f,recvmsg
1,01615334500,01615334700,00000000200,a2f,recvmsg
1,01615338200,01615344900,00000006700,a07,poll
1,01615346000,01615346200,00000000200,a2f,recvmsg
1,01615346400,01615346600,00000000200,a2f,recvmsg
1,01615349500,01615356100,00000006600,a07,poll
1,01615357200,01615357400,00000000200,a2f,recvmsg
1,01615357600,01615357800,00000000200,a2f,recvmsg
1,01615360800,01615367300,00000006500,a07,poll
1,01615368500,01615368700,00000000200,a2f,recvmsg
1,01615369000,01615369100,00000000100,a2f,recvmsg
1,01615372100,01615378600,00000006500,a07,poll
1,01615379800,01615379900,00000000100,a2f,recvmsg
1,01615380200,01615380400,00000000200,a2f,recvmsg
1,01615388800,01615395700,00000006900,a07,poll
1,01615396900,01615397100,00000000200,a2f,recvmsg
1,01615397400,01615397500,00000000100,a2f,recvmsg
1,01615400700,01615407200,00000006500,a07,poll
1,01615408400,01615408600,00000000200,a2f,recvmsg
1,01615408900,01615409000,00000000100,a2f,recvmsg
1,01615412100,01615418600,00000006500,a07,poll
1,01615419800,01615420000,00000000200,a2f,recvmsg
1,01615420300,01615420400,00000000100,a2f,recvmsg
1,01615423600,01615430200,00000006600,a07,poll
1,01615431300,01615431500,00000000200,a2f,recvmsg
1,01615431700,01615431900,00000000200,a2f,recvmsg
1,01615435100,01615441700,00000006600,a07,poll
1,01615442900,01615443100,00000000200,a2f,recvmsg
1,01615443300,01615443500,00000000200,a2f,recvmsg
1,01615488800,01615493000,00000004200,a14,writev
1,01615493600,01615592200,00000098600,a07,poll
1,01615493600,01615596000,00000102400,a07,poll
1,01615626300,01615626500,00000000200,a2f,recvmsg
1,01615630600,01615630800,00000000200,a2f,recvmsg
1,01615631100,01615631200,00000000100,a2f,recvmsg
1,01615635400,01615635600,00000000200,a2f,recvmsg
1,01615635800,01615636000,00000000200,a2f,recvmsg
1,01615640700,01615641500,00000000800,a00,read
1,01615651700,01615652000,00000000300,a2f,recvmsg
1,01615689200,01615745800,00000056600,a07,poll
1,01615747000,01615801000,00000054000,a07,poll
1,01615802100,01615857600,00000055500,a07,poll
1,01615858600,01615913800,00000055200,a07,poll
1,01615914700,01615969400,00000054700,a07,poll
1,01615970400,01616014300,00000043900,a07,poll
1,01616015300,01616058100,00000042800,a07,poll
1,01616059200,01616101200,00000042000,a07,poll
1,01616102300,01616145200,00000042900,a07,poll
1,01616147700,01616189000,00000041300,a07,poll
1,01616190100,01616242600,00000052500,a07,poll
1,01616243600,01616261500,00000017900,a07,poll
1,01616262600,01616277700,00000015100,a07,poll
1,01616278800,01616293000,00000014200,a07,poll
1,01616294200,01616308500,00000014300,a07,poll
1,01616309600,01616323700,00000014100,a07,poll
1,01616325000,01616329300,00000004300,a07,poll
1,01616331900,01616332100,00000000200,a2f,recvmsg
1,01616332600,01616332700,00000000100,a2f,recvmsg
1,01616325000,01616352800,00000027800,a07,poll
1,01616353300,01616354900,00000001600,a2f,recvmsg
1,01616358400,01616359800,00000001400,a2d,recvfrom
1,01616364100,01616364400,00000000300,a2f,recvmsg
1,01616364800,01616365000,00000000200,a2f,recvmsg
1,01616421800,01616422100,00000000300,a2f,recvmsg
1,01616424400,01616424600,00000000200,a2f,recvmsg
1,01616437100,01616549600,00000112500,a07,poll
1,01616550400,01616552100,00000001700,a2f,recvmsg
1,01616558100,01616558900,00000000800,a2d,recvfrom
1,01616559900,01616560100,00000000200,a2f,recvmsg
1,01616560700,01616560900,00000000200,a2f,recvmsg
1,01616592900,01616593200,00000000300,a2f,recvmsg
1,01616595300,01616595400,00000000100,a2f,recvmsg
1,01616598500,01616601000,00000002500,a07,poll
1,01616603500,01616603700,00000000200,a2f,recvmsg
1,01616604200,01616604400,00000000200,a2f,recvmsg
1,01617082200,01617086300,00000004100,a09,mmap
1,01617246500,01617251400,00000004900,a02,open
1,01617258900,01617261000,00000002100,a00,read
1,01617311800,01617312600,00000000800,a00,read
1,01617361100,01617361900,00000000800,a00,read
1,01617407500,01617408200,00000000700,a00,read
1,01617455700,01617456400,00000000700,a00,read
1,01617502200,01617502800,00000000600,a00,read
1,01617547100,01617547800,00000000700,a00,read
1,01617593900,01617594600,00000000700,a00,read
1,01617643000,01617643700,00000000700,a00,read
1,01617692100,01617692700,00000000600,a00,read
1,01617740100,01617740700,00000000600,a00,read
1,01617767300,01617769300,00000002000,a02,open
1,01617772400,01617773400,00000001000,a00,read
1,01617827000,01617827800,00000000800,a00,read
1,01617909900,01617910900,00000001000,a00,read
1,01617981800,01617982800,00000001000,a00,read
1,01618058700,01618059400,00000000700,a00,read
1,01618137100,01618137700,00000000600,a00,read
1,01618213500,01618214300,00000000800,a00,read
1,01618297200,01618298000,00000000800,a00,read
1,01618363100,01618363700,00000000600,a00,read
1,01618420700,01618421500,00000000800,a00,read
1,01618498400,01618520300,00000021900,a07,poll
1,01618524000,01618524200,00000000200,a2f,recvmsg
1,01618524800,01618524900,00000000100,a2f,recvmsg
1,01618527900,01618535500,00000007600,a07,poll
1,01618536700,01618536800,00000000100,a2f,recvmsg
1,01618537100,01618537300,00000000200,a2f,recvmsg
1,01618541600,01618546300,00000004700,a06,lstat
1,01618547200,01618548000,00000000800,a06,lstat
1,01618565000,01618575900,00000010900,a01,write
1,01618581200,01618587900,00000006700,a07,poll
1,01618589800,01618590000,00000000200,a2f,recvmsg
1,01618590400,01618590600,00000000200,a2f,recvmsg
1,01618592100,01618914700,00000322600,a38,clone
1,01619413400,01619413600,00000000200,a0c,brk
1,01619424400,01619427200,00000002800,a15,access
1,01619427900,01619428800,00000000900,a09,mmap
1,01619432300,01619434600,00000002300,a15,access
1,01619440700,01619441900,00000001200,a09,mmap
1,01619445400,01619446000,00000000600,a15,access
1,01619453300,01619454400,00000001100,a00,read
1,01619455900,01619457500,00000001600,a09,mmap
1,01619461800,01619464000,00000002200,a09,mmap
1,01619475500,01619476200,00000000700,a15,access
1,01619479600,01619480400,00000000800,a00,read
1,01619483900,01619485000,00000001100,a09,mmap
1,01619493100,01619493700,00000000600,a15,access
1,01619496600,01619497300,00000000700,a00,read
1,01619497800,01619498600,00000000800,a09,mmap
1,01619500100,01619501900,00000001800,a09,mmap
1,01619506100,01619509100,00000003000,a09,mmap
1,01619511200,01619512400,00000001200,a09,mmap
1,01619520900,01619521500,00000000600,a15,access
1,01619524100,01619524700,00000000600,a00,read
1,01619525400,01619526900,00000001500,a09,mmap
1,01619529300,01619531100,00000001800,a09,mmap
1,01619539400,01619539900,00000000500,a15,access
1,01619543100,01619543700,00000000600,a00,read
1,01619544300,01619545700,00000001400,a09,mmap
1,01619548900,01619550900,00000002000,a09,mmap
1,01619559100,01619559900,00000000800,a15,access
1,01619562500,01619563100,00000000600,a00,read
1,01619563600,01619564600,00000001000,a09,mmap
1,01619566000,01619567300,00000001300,a09,mmap
1,01619569700,01619571000,00000001300,a09,mmap
1,01619577300,01619577800,00000000500,a15,access
1,01619580000,01619580600,00000000600,a00,read
1,01619581300,01619582600,00000001300,a09,mmap
1,01619584500,01619586300,00000001800,a09,mmap
1,01619600800,01619601400,00000000600,a09,mmap
1,01619622300,01619622800,00000000500,a09,mmap
1,01619624000,01619624300,00000000300,a09,mmap
1,01619805600,01619805700,00000000100,a0c,brk
1,01619805800,01619806700,00000000900,a0c,brk
1,01619842000,01619847800,00000005800,a00,read
1,01619859700,01619861700,00000002000,a00,read
1,01619899200,01619900100,00000000900,a00,read
1,01620022900,01620023700,00000000800,a00,read
1,01620094300,01620094700,00000000400,a00,read
1,01620180200,01620180900,00000000700,a00,read
1,01620311900,01620312700,00000000800,a00,read
1,01620440500,01620441200,00000000700,a00,read
1,01620596900,01620597600,00000000700,a00,read
1,01620747800,01620748400,00000000600,a00,read
1,01620785200,01620786600,00000001400,a0c,brk
1,01620901800,01620902800,00000001000,a00,read
1,01621051100,01621051800,00000000700,a00,read
1,01621207000,01621207800,00000000800,a00,read
1,01621366800,01621367400,00000000600,a00,read
1,01621475300,01621475900,00000000600,a00,read
1,01621506500,01621507200,00000000700,a0c,brk
1,01621615200,01621616000,00000000800,a00,read
1,01621857300,01621857800,00000000500,a00,read
1,01621870100,01621870600,00000000500,a00,read
1,01621915300,01621915700,00000000400,a00,read
1,01621935700,01621936400,00000000700,a00,read
1,01622142200,01622142600,00000000400,a00,read
1,01622172300,01622173100,00000000800,a00,read
1,01622270100,01622271100,00000001000,a00,read
1,01622294700,01622296000,00000001300,a0c,brk
1,01622340900,01622341300,00000000400,a00,read
1,01622417800,01622418700,00000000900,a00,read
1,01622572700,01622573200,00000000500,a00,read
1,01622684200,01622684900,00000000700,a00,read
1,01622778700,01622779200,00000000500,a00,read
1,01622791000,01622791500,00000000500,a00,read
1,01622871400,01622871800,00000000400,a00,read
1,01622895600,01622895900,00000000300,a00,read
1,01622917700,01622918200,00000000500,a00,read
1,01623019900,01623020900,00000001000,a0c,brk
1,01623022600,01623023700,00000001100,a00,read
1,01623226900,01623227300,00000000400,a00,read
1,01623310100,01623310800,00000000700,a00,read
1,01623375300,01623375900,00000000600,a00,read
1,01623503800,01623504200,00000000400,a00,read
1,01623536400,01623537000,00000000600,a00,read
1,01623552900,01623554500,00000001600,a02,open
1,01623674500,01623675100,00000000600,a00,read
1,01623746100,01623746500,00000000400,a00,read
1,01623798700,01623799900,00000001200,a0c,brk
1,01623806000,01623806700,00000000700,a00,read
1,01623915400,01623916100,00000000700,a00,read
1,01624065500,01624066500,00000001000,a00,read
1,01624196500,01624197200,00000000700,a00,read
1,01624254300,01624255100,00000000800,a00,read
1,01624311200,01624312000,00000000800,a00,read
1,01624382500,01624383100,00000000600,a00,read
1,01624436200,01624436900,00000000700,a00,read
1,01624525100,01624525800,00000000700,a0c,brk
1,01624559300,01624563100,00000003800,a0c,brk
1,01624577500,01624578300,00000000800,a00,read
1,01624692700,01624693600,00000000900,a00,read
1,01624852500,01624853300,00000000800,a00,read
1,01624970000,01624970700,00000000700,a00,read
1,01625116600,01625117300,00000000700,a00,read
1,01625233800,01625234400,00000000600,a00,read
1,01625396400,01625397100,00000000700,a00,read
1,01625402000,01625402800,00000000800,a0c,brk
1,01625517500,01625518200,00000000700,a00,read
1,01625637400,01625638100,00000000700,a00,read
1,01625779600,01625780300,00000000700,a00,read
1,01625911100,01625911800,00000000700,a00,read
1,01626004700,01626005300,00000000600,a00,read
1,01626118100,01626118900,00000000800,a00,read
1,01626244200,01626244800,00000000600,a00,read
1,01626357200,01626357800,00000000600,a0c,brk
1,01626380700,01626381400,00000000700,a00,read
1,01626551000,01626551700,00000000700,a00,read
1,01626701200,01626702000,00000000800,a00,read
1,01626812200,01626812800,00000000600,a00,read
1,01626979600,01626980400,00000000800,a00,read
1,01627056500,01627057200,00000000700,a00,read
1,01627138000,01627138800,00000000800,a00,read
1,01627205100,01627205800,00000000700,a0c,brk
1,01627219000,01627219500,00000000500,a00,read
1,01627293100,01627293700,00000000600,a00,read
1,01627394100,01627394700,00000000600,a00,read
1,01627496600,01627497100,00000000500,a00,read
1,01627586100,01627586800,00000000700,a00,read
1,01627675000,01627675700,00000000700,a00,read
1,01627775900,01627776500,00000000600,a00,read
1,01627856600,01627856900,00000000300,a0c,brk
1,01627860900,01627861500,00000000600,a00,read
1,01627968200,01627968900,00000000700,a00,read
1,01628061000,01628061600,00000000600,a00,read
1,01628179700,01628180400,00000000700,a00,read
1,01628293200,01628294000,00000000800,a00,read
1,01628396100,01628396800,00000000700,a00,read
1,01628858800,01628862400,00000003600,a57,unlink
1,01628885700,01628886400,00000000700,a48,fcntl
1,01628936800,01628952800,00000016000,a01,write
1,01628970700,01628974900,00000004200,a01,write
1,01628991200,01628993700,00000002500,a01,write
1,01595680600,01629239300,00033558700,a17,select
1,01629264200,01629264500,00000000300,a2f,recvmsg
1,01629268100,01629295500,00000027400,a17,select
1,01629299600,01629299800,00000000200,a2f,recvmsg
1,01629300300,01629319200,00000018900,a17,select
1,01629322900,01629323100,00000000200,a2f,recvmsg
1,01629323600,01629340700,00000017100,a17,select
1,01629344400,01629344600,00000000200,a2f,recvmsg
1,01629345200,01629361600,00000016400,a17,select
1,01629365600,01629365800,00000000200,a2f,recvmsg
1,01629366300,01629381000,00000014700,a17,select
1,01629384300,01629384500,00000000200,a2f,recvmsg
1,01629385000,01629413100,00000028100,a17,select
1,01629417100,01629417200,00000000100,a2f,recvmsg
1,01629417700,01629427400,00000009700,a17,select
1,01629431000,01629431200,00000000200,a2f,recvmsg
1,01629431700,01629439000,00000007300,a17,select
1,01629442800,01629443000,00000000200,a2f,recvmsg
1,01629443500,01629451300,00000007800,a17,select
1,01629454700,01629454900,00000000200,a2f,recvmsg
1,01629455400,01629463600,00000008200,a17,select
1,01629467400,01629467600,00000000200,a2f,recvmsg
1,01629468100,01629475700,00000007600,a17,select
1,01629479200,01629479400,00000000200,a2f,recvmsg
1,01629479900,01629487300,00000007400,a17,select
1,01629491300,01629491400,00000000100,a2f,recvmsg
1,01629491900,01629499200,00000007300,a17,select
1,01629502700,01629502900,00000000200,a2f,recvmsg
1,01629503300,01629511800,00000008500,a17,select
1,01629515900,01629516100,00000000200,a2f,recvmsg
1,01629516500,01629524100,00000007600,a17,select
1,01629527800,01629527800,00000000000,a2f,recvmsg
1,01629528400,01629536400,00000008000,a17,select
1,01629540100,01629540300,00000000200,a2f,recvmsg
1,01629540900,01629548100,00000007200,a17,select
1,01629551700,01629551900,00000000200,a2f,recvmsg
1,01629552500,01629559800,00000007300,a17,select
1,01629563300,01629563400,00000000100,a2f,recvmsg
1,01629563900,01629571400,00000007500,a17,select
1,01629575000,01629575200,00000000200,a2f,recvmsg
1,01629575600,01629582900,00000007300,a17,select
1,01629586700,01629586700,00000000000,a2f,recvmsg
1,01629587300,01629594400,00000007100,a17,select
1,01629598200,01629598300,00000000100,a2f,recvmsg
1,01629598800,01629607600,00000008800,a17,select
1,01629611200,01629611400,00000000200,a2f,recvmsg
1,01629611800,01629618800,00000007000,a17,select
1,01629622500,01629622600,00000000100,a2f,recvmsg
1,01629623100,01629630200,00000007100,a17,select
1,01629633800,01629634000,00000000200,a2f,recvmsg
1,01629634400,01629641400,00000007000,a17,select
1,01629644900,01629645100,00000000200,a2f,recvmsg
1,01629645600,01629652700,00000007100,a17,select
1,01629656300,01629656500,00000000200,a2f,recvmsg
1,01629657000,01629664100,00000007100,a17,select
1,01629667600,01629667800,00000000200,a2f,recvmsg
1,01629668300,01629675800,00000007500,a17,select
1,01629679400,01629679600,00000000200,a2f,recvmsg
1,01629680000,01629687600,00000007600,a17,select
1,01629691200,01629691400,00000000200,a2f,recvmsg
1,01629691900,01629700100,00000008200,a17,select
1,01629703900,01629704100,00000000200,a2f,recvmsg
1,01629704500,01629712500,00000008000,a17,select
1,01629716000,01629716200,00000000200,a2f,recvmsg
1,01629716700,01629724200,00000007500,a17,select
1,01629728000,01629728200,00000000200,a2f,recvmsg
1,01629728700,01629738300,00000009600,a17,select
1,01629742000,01629742100,00000000100,a2f,recvmsg
1,01629742500,01629749800,00000007300,a17,select
1,01629753300,01629753500,00000000200,a2f,recvmsg
1,01629753900,01629761200,00000007300,a17,select
1,01629764900,01629765100,00000000200,a2f,recvmsg
1,01629765500,01629773500,00000008000,a17,select
1,01629777200,01629777400,00000000200,a2f,recvmsg
1,01629777900,01629786400,00000008500,a17,select
1,01629790000,01629790200,00000000200,a2f,recvmsg
1,01629790700,01629798600,00000007900,a17,select
1,01629802400,01629802600,00000000200,a2f,recvmsg
1,01629803100,01629810700,00000007600,a17,select
1,01629814400,01629814500,00000000100,a2f,recvmsg
1,01629815000,01629822200,00000007200,a17,select
1,01629825900,01629826100,00000000200,a2f,recvmsg
1,01629826500,01629833700,00000007200,a17,select
1,01629837300,01629837500,00000000200,a2f,recvmsg
1,01629837900,01629846300,00000008400,a17,select
1,01629850100,01629850300,00000000200,a2f,recvmsg
1,01629850800,01629866400,00000015600,a17,select
1,01629869900,01629870000,00000000100,a2f,recvmsg
1,01629870600,01629901400,00000030800,a17,select
1,01629905100,01629905200,00000000100,a2f,recvmsg
1,01629905800,01629923500,00000017700,a17,select
1,01629927000,01629927200,00000000200,a2f,recvmsg
1,01629927700,01629934800,00000007100,a17,select
1,01629938300,01629938400,00000000100,a2f,recvmsg
1,01629939000,01629945900,00000006900,a17,select
1,01629949500,01629949600,00000000100,a2f,recvmsg
1,01629950000,01629957200,00000007200,a17,select
1,01629960700,01629960900,00000000200,a2f,recvmsg
1,01629961300,01629968400,00000007100,a17,select
1,01629971900,01629972000,00000000100,a2f,recvmsg
1,01629972400,01629979400,00000007000,a17,select
1,01629983100,01629983200,00000000100,a2f,recvmsg
1,01629983800,01629990700,00000006900,a17,select
1,01629994200,01629994400,00000000200,a2f,recvmsg
1,01629994900,01630002400,00000007500,a17,select
1,01630006100,01630006300,00000000200,a2f,recvmsg
1,01630006700,01630014000,00000007300,a17,select
1,01630017400,01630017600,00000000200,a2f,recvmsg
1,01630018000,01630026800,00000008800,a17,select
1,01630030400,01630030600,00000000200,a2f,recvmsg
1,01630031100,01630040300,00000009200,a17,select
1,01630044000,01630044200,00000000200,a2f,recvmsg
1,01630044600,01630052200,00000007600,a17,select
1,01630055800,01630056000,00000000200,a2f,recvmsg
1,01630056400,01630063700,00000007300,a17,select
1,01630067300,01630067400,00000000100,a2f,recvmsg
1,01630067900,01630075000,00000007100,a17,select
1,01630078700,01630078800,00000000100,a2f,recvmsg
1,01630079300,01630086400,00000007100,a17,select
1,01630090000,01630090200,00000000200,a2f,recvmsg
1,01630090600,01630098400,00000007800,a17,select
1,01630101900,01630102100,00000000200,a2f,recvmsg
1,01630102600,01630109600,00000007000,a17,select
1,01630113100,01630113300,00000000200,a2f,recvmsg
1,01630113800,01630120900,00000007100,a17,select
1,01630124500,01630124700,00000000200,a2f,recvmsg
1,01630125200,01630132500,00000007300,a17,select
1,01630136000,01630136200,00000000200,a2f,recvmsg
1,01630136700,01630144000,00000007300,a17,select
1,01630147500,01630147700,00000000200,a2f,recvmsg
1,01630148200,01630155400,00000007200,a17,select
1,01630158900,01630159100,00000000200,a2f,recvmsg
1,01630159600,01630167700,00000008100,a17,select
1,01630171300,01630171500,00000000200,a2f,recvmsg
1,01630171900,01630179200,00000007300,a17,select
1,01630182700,01630182900,00000000200,a2f,recvmsg
1,01630183300,01630190500,00000007200,a17,select
1,01630194000,01630194200,00000000200,a2f,recvmsg
1,01630194700,01630201900,00000007200,a17,select
1,01630205400,01630205600,00000000200,a2f,recvmsg
1,01630206100,01630218700,00000012600,a17,select
1,01630222400,01630222600,00000000200,a2f,recvmsg
1,01630223100,01630230400,00000007300,a17,select
1,01630233900,01630234100,00000000200,a2f,recvmsg
1,01630234600,01630241900,00000007300,a17,select
1,01630245400,01630245600,00000000200,a2f,recvmsg
1,01630246000,01630253400,00000007400,a17,select
1,01630256900,01630257100,00000000200,a2f,recvmsg
1,01630257500,01630265000,00000007500,a17,select
1,01630268600,01630268700,00000000100,a2f,recvmsg
1,01630269200,01630326400,00000057200,a17,select
1,01630327400,01630328500,00000001100,a2f,recvmsg
1,01630428700,01630433400,00000004700,a14,writev
1,01630514200,01630515900,00000001700,a14,writev
1,01630578200,01630579800,00000001600,a14,writev
1,01630638800,01630640200,00000001400,a14,writev
1,01630698600,01630700400,00000001800,a14,writev
1,01630759300,01630760700,00000001400,a14,writev
1,01630764100,01630764800,00000000700,a2f,recvmsg
1,01630814100,01630815400,00000001300,a14,writev
1,01630859400,01630860900,00000001500,a14,writev
1,01630905100,01630906700,00000001600,a14,writev
1,01630949800,01630951200,00000001400,a14,writev
1,01630994000,01630995300,00000001300,a14,writev
1,01631038200,01631039600,00000001400,a14,writev
1,01631063900,01631065700,00000001800,a2f,recvmsg
1,01631091500,01631093000,00000001500,a14,writev
1,01631111000,01631112900,00000001900,a14,writev
1,01631129100,01631130500,00000001400,a14,writev
1,01631146400,01631147800,00000001400,a14,writev
1,01631162000,01631163500,00000001500,a14,writev
1,01631178000,01631179500,00000001500,a14,writev
1,01631184500,01631184600,00000000100,a2f,recvmsg
1,01631185300,01631185600,00000000300,a14,writev
1,01631203500,01631205200,00000001700,a14,writev
1,01631205500,01631206900,00000001400,a14,writev
1,01631207400,01631207500,00000000100,a2f,recvmsg
1,01631219000,01631220600,00000001600,a14,writev
1,01631220700,01631221800,00000001100,a14,writev
1,01631222200,01631222300,00000000100,a2f,recvmsg
1,01618581200,01631230100,00012648900,a07,poll
1,01631235600,01631238100,00000002500,a2f,recvmsg
1,01631243600,01631243800,00000000200,a2f,recvmsg
1,01631247400,01631247600,00000000200,a2f,recvmsg
1,01631248000,01631248200,00000000200,a2f,recvmsg
1,01631252900,01631253000,00000000100,a2f,recvmsg
1,01631253200,01631253300,00000000100,a2f,recvmsg
1,01631254200,01631258900,00000004700,a07,poll
1,01631264600,01631270300,00000005700,a2f,recvmsg
1,01631283200,01631283400,00000000200,a2f,recvmsg
1,01631308200,01631312900,00000004700,a07,poll
1,01631318600,01631324200,00000005600,a2f,recvmsg
1,01631336600,01631336700,00000000100,a2f,recvmsg
1,01631222800,01631366700,00000143900,a17,select
1,01631382000,01631383400,00000001400,a14,writev
1,01631383900,01631384100,00000000200,a2f,recvmsg
1,01631400200,01631400400,00000000200,a2f,recvmsg
1,01631412700,01631413600,00000000900,a14,writev
1,01631414000,01631414200,00000000200,a2f,recvmsg
1,01631361200,01631418700,00000057500,a07,poll
1,01631422100,01631422200,00000000100,a2f,recvmsg
1,01631423800,01631424000,00000000200,a2f,recvmsg
1,01631424100,01631424200,00000000100,a2f,recvmsg
1,01631425500,01631425600,00000000100,a2f,recvmsg
1,01631425800,01631425900,00000000100,a2f,recvmsg
1,01631426300,01631427700,00000001400,a07,poll
1,01631428100,01631429200,00000001100,a2f,recvmsg
1,01631434600,01631435400,00000000800,a2d,recvfrom
1,01631436300,01631436500,00000000200,a2f,recvmsg
1,01631437200,01631437300,00000000100,a2f,recvmsg
1,01631466000,01631466200,00000000200,a2f,recvmsg
1,01631468100,01631468300,00000000200,a2f,recvmsg
1,01631471500,01632029100,00000557600,a07,poll
1,01632047200,01632052700,00000005500,a2e,sendmsg
1,01610575600,01632056100,00021480500,ae8,epoll_wait
1,01632069900,01632071400,00000001500,a2f,recvmsg
1,01632086200,01632086400,00000000200,a2f,recvmsg
1,01632146100,01632149700,00000003600,a2e,sendmsg
1,01632170700,01632172600,00000001900,a2e,sendmsg
1,01632155500,01632174000,00000018500,ae8,epoll_wait
1,01632176400,01632177500,00000001100,a2f,recvmsg
1,01632184500,01632184700,00000000200,a2f,recvmsg
1,01632214200,01632215300,00000001100,a2e,sendmsg
1,01632233700,01632234200,00000000500,a00,read
1,01632236500,01632240600,00000004100,a07,poll
1,01632433400,01632433800,00000000400,aca,futex
1,01632218800,01632545300,00000326500,ae8,epoll_wait
1,01632549000,01632551200,00000002200,a2f,recvmsg
1,01632571700,01632572400,00000000700,a2f,recvmsg
1,01632617800,01632621600,00000003800,a2e,sendmsg
1,01632641200,01632642200,00000001000,a2e,sendmsg
1,01632542500,01632932700,00000390200,a07,poll
1,01633307200,01633315400,00000008200,a02,open
1,01633329700,01633332800,00000003100,a00,read
1,01633384800,01633385700,00000000900,a00,read
1,01633438000,01633438800,00000000800,a00,read
1,01633489500,01633490300,00000000800,a00,read
1,01633541000,01633541800,00000000800,a00,read
1,01633592000,01633592800,00000000800,a00,read
1,01633640400,01633641200,00000000800,a00,read
1,01633689500,01633690200,00000000700,a00,read
1,01633742000,01633742600,00000000600,a00,read
1,01633824900,01633825900,00000001000,a00,read
1,01633874600,01633875200,00000000600,a00,read
1,01633911500,01633913700,00000002200,a02,open
1,01633917300,01633918300,00000001000,a00,read
1,01633972500,01633973300,00000000800,a00,read
1,01634058000,01634058800,00000000800,a00,read
1,01634131100,01634131700,00000000600,a00,read
1,01634209500,01634210300,00000000800,a00,read
1,01634290000,01634290700,00000000700,a00,read
1,01634369100,01634369700,00000000600,a00,read
1,01634455300,01634456000,00000000700,a00,read
1,01634522300,01634522900,00000000600,a00,read
1,01634580700,01634581500,00000000800,a00,read
1,01634660800,01634694800,00000034000,a07,poll
1,01634698800,01634699100,00000000300,a2f,recvmsg
1,01634699800,01634700000,00000000200,a2f,recvmsg
1,01634702300,01634708600,00000006300,a07,poll
1,01634709700,01634709900,00000000200,a2f,recvmsg
1,01634710200,01634710400,00000000200,a2f,recvmsg
1,01634715200,01634722000,00000006800,a06,lstat
1,01634722700,01634723600,00000000900,a06,lstat
1,01634747100,01634761600,00000014500,a01,write
1,01634767300,01634788900,00000021600,a07,poll
1,01634790800,01634790900,00000000100,a2f,recvmsg
1,01634791400,01634791600,00000000200,a2f,recvmsg
1,01634793100,01635103200,00000310100,a38,clone
1,01635576800,01635576900,00000000100,a0c,brk
1,01635586700,01635589500,00000002800,a15,access
1,01635590300,01635591100,00000000800,a09,mmap
1,01635594900,01635597100,00000002200,a15,access
1,01635615200,01635616400,00000001200,a09,mmap
1,01635620600,01635621100,00000000500,a15,access
1,01635628900,01635630300,00000001400,a00,read
1,01635631900,01635633400,00000001500,a09,mmap
1,01635638100,01635640300,00000002200,a09,mmap
1,01635652200,01635652900,00000000700,a15,access
1,01635656100,01635656900,00000000800,a00,read
1,01635660500,01635661800,00000001300,a09,mmap
1,01635670000,01635670500,00000000500,a15,access
1,01635673900,01635674500,00000000600,a00,read
1,01635675200,01635676100,00000000900,a09,mmap
1,01635677700,01635679900,00000002200,a09,mmap
1,01635683600,01635686300,00000002700,a09,mmap
1,01635689100,01635690300,00000001200,a09,mmap
1,01635698700,01635699300,00000000600,a15,access
1,01635702200,01635702900,00000000700,a00,read
1,01635703800,01635705200,00000001400,a09,mmap
1,01635707500,01635709200,00000001700,a09,mmap
1,01635717700,01635718300,00000000600,a15,access
1,01635721900,01635722500,00000000600,a00,read
1,01635723300,01635724700,00000001400,a09,mmap
1,01635727600,01635729700,00000002100,a09,mmap
1,01635738600,01635739200,00000000600,a15,access
1,01635741900,01635742700,00000000800,a00,read
1,01635743200,01635744300,00000001100,a09,mmap
1,01635745700,01635747000,00000001300,a09,mmap
1,01635749400,01635750600,00000001200,a09,mmap
1,01635756900,01635757600,00000000700,a15,access
1,01635760100,01635760600,00000000500,a00,read
1,01635761400,01635762800,00000001400,a09,mmap
1,01635764700,01635766400,00000001700,a09,mmap
1,01635780200,01635780800,00000000600,a09,mmap
1,01635784700,01635785000,00000000300,a09,mmap
1,01635786100,01635786400,00000000300,a09,mmap
1,01635966000,01635966100,00000000100,a0c,brk
1,01635966200,01635967100,00000000900,a0c,brk
1,01636001500,01636007400,00000005900,a00,read
1,01636021100,01636022500,00000001400,a00,read
1,01636058400,01636059400,00000001000,a00,read
1,01636181600,01636182300,00000000700,a00,read
1,01636252800,01636253300,00000000500,a00,read
1,01636338500,01636339200,00000000700,a00,read
1,01636469500,01636470400,00000000900,a00,read
1,01636598900,01636599600,00000000700,a00,read
1,01636755400,01636756000,00000000600,a00,read
1,01636905500,01636906200,00000000700,a00,read
1,01637059100,01637059800,00000000700,a00,read
1,01637207800,01637208600,00000000800,a00,read
1,01637363500,01637364200,00000000700,a00,read
1,01637523500,01637524200,00000000700,a00,read
1,01637632000,01637632700,00000000700,a00,read
1,01637663300,01637663700,00000000400,a0c,brk
1,01637770900,01637771600,00000000700,a00,read
1,01638015900,01638016600,00000000700,a00,read
1,01638028500,01638028900,00000000400,a00,read
1,01638073400,01638073800,00000000400,a00,read
1,01638093600,01638094300,00000000700,a00,read
1,01638300700,01638301300,00000000600,a00,read
1,01638330300,01638331200,00000000900,a00,read
1,01638428100,01638428900,00000000800,a00,read
1,01638452800,01638454000,00000001200,a0c,brk
1,01638499200,01638499600,00000000400,a00,read
1,01638577500,01638578300,00000000800,a00,read
1,01638731400,01638731800,00000000400,a00,read
1,01638843800,01638844500,00000000700,a00,read
1,01638938400,01638938800,00000000400,a00,read
1,01638950500,01638951000,00000000500,a00,read
1,01639030400,01639030900,00000000500,a00,read
1,01639054500,01639054900,00000000400,a00,read
1,01639076700,01639077200,00000000500,a00,read
1,01639178000,01639179100,00000001100,a0c,brk
1,01639180900,01639182000,00000001100,a00,read
1,01639383400,01639383800,00000000400,a00,read
1,01639467600,01639467600,00000000000,a00,read
1,01639531400,01639532100,00000000700,a00,read
1,01639705300,01639705900,00000000600,a00,read
1,01639739100,01639739700,00000000600,a00,read
1,01639756500,01639757800,00000001300,a02,open
1,01639869300,01639869800,00000000500,a00,read
1,01639940800,01639941100,00000000300,a00,read
1,01639993800,01639995000,00000001200,a0c,brk
1,01640001300,01640002000,00000000700,a00,read
1,01640110700,01640111300,00000000600,a00,read
1,01640260900,01640261800,00000000900,a00,read
1,01640391500,01640392100,00000000600,a00,read
1,01640449400,01640450200,00000000800,a00,read
1,01640506200,01640507000,00000000800,a00,read
1,01640576700,01640577300,00000000600,a00,read
1,01640629600,01640630300,00000000700,a00,read
1,01640718300,01640719200,00000000900,a0c,brk
1,01640752400,01640755900,00000003500,a0c,brk
1,01640770000,01640770700,00000000700,a00,read
1,01640885100,01640885900,00000000800,a00,read
1,01641043600,01641044300,00000000700,a00,read
1,01641160800,01641161500,00000000700,a00,read
1,01641307000,01641307700,00000000700,a00,read
1,01641424000,01641424600,00000000600,a00,read
1,01641586400,01641587100,00000000700,a00,read
1,01641592000,01641592800,00000000800,a0c,brk
1,01641708600,01641709300,00000000700,a00,read
1,01641826900,01641827600,00000000700,a00,read
1,01641968600,01641969300,00000000700,a00,read
1,01642099800,01642100400,00000000600,a00,read
1,01642192700,01642193200,00000000500,a00,read
1,01642304800,01642305400,00000000600,a00,read
1,01642428600,01642429200,00000000600,a00,read
1,01642540200,01642540800,00000000600,a0c,brk
1,01642564800,01642565600,00000000800,a00,read
1,01642734700,01642735400,00000000700,a00,read
1,01642884700,01642885200,00000000500,a00,read
1,01642995000,01642995800,00000000800,a00,read
1,01681683300,01681697000,00000013700,a07,poll
1,01681701500,01681701700,00000000200,a2f,recvmsg
1,01681701900,01681702100,00000000200,a2f,recvmsg
1,01681703300,01681703700,00000000400,a08,lseek
1,01681714200,01681714300,00000000100,a08,lseek
1,01681717600,01681725200,00000007600,a07,poll
1,01681726500,01681726700,00000000200,a2f,recvmsg
1,01681727100,01681727300,00000000200,a2f,recvmsg
1,01681732100,01681739100,00000007000,a07,poll
1,01681740400,01681740500,00000000100,a2f,recvmsg
1,01681740900,01681741100,00000000200,a2f,recvmsg
1,01681744300,01681751300,00000007000,a07,poll
1,01681752600,01681752800,00000000200,a2f,recvmsg
1,01681753100,01681753200,00000000100,a2f,recvmsg
1,01681756900,01681763500,00000006600,a07,poll
1,01681764700,01681764900,00000000200,a2f,recvmsg
1,01681765200,01681765400,00000000200,a2f,recvmsg
1,01681768800,01681775800,00000007000,a07,poll
1,01681777000,01681777200,00000000200,a2f,recvmsg
1,01681777500,01681777700,00000000200,a2f,recvmsg
1,01681781200,01681787900,00000006700,a07,poll
1,01681789100,01681789200,00000000100,a2f,recvmsg
1,01681789500,01681789700,00000000200,a2f,recvmsg
1,01681793100,01681800100,00000007000,a07,poll
1,01681801300,01681801400,00000000100,a2f,recvmsg
1,01681801800,01681802000,00000000200,a2f,recvmsg
1,01681804800,01681811600,00000006800,a07,poll
1,01681812700,01681812900,00000000200,a2f,recvmsg
1,01681813200,01681813400,00000000200,a2f,recvmsg
1,01681817600,01681824600,00000007000,a07,poll
1,01681825700,01681825900,00000000200,a2f,recvmsg
1,01681826200,01681826400,00000000200,a2f,recvmsg
1,01681829700,01681836800,00000007100,a07,poll
1,01681838000,01681838100,00000000100,a2f,recvmsg
1,01681838500,01681838600,00000000100,a2f,recvmsg
1,01681841800,01681849000,00000007200,a07,poll
1,01681850200,01681850400,00000000200,a2f,recvmsg
1,01681850700,01681850900,00000000200,a2f,recvmsg
1,01681854100,01681861000,00000006900,a07,poll
1,01681863000,01681863200,00000000200,a2f,recvmsg
1,01681863400,01681863600,00000000200,a2f,recvmsg
1,01681866700,01681873600,00000006900,a07,poll
1,01681874800,01681875000,00000000200,a2f,recvmsg
1,01681875300,01681875500,00000000200,a2f,recvmsg
1,01681878800,01681885800,00000007000,a07,poll
1,01681886900,01681887100,00000000200,a2f,recvmsg
1,01681887400,01681887600,00000000200,a2f,recvmsg
1,01681890700,01681897800,00000007100,a07,poll
1,01681899000,01681899200,00000000200,a2f,recvmsg
1,01681899400,01681899600,00000000200,a2f,recvmsg
1,01681902400,01681909700,00000007300,a07,poll
1,01681910800,01681910900,00000000100,a2f,recvmsg
1,01681911200,01681911400,00000000200,a2f,recvmsg
1,01681916800,01681923600,00000006800,a07,poll
1,01681924700,01681924900,00000000200,a2f,recvmsg
1,01681925300,01681925400,00000000100,a2f,recvmsg
1,01681928100,01681935100,00000007000,a07,poll
1,01681936200,01681936400,00000000200,a2f,recvmsg
1,01681936700,01681936800,00000000100,a2f,recvmsg
1,01681939600,01681946400,00000006800,a07,poll
1,01681947600,01681947800,00000000200,a2f,recvmsg
1,01681948100,01681948300,00000000200,a2f,recvmsg
1,01681951000,01681957700,00000006700,a07,poll
1,01681958800,01681959000,00000000200,a2f,recvmsg
1,01681959300,01681959500,00000000200,a2f,recvmsg
1,01681962500,01681969200,00000006700,a07,poll
1,01681971300,01681971500,00000000200,a2f,recvmsg
1,01681971700,01681971900,00000000200,a2f,recvmsg
1,01681974800,01681981500,00000006700,a07,poll
1,01681982600,01681982800,00000000200,a2f,recvmsg
1,01681983000,01681983200,00000000200,a2f,recvmsg
1,01681986600,01681993800,00000007200,a07,poll
1,01681994900,01681995100,00000000200,a2f,recvmsg
1,01681995400,01681995600,00000000200,a2f,recvmsg
1,01681998900,01682005800,00000006900,a07,poll
1,01682006900,01682007100,00000000200,a2f,recvmsg
1,01682007400,01682007600,00000000200,a2f,recvmsg
1,01682011300,01682018200,00000006900,a07,poll
1,01682019300,01682019500,00000000200,a2f,recvmsg
1,01682019800,01682020000,00000000200,a2f,recvmsg
1,01682023500,01682030300,00000006800,a07,poll
1,01682031400,01682031500,00000000100,a2f,recvmsg
1,01682031900,01682032000,00000000100,a2f,recvmsg
1,01682035600,01682042500,00000006900,a07,poll
1,01682043700,01682043800,00000000100,a2f,recvmsg
1,01682044100,01682044300,00000000200,a2f,recvmsg
1,01682050400,01682057200,00000006800,a07,poll
1,01682058400,01682058600,00000000200,a2f,recvmsg
1,01682058900,01682059000,00000000100,a2f,recvmsg
1,01682062200,01682068900,00000006700,a07,poll
1,01682070100,01682070300,00000000200,a2f,recvmsg
1,01682070500,01682070700,00000000200,a2f,recvmsg
1,01682073900,01682080700,00000006800,a07,poll
1,01682081800,01682081900,00000000100,a2f,recvmsg
1,01682082200,01682082400,00000000200,a2f,recvmsg
1,01682087300,01682094000,00000006700,a07,poll
1,01682095200,01682095300,00000000100,a2f,recvmsg
1,01682095600,01682095800,00000000200,a2f,recvmsg
1,01682100100,01682106900,00000006800,a07,poll
1,01682108100,01682108300,00000000200,a2f,recvmsg
1,01682108500,01682108700,00000000200,a2f,recvmsg
1,01682112400,01682119400,00000007000,a07,poll
1,01682120500,01682120700,00000000200,a2f,recvmsg
1,01682121000,01682121200,00000000200,a2f,recvmsg
1,01682124600,01682131300,00000006700,a07,poll
1,01682132700,01682132900,00000000200,a2f,recvmsg
1,01682133100,01682133300,00000000200,a2f,recvmsg
1,01682136400,01682143300,00000006900,a07,poll
1,01682144500,01682144500,00000000000,a2f,recvmsg
1,01682144900,01682145000,00000000100,a2f,recvmsg
1,01682148000,01682154700,00000006700,a07,poll
1,01682155900,01682155900,00000000000,a2f,recvmsg
1,01682156300,01682156400,00000000100,a2f,recvmsg
1,01682159800,01682166600,00000006800,a07,poll
1,01682167700,01682167900,00000000200,a2f,recvmsg
1,01682168200,01682168400,00000000200,a2f,recvmsg
1,01682169300,01682169500,00000000200,a08,lseek
1,01682172200,01682173900,00000001700,a00,read
1,01682177600,01682177700,00000000100,a08,lseek
1,01682180600,01682187600,00000007000,a07,poll
1,01682188800,01682189000,00000000200,a2f,recvmsg
1,01682189300,01682189500,00000000200,a2f,recvmsg
1,01682215300,01682222300,00000007000,a07,poll
1,01682223600,01682223800,00000000200,a2f,recvmsg
1,01682224100,01682224300,00000000200,a2f,recvmsg
1,01682228300,01682229300,00000001000,a00,read
1,01682234700,01682234800,00000000100,a08,lseek
1,01682238100,01682244900,00000006800,a07,poll
1,01682246100,01682246300,00000000200,a2f,recvmsg
1,01682246700,01682246800,00000000100,a2f,recvmsg
1,01682249700,01682256400,00000006700,a07,poll
1,01682257500,01682257700,00000000200,a2f,recvmsg
1,01682258000,01682258200,00000000200,a2f,recvmsg
1,01682260800,01682267400,00000006600,a07,poll
1,01682268500,01682268700,00000000200,a2f,recvmsg
1,01682269000,01682269200,00000000200,a2f,recvmsg
1,01682271900,01682278700,00000006800,a07,poll
1,01682279800,01682280000,00000000200,a2f,recvmsg
1,01682280300,01682280500,00000000200,a2f,recvmsg
1,01682283200,01682289800,00000006600,a07,poll
1,01682290900,01682291100,00000000200,a2f,recvmsg
1,01682291400,01682291600,00000000200,a2f,recvmsg
1,01682294400,01682300900,00000006500,a07,poll
1,01682302200,01682302200,00000000000,a2f,recvmsg
1,01682302600,01682302800,00000000200,a2f,recvmsg
1,01682305500,01682312100,00000006600,a07,poll
1,01682313300,01682313500,00000000200,a2f,recvmsg
1,01682313700,01682313900,00000000200,a2f,recvmsg
1,01682317300,01682324300,00000007000,a07,poll
1,01682325300,01682325500,00000000200,a2f,recvmsg
1,01682325800,01682326000,00000000200,a2f,recvmsg
1,01682328800,01682335500,00000006700,a07,poll
1,01682336600,01682336800,00000000200,a2f,recvmsg
1,01682337100,01682337300,00000000200,a2f,recvmsg
1,01682337700,01682337800,00000000100,a08,lseek
1,01682342700,01682349500,00000006800,a07,poll
1,01682350700,01682350800,00000000100,a2f,recvmsg
1,01682351200,01682351400,00000000200,a2f,recvmsg
1,01682356500,01682363300,00000006800,a07,poll
1,01682364500,01682364700,00000000200,a2f,recvmsg
1,01682364900,01682365100,00000000200,a2f,recvmsg
1,01682368700,01682375200,00000006500,a07,poll
1,01682376400,01682376600,00000000200,a2f,recvmsg
1,01682376900,01682377100,00000000200,a2f,recvmsg
1,01682380200,01682386900,00000006700,a07,poll
1,01682388000,01682388200,00000000200,a2f,recvmsg
1,01682388600,01682388800,00000000200,a2f,recvmsg
1,01682391800,01682398600,00000006800,a07,poll
1,01682400100,01682400300,00000000200,a2f,recvmsg
1,01682400600,01682400800,00000000200,a2f,recvmsg
1,01682403800,01682410500,00000006700,a07,poll
1,01682411600,01682411800,00000000200,a2f,recvmsg
1,01682412100,01682412300,00000000200,a2f,recvmsg
1,01682415900,01682422500,00000006600,a07,poll
1,01682423700,01682423800,00000000100,a2f,recvmsg
1,01682424100,01682424300,00000000200,a2f,recvmsg
1,01682427400,01682434000,00000006600,a07,poll
1,01682435200,01682435200,00000000000,a2f,recvmsg
1,01682435500,01682435700,00000000200,a2f,recvmsg
1,01682438800,01682445400,00000006600,a07,poll
1,01682446600,01682446700,00000000100,a2f,recvmsg
1,01682447000,01682447200,00000000200,a2f,recvmsg
1,01682450300,01682456800,00000006500,a07,poll
1,01682458000,01682458000,00000000000,a2f,recvmsg
1,01682458400,01682458600,00000000200,a2f,recvmsg
1,01682461700,01682468500,00000006800,a07,poll
1,01682469700,01682469800,00000000100,a2f,recvmsg
1,01682470200,01682470300,00000000100,a2f,recvmsg
1,01682473500,01682480500,00000007000,a07,poll
1,01682481600,01682481800,00000000200,a2f,recvmsg
1,01682482100,01682482300,00000000200,a2f,recvmsg
1,01682485900,01682492700,00000006800,a07,poll
1,01682493900,01682494100,00000000200,a2f,recvmsg
1,01682494300,01682494500,00000000200,a2f,recvmsg
1,01682497500,01682504100,00000006600,a07,poll
1,01682505300,01682505500,00000000200,a2f,recvmsg
1,01682505700,01682505900,00000000200,a2f,recvmsg
1,01682509000,01682515800,00000006800,a07,poll
1,01682516900,01682517000,00000000100,a2f,recvmsg
1,01682517300,01682517500,00000000200,a2f,recvmsg
1,01682520600,01682527600,00000007000,a07,poll
1,01682528700,01682528800,00000000100,a2f,recvmsg
1,01682529200,01682529400,00000000200,a2f,recvmsg
1,01682537600,01682544300,00000006700,a07,poll
1,01682545400,01682545600,00000000200,a2f,recvmsg
1,01682545900,01682546100,00000000200,a2f,recvmsg
1,01682549400,01682556000,00000006600,a07,poll
1,01682557100,01682557200,00000000100,a2f,recvmsg
1,01682557500,01682557700,00000000200,a2f,recvmsg
1,01682560800,01682567700,00000006900,a07,poll
1,01682568800,01682569000,00000000200,a2f,recvmsg
1,01682569300,01682569500,00000000200,a2f,recvmsg
1,01682572700,01682579500,00000006800,a07,poll
1,01682580500,01682580700,00000000200,a2f,recvmsg
1,01682581000,01682581200,00000000200,a2f,recvmsg
1,01682584300,01682591000,00000006700,a07,poll
1,01682592100,01682592200,00000000100,a2f,recvmsg
1,01682592500,01682592700,00000000200,a2f,recvmsg
1,01682614100,01682643100,00000029000,a57,unlink
1,01682644400,01682648600,00000004200,a14,writev
1,01682649200,01682749700,00000100500,a07,poll
1,01682649200,01682754300,00000105100,a07,poll
1,01682767300,01682767500,00000000200,a2f,recvmsg
1,01682771700,01682771900,00000000200,a2f,recvmsg
1,01682772400,01682772500,00000000100,a2f,recvmsg
1,01682778100,01682778300,00000000200,a2f,recvmsg
1,01682778400,01682778600,00000000200,a2f,recvmsg
1,01682794300,01682794500,00000000200,a2f,recvmsg
1,01682832500,01682834000,00000001500,a07,poll
1,01682832500,01682836000,00000003500,a07,poll
1,01682841400,01682841600,00000000200,a2f,recvmsg
1,01682842800,01682843000,00000000200,a2f,recvmsg
1,01682843200,01682843300,00000000100,a2f,recvmsg
1,01682844600,01682844700,00000000100,a2f,recvmsg
1,01682844900,01682845100,00000000200,a2f,recvmsg
1,01682852200,01682895600,00000043400,a07,poll
1,01682895800,01682897000,00000001200,a2f,recvmsg
1,01682852200,01682898400,00000046200,a07,poll
1,01682900400,01682900600,00000000200,a2f,recvmsg
1,01682901400,01682901600,00000000200,a2f,recvmsg
1,01682901800,01682901900,00000000100,a2f,recvmsg
1,01682902600,01682902800,00000000200,a2f,recvmsg
1,01682903000,01682903100,00000000100,a2f,recvmsg
1,01682905300,01682954100,00000048800,a07,poll
1,01682954300,01682955400,00000001100,a2f,recvmsg
1,01682905300,01682956700,00000051400,a07,poll
1,01682958700,01682958800,00000000100,a2f,recvmsg
1,01682959500,01682959600,00000000100,a2f,recvmsg
1,01682959800,01682959900,00000000100,a2f,recvmsg
1,01682960600,01682960700,00000000100,a2f,recvmsg
1,01682960900,01682961100,00000000200,a2f,recvmsg
1,01682963000,01683011300,00000048300,a07,poll
1,01683011400,01683012600,00000001200,a2f,recvmsg
1,01682963000,01683013600,00000050600,a07,poll
1,01683015500,01683015700,00000000200,a2f,recvmsg
1,01683016300,01683016500,00000000200,a2f,recvmsg
1,01683016600,01683016700,00000000100,a2f,recvmsg
1,01683017300,01683017500,00000000200,a2f,recvmsg
1,01683017700,01683017900,00000000200,a2f,recvmsg
1,01683019700,01683068100,00000048400,a07,poll
1,01683019700,01683070400,00000050700,a07,poll
1,01683072300,01683072400,00000000100,a2f,recvmsg
1,01683073200,01683073400,00000000200,a2f,recvmsg
1,01683073600,01683073700,00000000100,a2f,recvmsg
1,01683074300,01683074500,00000000200,a2f,recvmsg
1,01683074700,01683074800,00000000100,a2f,recvmsg
1,01683076900,01683126200,00000049300,a07,poll
1,01683127700,01683169600,00000041900,a07,poll
1,01683170600,01683214200,00000043600,a07,poll
1,01683216400,01683276600,00000060200,a07,poll
1,01683278000,01683320900,00000042900,a07,poll
1,01683322100,01683365700,00000043600,a07,poll
1,01683366900,01683421700,00000054800,a07,poll
1,01683424500,01683441400,00000016900,a07,poll
1,01683442500,01683457700,00000015200,a07,poll
1,01683458900,01683473600,00000014700,a07,poll
1,01683474800,01683489500,00000014700,a07,poll
1,01683490700,01683505300,00000014600,a07,poll
1,01683506600,01683510700,00000004100,a07,poll
1,01683513400,01683513600,00000000200,a2f,recvmsg
1,01683514300,01683514400,00000000100,a2f,recvmsg
1,01683506600,01683534700,00000028100,a07,poll
1,01683535300,01683537200,00000001900,a2f,recvmsg
1,01683539900,01683541200,00000001300,a2d,recvfrom
1,01683547200,01683547400,00000000200,a2f,recvmsg
1,01683548100,01683548300,00000000200,a2f,recvmsg
1,01683619600,01683619900,00000000300,a2f,recvmsg
1,01683623100,01683623800,00000000700,a2f,recvmsg
1,01683641600,01683737800,00000096200,a07,poll
1,01683738900,01683740600,00000001700,a2f,recvmsg
1,01683749200,01683750200,00000001000,a2d,recvfrom
1,01683751600,01683751800,00000000200,a2f,recvmsg
1,01683752600,01683752800,00000000200,a2f,recvmsg
1,01683790100,01683790300,00000000200,a2f,recvmsg
1,01683793600,01683793700,00000000100,a2f,recvmsg
1,01683798000,01683801900,00000003900,a07,poll
1,01683806500,01683806600,00000000100,a2f,recvmsg
1,01683808100,01683808300,00000000200,a2f,recvmsg
1,01683808500,01683808700,00000000200,a2f,recvmsg
1,01683810100,01683810300,00000000200,a2f,recvmsg
1,01683810500,01683810700,00000000200,a2f,recvmsg
1,01683810900,01683812600,00000001700,a07,poll
1,01683815000,01683815200,00000000200,a2f,recvmsg
1,01683815800,01683815900,00000000100,a2f,recvmsg
1,01632644200,01684547500,00051903300,ae8,epoll_wait
1,01684560000,01684561300,00000001300,a2f,recvmsg
1,01684576200,01684576500,00000000300,a2f,recvmsg
1,01684637900,01684642900,00000005000,a2e,sendmsg
1,01684542300,01684653800,00000111500,60e,page_fault
1,01684576200,01684673800,00000097600,a2f,recvmsg
1,01684700900,01684701300,00000000400,a2f,recvmsg
1,01684739900,01684744700,00000004800,a07,poll
1,01684740400,01684916200,00000175800,a14,writev
1,01684650700,01684918800,00000268100,ae8,epoll_wait
1,01684925600,01684927900,00000002300,a2f,recvmsg
1,01684948500,01684948800,00000000300,a2f,recvmsg
1,01684988200,01684991100,00000002900,a2e,sendmsg
1,01685000200,01685002000,00000001800,a2f,recvmsg
1,01685012200,01685013500,00000001300,a2d,recvfrom
1,01685014200,01685014400,00000000200,a2f,recvmsg
1,01685015100,01685015300,00000000200,a2f,recvmsg
1,01685051100,01685054300,00000003200,a14,writev
1,01685054800,01685077800,00000023000,a07,poll
1,01685078000,01685079800,00000001800,a2f,recvmsg
1,01685080800,01685081000,00000000200,a2f,recvmsg
1,01685081400,01685081600,00000000200,a2f,recvmsg
1,01685104900,01685106800,00000001900,a14,writev
1,01685107300,01685123400,00000016100,a07,poll
1,01685123500,01685125100,00000001600,a2f,recvmsg
1,01685125800,01685126000,00000000200,a2f,recvmsg
1,01685126400,01685126600,00000000200,a2f,recvmsg
1,01685146700,01685146900,00000000200,a2f,recvmsg
1,01684994900,01685238500,00000243600,ae8,epoll_wait
1,01685243400,01685245200,00000001800,a2f,recvmsg
1,01685254300,01685254600,00000000300,a2f,recvmsg
1,01685294700,01685298000,00000003300,a2e,sendmsg
1,01685213300,01685356300,00000143000,a07,poll
1,01685302400,01685497700,00000195300,ae8,epoll_wait
1,01685501800,01685503500,00000001700,a2f,recvmsg
1,01685522800,01685523100,00000000300,a2f,recvmsg
1,01685551100,01685553600,00000002500,a2e,sendmsg
1,01685493400,01685674300,00000180900,a07,poll
1,01686038200,01686046200,00000008000,a02,open
1,01686064800,01686068100,00000003300,a00,read
1,01686119900,01686120800,00000000900,a00,read
1,01686175400,01686176300,00000000900,a00,read
1,01686228100,01686228800,00000000700,a00,read
1,01686281200,01686282200,00000001000,a00,read
1,01686333500,01686334100,00000000600,a00,read
1,01686383500,01686384400,00000000900,a00,read
1,01686436200,01686436800,00000000600,a00,read
1,01686489900,01686490600,00000000700,a00,read
1,01686541900,01686542600,00000000700,a00,read
1,01686592000,01686592500,00000000500,a00,read
1,01686620300,01686622800,00000002500,a02,open
1,01686626600,01686627400,00000000800,a00,read
1,01686682000,01686682800,00000000800,a00,read
1,01686767600,01686768500,00000000900,a00,read
1,01686841400,01686842400,00000001000,a00,read
1,01686921800,01686922600,00000000800,a00,read
1,01687002300,01687003000,00000000700,a00,read
1,01687081500,01687082200,00000000700,a00,read
1,01687168700,01687169400,00000000700,a00,read
1,01687263500,01687264400,00000000900,a00,read
1,01687322600,01687323300,00000000700,a00,read
1,01687409600,01687431500,00000021900,a07,poll
1,01687434800,01687435100,00000000300,a2f,recvmsg
1,01687435900,01687436000,00000000100,a2f,recvmsg
1,01687438900,01687447400,00000008500,a07,poll
1,01687448700,01687448900,00000000200,a2f,recvmsg
1,01687449300,01687449400,00000000100,a2f,recvmsg
1,01687454700,01687460800,00000006100,a06,lstat
1,01687461700,01687462700,00000001000,a06,lstat
1,01687486800,01687501000,00000014200,a01,write
1,01687507300,01687515700,00000008400,a07,poll
1,01687517700,01687518000,00000000300,a2f,recvmsg
1,01687518500,01687518700,00000000200,a2f,recvmsg
1,01687519900,01687843200,00000323300,a38,clone
1,01688399000,01688401400,00000002400,a15,access
1,01688402200,01688403100,00000000900,a09,mmap
1,01688406900,01688407700,00000000800,a15,access
1,01688418800,01688419300,00000000500,a15,access
1,01688426400,01688427500,00000001100,a00,read
1,01688429100,01688430600,00000001500,a09,mmap
1,01688435800,01688438700,00000002900,a09,mmap
1,01688450600,01688451200,00000000600,a15,access
1,01688454600,01688455300,00000000700,a00,read
1,01688456100,01688457100,00000001000,a09,mmap
1,01688459300,01688460800,00000001500,a09,mmap
1,01688469400,01688470000,00000000600,a15,access
1,01688473500,01688474300,00000000800,a00,read
1,01688475000,01688475800,00000000800,a09,mmap
1,01688477500,01688479600,00000002100,a09,mmap
1,01688484000,01688487000,00000003000,a09,mmap
1,01688489400,01688490500,00000001100,a09,mmap
1,01688499300,01688500000,00000000700,a15,access
1,01688503100,01688504000,00000000900,a00,read
1,01688504800,01688506400,00000001600,a09,mmap
1,01688509100,01688510800,00000001700,a09,mmap
1,01688519000,01688519500,00000000500,a15,access
1,01688522800,01688523400,00000000600,a00,read
1,01688524200,01688525600,00000001400,a09,mmap
1,01688529100,01688531300,00000002200,a09,mmap
1,01688540100,01688540700,00000000600,a15,access
1,01688543800,01688544400,00000000600,a00,read
1,01688544900,01688546000,00000001100,a09,mmap
1,01688547500,01688548800,00000001300,a09,mmap
1,01688560100,01688560800,00000000700,a15,access
1,01688563100,01688563800,00000000700,a00,read
1,01688564500,01688565900,00000001400,a09,mmap
1,01688568000,01688569700,00000001700,a09,mmap
1,01688584900,01688585500,00000000600,a09,mmap
1,01688589500,01688589900,00000000400,a09,mmap
1,01688591100,01688591300,00000000200,a09,mmap
1,01688782800,01688783500,00000000700,a0c,brk
1,01688819200,01688820300,00000001100,a00,read
1,01688832500,01688834200,00000001700,a00,read
1,01688871300,01688872300,00000001000,a00,read
1,01688998100,01688998900,00000000800,a00,read
1,01689071100,01689071600,00000000500,a00,read
1,01689160100,01689160900,00000000800,a00,read
1,01689291500,01689292600,00000001100,a00,read
1,01689422200,01689422800,00000000600,a00,read
1,01689579100,01689579700,00000000600,a00,read
1,01689730400,01689731100,00000000700,a00,read
1,01689767500,01689768800,00000001300,a0c,brk
1,01689883700,01689884400,00000000700,a00,read
1,01690032600,01690033300,00000000700,a00,read
1,01690189200,01690189900,00000000700,a00,read
1,01690349000,01690349700,00000000700,a00,read
1,01690457200,01690457900,00000000700,a00,read
1,01690488300,01690488900,00000000600,a0c,brk
1,01690598600,01690599400,00000000800,a00,read
1,01690847200,01690847800,00000000600,a00,read
1,01690859300,01690859700,00000000400,a00,read
1,01690904000,01690904400,00000000400,a00,read
1,01690923600,01690924400,00000000800,a00,read
1,01691131000,01691131500,00000000500,a00,read
1,01691160600,01691161500,00000000900,a00,read
1,01691313800,01691314800,00000001000,a00,read
1,01691339600,01691341000,00000001400,a0c,brk
1,01691389100,01691389400,00000000300,a00,read
1,01691481400,01691482500,00000001100,a00,read
1,01691635700,01691636200,00000000500,a00,read
1,01691749500,01691750200,00000000700,a00,read
1,01691845700,01691846100,00000000400,a00,read
1,01691858000,01691858500,00000000500,a00,read
1,01691943400,01691943900,00000000500,a00,read
1,01691967800,01691968100,00000000300,a00,read
1,01691990300,01691990900,00000000600,a00,read
1,01692096300,01692097500,00000001200,a0c,brk
1,01692099600,01692100500,00000000900,a00,read
1,01692300700,01692301400,00000000700,a00,read
1,01692385700,01692386300,00000000600,a00,read
1,01692450300,01692451200,00000000900,a00,read
1,01692579200,01692579500,00000000300,a00,read
1,01692611800,01692612300,00000000500,a00,read
1,01692626600,01692627900,00000001300,a02,open
1,01692739800,01692740300,00000000500,a00,read
1,01692813900,01692814300,00000000400,a00,read
1,01692866900,01692868100,00000001200,a0c,brk
1,01692874900,01692875600,00000000700,a00,read
1,01692982900,01692983600,00000000700,a00,read
1,01693134100,01693134800,00000000700,a00,read
1,01693264900,01693265400,00000000500,a00,read
1,01693323100,01693323800,00000000700,a00,read
1,01693379400,01693380100,00000000700,a00,read
1,01693449700,01693450500,00000000800,a00,read
1,01693503400,01693504200,00000000800,a00,read
1,01693594600,01693595500,00000000900,a0c,brk
1,01693627200,01693631300,00000004100,a0c,brk
1,01693645400,01693646300,00000000900,a00,read
1,01693760500,01693761200,00000000700,a00,read
1,01693919600,01693920600,00000001000,a00,read
1,01694037600,01694038300,00000000700,a00,read
1,01694185000,01694185900,00000000900,a00,read
1,01694303000,01694303800,00000000800,a00,read
1,01694468200,01694468900,00000000700,a00,read
1,01694473800,01694474600,00000000800,a0c,brk
1,01694589800,01694590500,00000000700,a00,read
1,01694709900,01694710600,00000000700,a00,read
1,01694852800,01694853600,00000000800,a00,read
1,01694984400,01694985100,00000000700,a00,read
1,01695078100,01695078900,00000000800,a00,read
1,01695191200,01695191800,00000000600,a00,read
1,01695326100,01695326800,00000000700,a00,read
1,01695440000,01695440600,00000000600,a0c,brk
1,01695463400,01695464100,00000000700,a00,read
1,01695633000,01695633800,00000000800,a00,read
1,01695784500,01695785000,00000000500,a00,read
1,01695895700,01695896400,00000000700,a00,read
1,01696067700,01696068600,00000000900,a00,read
1,01696145500,01696146100,00000000600,a00,read
1,01696227400,01696228100,00000000700,a00,read
1,01696294800,01696295600,00000000800,a0c,brk
1,01696309000,01696309600,00000000600,a00,read
1,01696382000,01696382800,00000000800,a00,read
1,01696483900,01696484800,00000000900,a00,read
1,01696587300,01696588000,00000000700,a00,read
1,01696677600,01696678300,00000000700,a00,read
1,01696758700,01696759300,00000000600,a00,read
1,01696861900,01696862600,00000000700,a00,read
1,01696943200,01696943600,00000000400,a0c,brk
1,01696946100,01696946800,00000000700,a00,read
1,01697053500,01697054100,00000000600,a00,read
1,01697146600,01697147200,00000000600,a00,read
1,01697265600,01697266300,00000000700,a00,read
1,01697380800,01697381500,00000000700,a00,read
1,01697484600,01697485300,00000000700,a00,read
1,01697585000,01697585400,00000000400,a0c,brk
1,01697952500,01697956000,00000003500,a57,unlink
1,01697979600,01697980100,00000000500,a48,fcntl
1,01698025300,01698039300,00000014000,a01,write
1,01698057000,01698059900,00000002900,a01,write
1,01698076700,01698079500,00000002800,a01,write
1,01631414600,01698322500,00066907900,a17,select
1,01698347500,01698347700,00000000200,a2f,recvmsg
1,01698351600,01698378100,00000026500,a17,select
1,01698383500,01698383700,00000000200,a2f,recvmsg
1,01698384500,01698412000,00000027500,a17,select
1,01698416100,01698416200,00000000100,a2f,recvmsg
1,01698416800,01698431900,00000015100,a17,select
1,01698436200,01698436400,00000000200,a2f,recvmsg
1,01698436900,01698450400,00000013500,a17,select
1,01698455000,01698455200,00000000200,a2f,recvmsg
1,01698455800,01698470200,00000014400,a17,select
1,01698474000,01698474200,00000000200,a2f,recvmsg
1,01698474700,01698500600,00000025900,a17,select
1,01698505100,01698505300,00000000200,a2f,recvmsg
1,01698505700,01698515400,00000009700,a17,select
1,01698519400,01698519600,00000000200,a2f,recvmsg
1,01698520200,01698527900,00000007700,a17,select
1,01698531600,01698531800,00000000200,a2f,recvmsg
1,01698532200,01698539900,00000007700,a17,select
1,01698543900,01698544100,00000000200,a2f,recvmsg
1,01698544600,01698553100,00000008500,a17,select
1,01698557100,01698557300,00000000200,a2f,recvmsg
1,01698557800,01698565600,00000007800,a17,select
1,01698569200,01698569400,00000000200,a2f,recvmsg
1,01698569900,01698577900,00000008000,a17,select
1,01698581900,01698582100,00000000200,a2f,recvmsg
1,01698582600,01698590700,00000008100,a17,select
1,01698594400,01698594600,00000000200,a2f,recvmsg
1,01698595000,01698603700,00000008700,a17,select
1,01698607700,01698607900,00000000200,a2f,recvmsg
1,01698608300,01698615900,00000007600,a17,select
1,01698619600,01698619800,00000000200,a2f,recvmsg
1,01698620300,01698627800,00000007500,a17,select
1,01698631500,01698631700,00000000200,a2f,recvmsg
1,01698632200,01698640300,00000008100,a17,select
1,01698644100,01698644300,00000000200,a2f,recvmsg
1,01698644800,01698652200,00000007400,a17,select
1,01698655900,01698656100,00000000200,a2f,recvmsg
1,01698656700,01698664200,00000007500,a17,select
1,01698668100,01698668200,00000000100,a2f,recvmsg
1,01698668800,01698676200,00000007400,a17,select
1,01698680000,01698680200,00000000200,a2f,recvmsg
1,01698680600,01698687700,00000007100,a17,select
1,01698691400,01698691600,00000000200,a2f,recvmsg
1,01698692000,01698700900,00000008900,a17,select
1,01698704500,01698704700,00000000200,a2f,recvmsg
1,01698705100,01698712100,00000007000,a17,select
1,01698715800,01698716000,00000000200,a2f,recvmsg
1,01698716400,01698723300,00000006900,a17,select
1,01698727100,01698727300,00000000200,a2f,recvmsg
1,01698727700,01698734900,00000007200,a17,select
1,01698738700,01698738800,00000000100,a2f,recvmsg
1,01698739300,01698746700,00000007400,a17,select
1,01698750400,01698750500,00000000100,a2f,recvmsg
1,01698751000,01698758000,00000007000,a17,select
1,01698761700,01698761800,00000000100,a2f,recvmsg
1,01698762300,01698769600,00000007300,a17,select
1,01698773300,01698773400,00000000100,a2f,recvmsg
1,01698774000,01698781300,00000007300,a17,select
1,01698785000,01698785100,00000000100,a2f,recvmsg
1,01698785700,01698793800,00000008100,a17,select
1,01698797900,01698798000,00000000100,a2f,recvmsg
1,01698798500,01698806200,00000007700,a17,select
1,01698809800,01698810000,00000000200,a2f,recvmsg
1,01698810600,01698818200,00000007600,a17,select
1,01698821900,01698822100,00000000200,a2f,recvmsg
1,01698822600,01698832200,00000009600,a17,select
1,01698835900,01698836000,00000000100,a2f,recvmsg
1,01698836500,01698843700,00000007200,a17,select
1,01698847300,01698847400,00000000100,a2f,recvmsg
1,01698847900,01698855000,00000007100,a17,select
1,01698858700,01698858800,00000000100,a2f,recvmsg
1,01698859400,01698867300,00000007900,a17,select
1,01698871000,01698871200,00000000200,a2f,recvmsg
1,01698871800,01698880100,00000008300,a17,select
1,01698883700,01698883900,00000000200,a2f,recvmsg
1,01698884500,01698892500,00000008000,a17,select
1,01698896200,01698896300,00000000100,a2f,recvmsg
1,01698896800,01698904300,00000007500,a17,select
1,01698907800,01698908000,00000000200,a2f,recvmsg
1,01698908500,01698915800,00000007300,a17,select
1,01698919600,01698919800,00000000200,a2f,recvmsg
1,01698920400,01698927300,00000006900,a17,select
1,01698931000,01698931000,00000000000,a2f,recvmsg
1,01698931600,01698939300,00000007700,a17,select
1,01698943000,01698943200,00000000200,a2f,recvmsg
1,01698943700,01698959900,00000016200,a17,select
1,01698963500,01698963700,00000000200,a2f,recvmsg
1,01698964300,01698994400,00000030100,a17,select
1,01698998200,01698998300,00000000100,a2f,recvmsg
1,01698998900,01699016600,00000017700,a17,select
1,01699020200,01699020300,00000000100,a2f,recvmsg
1,01699020800,01699027900,00000007100,a17,select
1,01699031500,01699031700,00000000200,a2f,recvmsg
1,01699032200,01699038900,00000006700,a17,select
1,01699042300,01699042500,00000000200,a2f,recvmsg
1,01699043000,01699050000,00000007000,a17,select
1,01699053500,01699053700,00000000200,a2f,recvmsg
1,01699054300,01699061100,00000006800,a17,select
1,01699064700,01699064900,00000000200,a2f,recvmsg
1,01699065400,01699072400,00000007000,a17,select
1,01699076000,01699076200,00000000200,a2f,recvmsg
1,01699076800,01699083600,00000006800,a17,select
1,01699087100,01699087300,00000000200,a2f,recvmsg
1,01699087800,01699095300,00000007500,a17,select
1,01699099000,01699099200,00000000200,a2f,recvmsg
1,01699099700,01699106900,00000007200,a17,select
1,01699110400,01699110600,00000000200,a2f,recvmsg
1,01699111100,01699119800,00000008700,a17,select
1,01699123600,01699123800,00000000200,a2f,recvmsg
1,01699124300,01699133500,00000009200,a17,select
1,01699137300,01699137400,00000000100,a2f,recvmsg
1,01699138000,01699145600,00000007600,a17,select
1,01699149000,01699149200,00000000200,a2f,recvmsg
1,01699149600,01699156900,00000007300,a17,select
1,01699160400,01699160500,00000000100,a2f,recvmsg
1,01699161000,01699168300,00000007300,a17,select
1,01699171700,01699171900,00000000200,a2f,recvmsg
1,01699172300,01699179500,00000007200,a17,select
1,01699183100,01699183300,00000000200,a2f,recvmsg
1,01699183800,01699191600,00000007800,a17,select
1,01699195200,01699195400,00000000200,a2f,recvmsg
1,01699195900,01699203100,00000007200,a17,select
1,01699206600,01699206800,00000000200,a2f,recvmsg
1,01699207400,01699214600,00000007200,a17,select
1,01699218100,01699218300,00000000200,a2f,recvmsg
1,01699218900,01699240900,00000022000,a17,select
1,01699244900,01699245100,00000000200,a2f,recvmsg
1,01699245700,01699253800,00000008100,a17,select
1,01699257400,01699257600,00000000200,a2f,recvmsg
1,01699258000,01699265300,00000007300,a17,select
1,01699268800,01699269000,00000000200,a2f,recvmsg
1,01699269400,01699277300,00000007900,a17,select
1,01699281100,01699281300,00000000200,a2f,recvmsg
1,01699281800,01699289100,00000007300,a17,select
1,01699292600,01699292800,00000000200,a2f,recvmsg
1,01699293300,01699300700,00000007400,a17,select
1,01699304200,01699304400,00000000200,a2f,recvmsg
1,01699304900,01699312100,00000007200,a17,select
1,01699315900,01699316100,00000000200,a2f,recvmsg
1,01699316600,01699329000,00000012400,a17,select
1,01699332700,01699332900,00000000200,a2f,recvmsg
1,01699333400,01699340800,00000007400,a17,select
1,01699344300,01699344500,00000000200,a2f,recvmsg
1,01699345000,01699352200,00000007200,a17,select
1,01699355900,01699356000,00000000100,a2f,recvmsg
1,01699356600,01699363900,00000007300,a17,select
1,01699367600,01699367700,00000000100,a2f,recvmsg
1,01699368200,01699375600,00000007400,a17,select
1,01699379300,01699379400,00000000100,a2f,recvmsg
1,01699379900,01699442100,00000062200,a17,select
1,01699443200,01699444400,00000001200,a2f,recvmsg
1,01699538100,01699542200,00000004100,a14,writev
1,01699620700,01699623100,00000002400,a14,writev
1,01699685000,01699686400,00000001400,a14,writev
1,01699744800,01699746300,00000001500,a14,writev
1,01699802200,01699803600,00000001400,a14,writev
1,01699860000,01699861400,00000001400,a14,writev
1,01699864500,01699865500,00000001000,a2f,recvmsg
1,01699916300,01699917900,00000001600,a14,writev
1,01699963300,01699964800,00000001500,a14,writev
1,01700008500,01700010000,00000001500,a14,writev
1,01700053600,01700055400,00000001800,a14,writev
1,01700098500,01700099900,00000001400,a14,writev
1,01700143900,01700145300,00000001400,a14,writev
1,01700171500,01700173600,00000002100,a2f,recvmsg
1,01700201300,01700202800,00000001500,a14,writev
1,01700220300,01700221700,00000001400,a14,writev
1,01700238200,01700239600,00000001400,a14,writev
1,01700255300,01700256800,00000001500,a14,writev
1,01700270900,01700272300,00000001400,a14,writev
1,01700286800,01700288200,00000001400,a14,writev
1,01700294200,01700294400,00000000200,a2f,recvmsg
1,01700295200,01700295500,00000000300,a14,writev
1,01700314500,01700316300,00000001800,a14,writev
1,01700316500,01700318300,00000001800,a14,writev
1,01700318900,01700319100,00000000200,a2f,recvmsg
1,01700332000,01700333400,00000001400,a14,writev
1,01700333700,01700333800,00000000100,a2f,recvmsg
1,01700344400,01700345900,00000001500,a14,writev
1,01700346100,01700347300,00000001200,a14,writev
1,01700347600,01700347800,00000000200,a2f,recvmsg
1,01687507300,01700356000,00012848700,a07,poll
1,01700361900,01700365800,00000003900,a2f,recvmsg
1,01700371500,01700371700,00000000200,a2f,recvmsg
1,01700375700,01700376100,00000000400,a2f,recvmsg
1,01700376500,01700376600,00000000100,a2f,recvmsg
1,01700381700,01700382000,00000000300,a2f,recvmsg
1,01700382300,01700382400,00000000100,a2f,recvmsg
1,01700383100,01700388200,00000005100,a07,poll
1,01700394200,01700401200,00000007000,a2f,recvmsg
1,01700414300,01700414500,00000000200,a2f,recvmsg
1,01700441200,01700444000,00000002800,a07,poll
1,01700445500,01700452100,00000006600,a2f,recvmsg
1,01700462100,01700463200,00000001100,a2d,recvfrom
1,01700469100,01700469300,00000000200,a2f,recvmsg
1,01700470000,01700470200,00000000200,a2f,recvmsg
1,01700508600,01700509000,00000000400,a2f,recvmsg
1,01700511900,01700512100,00000000200,a2f,recvmsg
1,01700348300,01700525100,00000176800,a17,select
1,01700542200,01700543600,00000001400,a14,writev
1,01700544100,01700544200,00000000100,a2f,recvmsg
1,01700561000,01700561200,00000000200,a2f,recvmsg
1,01700516900,01700566600,00000049700,a07,poll
1,01700572700,01700572900,00000000200,a2f,recvmsg
1,01700574900,01700575100,00000000200,a2f,recvmsg
1,01700575400,01700575600,00000000200,a2f,recvmsg
1,01700577600,01700577800,00000000200,a2f,recvmsg
1,01700577900,01700578100,00000000200,a2f,recvmsg
1,01700578500,01701370600,00000792100,a07,poll
1,01701395000,01701399100,00000004100,a2e,sendmsg
1,01685556800,01701402900,00015846100,ae8,epoll_wait
1,01701414300,01701415900,00000001600,a2f,recvmsg
1,01701431700,01701432100,00000000400,a2f,recvmsg
1,01701458300,01701462200,00000003900,a2e,sendmsg
1,01701479800,01701480300,00000000500,a00,read
1,01701485800,01701488100,00000002300,a2e,sendmsg
1,01701467200,01701489900,00000022700,ae8,epoll_wait
1,01701493700,01701494800,00000001100,a2f,recvmsg
1,01701506000,01701506200,00000000200,a2f,recvmsg
1,01701516800,01701517700,00000000900,a2e,sendmsg
1,01701548000,01701562800,00000014800,a07,poll
1,01701623300,01701625200,00000001900,aca,futex
1,01701742400,01701743300,00000000900,a2f,recvmsg
1,01702092300,01702093300,00000001000,a2f,recvmsg
1,01700561700,01703056500,00002494800,a17,select
1,01703074800,01703075000,00000000200,a2f,recvmsg
1,01703089500,01703089700,00000000200,a2f,recvmsg
1,01703090200,01703151100,00000060900,a17,select
1,01703156000,01703156300,00000000300,a2f,recvmsg
0,01621576100,01621576300,00000000200,a0c,brk
0,01621587200,01621590000,00000002800,a15,access
0,01621590600,01621591600,00000001000,a09,mmap
0,01621596900,01621597800,00000000900,a15,access
0,01621603700,01621604900,00000001200,a09,mmap
0,01621608600,01621609200,00000000600,a15,access
0,01621615800,01621616900,00000001100,a00,read
0,01621624400,01621626500,00000002100,a09,mmap
0,01621639000,01621640000,00000001000,a15,access
0,01621643200,01621643800,00000000600,a00,read
0,01621644600,01621645400,00000000800,a09,mmap
0,01621647500,01621648800,00000001300,a09,mmap
0,01621657300,01621658000,00000000700,a15,access
0,01621661000,01621661600,00000000600,a00,read
0,01621662400,01621663200,00000000800,a09,mmap
0,01621664800,01621666900,00000002100,a09,mmap
0,01621675700,01621676700,00000001000,a09,mmap
0,01621687000,01621687500,00000000500,a15,access
0,01621690000,01621690700,00000000700,a00,read
0,01621691300,01621692800,00000001500,a09,mmap
0,01621695300,01621697000,00000001700,a09,mmap
0,01621705100,01621705700,00000000600,a15,access
0,01621708800,01621709600,00000000800,a00,read
0,01621710200,01621711700,00000001500,a09,mmap
0,01621714700,01621716900,00000002200,a09,mmap
0,01621725400,01621726000,00000000600,a15,access
0,01621728500,01621729100,00000000600,a00,read
0,01621729500,01621730600,00000001100,a09,mmap
0,01621731900,01621733300,00000001400,a09,mmap
0,01621736000,01621737200,00000001200,a09,mmap
0,01621743700,01621744200,00000000500,a15,access
0,01621746600,01621747100,00000000500,a00,read
0,01621747700,01621749200,00000001500,a09,mmap
0,01621751100,01621752900,00000001800,a09,mmap
0,01621766600,01621767100,00000000500,a09,mmap
0,01621770900,01621771200,00000000300,a09,mmap
0,01621772400,01621772600,00000000200,a09,mmap
0,01621950400,01621950500,00000000100,a0c,brk
0,01621950600,01621951400,00000000800,a0c,brk
0,01621982600,01621987400,00000004800,a00,read
0,01621998700,01622000100,00000001400,a00,read
0,01622038500,01622039600,00000001100,a00,read
0,01622158900,01622159700,00000000800,a00,read
0,01622230200,01622230600,00000000400,a00,read
0,01622315200,01622315800,00000000600,a00,read
0,01622445400,01622446300,00000000900,a00,read
0,01622574700,01622575400,00000000700,a00,read
0,01622731400,01622732000,00000000600,a00,read
0,01622881400,01622882000,00000000600,a00,read
0,01622918300,01622919600,00000001300,a0c,brk
0,01623035800,01623036500,00000000700,a00,read
0,01623184300,01623185000,00000000700,a00,read
0,01623339100,01623339800,00000000700,a00,read
0,01623500300,01623501000,00000000700,a00,read
0,01623609400,01623609900,00000000500,a00,read
0,01623640300,01623640900,00000000600,a0c,brk
0,01623750800,01623751500,00000000700,a00,read
0,01623991800,01623992500,00000000700,a00,read
0,01624004100,01624004500,00000000400,a00,read
0,01624047800,01624048200,00000000400,a00,read
0,01624067600,01624068200,00000000600,a00,read
0,01624275300,01624275800,00000000500,a00,read
0,01624304800,01624305700,00000000900,a00,read
0,01624405300,01624406000,00000000700,a00,read
0,01624429700,01624430800,00000001100,a0c,brk
0,01624475700,01624476100,00000000400,a00,read
0,01624551200,01624552000,00000000800,a00,read
0,01624704300,01624704700,00000000400,a00,read
0,01624739300,01624763400,00000024100,60e,page_fault
0,01624842000,01624842700,00000000700,a00,read
0,01624936400,01624936800,00000000400,a00,read
0,01624948700,01624949200,00000000500,a00,read
0,01625032600,01625033000,00000000400,a00,read
0,01625059300,01625059600,00000000300,a00,read
0,01625081900,01625082400,00000000500,a00,read
0,01625183200,01625184400,00000001200,a0c,brk
0,01625186500,01625187500,00000001000,a00,read
0,01625387100,01625387600,00000000500,a00,read
0,01625470600,01625471200,00000000600,a00,read
0,01625535700,01625536300,00000000600,a00,read
0,01625663900,01625664300,00000000400,a00,read
0,01625696000,01625696500,00000000500,a00,read
0,01625712900,01625714800,00000001900,a02,open
0,01625827600,01625828200,00000000600,a00,read
0,01625898200,01625898600,00000000400,a00,read
0,01625950700,01625951800,00000001100,a0c,brk
0,01625957900,01625958500,00000000600,a00,read
0,01626068800,01626069400,00000000600,a00,read
0,01626219200,01626220200,00000001000,a00,read
0,01626350200,01626350900,00000000700,a00,read
0,01626408700,01626409400,00000000700,a00,read
0,01626464700,01626465500,00000000800,a00,read
0,01626534900,01626535600,00000000700,a00,read
0,01626589900,01626590600,00000000700,a00,read
0,01626678500,01626679800,00000001300,a0c,brk
0,01626711800,01626714800,00000003000,a0c,brk
0,01626729300,01626730200,00000000900,a00,read
0,01626846500,01626847500,00000001000,a00,read
0,01627013400,01627014200,00000000800,a00,read
0,01627136400,01627137200,00000000800,a00,read
0,01627294100,01627295100,00000001000,a00,read
0,01627419600,01627420700,00000001100,a00,read
0,01627595100,01627596200,00000001100,a00,read
0,01627601700,01627603700,00000002000,a0c,brk
0,01627726000,01627727200,00000001200,a00,read
0,01627851600,01627852400,00000000800,a00,read
0,01627999200,01628000000,00000000800,a00,read
0,01628137000,01628137600,00000000600,a00,read
0,01628235100,01628235900,00000000800,a00,read
0,01628352400,01628353100,00000000700,a00,read
0,01628483100,01628483800,00000000700,a00,read
0,01628624400,01628625100,00000000700,a00,read
0,01628811500,01628812200,00000000700,a00,read
0,01628968200,01628968900,00000000700,a00,read
0,01629083400,01629084200,00000000800,a00,read
0,01629267400,01629268200,00000000800,a00,read
0,01629348800,01629349500,00000000700,a00,read
0,01629435000,01629435600,00000000600,a00,read
0,01629505800,01629507100,00000001300,a0c,brk
0,01629521100,01629521800,00000000700,a00,read
0,01629597400,01629598100,00000000700,a00,read
0,01629703700,01629704400,00000000700,a00,read
0,01629810900,01629811500,00000000600,a00,read
0,01629904300,01629904800,00000000500,a00,read
0,01629989700,01629990600,00000000900,a00,read
0,01630095700,01630096400,00000000700,a00,read
0,01630180200,01630180800,00000000600,a0c,brk
0,01630183500,01630184000,00000000500,a00,read
0,01630295000,01630295800,00000000800,a00,read
0,01630391400,01630392100,00000000700,a00,read
0,01630515300,01630515900,00000000600,a00,read
0,01630634900,01630635600,00000000700,a00,read
0,01630741800,01630742500,00000000700,a00,read
0,01630845700,01630846300,00000000600,a0c,brk
0,01631218300,01631221300,00000003000,a57,unlink
0,01631240900,01631241600,00000000700,a48,fcntl
0,01631291800,01631302500,00000010700,a01,write
0,01631320500,01631322900,00000002400,a01,write
0,01631339200,01631341600,00000002400,a01,write
0,01631084300,01631580900,00000496600,a17,select
0,01631602800,01631603000,00000000200,a2f,recvmsg
0,01631606600,01631626300,00000019700,a17,select
0,01631630100,01631630300,00000000200,a2f,recvmsg
0,01631630900,01631644300,00000013400,a17,select
0,01631647800,01631648000,00000000200,a2f,recvmsg
0,01631648600,01631663500,00000014900,a17,select
0,01631667200,01631667400,00000000200,a2f,recvmsg
0,01631667800,01631682800,00000015000,a17,select
0,01631686900,01631687000,00000000100,a2f,recvmsg
0,01631687600,01631700500,00000012900,a17,select
0,01631704300,01631704400,00000000100,a2f,recvmsg
0,01631705000,01631721800,00000016800,a17,select
0,01631725800,01631726000,00000000200,a2f,recvmsg
0,01631726600,01631736100,00000009500,a17,select
0,01631739700,01631739800,00000000100,a2f,recvmsg
0,01631740300,01631747700,00000007400,a17,select
0,01631751400,01631751500,00000000100,a2f,recvmsg
0,01631752000,01631759600,00000007600,a17,select
0,01631763000,01631763200,00000000200,a2f,recvmsg
0,01631763700,01631771400,00000007700,a17,select
0,01631775000,01631775200,00000000200,a2f,recvmsg
0,01631775800,01631784100,00000008300,a17,select
0,01631787700,01631787900,00000000200,a2f,recvmsg
0,01631788400,01631796500,00000008100,a17,select
0,01631800200,01631800400,00000000200,a2f,recvmsg
0,01631800800,01631808100,00000007300,a17,select
0,01631811700,01631811900,00000000200,a2f,recvmsg
0,01631812300,01631820800,00000008500,a17,select
0,01631824800,01631825000,00000000200,a2f,recvmsg
0,01631825500,01631833100,00000007600,a17,select
0,01631836800,01631836900,00000000100,a2f,recvmsg
0,01631837400,01631844900,00000007500,a17,select
0,01631848400,01631848600,00000000200,a2f,recvmsg
0,01631849100,01631856400,00000007300,a17,select
0,01631860000,01631860200,00000000200,a2f,recvmsg
0,01631860700,01631867800,00000007100,a17,select
0,01631871200,01631871400,00000000200,a2f,recvmsg
0,01631872000,01631879400,00000007400,a17,select
0,01631883000,01631883100,00000000100,a2f,recvmsg
0,01631883700,01631890900,00000007200,a17,select
0,01631894500,01631894700,00000000200,a2f,recvmsg
0,01631895200,01631902100,00000006900,a17,select
0,01631905700,01631905900,00000000200,a2f,recvmsg
0,01631906400,01631915600,00000009200,a17,select
0,01631919100,01631919300,00000000200,a2f,recvmsg
0,01631919800,01631926600,00000006800,a17,select
0,01631930300,01631930400,00000000100,a2f,recvmsg
0,01631931000,01631937800,00000006800,a17,select
0,01631941400,01631941400,00000000000,a2f,recvmsg
0,01631942000,01631948900,00000006900,a17,select
0,01631952600,01631952800,00000000200,a2f,recvmsg
0,01631953200,01631960500,00000007300,a17,select
0,01631964100,01631964200,00000000100,a2f,recvmsg
0,01631964800,01631971700,00000006900,a17,select
0,01631975200,01631975400,00000000200,a2f,recvmsg
0,01631975800,01631983500,00000007700,a17,select
0,01631987300,01631987500,00000000200,a2f,recvmsg
0,01631988000,01631995500,00000007500,a17,select
0,01631999300,01631999400,00000000100,a2f,recvmsg
0,01632000000,01632007900,00000007900,a17,select
0,01632011700,01632011800,00000000100,a2f,recvmsg
0,01632012300,01632020100,00000007800,a17,select
0,01632023500,01632023700,00000000200,a2f,recvmsg
0,01632024200,01632031900,00000007700,a17,select
0,01632035600,01632035800,00000000200,a2f,recvmsg
0,01632036300,01632045700,00000009400,a17,select
0,01632049400,01632049500,00000000100,a2f,recvmsg
0,01632050000,01632057300,00000007300,a17,select
0,01632061000,01632061100,00000000100,a2f,recvmsg
0,01632061600,01632068800,00000007200,a17,select
0,01632072500,01632072600,00000000100,a2f,recvmsg
0,01632073100,01632081100,00000008000,a17,select
0,01632084700,01632084900,00000000200,a2f,recvmsg
0,01632085400,01632093600,00000008200,a17,select
0,01632097200,01632097400,00000000200,a2f,recvmsg
0,01632097900,01632105900,00000008000,a17,select
0,01632109500,01632109700,00000000200,a2f,recvmsg
0,01632110300,01632117800,00000007500,a17,select
0,01632121600,01632121800,00000000200,a2f,recvmsg
0,01632122200,01632129500,00000007300,a17,select
0,01632133100,01632133200,00000000100,a2f,recvmsg
0,01632133700,01632140800,00000007100,a17,select
0,01632144200,01632144400,00000000200,a2f,recvmsg
0,01632144900,01632152300,00000007400,a17,select
0,01632156000,01632156100,00000000100,a2f,recvmsg
0,01632156600,01632172300,00000015700,a17,select
0,01632175900,01632176100,00000000200,a2f,recvmsg
0,01632176600,01632205500,00000028900,a17,select
0,01632209100,01632209300,00000000200,a2f,recvmsg
0,01632209800,01632227500,00000017700,a17,select
0,01632231100,01632231300,00000000200,a2f,recvmsg
0,01632231800,01632239000,00000007200,a17,select
0,01632242500,01632242600,00000000100,a2f,recvmsg
0,01632243200,01632250000,00000006800,a17,select
0,01632253600,01632253800,00000000200,a2f,recvmsg
0,01632254300,01632261200,00000006900,a17,select
0,01632264700,01632264900,00000000200,a2f,recvmsg
0,01632265400,01632272400,00000007000,a17,select
0,01632275900,01632276100,00000000200,a2f,recvmsg
0,01632276600,01632283500,00000006900,a17,select
0,01632287000,01632287200,00000000200,a2f,recvmsg
0,01632287700,01632294600,00000006900,a17,select
0,01632298000,01632298200,00000000200,a2f,recvmsg
0,01632298600,01632306300,00000007700,a17,select
0,01632310000,01632310100,00000000100,a2f,recvmsg
0,01632310600,01632317700,00000007100,a17,select
0,01632321400,01632321500,00000000100,a2f,recvmsg
0,01632322000,01632330700,00000008700,a17,select
0,01632334200,01632334400,00000000200,a2f,recvmsg
0,01632334800,01632344200,00000009400,a17,select
0,01632348000,01632348100,00000000100,a2f,recvmsg
0,01632348600,01632356200,00000007600,a17,select
0,01632359800,01632359900,00000000100,a2f,recvmsg
0,01632360500,01632367800,00000007300,a17,select
0,01632371300,01632371500,00000000200,a2f,recvmsg
0,01632372000,01632379200,00000007200,a17,select
0,01632382700,01632382800,00000000100,a2f,recvmsg
0,01632383400,01632390500,00000007100,a17,select
0,01632394100,01632394300,00000000200,a2f,recvmsg
0,01632394800,01632402400,00000007600,a17,select
0,01632405900,01632406100,00000000200,a2f,recvmsg
0,01632406700,01632413900,00000007200,a17,select
0,01632417400,01632417500,00000000100,a2f,recvmsg
0,01632418100,01632425200,00000007100,a17,select
0,01632428700,01632428900,00000000200,a2f,recvmsg
0,01632429400,01632436500,00000007100,a17,select
0,01632440000,01632440200,00000000200,a2f,recvmsg
0,01632440700,01632447900,00000007200,a17,select
0,01632451500,01632451700,00000000200,a2f,recvmsg
0,01632452200,01632459400,00000007200,a17,select
0,01632463000,01632463200,00000000200,a2f,recvmsg
0,01632463800,01632471500,00000007700,a17,select
0,01632475000,01632475200,00000000200,a2f,recvmsg
0,01632475700,01632482800,00000007100,a17,select
0,01632486200,01632486400,00000000200,a2f,recvmsg
0,01632486800,01632494000,00000007200,a17,select
0,01632497500,01632497700,00000000200,a2f,recvmsg
0,01632498100,01632505300,00000007200,a17,select
0,01632508800,01632508900,00000000100,a2f,recvmsg
0,01632509500,01632522200,00000012700,a17,select
0,01632525900,01632526000,00000000100,a2f,recvmsg
0,01632526600,01632533900,00000007300,a17,select
0,01632537400,01632537600,00000000200,a2f,recvmsg
0,01632538000,01632545300,00000007300,a17,select
0,01632548800,01632548900,00000000100,a2f,recvmsg
0,01632549400,01632556900,00000007500,a17,select
0,01632560300,01632560500,00000000200,a2f,recvmsg
0,01632560900,01632568300,00000007400,a17,select
0,01632571900,01632572000,00000000100,a2f,recvmsg
0,01632572500,01632626600,00000054100,a17,select
0,01632627500,01632628800,00000001300,a2f,recvmsg
0,01632717400,01632721200,00000003800,a14,writev
0,01632736800,01632755800,00000019000,a14,writev
0,01633048800,01633049600,00000000800,a2f,recvmsg
0,01633344000,01633345800,00000001800,a2f,recvmsg
0,01633459200,01633459500,00000000300,a2f,recvmsg
0,01633460100,01633460500,00000000400,a14,writev
0,01633479700,01633481800,00000002100,a14,writev
0,01633482000,01633483500,00000001500,a14,writev
0,01633484000,01633484200,00000000200,a2f,recvmsg
0,01642371100,01633490800,-0008880300,a07,poll
0,01633493700,01633495600,00000001900,a2f,recvmsg
0,01633499100,01633499300,00000000200,a2f,recvmsg
0,01633501500,01633501700,00000000200,a2f,recvmsg
0,01633501900,01633502100,00000000200,a2f,recvmsg
0,01633503900,01633504100,00000000200,a2f,recvmsg
0,01633504300,01633504500,00000000200,a2f,recvmsg
0,01633504900,01633509000,00000004100,a07,poll
0,01633513200,01633518800,00000005600,a2f,recvmsg
0,01633530100,01633530300,00000000200,a2f,recvmsg
0,01633555500,01633560400,00000004900,a07,poll
0,01633566100,01633571900,00000005800,a2f,recvmsg
0,01633583700,01633584000,00000000300,a2f,recvmsg
0,01633605900,01633610500,00000004600,a07,poll
0,01633616300,01633621900,00000005600,a2f,recvmsg
0,01633634800,01633635000,00000000200,a2f,recvmsg
0,01633484900,01633662100,00000177200,a17,select
0,01633678700,01633680200,00000001500,a14,writev
0,01633680700,01633680900,00000000200,a2f,recvmsg
0,01633694500,01633695700,00000001200,a14,writev
0,01633696000,01633696200,00000000200,a2f,recvmsg
0,01633708200,01633709100,00000000900,a14,writev
0,01633709400,01633709600,00000000200,a2f,recvmsg
0,01633723600,01633723800,00000000200,a2f,recvmsg
0,01633656800,01633728500,00000071700,a07,poll
0,01633732200,01633732400,00000000200,a2f,recvmsg
0,01633733900,01633734000,00000000100,a2f,recvmsg
0,01633734300,01633734400,00000000100,a2f,recvmsg
0,01633735700,01633735900,00000000200,a2f,recvmsg
0,01633736100,01633736200,00000000100,a2f,recvmsg
0,01633736700,01633738200,00000001500,a07,poll
0,01633738800,01633739800,00000001000,a2f,recvmsg
0,01633745100,01633746200,00000001100,a2d,recvfrom
0,01633747100,01633747300,00000000200,a2f,recvmsg
0,01633748000,01633748100,00000000100,a2f,recvmsg
0,01633789500,01633789800,00000000300,a2f,recvmsg
0,01633791900,01633792000,00000000100,a2f,recvmsg
0,01633794400,01633796200,00000001800,a07,poll
0,01633796800,01633797800,00000001000,a2f,recvmsg
0,01633803900,01633804600,00000000700,a2d,recvfrom
0,01633805400,01633805600,00000000200,a2f,recvmsg
0,01633806300,01633806400,00000000100,a2f,recvmsg
0,01633836300,01633836600,00000000300,a2f,recvmsg
0,01633838500,01633838600,00000000100,a2f,recvmsg
0,01633724400,01635636900,00001912500,a17,select
0,01635650000,01635650200,00000000200,a2f,recvmsg
0,01635651900,01635661500,00000009600,a17,select
0,01635665500,01635665700,00000000200,a2f,recvmsg
0,01635666300,01635714300,00000048000,a17,select
0,01635717700,01635717900,00000000200,a2f,recvmsg
0,01614575800,01646308300,00031732500,a3d,wait4
0,01646330700,01646332500,00000001800,a00,read
0,01646334600,01646335000,00000000400,a00,read
0,01646356700,01646409100,00000052400,a07,poll
0,01646415200,01646415500,00000000300,a2f,recvmsg
0,01646416300,01646416400,00000000100,a2f,recvmsg
0,01646424300,01646439600,00000015300,a07,poll
0,01646441800,01646442000,00000000200,a2f,recvmsg
0,01646442300,01646442500,00000000200,a2f,recvmsg
0,01646447900,01646461400,00000013500,a07,poll
0,01646463600,01646463800,00000000200,a2f,recvmsg
0,01646464200,01646464300,00000000100,a2f,recvmsg
0,01646469400,01646482700,00000013300,a07,poll
0,01646484700,01646484900,00000000200,a2f,recvmsg
0,01646485300,01646485500,00000000200,a2f,recvmsg
0,01646490200,01646503500,00000013300,a07,poll
0,01646505600,01646505800,00000000200,a2f,recvmsg
0,01646506200,01646506400,00000000200,a2f,recvmsg
0,01646509600,01646522900,00000013300,a07,poll
0,01646525000,01646525200,00000000200,a2f,recvmsg
0,01646525600,01646525800,00000000200,a2f,recvmsg
0,01646526600,01646526900,00000000300,a08,lseek
0,01646538600,01646538700,00000000100,a08,lseek
0,01646542000,01646548900,00000006900,a07,poll
0,01646550200,01646550400,00000000200,a2f,recvmsg
0,01646550600,01646550800,00000000200,a2f,recvmsg
0,01646556200,01646562900,00000006700,a07,poll
0,01646564000,01646564200,00000000200,a2f,recvmsg
0,01646564600,01646564700,00000000100,a2f,recvmsg
0,01646567800,01646574700,00000006900,a07,poll
0,01646575900,01646576100,00000000200,a2f,recvmsg
0,01646576400,01646576600,00000000200,a2f,recvmsg
0,01646580100,01646586600,00000006500,a07,poll
0,01646587900,01646588100,00000000200,a2f,recvmsg
0,01646588400,01646588500,00000000100,a2f,recvmsg
0,01646592300,01646599300,00000007000,a07,poll
0,01646600500,01646600600,00000000100,a2f,recvmsg
0,01646601000,01646601100,00000000100,a2f,recvmsg
0,01646604500,01646611100,00000006600,a07,poll
0,01646612200,01646612400,00000000200,a2f,recvmsg
0,01646612700,01646612900,00000000200,a2f,recvmsg
0,01646616000,01646623100,00000007100,a07,poll
0,01646624300,01646624500,00000000200,a2f,recvmsg
0,01646624700,01646624900,00000000200,a2f,recvmsg
0,01646628100,01646634600,00000006500,a07,poll
0,01646635800,01646635900,00000000100,a2f,recvmsg
0,01646636200,01646636400,00000000200,a2f,recvmsg
0,01646640600,01646647700,00000007100,a07,poll
0,01646648900,01646649100,00000000200,a2f,recvmsg
0,01646649300,01646649500,00000000200,a2f,recvmsg
0,01646652900,01646659600,00000006700,a07,poll
0,01646660700,01646660800,00000000100,a2f,recvmsg
0,01646661200,01646661300,00000000100,a2f,recvmsg
0,01646665100,01646671900,00000006800,a07,poll
0,01646673000,01646673200,00000000200,a2f,recvmsg
0,01646673500,01646673700,00000000200,a2f,recvmsg
0,01646676800,01646683500,00000006700,a07,poll
0,01646684800,01646685000,00000000200,a2f,recvmsg
0,01646685300,01646685400,00000000100,a2f,recvmsg
0,01646688700,01646695100,00000006400,a07,poll
0,01646696300,01646696400,00000000100,a2f,recvmsg
0,01646696800,01646696900,00000000100,a2f,recvmsg
0,01646700100,01646706800,00000006700,a07,poll
0,01646708000,01646708200,00000000200,a2f,recvmsg
0,01646708400,01646708600,00000000200,a2f,recvmsg
0,01646711700,01646718500,00000006800,a07,poll
0,01646719600,01646719800,00000000200,a2f,recvmsg
0,01646720100,01646720300,00000000200,a2f,recvmsg
0,01646723100,01646730000,00000006900,a07,poll
0,01646731100,01646731300,00000000200,a2f,recvmsg
0,01646731600,01646731800,00000000200,a2f,recvmsg
0,01646736400,01646743000,00000006600,a07,poll
0,01646744200,01646744300,00000000100,a2f,recvmsg
0,01646744600,01646744800,00000000200,a2f,recvmsg
0,01646747400,01646754300,00000006900,a07,poll
0,01646755500,01646755700,00000000200,a2f,recvmsg
0,01646755900,01646756100,00000000200,a2f,recvmsg
0,01646758900,01646765600,00000006700,a07,poll
0,01646766800,01646767000,00000000200,a2f,recvmsg
0,01646767200,01646767400,00000000200,a2f,recvmsg
0,01646770100,01646776700,00000006600,a07,poll
0,01646777900,01646778000,00000000100,a2f,recvmsg
0,01646778400,01646778500,00000000100,a2f,recvmsg
0,01646781400,01646788100,00000006700,a07,poll
0,01646789300,01646789500,00000000200,a2f,recvmsg
0,01646789800,01646789900,00000000100,a2f,recvmsg
0,01646792800,01646799400,00000006600,a07,poll
0,01646800600,01646800700,00000000100,a2f,recvmsg
0,01646801100,01646801300,00000000200,a2f,recvmsg
0,01646804500,01646811200,00000006700,a07,poll
0,01646812400,01646812600,00000000200,a2f,recvmsg
0,01646812800,01646813000,00000000200,a2f,recvmsg
0,01646816300,01646823100,00000006800,a07,poll
0,01646824200,01646824400,00000000200,a2f,recvmsg
0,01646824700,01646824900,00000000200,a2f,recvmsg
0,01646828700,01646835700,00000007000,a07,poll
0,01646836900,01646837100,00000000200,a2f,recvmsg
0,01646837400,01646837500,00000000100,a2f,recvmsg
0,01646841200,01646847900,00000006700,a07,poll
0,01646849000,01646849200,00000000200,a2f,recvmsg
0,01646849500,01646849700,00000000200,a2f,recvmsg
0,01646852900,01646859900,00000007000,a07,poll
0,01646861000,01646861200,00000000200,a2f,recvmsg
0,01646861500,01646861700,00000000200,a2f,recvmsg
0,01646867000,01646873700,00000006700,a07,poll
0,01646874900,01646875100,00000000200,a2f,recvmsg
0,01646875400,01646875500,00000000100,a2f,recvmsg
0,01646878500,01646885100,00000006600,a07,poll
0,01646886300,01646886500,00000000200,a2f,recvmsg
0,01646886800,01646886900,00000000100,a2f,recvmsg
0,01646890000,01646896700,00000006700,a07,poll
0,01646897900,01646898000,00000000100,a2f,recvmsg
0,01646898300,01646898500,00000000200,a2f,recvmsg
0,01646902300,01646909100,00000006800,a07,poll
0,01646910300,01646910500,00000000200,a2f,recvmsg
0,01646910800,01646911000,00000000200,a2f,recvmsg
0,01646915200,01646921900,00000006700,a07,poll
0,01646923000,01646923100,00000000100,a2f,recvmsg
0,01646923500,01646923600,00000000100,a2f,recvmsg
0,01646927300,01646934300,00000007000,a07,poll
0,01646935500,01646935700,00000000200,a2f,recvmsg
0,01646936000,01646936200,00000000200,a2f,recvmsg
0,01646939400,01646946200,00000006800,a07,poll
0,01646947300,01646947500,00000000200,a2f,recvmsg
0,01646947700,01646947900,00000000200,a2f,recvmsg
0,01646951000,01646957700,00000006700,a07,poll
0,01646958900,01646959000,00000000100,a2f,recvmsg
0,01646959300,01646959500,00000000200,a2f,recvmsg
0,01646962400,01646969100,00000006700,a07,poll
0,01646971000,01646971200,00000000200,a2f,recvmsg
0,01646971500,01646971700,00000000200,a2f,recvmsg
0,01646975100,01646981900,00000006800,a07,poll
0,01646983100,01646983200,00000000100,a2f,recvmsg
0,01646983500,01646983700,00000000200,a2f,recvmsg
0,01646984600,01646984800,00000000200,a08,lseek
0,01646987400,01646988600,00000001200,a00,read
0,01646992300,01646992400,00000000100,a08,lseek
0,01646995200,01647001800,00000006600,a07,poll
0,01647003100,01647003200,00000000100,a2f,recvmsg
0,01647003600,01647003800,00000000200,a2f,recvmsg
0,01647030100,01647036900,00000006800,a07,poll
0,01647038400,01647038600,00000000200,a2f,recvmsg
0,01647038800,01647039000,00000000200,a2f,recvmsg
0,01647042800,01647043600,00000000800,a00,read
0,01647049000,01647049100,00000000100,a08,lseek
0,01647052200,01647058900,00000006700,a07,poll
0,01647060100,01647060300,00000000200,a2f,recvmsg
0,01647060700,01647060800,00000000100,a2f,recvmsg
0,01647063500,01647070200,00000006700,a07,poll
0,01647071300,01647071400,00000000100,a2f,recvmsg
0,01647071800,01647071900,00000000100,a2f,recvmsg
0,01647074700,01647081300,00000006600,a07,poll
0,01647082400,01647082500,00000000100,a2f,recvmsg
0,01647082800,01647083000,00000000200,a2f,recvmsg
0,01647085900,01647092500,00000006600,a07,poll
0,01647093700,01647093900,00000000200,a2f,recvmsg
0,01647094100,01647094300,00000000200,a2f,recvmsg
0,01647097100,01647103600,00000006500,a07,poll
0,01647104800,01647105000,00000000200,a2f,recvmsg
0,01647105300,01647105400,00000000100,a2f,recvmsg
0,01647108000,01647114800,00000006800,a07,poll
0,01647116000,01647116200,00000000200,a2f,recvmsg
0,01647116500,01647116700,00000000200,a2f,recvmsg
0,01647119400,01647126200,00000006800,a07,poll
0,01647127200,01647127400,00000000200,a2f,recvmsg
0,01647127700,01647127900,00000000200,a2f,recvmsg
0,01647131200,01647137900,00000006700,a07,poll
0,01647139100,01647139300,00000000200,a2f,recvmsg
0,01647139500,01647139700,00000000200,a2f,recvmsg
0,01647142500,01647149200,00000006700,a07,poll
0,01647150400,01647150600,00000000200,a2f,recvmsg
0,01647150900,01647151000,00000000100,a2f,recvmsg
0,01647151400,01647151500,00000000100,a08,lseek
0,01647155500,01647162300,00000006800,a07,poll
0,01647163500,01647163700,00000000200,a2f,recvmsg
0,01647164000,01647164200,00000000200,a2f,recvmsg
0,01647169000,01647175800,00000006800,a07,poll
0,01647177000,01647177200,00000000200,a2f,recvmsg
0,01647177500,01647177600,00000000100,a2f,recvmsg
0,01647181000,01647187600,00000006600,a07,poll
0,01647188800,01647188900,00000000100,a2f,recvmsg
0,01647189200,01647189400,00000000200,a2f,recvmsg
0,01647192600,01647199100,00000006500,a07,poll
0,01647200300,01647200300,00000000000,a2f,recvmsg
0,01647200700,01647200900,00000000200,a2f,recvmsg
0,01647203900,01647210500,00000006600,a07,poll
0,01647211700,01647211700,00000000000,a2f,recvmsg
0,01647212000,01647212200,00000000200,a2f,recvmsg
0,01647215200,01647221900,00000006700,a07,poll
0,01647223000,01647223100,00000000100,a2f,recvmsg
0,01647223400,01647223600,00000000200,a2f,recvmsg
0,01647227000,01647233800,00000006800,a07,poll
0,01647234800,01647235000,00000000200,a2f,recvmsg
0,01647235300,01647235500,00000000200,a2f,recvmsg
0,01647238400,01647245000,00000006600,a07,poll
0,01647246100,01647246200,00000000100,a2f,recvmsg
0,01647246500,01647246700,00000000200,a2f,recvmsg
0,01647249600,01647256400,00000006800,a07,poll
0,01647257500,01647257700,00000000200,a2f,recvmsg
0,01647258000,01647258200,00000000200,a2f,recvmsg
0,01647261300,01647267900,00000006600,a07,poll
0,01647269000,01647269200,00000000200,a2f,recvmsg
0,01647269500,01647269700,00000000200,a2f,recvmsg
0,01647272600,01647279400,00000006800,a07,poll
0,01647280500,01647280700,00000000200,a2f,recvmsg
0,01647281000,01647281200,00000000200,a2f,recvmsg
0,01647284200,01647290800,00000006600,a07,poll
0,01647292000,01647292200,00000000200,a2f,recvmsg
0,01647292500,01647292700,00000000200,a2f,recvmsg
0,01647296400,01647303100,00000006700,a07,poll
0,01647304300,01647304500,00000000200,a2f,recvmsg
0,01647304800,01647304900,00000000100,a2f,recvmsg
0,01647307900,01647314500,00000006600,a07,poll
0,01647315700,01647315900,00000000200,a2f,recvmsg
0,01647316200,01647316300,00000000100,a2f,recvmsg
0,01647319200,01647325800,00000006600,a07,poll
0,01647327000,01647327200,00000000200,a2f,recvmsg
0,01647327500,01647327600,00000000100,a2f,recvmsg
0,01647330700,01647337200,00000006500,a07,poll
0,01647338400,01647338600,00000000200,a2f,recvmsg
0,01647338900,01647339000,00000000100,a2f,recvmsg
0,01647347500,01647354200,00000006700,a07,poll
0,01647355400,01647355600,00000000200,a2f,recvmsg
0,01647355900,01647356100,00000000200,a2f,recvmsg
0,01647359200,01647365700,00000006500,a07,poll
0,01647366900,01647367100,00000000200,a2f,recvmsg
0,01647367400,01647367500,00000000100,a2f,recvmsg
0,01647370600,01647377200,00000006600,a07,poll
0,01647378500,01647378700,00000000200,a2f,recvmsg
0,01647378900,01647379000,00000000100,a2f,recvmsg
0,01647382200,01647388800,00000006600,a07,poll
0,01647389900,01647390100,00000000200,a2f,recvmsg
0,01647390300,01647390500,00000000200,a2f,recvmsg
0,01647393800,01647400300,00000006500,a07,poll
0,01647401600,01647401700,00000000100,a2f,recvmsg
0,01647401900,01647402100,00000000200,a2f,recvmsg
0,01647422300,01647449400,00000027100,a57,unlink
0,01647450800,01647454800,00000004000,a14,writev
0,01647455400,01647560200,00000104800,a07,poll
0,01647455400,01647568900,00000113500,a07,poll
0,01647580600,01647580800,00000000200,a2f,recvmsg
0,01647624000,01647624100,00000000100,a2f,recvmsg
0,01647645700,01647647500,00000001800,a14,writev
0,01647644000,01647648800,00000004800,a07,poll
0,01647653200,01647709300,00000056100,a07,poll
0,01647710400,01647712200,00000001800,a07,poll
0,01647713700,01647769600,00000055900,a07,poll
0,01647771000,01647772500,00000001500,a07,poll
0,01647774100,01647829800,00000055700,a07,poll
0,01647831200,01647832800,00000001600,a07,poll
0,01647834300,01647890500,00000056200,a07,poll
0,01647834300,01647892900,00000058600,a07,poll
0,01647895700,01647945900,00000050200,a07,poll
0,01647946000,01647947000,00000001000,a2f,recvmsg
0,01647895700,01647948000,00000052300,a07,poll
0,01647950700,01647991300,00000040600,a07,poll
0,01647991400,01647992400,00000001000,a2f,recvmsg
0,01647950700,01647993300,00000042600,a07,poll
0,01647996400,01648036900,00000040500,a07,poll
0,01648037000,01648038200,00000001200,a2f,recvmsg
0,01647996400,01648039000,00000042600,a07,poll
0,01648041500,01648081800,00000040300,a07,poll
0,01648081900,01648082900,00000001000,a2f,recvmsg
0,01648041500,01648083800,00000042300,a07,poll
0,01648086600,01648125900,00000039300,a07,poll
0,01648126000,01648127100,00000001100,a2f,recvmsg
0,01648086600,01648127900,00000041300,a07,poll
0,01648130400,01648170100,00000039700,a07,poll
0,01648130400,01648171900,00000041500,a07,poll
0,01648172100,01648174800,00000002700,a2f,recvmsg
0,01648175200,01648223300,00000048100,a07,poll
0,01648223400,01648224400,00000001000,a2f,recvmsg
0,01648175200,01648225300,00000050100,a07,poll
0,01648227900,01648243000,00000015100,a07,poll
0,01648227900,01648245200,00000017300,a07,poll
0,01648247700,01648260900,00000013200,a07,poll
0,01648261000,01648262100,00000001100,a2f,recvmsg
0,01648247700,01648262900,00000015200,a07,poll
0,01648265400,01648278200,00000012800,a07,poll
0,01648278400,01648279500,00000001100,a2f,recvmsg
0,01648265400,01648280400,00000015000,a07,poll
0,01648283200,01648294000,00000010800,a07,poll
0,01648294100,01648295700,00000001600,a2f,recvmsg
0,01648283200,01648296600,00000013400,a07,poll
0,01648299200,01648309900,00000010700,a07,poll
0,01648310000,01648311100,00000001100,a2f,recvmsg
0,01648299200,01648311900,00000012700,a07,poll
0,01648314600,01648316500,00000001900,a07,poll
0,01648319200,01648319400,00000000200,a2f,recvmsg
0,01648319900,01648320000,00000000100,a2f,recvmsg
0,01648314600,01648338100,00000023500,a07,poll
0,01648338400,01648339900,00000001500,a2f,recvmsg
0,01648341300,01648342800,00000001500,a2d,recvfrom
0,01648347000,01648347200,00000000200,a2f,recvmsg
0,01648347700,01648347900,00000000200,a2f,recvmsg
0,01648314600,01648353100,00000038500,a07,poll
0,01648353500,01648355000,00000001500,a2f,recvmsg
0,01648356300,01648360300,00000004000,a2d,recvfrom
0,01648364500,01648364700,00000000200,a2f,recvmsg
0,01648365200,01648365400,00000000200,a2f,recvmsg
0,01648405800,01648406200,00000000400,a2f,recvmsg
0,01648408500,01648408700,00000000200,a2f,recvmsg
0,01648467600,01648467900,00000000300,a2f,recvmsg
0,01648470300,01648470500,00000000200,a2f,recvmsg
0,01648484100,01648514800,00000030700,a07,poll
0,01648515500,01648517100,00000001600,a2f,recvmsg
0,01648523500,01648524500,00000001000,a2d,recvfrom
0,01648525400,01648525600,00000000200,a2f,recvmsg
0,01648526300,01648526500,00000000200,a2f,recvmsg
0,01648558400,01648558700,00000000300,a2f,recvmsg
0,01648561000,01648561200,00000000200,a2f,recvmsg
0,01648564700,01648567100,00000002400,a07,poll
0,01648569500,01648569700,00000000200,a2f,recvmsg
0,01648570300,01648570500,00000000200,a2f,recvmsg
0,01649223300,01649284900,00000061600,a07,poll
0,01649303500,01649305100,00000001600,a2f,recvmsg
0,01649365100,01649368900,00000003800,a01,write
0,01649377500,01649378400,00000000900,a2f,recvmsg
0,01649380700,01649380800,00000000100,a00,read
0,01649392200,01649393700,00000001500,aca,futex
0,01649419000,01649528600,00000109600,a07,poll
0,01649532700,01649536400,00000003700,a2e,sendmsg
0,01649538700,01649538800,00000000100,a00,read
0,01649542600,01649542900,00000000300,aca,futex
0,01649566700,01649670300,00000103600,a07,poll
0,01649672500,01649673900,00000001400,a2e,sendmsg
0,01649692300,01649754800,00000062500,a07,poll
0,01649759400,01649761200,00000001800,a2f,recvmsg
0,01649767000,01649768100,00000001100,a2f,recvmsg
0,01649922400,01649923300,00000000900,a2f,recvmsg
0,01649925500,01649925700,00000000200,a00,read
0,01635718500,01651803500,00016085000,a17,select
0,01651824800,01651825000,00000000200,a2f,recvmsg
0,01651838700,01651838900,00000000200,a2f,recvmsg
0,01651839400,01651912400,00000073000,a17,select
0,01651918800,01651918900,00000000100,a2f,recvmsg
0,01614575800,01662487200,00047911400,a3d,wait4
0,01662509500,01662511500,00000002000,a00,read
0,01662513500,01662513900,00000000400,a00,read
0,01662536400,01662587400,00000051000,a07,poll
0,01662593600,01662593800,00000000200,a2f,recvmsg
0,01662594600,01662594800,00000000200,a2f,recvmsg
0,01662604300,01662619800,00000015500,a07,poll
0,01662622000,01662622200,00000000200,a2f,recvmsg
0,01662622600,01662622600,00000000000,a2f,recvmsg
0,01662626200,01662639700,00000013500,a07,poll
0,01662641800,01662642000,00000000200,a2f,recvmsg
0,01662642400,01662642600,00000000200,a2f,recvmsg
0,01662646900,01662660300,00000013400,a07,poll
0,01662662400,01662662500,00000000100,a2f,recvmsg
0,01662662800,01662663000,00000000200,a2f,recvmsg
0,01662667900,01662681100,00000013200,a07,poll
0,01662683200,01662683400,00000000200,a2f,recvmsg
0,01662683600,01662683800,00000000200,a2f,recvmsg
0,01662688000,01662701300,00000013300,a07,poll
0,01662703500,01662703600,00000000100,a2f,recvmsg
0,01662704000,01662704200,00000000200,a2f,recvmsg
0,01662705000,01662705400,00000000400,a08,lseek
0,01662715500,01662715600,00000000100,a08,lseek
0,01662718700,01662725800,00000007100,a07,poll
0,01662727100,01662727200,00000000100,a2f,recvmsg
0,01662727600,01662727700,00000000100,a2f,recvmsg
0,01662732900,01662739700,00000006800,a07,poll
0,01662741000,01662741100,00000000100,a2f,recvmsg
0,01662741500,01662741600,00000000100,a2f,recvmsg
0,01662744600,01662751400,00000006800,a07,poll
0,01662752600,01662752800,00000000200,a2f,recvmsg
0,01662753100,01662753300,00000000200,a2f,recvmsg
0,01662756700,01662763200,00000006500,a07,poll
0,01662764500,01662764600,00000000100,a2f,recvmsg
0,01662764900,01662765100,00000000200,a2f,recvmsg
0,01662768400,01662775300,00000006900,a07,poll
0,01662776500,01662776700,00000000200,a2f,recvmsg
0,01662777000,01662777200,00000000200,a2f,recvmsg
0,01662780800,01662787400,00000006600,a07,poll
0,01662788600,01662788800,00000000200,a2f,recvmsg
0,01662789100,01662789300,00000000200,a2f,recvmsg
0,01662793200,01662800000,00000006800,a07,poll
0,01662801200,01662801300,00000000100,a2f,recvmsg
0,01662801700,01662801800,00000000100,a2f,recvmsg
0,01662804600,01662811300,00000006700,a07,poll
0,01662812400,01662812600,00000000200,a2f,recvmsg
0,01662812800,01662813000,00000000200,a2f,recvmsg
0,01662817200,01662824100,00000006900,a07,poll
0,01662825200,01662825400,00000000200,a2f,recvmsg
0,01662825700,01662825900,00000000200,a2f,recvmsg
0,01662829100,01662835900,00000006800,a07,poll
0,01662837300,01662837300,00000000000,a2f,recvmsg
0,01662837700,01662837800,00000000100,a2f,recvmsg
0,01662841000,01662847700,00000006700,a07,poll
0,01662848700,01662848900,00000000200,a2f,recvmsg
0,01662849200,01662849400,00000000200,a2f,recvmsg
0,01662852500,01662859500,00000007000,a07,poll
0,01662860600,01662860800,00000000200,a2f,recvmsg
0,01662861100,01662861300,00000000200,a2f,recvmsg
0,01662864300,01662871000,00000006700,a07,poll
0,01662872100,01662872300,00000000200,a2f,recvmsg
0,01662872600,01662872800,00000000200,a2f,recvmsg
0,01662875900,01662882800,00000006900,a07,poll
0,01662883900,01662884100,00000000200,a2f,recvmsg
0,01662884400,01662884600,00000000200,a2f,recvmsg
0,01662887600,01662894300,00000006700,a07,poll
0,01662895400,01662895600,00000000200,a2f,recvmsg
0,01662895900,01662896100,00000000200,a2f,recvmsg
0,01662898700,01662905600,00000006900,a07,poll
0,01662906600,01662906800,00000000200,a2f,recvmsg
0,01662907100,01662907300,00000000200,a2f,recvmsg
0,01662911800,01662918600,00000006800,a07,poll
0,01662919700,01662919900,00000000200,a2f,recvmsg
0,01662920200,01662920300,00000000100,a2f,recvmsg
0,01662922900,01662929800,00000006900,a07,poll
0,01662930800,01662931000,00000000200,a2f,recvmsg
0,01662931300,01662931500,00000000200,a2f,recvmsg
0,01662934200,01662941300,00000007100,a07,poll
0,01662942400,01662942600,00000000200,a2f,recvmsg
0,01662942900,01662943100,00000000200,a2f,recvmsg
0,01662945600,01662952500,00000006900,a07,poll
0,01662953500,01662953700,00000000200,a2f,recvmsg
0,01662954000,01662954200,00000000200,a2f,recvmsg
0,01662957000,01662964000,00000007000,a07,poll
0,01662965100,01662965200,00000000100,a2f,recvmsg
0,01662965500,01662965700,00000000200,a2f,recvmsg
0,01662968500,01662975400,00000006900,a07,poll
0,01662976500,01662976700,00000000200,a2f,recvmsg
0,01662977000,01662977200,00000000200,a2f,recvmsg
0,01662980500,01662987400,00000006900,a07,poll
0,01662988500,01662988700,00000000200,a2f,recvmsg
0,01662989000,01662989200,00000000200,a2f,recvmsg
0,01662992400,01662999300,00000006900,a07,poll
0,01663000500,01663000700,00000000200,a2f,recvmsg
0,01663000900,01663001100,00000000200,a2f,recvmsg
0,01663004800,01663011900,00000007100,a07,poll
0,01663013000,01663013100,00000000100,a2f,recvmsg
0,01663013400,01663013600,00000000200,a2f,recvmsg
0,01663017200,01663023900,00000006700,a07,poll
0,01663025000,01663025200,00000000200,a2f,recvmsg
0,01663025400,01663025600,00000000200,a2f,recvmsg
0,01663030500,01663037400,00000006900,a07,poll
0,01663038500,01663038700,00000000200,a2f,recvmsg
0,01663038900,01663039100,00000000200,a2f,recvmsg
0,01663044400,01663051300,00000006900,a07,poll
0,01663052400,01663052600,00000000200,a2f,recvmsg
0,01663052900,01663053100,00000000200,a2f,recvmsg
0,01663056000,01663063000,00000007000,a07,poll
0,01663064200,01663064400,00000000200,a2f,recvmsg
0,01663064600,01663064800,00000000200,a2f,recvmsg
0,01663068700,01663075400,00000006700,a07,poll
0,01663076600,01663076700,00000000100,a2f,recvmsg
0,01663077000,01663077200,00000000200,a2f,recvmsg
0,01663081000,01663088000,00000007000,a07,poll
0,01663089100,01663089300,00000000200,a2f,recvmsg
0,01663089600,01663089800,00000000200,a2f,recvmsg
0,01663093000,01663099900,00000006900,a07,poll
0,01663101100,01663101300,00000000200,a2f,recvmsg
0,01663101500,01663101700,00000000200,a2f,recvmsg
0,01663105400,01663112400,00000007000,a07,poll
0,01663113400,01663113600,00000000200,a2f,recvmsg
0,01663113900,01663114100,00000000200,a2f,recvmsg
0,01663117400,01663124300,00000006900,a07,poll
0,01663125500,01663125600,00000000100,a2f,recvmsg
0,01663125900,01663126100,00000000200,a2f,recvmsg
0,01663129100,01663135900,00000006800,a07,poll
0,01663137000,01663137200,00000000200,a2f,recvmsg
0,01663137500,01663137600,00000000100,a2f,recvmsg
0,01663140400,01663147200,00000006800,a07,poll
0,01663148300,01663148500,00000000200,a2f,recvmsg
0,01663148800,01663148900,00000000100,a2f,recvmsg
0,01663152300,01663159000,00000006700,a07,poll
0,01663160200,01663160300,00000000100,a2f,recvmsg
0,01663160600,01663160800,00000000200,a2f,recvmsg
0,01663161800,01663161900,00000000100,a08,lseek
0,01663164300,01663165700,00000001400,a00,read
0,01663169400,01663169500,00000000100,a08,lseek
0,01663172300,01663178900,00000006600,a07,poll
0,01663180200,01663180400,00000000200,a2f,recvmsg
0,01663180700,01663180900,00000000200,a2f,recvmsg
0,01663206400,01663213200,00000006800,a07,poll
0,01663214500,01663214600,00000000100,a2f,recvmsg
0,01663215000,01663215100,00000000100,a2f,recvmsg
0,01663218900,01663219600,00000000700,a00,read
0,01663225000,01663225100,00000000100,a08,lseek
0,01663228600,01663235500,00000006900,a07,poll
0,01663236600,01663236800,00000000200,a2f,recvmsg
0,01663237100,01663237300,00000000200,a2f,recvmsg
0,01663240100,01663246800,00000006700,a07,poll
0,01663247800,01663248000,00000000200,a2f,recvmsg
0,01663248300,01663248500,00000000200,a2f,recvmsg
0,01663251200,01663257800,00000006600,a07,poll
0,01663259000,01663259100,00000000100,a2f,recvmsg
0,01663259400,01663259600,00000000200,a2f,recvmsg
0,01663262400,01663269100,00000006700,a07,poll
0,01663270300,01663270500,00000000200,a2f,recvmsg
0,01663270700,01663270900,00000000200,a2f,recvmsg
0,01663273600,01663280500,00000006900,a07,poll
0,01663281600,01663281800,00000000200,a2f,recvmsg
0,01663282000,01663282200,00000000200,a2f,recvmsg
0,01663284900,01663291500,00000006600,a07,poll
0,01663292700,01663292900,00000000200,a2f,recvmsg
0,01663293200,01663293300,00000000100,a2f,recvmsg
0,01663296100,01663302800,00000006700,a07,poll
0,01663303800,01663304000,00000000200,a2f,recvmsg
0,01663304300,01663304500,00000000200,a2f,recvmsg
0,01663307800,01663314800,00000007000,a07,poll
0,01663315900,01663316100,00000000200,a2f,recvmsg
0,01663316300,01663316500,00000000200,a2f,recvmsg
0,01663319300,01663326100,00000006800,a07,poll
0,01663327200,01663327400,00000000200,a2f,recvmsg
0,01663327600,01663327800,00000000200,a2f,recvmsg
0,01663328200,01663328300,00000000100,a08,lseek
0,01663332100,01663338900,00000006800,a07,poll
0,01663340200,01663340400,00000000200,a2f,recvmsg
0,01663340700,01663340800,00000000100,a2f,recvmsg
0,01663345700,01663352600,00000006900,a07,poll
0,01663353800,01663354000,00000000200,a2f,recvmsg
0,01663354200,01663354400,00000000200,a2f,recvmsg
0,01663357700,01663364300,00000006600,a07,poll
0,01663365500,01663365500,00000000000,a2f,recvmsg
0,01663365800,01663366000,00000000200,a2f,recvmsg
0,01663369100,01663375800,00000006700,a07,poll
0,01663376900,01663377100,00000000200,a2f,recvmsg
0,01663377400,01663377600,00000000200,a2f,recvmsg
0,01663380500,01663387100,00000006600,a07,poll
0,01663388400,01663388600,00000000200,a2f,recvmsg
0,01663388900,01663389100,00000000200,a2f,recvmsg
0,01663392100,01663398800,00000006700,a07,poll
0,01663399800,01663400000,00000000200,a2f,recvmsg
0,01663400300,01663400500,00000000200,a2f,recvmsg
0,01663404200,01663410900,00000006700,a07,poll
0,01663412000,01663412100,00000000100,a2f,recvmsg
0,01663412400,01663412700,00000000300,a2f,recvmsg
0,01663415600,01663422400,00000006800,a07,poll
0,01663423500,01663423600,00000000100,a2f,recvmsg
0,01663424000,01663424200,00000000200,a2f,recvmsg
0,01663427000,01663433700,00000006700,a07,poll
0,01663434800,01663434900,00000000100,a2f,recvmsg
0,01663435300,01663435500,00000000200,a2f,recvmsg
0,01663438400,01663445300,00000006900,a07,poll
0,01663446400,01663446600,00000000200,a2f,recvmsg
0,01663446900,01663447100,00000000200,a2f,recvmsg
0,01663449900,01663456700,00000006800,a07,poll
0,01663458100,01663458300,00000000200,a2f,recvmsg
0,01663458600,01663458700,00000000100,a2f,recvmsg
0,01663461800,01663468400,00000006600,a07,poll
0,01663469600,01663469700,00000000100,a2f,recvmsg
0,01663470000,01663470200,00000000200,a2f,recvmsg
0,01663473800,01663480700,00000006900,a07,poll
0,01663481800,01663482000,00000000200,a2f,recvmsg
0,01663482300,01663482500,00000000200,a2f,recvmsg
0,01663485500,01663492300,00000006800,a07,poll
0,01663493400,01663493600,00000000200,a2f,recvmsg
0,01663493900,01663494100,00000000200,a2f,recvmsg
0,01663496900,01663503700,00000006800,a07,poll
0,01663504800,01663505000,00000000200,a2f,recvmsg
0,01663505300,01663505500,00000000200,a2f,recvmsg
0,01663508500,01663515300,00000006800,a07,poll
0,01663516400,01663516500,00000000100,a2f,recvmsg
0,01663516900,01663517100,00000000200,a2f,recvmsg
0,01663528200,01663535000,00000006800,a07,poll
0,01663536200,01663536400,00000000200,a2f,recvmsg
0,01663536600,01663536800,00000000200,a2f,recvmsg
0,01663539900,01663546600,00000006700,a07,poll
0,01663547700,01663547900,00000000200,a2f,recvmsg
0,01663548100,01663548300,00000000200,a2f,recvmsg
0,01663551500,01663558100,00000006600,a07,poll
0,01663559300,01663559500,00000000200,a2f,recvmsg
0,01663559800,01663560000,00000000200,a2f,recvmsg
0,01663563200,01663569800,00000006600,a07,poll
0,01663570900,01663571000,00000000100,a2f,recvmsg
0,01663571400,01663571600,00000000200,a2f,recvmsg
0,01663574600,01663581400,00000006800,a07,poll
0,01663582500,01663582600,00000000100,a2f,recvmsg
0,01663583000,01663583100,00000000100,a2f,recvmsg
0,01663603400,01663630200,00000026800,a57,unlink
0,01663631500,01663635400,00000003900,a14,writev
0,01602470800,01663743200,00061272400,a4a,fsync
0,01663797400,01663802900,00000005500,a09,mmap
0,01664059600,01664066800,00000007200,a01,write
0,01663928400,01664100900,00000172500,a07,poll
0,01664106300,01664111900,00000005600,a2f,recvmsg
0,01664120400,01664120600,00000000200,a2f,recvmsg
0,01664151800,01664157700,00000005900,a07,poll
0,01664151800,01664165300,00000013500,a07,poll
0,01664170200,01664174000,00000003800,a2f,recvmsg
0,01664180800,01664181000,00000000200,a2f,recvmsg
0,01664210300,01664226400,00000016100,a07,poll
0,01664228900,01664230100,00000001200,a07,poll
0,01664231800,01664262300,00000030500,a07,poll
0,01664262400,01664263600,00000001200,a2f,recvmsg
0,01664231800,01664264700,00000032900,a07,poll
0,01664267200,01664307300,00000040100,a07,poll
0,01664267200,01664308900,00000041700,a07,poll
0,01664309200,01664311400,00000002200,a2f,recvmsg
0,01664311800,01664359900,00000048100,a07,poll
0,01664311800,01664361600,00000049800,a07,poll
0,01664365400,01664416600,00000051200,a07,poll
0,01664416700,01664417900,00000001200,a2f,recvmsg
0,01664365400,01664418800,00000053400,a07,poll
0,01664421200,01664435800,00000014600,a07,poll
0,01664435900,01664437000,00000001100,a2f,recvmsg
0,01664421200,01664437800,00000016600,a07,poll
0,01664440200,01664453500,00000013300,a07,poll
0,01664453600,01664454600,00000001000,a2f,recvmsg
0,01664440200,01664455600,00000015400,a07,poll
0,01664458000,01664469400,00000011400,a07,poll
0,01664469500,01664470500,00000001000,a2f,recvmsg
0,01664458000,01664471300,00000013300,a07,poll
0,01664473600,01664485800,00000012200,a07,poll
0,01664485900,01664486900,00000001000,a2f,recvmsg
0,01664473600,01664487800,00000014200,a07,poll
0,01664490400,01664502600,00000012200,a07,poll
0,01664502800,01664504000,00000001200,a2f,recvmsg
0,01664490400,01664505000,00000014600,a07,poll
0,01664508500,01664510500,00000002000,a07,poll
0,01664514400,01664514600,00000000200,a2f,recvmsg
0,01664515300,01664515400,00000000100,a2f,recvmsg
0,01664508500,01664536600,00000028100,a07,poll
0,01664536900,01664538500,00000001600,a2f,recvmsg
0,01664542000,01664543400,00000001400,a2d,recvfrom
0,01664546100,01664546300,00000000200,a2f,recvmsg
0,01664546900,01664547100,00000000200,a2f,recvmsg
0,01664508500,01664552400,00000043900,a07,poll
0,01664552800,01664554300,00000001500,a2f,recvmsg
0,01664556900,01664557900,00000001000,a2d,recvfrom
0,01664560900,01664561000,00000000100,a2f,recvmsg
0,01664561700,01664561900,00000000200,a2f,recvmsg
0,01664606600,01664606800,00000000200,a2f,recvmsg
0,01664609200,01664609400,00000000200,a2f,recvmsg
0,01664668800,01664669000,00000000200,a2f,recvmsg
0,01664671800,01664672000,00000000200,a2f,recvmsg
0,01651919800,01664707800,00012788000,a17,select
0,01664725800,01664746600,00000020800,a14,writev
0,01664747100,01664749000,00000001900,a14,writev
0,01664749800,01664750000,00000000200,a2f,recvmsg
0,01664752300,01664774300,00000022000,a17,select
0,01664786400,01664787300,00000000900,a14,writev
0,01664787700,01664787900,00000000200,a2f,recvmsg
0,01664675000,01664792800,00000117800,a07,poll
0,01664793800,01664794800,00000001000,a2f,recvmsg
0,01664801300,01664802000,00000000700,a2d,recvfrom
0,01664803300,01664803500,00000000200,a2f,recvmsg
0,01664804300,01664804500,00000000200,a2f,recvmsg
0,01664836700,01664837000,00000000300,a2f,recvmsg
0,01664839200,01664839400,00000000200,a2f,recvmsg
0,01664843100,01664881000,00000037900,a07,poll
0,01664885000,01664885500,00000000500,a00,read
0,01664933100,01664934100,00000001000,60e,page_fault
0,01664788600,01664939500,00000150900,a17,select
0,01664958400,01664958600,00000000200,a2f,recvmsg
0,01665063900,01665064700,00000000800,a2f,recvmsg
0,01665067100,01665067300,00000000200,a00,read
0,01665126300,01665666500,00000540200,a07,poll
0,01665673000,01665677600,00000004600,a2e,sendmsg
0,01665681200,01665681400,00000000200,a00,read
0,01665688700,01665732000,00000043300,a07,poll
0,01665733600,01665734100,00000000500,a00,read
0,01665749000,01665750100,00000001100,a2f,recvmsg
0,01665825800,01665829900,00000004100,a07,poll
0,01665982700,01665983700,00000001000,a2f,recvmsg
0,01665989800,01665990000,00000000200,a2f,recvmsg
0,01665990600,01665994900,00000004300,a07,poll
0,01666002300,01666006300,00000004000,a2e,sendmsg
0,01666012800,01666013600,00000000800,a2e,sendmsg
0,01666021700,01666021900,00000000200,a00,read
0,01666028900,01666058400,00000029500,a07,poll
0,01666072800,01666074700,00000001900,a2f,recvmsg
0,01666142200,01666154500,00000012300,a07,poll
0,01666481000,01666482100,00000001100,a2f,recvmsg
0,01664959900,01667449800,00002489900,a17,select
0,01667470600,01667470800,00000000200,a2f,recvmsg
0,01667483900,01667484100,00000000200,a2f,recvmsg
0,01667484700,01667542900,00000058200,a17,select
0,01667546800,01667547000,00000000200,a2f,recvmsg
0,01614575800,01678119100,00063543300,a3d,wait4
0,01678139900,01678141800,00000001900,a00,read
0,01678144100,01678144500,00000000400,a00,read
0,01678165500,01678213400,00000047900,a07,poll
0,01678218200,01678218400,00000000200,a2f,recvmsg
0,01678219400,01678219500,00000000100,a2f,recvmsg
0,01678225700,01678237600,00000011900,a07,poll
0,01678239600,01678239800,00000000200,a2f,recvmsg
0,01678240200,01678240400,00000000200,a2f,recvmsg
0,01678244700,01678256500,00000011800,a07,poll
0,01678258600,01678258700,00000000100,a2f,recvmsg
0,01678259100,01678259300,00000000200,a2f,recvmsg
0,01678264200,01678276000,00000011800,a07,poll
0,01678278000,01678278200,00000000200,a2f,recvmsg
0,01678278500,01678278600,00000000100,a2f,recvmsg
0,01678282500,01678294200,00000011700,a07,poll
0,01678296100,01678296300,00000000200,a2f,recvmsg
0,01678296700,01678296900,00000000200,a2f,recvmsg
0,01678301000,01678312700,00000011700,a07,poll
0,01678314700,01678314900,00000000200,a2f,recvmsg
0,01678315300,01678315500,00000000200,a2f,recvmsg
0,01678316200,01678316500,00000000300,a08,lseek
0,01678326500,01678326600,00000000100,a08,lseek
0,01678329700,01678336700,00000007000,a07,poll
0,01678337900,01678338100,00000000200,a2f,recvmsg
0,01678338500,01678338600,00000000100,a2f,recvmsg
0,01678344800,01678351600,00000006800,a07,poll
0,01678352800,01678352900,00000000100,a2f,recvmsg
0,01678353300,01678353400,00000000100,a2f,recvmsg
0,01678356500,01678363300,00000006800,a07,poll
0,01678364300,01678364500,00000000200,a2f,recvmsg
0,01678364800,01678365000,00000000200,a2f,recvmsg
0,01678368400,01678375000,00000006600,a07,poll
0,01678376200,01678376400,00000000200,a2f,recvmsg
0,01678376700,01678376900,00000000200,a2f,recvmsg
0,01678380100,01678386900,00000006800,a07,poll
0,01678388000,01678388200,00000000200,a2f,recvmsg
0,01678388500,01678388700,00000000200,a2f,recvmsg
0,01678392000,01678398500,00000006500,a07,poll
0,01678399700,01678399900,00000000200,a2f,recvmsg
0,01678400200,01678400300,00000000100,a2f,recvmsg
0,01678403400,01678410200,00000006800,a07,poll
0,01678411400,01678411600,00000000200,a2f,recvmsg
0,01678411800,01678412000,00000000200,a2f,recvmsg
0,01678414800,01678421400,00000006600,a07,poll
0,01678422700,01678422800,00000000100,a2f,recvmsg
0,01678423000,01678423200,00000000200,a2f,recvmsg
0,01678427300,01678434200,00000006900,a07,poll
0,01678435300,01678435500,00000000200,a2f,recvmsg
0,01678435800,01678436000,00000000200,a2f,recvmsg
0,01678439200,01678446100,00000006900,a07,poll
0,01678447600,01678447700,00000000100,a2f,recvmsg
0,01678448000,01678448200,00000000200,a2f,recvmsg
0,01678451300,01678458000,00000006700,a07,poll
0,01678459100,01678459200,00000000100,a2f,recvmsg
0,01678459600,01678459700,00000000100,a2f,recvmsg
0,01678462800,01678469700,00000006900,a07,poll
0,01678470700,01678470900,00000000200,a2f,recvmsg
0,01678471200,01678471400,00000000200,a2f,recvmsg
0,01678474400,01678481100,00000006700,a07,poll
0,01678482200,01678482400,00000000200,a2f,recvmsg
0,01678482700,01678482900,00000000200,a2f,recvmsg
0,01678486000,01678492800,00000006800,a07,poll
0,01678493800,01678494000,00000000200,a2f,recvmsg
0,01678494300,01678494500,00000000200,a2f,recvmsg
0,01678497500,01678504300,00000006800,a07,poll
0,01678505400,01678505600,00000000200,a2f,recvmsg
0,01678505900,01678506100,00000000200,a2f,recvmsg
0,01678508800,01678515800,00000007000,a07,poll
0,01678517000,01678517200,00000000200,a2f,recvmsg
0,01678517500,01678517700,00000000200,a2f,recvmsg
0,01678522100,01678528700,00000006600,a07,poll
0,01678529700,01678529900,00000000200,a2f,recvmsg
0,01678530200,01678530400,00000000200,a2f,recvmsg
0,01678533000,01678539800,00000006800,a07,poll
0,01678540800,01678541000,00000000200,a2f,recvmsg
0,01678541300,01678541500,00000000200,a2f,recvmsg
0,01678544200,01678550800,00000006600,a07,poll
0,01678552000,01678552200,00000000200,a2f,recvmsg
0,01678552400,01678552600,00000000200,a2f,recvmsg
0,01678555300,01678561900,00000006600,a07,poll
0,01678563100,01678563300,00000000200,a2f,recvmsg
0,01678563600,01678563700,00000000100,a2f,recvmsg
0,01678566600,01678573400,00000006800,a07,poll
0,01678574500,01678574700,00000000200,a2f,recvmsg
0,01678575000,01678575100,00000000100,a2f,recvmsg
0,01678578000,01678584700,00000006700,a07,poll
0,01678586000,01678586200,00000000200,a2f,recvmsg
0,01678586400,01678586600,00000000200,a2f,recvmsg
0,01678589800,01678596500,00000006700,a07,poll
0,01678597700,01678597800,00000000100,a2f,recvmsg
0,01678598100,01678598300,00000000200,a2f,recvmsg
0,01678601600,01678608400,00000006800,a07,poll
0,01678609400,01678609600,00000000200,a2f,recvmsg
0,01678609900,01678610100,00000000200,a2f,recvmsg
0,01678613800,01678620600,00000006800,a07,poll
0,01678621700,01678621900,00000000200,a2f,recvmsg
0,01678622200,01678622400,00000000200,a2f,recvmsg
0,01678625700,01678632400,00000006700,a07,poll
0,01678633600,01678633700,00000000100,a2f,recvmsg
0,01678633900,01678634100,00000000200,a2f,recvmsg
0,01678637600,01678644400,00000006800,a07,poll
0,01678645400,01678645600,00000000200,a2f,recvmsg
0,01678645900,01678646100,00000000200,a2f,recvmsg
0,01678651500,01678658400,00000006900,a07,poll
0,01678659500,01678659700,00000000200,a2f,recvmsg
0,01678660000,01678660200,00000000200,a2f,recvmsg
0,01678663100,01678669800,00000006700,a07,poll
0,01678670900,01678671000,00000000100,a2f,recvmsg
0,01678671400,01678671500,00000000100,a2f,recvmsg
0,01678674500,01678681300,00000006800,a07,poll
0,01678682300,01678682500,00000000200,a2f,recvmsg
0,01678682800,01678683000,00000000200,a2f,recvmsg
0,01678686900,01678693700,00000006800,a07,poll
0,01678694900,01678695000,00000000100,a2f,recvmsg
0,01678695400,01678695500,00000000100,a2f,recvmsg
0,01678700400,01678707400,00000007000,a07,poll
0,01678708500,01678708700,00000000200,a2f,recvmsg
0,01678709000,01678709200,00000000200,a2f,recvmsg
0,01678712700,01678719400,00000006700,a07,poll
0,01678720600,01678720800,00000000200,a2f,recvmsg
0,01678721100,01678721300,00000000200,a2f,recvmsg
0,01678724700,01678731400,00000006700,a07,poll
0,01678732600,01678732700,00000000100,a2f,recvmsg
0,01678733000,01678733200,00000000200,a2f,recvmsg
0,01678736100,01678742700,00000006600,a07,poll
0,01678743800,01678744000,00000000200,a2f,recvmsg
0,01678744200,01678744400,00000000200,a2f,recvmsg
0,01678747200,01678753900,00000006700,a07,poll
0,01678755000,01678755200,00000000200,a2f,recvmsg
0,01678755500,01678755600,00000000100,a2f,recvmsg
0,01678759000,01678765700,00000006700,a07,poll
0,01678766900,01678766900,00000000000,a2f,recvmsg
0,01678767200,01678767400,00000000200,a2f,recvmsg
0,01678768400,01678768600,00000000200,a08,lseek
0,01678771500,01678772500,00000001000,a00,read
0,01678776200,01678776300,00000000100,a08,lseek
0,01678779100,01678785800,00000006700,a07,poll
0,01678787100,01678787200,00000000100,a2f,recvmsg
0,01678787600,01678787800,00000000200,a2f,recvmsg
0,01678813200,01678820000,00000006800,a07,poll
0,01678821200,01678821400,00000000200,a2f,recvmsg
0,01678821700,01678821900,00000000200,a2f,recvmsg
0,01678825800,01678826500,00000000700,a00,read
0,01678831900,01678832000,00000000100,a08,lseek
0,01678835300,01678842100,00000006800,a07,poll
0,01678843300,01678843400,00000000100,a2f,recvmsg
0,01678843800,01678844000,00000000200,a2f,recvmsg
0,01678846700,01678853400,00000006700,a07,poll
0,01678854400,01678854600,00000000200,a2f,recvmsg
0,01678854900,01678855100,00000000200,a2f,recvmsg
0,01678857700,01678864300,00000006600,a07,poll
0,01678865400,01678865600,00000000200,a2f,recvmsg
0,01678865800,01678866000,00000000200,a2f,recvmsg
0,01678868700,01678875200,00000006500,a07,poll
0,01678876500,01678876600,00000000100,a2f,recvmsg
0,01678877000,01678877100,00000000100,a2f,recvmsg
0,01678879800,01678886500,00000006700,a07,poll
0,01678887800,01678888000,00000000200,a2f,recvmsg
0,01678888300,01678888500,00000000200,a2f,recvmsg
0,01678891000,01678897800,00000006800,a07,poll
0,01678898800,01678899000,00000000200,a2f,recvmsg
0,01678899300,01678899500,00000000200,a2f,recvmsg
0,01678902200,01678909000,00000006800,a07,poll
0,01678910100,01678910200,00000000100,a2f,recvmsg
0,01678910500,01678910700,00000000200,a2f,recvmsg
0,01678913900,01678920700,00000006800,a07,poll
0,01678921800,01678921900,00000000100,a2f,recvmsg
0,01678922300,01678922500,00000000200,a2f,recvmsg
0,01678925200,01678932000,00000006800,a07,poll
0,01678933000,01678933200,00000000200,a2f,recvmsg
0,01678933500,01678933700,00000000200,a2f,recvmsg
0,01678934100,01678934100,00000000000,a08,lseek
0,01678938100,01678944700,00000006600,a07,poll
0,01678945800,01678946000,00000000200,a2f,recvmsg
0,01678946300,01678946500,00000000200,a2f,recvmsg
0,01678951600,01678958500,00000006900,a07,poll
0,01678959500,01678959700,00000000200,a2f,recvmsg
0,01678960100,01678960200,00000000100,a2f,recvmsg
0,01678963500,01678970100,00000006600,a07,poll
0,01678971200,01678971400,00000000200,a2f,recvmsg
0,01678971700,01678971900,00000000200,a2f,recvmsg
0,01678974900,01678981700,00000006800,a07,poll
0,01678982900,01678983000,00000000100,a2f,recvmsg
0,01678983400,01678983500,00000000100,a2f,recvmsg
0,01678986300,01678992900,00000006600,a07,poll
0,01678994000,01678994100,00000000100,a2f,recvmsg
0,01678994500,01678994700,00000000200,a2f,recvmsg
0,01678997500,01679004200,00000006700,a07,poll
0,01679005200,01679005400,00000000200,a2f,recvmsg
0,01679005700,01679005900,00000000200,a2f,recvmsg
0,01679009300,01679016000,00000006700,a07,poll
0,01679017200,01679017300,00000000100,a2f,recvmsg
0,01679017700,01679017800,00000000100,a2f,recvmsg
0,01679021100,01679027500,00000006400,a07,poll
0,01679028700,01679028800,00000000100,a2f,recvmsg
0,01679029100,01679029300,00000000200,a2f,recvmsg
0,01679032300,01679038900,00000006600,a07,poll
0,01679040000,01679040200,00000000200,a2f,recvmsg
0,01679040500,01679040600,00000000100,a2f,recvmsg
0,01679043800,01679050400,00000006600,a07,poll
0,01679051600,01679051800,00000000200,a2f,recvmsg
0,01679052000,01679052200,00000000200,a2f,recvmsg
0,01679055300,01679062000,00000006700,a07,poll
0,01679063100,01679063300,00000000200,a2f,recvmsg
0,01679063500,01679063700,00000000200,a2f,recvmsg
0,01679066700,01679073400,00000006700,a07,poll
0,01679074600,01679074700,00000000100,a2f,recvmsg
0,01679075000,01679075200,00000000200,a2f,recvmsg
0,01679078600,01679085400,00000006800,a07,poll
0,01679086500,01679086700,00000000200,a2f,recvmsg
0,01679087000,01679087200,00000000200,a2f,recvmsg
0,01679090000,01679096700,00000006700,a07,poll
0,01679097800,01679098000,00000000200,a2f,recvmsg
0,01679098300,01679098500,00000000200,a2f,recvmsg
0,01679101300,01679107900,00000006600,a07,poll
0,01679109000,01679109200,00000000200,a2f,recvmsg
0,01679109500,01679109700,00000000200,a2f,recvmsg
0,01679112700,01679119400,00000006700,a07,poll
0,01679120400,01679120600,00000000200,a2f,recvmsg
0,01679120900,01679121100,00000000200,a2f,recvmsg
0,01679129400,01679135900,00000006500,a07,poll
0,01679137100,01679137200,00000000100,a2f,recvmsg
0,01679137400,01679137600,00000000200,a2f,recvmsg
0,01679140900,01679147400,00000006500,a07,poll
0,01679148600,01679148800,00000000200,a2f,recvmsg
0,01679149000,01679149200,00000000200,a2f,recvmsg
0,01679152200,01679158800,00000006600,a07,poll
0,01679160000,01679160100,00000000100,a2f,recvmsg
0,01679160300,01679160500,00000000200,a2f,recvmsg
0,01679163800,01679170300,00000006500,a07,poll
0,01679171400,01679171600,00000000200,a2f,recvmsg
0,01679171800,01679172000,00000000200,a2f,recvmsg
0,01679175100,01679181600,00000006500,a07,poll
0,01679182800,01679183000,00000000200,a2f,recvmsg
0,01679183200,01679183400,00000000200,a2f,recvmsg
0,01679203900,01679228900,00000025000,a57,unlink
0,01679230000,01679234100,00000004100,a14,writev
0,01679234600,01679334200,00000099600,a07,poll
0,01679337400,01679339800,00000002400,a00,read
0,01679234600,01679343700,00000109100,a07,poll
0,01679356900,01679357000,00000000100,a2f,recvmsg
0,01679400100,01679400300,00000000200,a2f,recvmsg
0,01679387800,01679417700,00000029900,a07,poll
0,01679430400,01679473800,00000043400,a07,poll
0,01679430400,01679477000,00000046600,a07,poll
0,01679480400,01679532100,00000051700,a07,poll
0,01679480400,01679534500,00000054100,a07,poll
0,01679537200,01679588300,00000051100,a07,poll
0,01679589500,01679591500,00000002000,a07,poll
0,01679592800,01679644900,00000052100,a07,poll
0,01679592800,01679647100,00000054300,a07,poll
0,01679649800,01679700900,00000051100,a07,poll
0,01679701100,01679702100,00000001000,a2f,recvmsg
0,01679649800,01679703000,00000053200,a07,poll
0,01679705700,01679747200,00000041500,a07,poll
0,01679747300,01679748500,00000001200,a2f,recvmsg
0,01679705700,01679749400,00000043700,a07,poll
0,01679752700,01679791600,00000038900,a07,poll
0,01679791700,01679792700,00000001000,a2f,recvmsg
0,01679752700,01679793600,00000040900,a07,poll
0,01679796400,01679836300,00000039900,a07,poll
0,01679836400,01679837400,00000001000,a2f,recvmsg
0,01679796400,01679838300,00000041900,a07,poll
0,01679840900,01679881400,00000040500,a07,poll
0,01679881500,01679882500,00000001000,a2f,recvmsg
0,01679840900,01679883400,00000042500,a07,poll
0,01679885900,01679925400,00000039500,a07,poll
0,01679925600,01679926500,00000000900,a2f,recvmsg
0,01679885900,01679927400,00000041500,a07,poll
0,01679929800,01679980300,00000050500,a07,poll
0,01679980500,01679981400,00000000900,a2f,recvmsg
0,01679929800,01679982400,00000052600,a07,poll
0,01679984800,01680000900,00000016100,a07,poll
0,01680001100,01680002100,00000001000,a2f,recvmsg
0,01679984800,01680003000,00000018200,a07,poll
0,01680005700,01680019300,00000013600,a07,poll
0,01680005700,01680021300,00000015600,a07,poll
0,01680024200,01680035800,00000011600,a07,poll
0,01680035900,01680036800,00000000900,a2f,recvmsg
0,01680024200,01680037800,00000013600,a07,poll
0,01680040300,01680052100,00000011800,a07,poll
0,01680052300,01680053700,00000001400,a2f,recvmsg
0,01680040300,01680054700,00000014400,a07,poll
0,01680057100,01680067600,00000010500,a07,poll
0,01680067800,01680068800,00000001000,a2f,recvmsg
0,01680057100,01680069800,00000012700,a07,poll
0,01680072400,01680074500,00000002100,a07,poll
0,01680077100,01680077300,00000000200,a2f,recvmsg
0,01680077900,01680078000,00000000100,a2f,recvmsg
0,01680072400,01680096400,00000024000,a07,poll
0,01680096800,01680098300,00000001500,a2f,recvmsg
0,01680101600,01680102700,00000001100,a2d,recvfrom
0,01680106700,01680106900,00000000200,a2f,recvmsg
0,01680107400,01680107600,00000000200,a2f,recvmsg
0,01680072400,01680110600,00000038200,a07,poll
0,01680111100,01680112600,00000001500,a2f,recvmsg
0,01680114100,01680115000,00000000900,a2d,recvfrom
0,01680119500,01680119700,00000000200,a2f,recvmsg
0,01680120200,01680120400,00000000200,a2f,recvmsg
0,01680161500,01680161800,00000000300,a2f,recvmsg
0,01680164400,01680164600,00000000200,a2f,recvmsg
0,01680222900,01680223300,00000000400,a2f,recvmsg
0,01680225500,01680225700,00000000200,a2f,recvmsg
0,01680239500,01680273000,00000033500,a07,poll
0,01680273800,01680275400,00000001600,a2f,recvmsg
0,01680282000,01680282800,00000000800,a2d,recvfrom
0,01680283700,01680283900,00000000200,a2f,recvmsg
0,01680284600,01680284800,00000000200,a2f,recvmsg
0,01680316400,01680316800,00000000400,a2f,recvmsg
0,01680319200,01680319200,00000000000,a2f,recvmsg
0,01680322500,01680324900,00000002400,a07,poll
0,01680327200,01680327400,00000000200,a2f,recvmsg
0,01680328100,01680328200,00000000100,a2f,recvmsg
0,01680901600,01680909200,00000007600,a02,open
0,01680919600,01680922300,00000002700,a00,read
0,01680973600,01680974400,00000000800,a00,read
0,01681023400,01681024100,00000000700,a00,read
0,01681070200,01681071000,00000000800,a00,read
0,01681118000,01681118800,00000000800,a00,read
0,01681164600,01681165300,00000000700,a00,read
0,01681209100,01681209800,00000000700,a00,read
0,01681254300,01681255200,00000000900,a00,read
0,01681302500,01681303200,00000000700,a00,read
0,01681351600,01681352400,00000000800,a00,read
0,01681399800,01681400300,00000000500,a00,read
0,01681428300,01681430100,00000001800,a02,open
0,01681433100,01681434100,00000001000,a00,read
0,01681488400,01681489200,00000000800,a00,read
0,01681570800,01681571500,00000000700,a00,read
0,01681642300,01681643300,00000001000,a00,read
0,01681719500,01681720200,00000000700,a00,read
0,01681797400,01681798100,00000000700,a00,read
0,01681874000,01681874800,00000000800,a00,read
0,01681957700,01681958400,00000000700,a00,read
0,01682024200,01682024900,00000000700,a00,read
0,01682081300,01682082000,00000000700,a00,read
0,01682157300,01682177200,00000019900,a07,poll
0,01682180700,01682180900,00000000200,a2f,recvmsg
0,01682181500,01682181700,00000000200,a2f,recvmsg
0,01682184900,01682192200,00000007300,a07,poll
0,01682193200,01682193400,00000000200,a2f,recvmsg
0,01682193800,01682194000,00000000200,a2f,recvmsg
0,01682198600,01682205200,00000006600,a06,lstat
0,01682205900,01682207000,00000001100,a06,lstat
0,01682226800,01682241100,00000014300,a01,write
0,01682247100,01682253800,00000006700,a07,poll
0,01682255800,01682256000,00000000200,a2f,recvmsg
0,01682256500,01682256700,00000000200,a2f,recvmsg
0,01682258100,01682573400,00000315300,a38,clone
0,01683053800,01683054000,00000000200,a0c,brk
0,01683063800,01683066400,00000002600,a15,access
0,01683067100,01683068000,00000000900,a09,mmap
0,01683072300,01683074300,00000002000,a15,access
0,01683080700,01683081800,00000001100,a09,mmap
0,01683085600,01683086100,00000000500,a15,access
0,01683093400,01683094500,00000001100,a00,read
0,01683096900,01683098400,00000001500,a09,mmap
0,01683102500,01683104600,00000002100,a09,mmap
0,01683116500,01683117100,00000000600,a15,access
0,01683120300,01683120900,00000000600,a00,read
0,01683121600,01683122500,00000000900,a09,mmap
0,01683124400,01683125700,00000001300,a09,mmap
0,01683134100,01683134700,00000000600,a15,access
0,01683137500,01683138100,00000000600,a00,read
0,01683138800,01683139600,00000000800,a09,mmap
0,01683141200,01683143100,00000001900,a09,mmap
0,01683147000,01683150000,00000003000,a09,mmap
0,01683152100,01683153100,00000001000,a09,mmap
0,01683161200,01683161700,00000000500,a15,access
0,01683164600,01683165300,00000000700,a00,read
0,01683165900,01683167400,00000001500,a09,mmap
0,01683169900,01683171600,00000001700,a09,mmap
0,01683179900,01683180500,00000000600,a15,access
0,01683183800,01683184400,00000000600,a00,read
0,01683189200,01683191400,00000002200,a09,mmap
0,01683200000,01683200600,00000000600,a15,access
0,01683203800,01683204400,00000000600,a00,read
0,01683204900,01683206000,00000001100,a09,mmap
0,01683207200,01683208500,00000001300,a09,mmap
0,01683211000,01683212300,00000001300,a09,mmap
0,01683218700,01683219300,00000000600,a15,access
0,01683221700,01683222300,00000000600,a00,read
0,01683222800,01683224200,00000001400,a09,mmap
0,01683226100,01683227600,00000001500,a09,mmap
0,01683241700,01683242200,00000000500,a09,mmap
0,01683246100,01683246400,00000000300,a09,mmap
0,01683247500,01683247800,00000000300,a09,mmap
0,01683428800,01683428900,00000000100,a0c,brk
0,01683429000,01683429800,00000000800,a0c,brk
0,01683465000,01683466100,00000001100,a00,read
0,01683477700,01683479100,00000001400,a00,read
0,01683513100,01683513900,00000000800,a00,read
0,01683635000,01683635800,00000000800,a00,read
0,01683706300,01683706800,00000000500,a00,read
0,01683792400,01683793000,00000000600,a00,read
0,01683923300,01683924100,00000000800,a00,read
0,01684051700,01684052400,00000000700,a00,read
0,01684207800,01684208400,00000000600,a00,read
0,01684358300,01684359000,00000000700,a00,read
0,01684395500,01684396900,00000001400,a0c,brk
0,01684511800,01684512500,00000000700,a00,read
0,01684660200,01684660900,00000000700,a00,read
0,01684839300,01684840300,00000001000,a00,read
0,01684999100,01684999900,00000000800,a00,read
0,01685108300,01685109000,00000000700,a00,read
0,01685139600,01685140400,00000000800,a0c,brk
0,01685250700,01685251600,00000000900,a00,read
0,01685494800,01685495300,00000000500,a00,read
0,01685507100,01685507500,00000000400,a00,read
0,01685550700,01685551100,00000000400,a00,read
0,01685571300,01685572000,00000000700,a00,read
0,01685777400,01685777900,00000000500,a00,read
0,01685807200,01685808100,00000000900,a00,read
0,01685904400,01685905200,00000000800,a00,read
0,01685928900,01685930100,00000001200,a0c,brk
0,01685977400,01685977800,00000000400,a00,read
0,01686054200,01686055100,00000000900,a00,read
0,01686206900,01686207300,00000000400,a00,read
0,01686317700,01686318500,00000000800,a00,read
0,01686411600,01686412100,00000000500,a00,read
0,01686423900,01686424400,00000000500,a00,read
0,01686504100,01686504600,00000000500,a00,read
0,01686528200,01686528500,00000000300,a00,read
0,01686550500,01686551000,00000000500,a00,read
0,01686654700,01686655700,00000001000,a0c,brk
0,01686657100,01686657900,00000000800,a00,read
0,01686859000,01686859500,00000000500,a00,read
0,01686941500,01686942000,00000000500,a00,read
0,01687004900,01687005500,00000000600,a00,read
0,01687133200,01687133600,00000000400,a00,read
0,01687166300,01687166300,00000000000,a00,read
0,01687182400,01687184100,00000001700,a02,open
0,01687296000,01687296000,00000000000,a00,read
0,01687365200,01687365800,00000000600,a00,read
0,01687418100,01687419200,00000001100,a0c,brk
0,01682243900,01715934700,00033690800,a14,writev
0,01715935300,01715941700,00000006400,a07,poll
0,01715942800,01715943000,00000000200,a2f,recvmsg
0,01715943300,01715943400,00000000100,a2f,recvmsg
0,01715946900,01715953700,00000006800,a07,poll
0,01715954900,01715955100,00000000200,a2f,recvmsg
0,01715955400,01715955500,00000000100,a2f,recvmsg
0,01715960900,01715967700,00000006800,a07,poll
0,01715968800,01715968900,00000000100,a2f,recvmsg
0,01715969200,01715969400,00000000200,a2f,recvmsg
0,01715972600,01715979200,00000006600,a07,poll
0,01715980300,01715980400,00000000100,a2f,recvmsg
0,01715980700,01715980900,00000000200,a2f,recvmsg
0,01715983800,01715990600,00000006800,a07,poll
0,01715991700,01715991800,00000000100,a2f,recvmsg
0,01715992100,01715992300,00000000200,a2f,recvmsg
0,01715996100,01716002900,00000006800,a07,poll
0,01716004000,01716004200,00000000200,a2f,recvmsg
0,01716004500,01716004700,00000000200,a2f,recvmsg
0,01716008800,01716015700,00000006900,a07,poll
0,01716016800,01716017000,00000000200,a2f,recvmsg
0,01716017300,01716017500,00000000200,a2f,recvmsg
0,01716021200,01716028000,00000006800,a07,poll
0,01716029200,01716029300,00000000100,a2f,recvmsg
0,01716029600,01716029700,00000000100,a2f,recvmsg
0,01716033000,01716039700,00000006700,a07,poll
0,01716040800,01716041000,00000000200,a2f,recvmsg
0,01716041200,01716041400,00000000200,a2f,recvmsg
0,01716044600,01716051500,00000006900,a07,poll
0,01716052600,01716052800,00000000200,a2f,recvmsg
0,01716053100,01716053300,00000000200,a2f,recvmsg
0,01716056200,01716062800,00000006600,a07,poll
0,01716063900,01716064100,00000000200,a2f,recvmsg
0,01716064400,01716064600,00000000200,a2f,recvmsg
0,01716068100,01716074900,00000006800,a07,poll
0,01716076000,01716076200,00000000200,a2f,recvmsg
0,01716076500,01716076700,00000000200,a2f,recvmsg
0,01716077600,01716077800,00000000200,a08,lseek
0,01716080800,01716082100,00000001300,a00,read
0,01716085800,01716085900,00000000100,a08,lseek
0,01716088700,01716095500,00000006800,a07,poll
0,01716096700,01716096800,00000000100,a2f,recvmsg
0,01716097200,01716097400,00000000200,a2f,recvmsg
0,01716123200,01716130100,00000006900,a07,poll
0,01716131400,01716131600,00000000200,a2f,recvmsg
0,01716131900,01716132100,00000000200,a2f,recvmsg
0,01716135900,01716136800,00000000900,a00,read
0,01716142300,01716142400,00000000100,a08,lseek
0,01716145500,01716152000,00000006500,a07,poll
0,01716153200,01716153300,00000000100,a2f,recvmsg
0,01716153700,01716153900,00000000200,a2f,recvmsg
0,01716156700,01716163300,00000006600,a07,poll
0,01716164500,01716164600,00000000100,a2f,recvmsg
0,01716164900,01716165100,00000000200,a2f,recvmsg
0,01716167700,01716174100,00000006400,a07,poll
0,01716175300,01716175400,00000000100,a2f,recvmsg
0,01716175800,01716176000,00000000200,a2f,recvmsg
0,01716178700,01716185500,00000006800,a07,poll
0,01716186600,01716186800,00000000200,a2f,recvmsg
0,01716187100,01716187300,00000000200,a2f,recvmsg
0,01716189900,01716196500,00000006600,a07,poll
0,01716197700,01716197800,00000000100,a2f,recvmsg
0,01716198200,01716198400,00000000200,a2f,recvmsg
0,01716201100,01716208000,00000006900,a07,poll
0,01716209000,01716209200,00000000200,a2f,recvmsg
0,01716209500,01716209700,00000000200,a2f,recvmsg
0,01716212200,01716219000,00000006800,a07,poll
0,01716220100,01716220200,00000000100,a2f,recvmsg
0,01716220500,01716220700,00000000200,a2f,recvmsg
0,01716224100,01716230900,00000006800,a07,poll
0,01716232000,01716232100,00000000100,a2f,recvmsg
0,01716232400,01716232600,00000000200,a2f,recvmsg
0,01716235300,01716242300,00000007000,a07,poll
0,01716243400,01716243500,00000000100,a2f,recvmsg
0,01716243800,01716244000,00000000200,a2f,recvmsg
0,01716244400,01716244500,00000000100,a08,lseek
0,01716248600,01716255500,00000006900,a07,poll
0,01716256600,01716256800,00000000200,a2f,recvmsg
0,01716257100,01716257300,00000000200,a2f,recvmsg
0,01716262300,01716269100,00000006800,a07,poll
0,01716270400,01716270600,00000000200,a2f,recvmsg
0,01716270900,01716271000,00000000100,a2f,recvmsg
0,01716274400,01716280800,00000006400,a07,poll
0,01716282000,01716282200,00000000200,a2f,recvmsg
0,01716282400,01716282600,00000000200,a2f,recvmsg
0,01716285900,01716292200,00000006300,a07,poll
0,01716293400,01716293600,00000000200,a2f,recvmsg
0,01716293800,01716294000,00000000200,a2f,recvmsg
0,01716297100,01716303500,00000006400,a07,poll
0,01716304700,01716304900,00000000200,a2f,recvmsg
0,01716305200,01716305300,00000000100,a2f,recvmsg
0,01716308300,01716314900,00000006600,a07,poll
0,01716316200,01716316300,00000000100,a2f,recvmsg
0,01716316600,01716316700,00000000100,a2f,recvmsg
0,01716320300,01716327100,00000006800,a07,poll
0,01716328200,01716328400,00000000200,a2f,recvmsg
0,01716328700,01716328900,00000000200,a2f,recvmsg
0,01716331800,01716338500,00000006700,a07,poll
0,01716339600,01716339800,00000000200,a2f,recvmsg
0,01716340100,01716340300,00000000200,a2f,recvmsg
0,01716343200,01716350000,00000006800,a07,poll
0,01716351100,01716351300,00000000200,a2f,recvmsg
0,01716351600,01716351800,00000000200,a2f,recvmsg
0,01716354700,01716376900,00000022200,a07,poll
0,01716378400,01716378600,00000000200,a2f,recvmsg
0,01716379000,01716379200,00000000200,a2f,recvmsg
0,01716382500,01716389200,00000006700,a07,poll
0,01716390400,01716390600,00000000200,a2f,recvmsg
0,01716390900,01716391100,00000000200,a2f,recvmsg
0,01716394100,01716400700,00000006600,a07,poll
0,01716401900,01716402000,00000000100,a2f,recvmsg
0,01716402300,01716402500,00000000200,a2f,recvmsg
0,01716406100,01716413000,00000006900,a07,poll
0,01716414100,01716414300,00000000200,a2f,recvmsg
0,01716414600,01716414800,00000000200,a2f,recvmsg
0,01716418100,01716424500,00000006400,a07,poll
0,01716425700,01716425900,00000000200,a2f,recvmsg
0,01716426200,01716426400,00000000200,a2f,recvmsg
0,01716429500,01716436100,00000006600,a07,poll
0,01716437200,01716437400,00000000200,a2f,recvmsg
0,01716437700,01716437900,00000000200,a2f,recvmsg
0,01716440800,01716447700,00000006900,a07,poll
0,01716448900,01716449100,00000000200,a2f,recvmsg
0,01716449400,01716449600,00000000200,a2f,recvmsg
0,01716457800,01716464600,00000006800,a07,poll
0,01716465700,01716465900,00000000200,a2f,recvmsg
0,01716466200,01716466400,00000000200,a2f,recvmsg
0,01716469600,01716476200,00000006600,a07,poll
0,01716477300,01716477400,00000000100,a2f,recvmsg
0,01716477800,01716478000,00000000200,a2f,recvmsg
0,01716481000,01716487700,00000006700,a07,poll
0,01716488900,01716489000,00000000100,a2f,recvmsg
0,01716489400,01716489500,00000000100,a2f,recvmsg
0,01716492700,01716499300,00000006600,a07,poll
0,01716500500,01716500700,00000000200,a2f,recvmsg
0,01716500900,01716501100,00000000200,a2f,recvmsg
0,01716504400,01716511100,00000006700,a07,poll
0,01716512200,01716512300,00000000100,a2f,recvmsg
0,01716512600,01716512800,00000000200,a2f,recvmsg
0,01716535400,01716564900,00000029500,a57,unlink
0,01716566000,01716570200,00000004200,a14,writev
0,01716570800,01716670300,00000099500,a07,poll
0,01716570800,01716677800,00000107000,a07,poll
0,01716689100,01716689300,00000000200,a2f,recvmsg
0,01716734500,01716734600,00000000100,a2f,recvmsg
0,01716721600,01716756500,00000034900,a07,poll
0,01716771000,01716775400,00000004400,a07,poll
0,01716787900,01716788100,00000000200,a2f,recvmsg
0,01716806000,01716816200,00000010200,a07,poll
0,01716806000,01716819400,00000013400,a07,poll
0,01716823600,01716875600,00000052000,a07,poll
0,01716876700,01716878700,00000002000,a07,poll
0,01716880100,01716933400,00000053300,a07,poll
0,01716880100,01716935900,00000055800,a07,poll
0,01716938900,01716991100,00000052200,a07,poll
0,01716992100,01716993600,00000001500,a07,poll
0,01716994900,01717048200,00000053300,a07,poll
0,01717048500,01717049600,00000001100,a2f,recvmsg
0,01716994900,01717050500,00000055600,a07,poll
0,01717053500,01717095000,00000041500,a07,poll
0,01717095200,01717096200,00000001000,a2f,recvmsg
0,01717053500,01717097200,00000043700,a07,poll
0,01717099600,01717140400,00000040800,a07,poll
0,01717140500,01717141600,00000001100,a2f,recvmsg
0,01717099600,01717142500,00000042900,a07,poll
0,01717145800,01717185400,00000039600,a07,poll
0,01717185600,01717186700,00000001100,a2f,recvmsg
0,01717145800,01717187500,00000041700,a07,poll
0,01717190400,01717230500,00000040100,a07,poll
0,01717230500,01717231600,00000001100,a2f,recvmsg
0,01717190400,01717232600,00000042200,a07,poll
0,01717235200,01717275900,00000040700,a07,poll
0,01717276000,01717277000,00000001000,a2f,recvmsg
0,01717235200,01717278000,00000042800,a07,poll
0,01717280600,01717333100,00000052500,a07,poll
0,01717333200,01717334200,00000001000,a2f,recvmsg
0,01717280600,01717335200,00000054600,a07,poll
0,01717338100,01717352100,00000014000,a07,poll
0,01717352200,01717353200,00000001000,a2f,recvmsg
0,01717338100,01717354100,00000016000,a07,poll
0,01717356800,01717370100,00000013300,a07,poll
0,01717370200,01717371100,00000000900,a2f,recvmsg
0,01717356800,01717372000,00000015200,a07,poll
0,01717375900,01717387300,00000011400,a07,poll
0,01717387500,01717388500,00000001000,a2f,recvmsg
0,01717375900,01717389500,00000013600,a07,poll
0,01717392000,01717402800,00000010800,a07,poll
0,01717403000,01717403900,00000000900,a2f,recvmsg
0,01717392000,01717404800,00000012800,a07,poll
0,01717407200,01717418600,00000011400,a07,poll
0,01717418800,01717420000,00000001200,a2f,recvmsg
0,01717407200,01717420900,00000013700,a07,poll
0,01717424600,01717426100,00000001500,a07,poll
0,01717428600,01717428800,00000000200,a2f,recvmsg
0,01717429400,01717429600,00000000200,a2f,recvmsg
0,01717430200,01717447800,00000017600,a57,unlink
0,01717424600,01717449500,00000024900,a07,poll
0,01717449900,01717451400,00000001500,a2f,recvmsg
0,01717452800,01717454500,00000001700,a2d,recvfrom
0,01717459800,01717460100,00000000300,a2f,recvmsg
0,01717460700,01717460900,00000000200,a2f,recvmsg
0,01717424600,01717478400,00000053800,a07,poll
0,01717478900,01717480500,00000001600,a2f,recvmsg
0,01717482100,01717483100,00000001000,a2d,recvfrom
0,01717488600,01717488800,00000000200,a2f,recvmsg
0,01717489600,01717489800,00000000200,a2f,recvmsg
0,01717539200,01717539500,00000000300,a2f,recvmsg
0,01717542200,01717542400,00000000200,a2f,recvmsg
0,01717596700,01717597100,00000000400,a2f,recvmsg
0,01717600300,01717600600,00000000300,a2f,recvmsg
0,01717617300,01717675200,00000057900,a07,poll
0,01717676400,01717678300,00000001900,a2f,recvmsg
0,01717687900,01717691900,00000004000,a2d,recvfrom
0,01717693000,01717693200,00000000200,a2f,recvmsg
0,01717694000,01717694100,00000000100,a2f,recvmsg
0,01717730200,01717730400,00000000200,a2f,recvmsg
0,01717733300,01717733500,00000000200,a2f,recvmsg
0,01717737100,01717740200,00000003100,a07,poll
0,01717742600,01717742800,00000000200,a2f,recvmsg
0,01717743400,01717743500,00000000100,a2f,recvmsg
0,01717737100,01718599400,00000862300,a07,poll
0,01718600900,01718601500,00000000600,a00,read
0,01718619400,01718621000,00000001600,a2f,recvmsg
0,01718701600,01718702600,00000001000,a2f,recvmsg
0,01718707500,01718707700,00000000200,a00,read
0,01718825100,01718834000,00000008900,a02,open
0,01718847100,01718849700,00000002600,a00,read
0,01718909800,01718910700,00000000900,a00,read
0,01718966400,01718967400,00000001000,a00,read
0,01719021000,01719021900,00000000900,a00,read
0,01719078500,01719079400,00000000900,a00,read
0,01719131300,01719132100,00000000800,a00,read
0,01719182100,01719182900,00000000800,a00,read
0,01719235600,01719236400,00000000800,a00,read
0,01719289000,01719289800,00000000800,a00,read
0,01719341500,01719342200,00000000700,a00,read
0,01719391500,01719392100,00000000600,a00,read
0,01719420400,01719423300,00000002900,a02,open
0,01719427000,01719428100,00000001100,a00,read
0,01719484200,01719485100,00000000900,a00,read
0,01719569600,01719570500,00000000900,a00,read
0,01719642800,01719643600,00000000800,a00,read
0,01719721500,01719722400,00000000900,a00,read
0,01719800900,01719801500,00000000600,a00,read
0,01719880400,01719881000,00000000600,a00,read
0,01719966500,01719967200,00000000700,a00,read
0,01720033800,01720034600,00000000800,a00,read
0,01720092300,01720093100,00000000800,a00,read
0,01720177400,01720206600,00000029200,a07,poll
0,01720210100,01720210400,00000000300,a2f,recvmsg
0,01720211200,01720211400,00000000200,a2f,recvmsg
0,01720213500,01720221300,00000007800,a07,poll
0,01720222600,01720222800,00000000200,a2f,recvmsg
0,01720223000,01720223200,00000000200,a2f,recvmsg
0,01720228400,01720234800,00000006400,a06,lstat
0,01720235600,01720236800,00000001200,a06,lstat
0,01720258000,01720272800,00000014800,a01,write
0,01720278600,01720288000,00000009400,a07,poll
0,01720290200,01720290400,00000000200,a2f,recvmsg
0,01720290900,01720291100,00000000200,a2f,recvmsg
0,01720292600,01720647600,00000355000,a38,clone
1,01665572900,01665573800,00000000900,a00,read
1,01665722300,01665722900,00000000600,a00,read
1,01665825500,01665826200,00000000700,a00,read
1,01665951600,01665952400,00000000800,a00,read
1,01666092400,01666093200,00000000800,a00,read
1,01666222900,01666223600,00000000700,a0c,brk
1,01666250800,01666251400,00000000600,a00,read
1,01666444700,01666445300,00000000600,a00,read
1,01666589300,01704171800,00037582500,60e,page_fault
1,01704226500,01704227400,00000000900,a00,read
1,01704303600,01704304200,00000000600,a00,read
1,01704385200,01704385900,00000000700,a00,read
1,01704453500,01704454200,00000000700,a0c,brk
1,01704467700,01704468400,00000000700,a00,read
1,01704540900,01704541600,00000000700,a00,read
1,01704642100,01704642700,00000000600,a00,read
1,01704749400,01704750100,00000000700,a00,read
1,01704839100,01704839800,00000000700,a00,read
1,01704919900,01704920800,00000000900,a00,read
1,01705020800,01705021600,00000000800,a00,read
1,01705103500,01705104000,00000000500,a0c,brk
1,01705106400,01705107000,00000000600,a00,read
1,01705213400,01705214100,00000000700,a00,read
1,01705305700,01705306400,00000000700,a00,read
1,01705424800,01705425400,00000000600,a00,read
1,01705538500,01705539100,00000000600,a00,read
1,01705643500,01705644100,00000000600,a00,read
1,01705743300,01705743700,00000000400,a0c,brk
1,01706103200,01706106900,00000003700,a57,unlink
1,01706131200,01706131800,00000000600,a48,fcntl
1,01706181300,01706197000,00000015700,a01,write
1,01706214700,01706217300,00000002600,a01,write
1,01706233400,01706235700,00000002300,a01,write
1,01703156800,01706482200,00003325400,a17,select
1,01706506500,01706506800,00000000300,a2f,recvmsg
1,01706510200,01706539600,00000029400,a17,select
1,01706543900,01706544100,00000000200,a2f,recvmsg
1,01706544600,01706561500,00000016900,a17,select
1,01706565100,01706565300,00000000200,a2f,recvmsg
1,01706565900,01706582200,00000016300,a17,select
1,01706586100,01706586300,00000000200,a2f,recvmsg
1,01706586800,01706603100,00000016300,a17,select
1,01706607100,01706607300,00000000200,a2f,recvmsg
1,01706607800,01706623300,00000015500,a17,select
1,01706626700,01706626900,00000000200,a2f,recvmsg
1,01706627500,01706653900,00000026400,a17,select
1,01706658000,01706658100,00000000100,a2f,recvmsg
1,01706658600,01706668100,00000009500,a17,select
1,01706671900,01706672100,00000000200,a2f,recvmsg
1,01706672600,01706679900,00000007300,a17,select
1,01706683500,01706683700,00000000200,a2f,recvmsg
1,01706684200,01706691900,00000007700,a17,select
1,01706695400,01706695600,00000000200,a2f,recvmsg
1,01706696100,01706703600,00000007500,a17,select
1,01706707600,01706707600,00000000000,a2f,recvmsg
1,01706708200,01706716000,00000007800,a17,select
1,01706719600,01706719700,00000000100,a2f,recvmsg
1,01706720300,01706728400,00000008100,a17,select
1,01706732200,01706732300,00000000100,a2f,recvmsg
1,01706732900,01706739900,00000007000,a17,select
1,01706743500,01706743700,00000000200,a2f,recvmsg
1,01706744100,01706752400,00000008300,a17,select
1,01706756300,01706756500,00000000200,a2f,recvmsg
1,01706757000,01706764400,00000007400,a17,select
1,01706768100,01706768300,00000000200,a2f,recvmsg
1,01706768800,01706776100,00000007300,a17,select
1,01706779800,01706780000,00000000200,a2f,recvmsg
1,01706780500,01706787800,00000007300,a17,select
1,01706791600,01706791800,00000000200,a2f,recvmsg
1,01706792400,01706799600,00000007200,a17,select
1,01706803200,01706803300,00000000100,a2f,recvmsg
1,01706803900,01706811200,00000007300,a17,select
1,01706814900,01706815100,00000000200,a2f,recvmsg
1,01706815600,01706822800,00000007200,a17,select
1,01706826400,01706826600,00000000200,a2f,recvmsg
1,01706827100,01706834000,00000006900,a17,select
1,01706837700,01706837900,00000000200,a2f,recvmsg
1,01706838400,01706847100,00000008700,a17,select
1,01706850700,01706850900,00000000200,a2f,recvmsg
1,01706851400,01706858100,00000006700,a17,select
1,01706861900,01706862100,00000000200,a2f,recvmsg
1,01706862600,01706869600,00000007000,a17,select
1,01706873400,01706873600,00000000200,a2f,recvmsg
1,01706874100,01706880900,00000006800,a17,select
1,01706884700,01706884800,00000000100,a2f,recvmsg
1,01706885400,01706892400,00000007000,a17,select
1,01706896100,01706896300,00000000200,a2f,recvmsg
1,01706896800,01706903900,00000007100,a17,select
1,01706907500,01706907700,00000000200,a2f,recvmsg
1,01706908200,01706915900,00000007700,a17,select
1,01706919600,01706919800,00000000200,a2f,recvmsg
1,01706920300,01706927800,00000007500,a17,select
1,01706931500,01706931700,00000000200,a2f,recvmsg
1,01706932200,01706940000,00000007800,a17,select
1,01706944000,01706944200,00000000200,a2f,recvmsg
1,01706944700,01706952500,00000007800,a17,select
1,01706956200,01706956300,00000000100,a2f,recvmsg
1,01706956800,01706965800,00000009000,a17,select
1,01706969600,01706969800,00000000200,a2f,recvmsg
1,01706970200,01706979600,00000009400,a17,select
1,01706983400,01706983500,00000000100,a2f,recvmsg
1,01706984100,01706991300,00000007200,a17,select
1,01706995100,01706995300,00000000200,a2f,recvmsg
1,01706995900,01707004000,00000008100,a17,select
1,01707007700,01707007800,00000000100,a2f,recvmsg
1,01707008300,01707016300,00000008000,a17,select
1,01707020100,01707020300,00000000200,a2f,recvmsg
1,01707020900,01707028300,00000007400,a17,select
1,01707032200,01707032300,00000000100,a2f,recvmsg
1,01707032800,01707040600,00000007800,a17,select
1,01707044500,01707044700,00000000200,a2f,recvmsg
1,01707045200,01707052700,00000007500,a17,select
1,01707056500,01707056700,00000000200,a2f,recvmsg
1,01707057200,01707064400,00000007200,a17,select
1,01707068100,01707068300,00000000200,a2f,recvmsg
1,01707068700,01707075800,00000007100,a17,select
1,01707079400,01707079600,00000000200,a2f,recvmsg
1,01707080000,01707087600,00000007600,a17,select
1,01707091300,01707091400,00000000100,a2f,recvmsg
1,01707091900,01707107500,00000015600,a17,select
1,01707111100,01707111200,00000000100,a2f,recvmsg
1,01707111800,01707141700,00000029900,a17,select
1,01707145300,01707145500,00000000200,a2f,recvmsg
1,01707146100,01707163800,00000017700,a17,select
1,01707167600,01707167800,00000000200,a2f,recvmsg
1,01707168300,01707175200,00000006900,a17,select
1,01707178900,01707179100,00000000200,a2f,recvmsg
1,01707179600,01707186400,00000006800,a17,select
1,01707190100,01707190200,00000000100,a2f,recvmsg
1,01707190700,01707197700,00000007000,a17,select
1,01707201300,01707201500,00000000200,a2f,recvmsg
1,01707202000,01707208900,00000006900,a17,select
1,01707212800,01707212900,00000000100,a2f,recvmsg
1,01707213400,01707220200,00000006800,a17,select
1,01707223800,01707223900,00000000100,a2f,recvmsg
1,01707224400,01707231300,00000006900,a17,select
1,01707234900,01707235100,00000000200,a2f,recvmsg
1,01707235600,01707243100,00000007500,a17,select
1,01707247000,01707247200,00000000200,a2f,recvmsg
1,01707247600,01707254600,00000007000,a17,select
1,01707258300,01707258500,00000000200,a2f,recvmsg
1,01707258900,01707267400,00000008500,a17,select
1,01707271200,01707271300,00000000100,a2f,recvmsg
1,01707271900,01707281000,00000009100,a17,select
1,01707284900,01707285000,00000000100,a2f,recvmsg
1,01707285500,01707292800,00000007300,a17,select
1,01707296500,01707296600,00000000100,a2f,recvmsg
1,01707297100,01707304300,00000007200,a17,select
1,01707308000,01707308100,00000000100,a2f,recvmsg
1,01707308600,01707315700,00000007100,a17,select
1,01707319400,01707319500,00000000100,a2f,recvmsg
1,01707320000,01707327300,00000007300,a17,select
1,01707330900,01707331100,00000000200,a2f,recvmsg
1,01707331600,01707339300,00000007700,a17,select
1,01707343000,01707343200,00000000200,a2f,recvmsg
1,01707343700,01707350900,00000007200,a17,select
1,01707354500,01707354700,00000000200,a2f,recvmsg
1,01707355300,01707362300,00000007000,a17,select
1,01707365800,01707366000,00000000200,a2f,recvmsg
1,01707366600,01707373700,00000007100,a17,select
1,01707377400,01707377600,00000000200,a2f,recvmsg
1,01707378100,01707385200,00000007100,a17,select
1,01707388800,01707389000,00000000200,a2f,recvmsg
1,01707389500,01707397000,00000007500,a17,select
1,01707400600,01707400800,00000000200,a2f,recvmsg
1,01707401300,01707409100,00000007800,a17,select
1,01707412900,01707413100,00000000200,a2f,recvmsg
1,01707413600,01707420800,00000007200,a17,select
1,01707424500,01707424700,00000000200,a2f,recvmsg
1,01707425200,01707432300,00000007100,a17,select
1,01707435900,01707436100,00000000200,a2f,recvmsg
1,01707436600,01707443800,00000007200,a17,select
1,01707447500,01707447700,00000000200,a2f,recvmsg
1,01707448200,01707463500,00000015300,a17,select
1,01707467200,01707467400,00000000200,a2f,recvmsg
1,01707467800,01707475200,00000007400,a17,select
1,01707478800,01707479000,00000000200,a2f,recvmsg
1,01707479400,01707486600,00000007200,a17,select
1,01707490400,01707490400,00000000000,a2f,recvmsg
1,01707491000,01707498400,00000007400,a17,select
1,01707502000,01707502200,00000000200,a2f,recvmsg
1,01707502800,01707509800,00000007000,a17,select
1,01707513500,01707513700,00000000200,a2f,recvmsg
1,01707514200,01707571100,00000056900,a17,select
1,01707572000,01707573100,00000001100,a2f,recvmsg
1,01707997500,01707999000,00000001500,a2f,recvmsg
1,01708092600,01708095900,00000003300,a14,writev
1,01708193800,01708195900,00000002100,a14,writev
1,01708239200,01708240700,00000001500,a14,writev
1,01708242900,01708250100,00000007200,a14,writev
1,01708291600,01708293200,00000001600,a14,writev
1,01708319200,01708321600,00000002400,a2f,recvmsg
1,01708348800,01708350400,00000001600,a14,writev
1,01708368000,01708369400,00000001400,a14,writev
1,01708385600,01708387200,00000001600,a14,writev
1,01708401600,01708402900,00000001300,a14,writev
1,01708417900,01708419500,00000001600,a14,writev
1,01708434700,01708436600,00000001900,a14,writev
1,01708442300,01708442500,00000000200,a2f,recvmsg
1,01708443300,01708443800,00000000500,a14,writev
1,01708468400,01708469700,00000001300,a14,writev
1,01708470200,01708470500,00000000300,a2f,recvmsg
1,01708482400,01708484000,00000001600,a14,writev
1,01708484200,01708485200,00000001000,a14,writev
1,01708485500,01708485700,00000000200,a2f,recvmsg
1,01702095900,01708494100,00006398200,a07,poll
1,01708500000,01708503100,00000003100,a2f,recvmsg
1,01708508200,01708508400,00000000200,a2f,recvmsg
1,01708512200,01708512400,00000000200,a2f,recvmsg
1,01708512600,01708512700,00000000100,a2f,recvmsg
1,01708517400,01708517600,00000000200,a2f,recvmsg
1,01708517800,01708517900,00000000100,a2f,recvmsg
1,01708518400,01708522000,00000003600,a07,poll
1,01708548300,01708548500,00000000200,a00,read
1,01708550800,01708551700,00000000900,a2e,sendmsg
1,01708564900,01708569500,00000004600,a07,poll
1,01708588500,01708595500,00000007000,a2f,recvmsg
1,01708607900,01708608100,00000000200,a2f,recvmsg
1,01708633500,01708638000,00000004500,a07,poll
1,01708644100,01708650300,00000006200,a2f,recvmsg
1,01708680100,01708680300,00000000200,a2f,recvmsg
1,01708705400,01708707200,00000001800,a07,poll
1,01708707700,01708709100,00000001400,a2f,recvmsg
1,01708714200,01708715400,00000001200,a2d,recvfrom
1,01708716400,01708716600,00000000200,a2f,recvmsg
1,01708717100,01708717300,00000000200,a2f,recvmsg
1,01708745400,01708745700,00000000300,a2f,recvmsg
1,01708747800,01708747900,00000000100,a2f,recvmsg
1,01701520200,01708755000,00007234800,ae8,epoll_wait
1,01708765500,01708767100,00000001600,a2f,recvmsg
1,01708785200,01708785400,00000000200,a2f,recvmsg
1,01708829500,01708830000,00000000500,a2e,sendmsg
1,01706103200,01708855900,00002752700,a57,unlink
1,01708863600,01708866600,00000003000,a14,writev
1,01708867600,01708890900,00000023300,a07,poll
1,01708896400,01708896600,00000000200,a2f,recvmsg
1,01708898600,01708898800,00000000200,a2f,recvmsg
1,01708899000,01708899200,00000000200,a2f,recvmsg
1,01708901300,01708901500,00000000200,a2f,recvmsg
1,01708901700,01708901900,00000000200,a2f,recvmsg
1,01708902200,01708904000,00000001800,a07,poll
1,01708906400,01708906600,00000000200,a2f,recvmsg
1,01708907200,01708907400,00000000200,a2f,recvmsg
1,01709283900,01709293500,00000009600,a0b,munmap
1,01709356400,01709360300,00000003900,a09,mmap
1,01708832100,01709615500,00000783400,ae8,epoll_wait
1,01709624100,01709626700,00000002600,a2f,recvmsg
1,01709638500,01709638800,00000000300,a2f,recvmsg
1,01709657600,01709661500,00000003900,a2e,sendmsg
1,01708902200,01709670900,00000768700,a07,poll
1,01709879100,01709886400,00000007300,a02,open
1,01709896500,01709899300,00000002800,a00,read
1,01709664700,01709942600,00000277900,ae8,epoll_wait
1,01709947500,01709950100,00000002600,a2f,recvmsg
1,01709967900,01709968100,00000000200,a2f,recvmsg
1,01709982900,01709988200,00000005300,a2e,sendmsg
1,01709997500,01710000300,00000002800,a2e,sendmsg
1,01709760400,01710007200,00000246800,a07,poll
1,01710008100,01710008900,00000000800,a00,read
1,01710019600,01710020600,00000001000,a2f,recvmsg
1,01710117700,01710119100,00000001400,a00,read
1,01710173400,01710174300,00000000900,a00,read
1,01710225500,01710226300,00000000800,a00,read
1,01710278600,01710279300,00000000700,a00,read
1,01710329600,01710330500,00000000900,a00,read
1,01710378500,01710379300,00000000800,a00,read
1,01710429200,01710429900,00000000700,a00,read
1,01710483500,01710484200,00000000700,a00,read
1,01710535400,01710536100,00000000700,a00,read
1,01710585300,01710585900,00000000600,a00,read
1,01710616800,01710620800,00000004000,a02,open
1,01710626800,01710627700,00000000900,a00,read
1,01710683700,01710684600,00000000900,a00,read
1,01710769000,01710769800,00000000800,a00,read
1,01710842400,01710843200,00000000800,a00,read
1,01710920300,01710921000,00000000700,a00,read
1,01711000600,01711001300,00000000700,a00,read
1,01711079700,01711080600,00000000900,a00,read
1,01711165800,01711166500,00000000700,a00,read
1,01711233400,01711234200,00000000800,a00,read
1,01711292300,01711293000,00000000700,a00,read
1,01711371700,01711404500,00000032800,a07,poll
1,01711407700,01711407900,00000000200,a2f,recvmsg
1,01711408500,01711408700,00000000200,a2f,recvmsg
1,01711411000,01711417700,00000006700,a07,poll
1,01711418900,01711419100,00000000200,a2f,recvmsg
1,01711419400,01711419600,00000000200,a2f,recvmsg
1,01711424600,01711431000,00000006400,a06,lstat
1,01711431700,01711432700,00000001000,a06,lstat
1,01711453800,01711468500,00000014700,a01,write
1,01711473800,01711481000,00000007200,a07,poll
1,01711483100,01711483300,00000000200,a2f,recvmsg
1,01711483700,01711483900,00000000200,a2f,recvmsg
1,01711485400,01711800000,00000314600,a38,clone
1,01712279600,01712279700,00000000100,a0c,brk
1,01712289500,01712292200,00000002700,a15,access
1,01712292900,01712293900,00000001000,a09,mmap
1,01712298800,01712299400,00000000600,a15,access
1,01712306600,01712307600,00000001000,a09,mmap
1,01712311700,01712312300,00000000600,a15,access
1,01712318900,01712320000,00000001100,a00,read
1,01712321600,01712323100,00000001500,a09,mmap
1,01712327100,01712329200,00000002100,a09,mmap
1,01712341400,01712342000,00000000600,a15,access
1,01712345300,01712346200,00000000900,a00,read
1,01712346800,01712347900,00000001100,a09,mmap
1,01712360000,01712360500,00000000500,a15,access
1,01712363400,01712364200,00000000800,a00,read
1,01712364900,01712365700,00000000800,a09,mmap
1,01712367200,01712369200,00000002000,a09,mmap
1,01712373600,01712376500,00000002900,a09,mmap
1,01712378500,01712379600,00000001100,a09,mmap
1,01712388600,01712389300,00000000700,a15,access
1,01712391900,01712392500,00000000600,a00,read
1,01712393200,01712394600,00000001400,a09,mmap
1,01712397300,01712398900,00000001600,a09,mmap
1,01712407200,01712407600,00000000400,a15,access
1,01712410800,01712411400,00000000600,a00,read
1,01712412000,01712413400,00000001400,a09,mmap
1,01712417000,01712419100,00000002100,a09,mmap
1,01712427900,01712428500,00000000600,a15,access
1,01712430700,01712431500,00000000800,a00,read
1,01712432000,01712433000,00000001000,a09,mmap
1,01712434300,01712435700,00000001400,a09,mmap
1,01712438600,01712439900,00000001300,a09,mmap
1,01712446100,01712446600,00000000500,a15,access
1,01712448800,01712449400,00000000600,a00,read
1,01712449900,01712451300,00000001400,a09,mmap
1,01712453600,01712455100,00000001500,a09,mmap
1,01712469200,01712469900,00000000700,a09,mmap
1,01712473700,01712474100,00000000400,a09,mmap
1,01712475100,01712475400,00000000300,a09,mmap
1,01712653600,01712653700,00000000100,a0c,brk
1,01712653800,01712654600,00000000800,a0c,brk
1,01712716300,01712722500,00000006200,a00,read
1,01712734300,01712735800,00000001500,a00,read
1,01712770800,01712771800,00000001000,a00,read
1,01712894200,01712895200,00000001000,a00,read
1,01712966500,01712966800,00000000300,a00,read
1,01713051400,01713051900,00000000500,a00,read
1,01713183100,01713183900,00000000800,a00,read
1,01713312000,01713312800,00000000800,a00,read
1,01713468900,01713469600,00000000700,a00,read
1,01713619800,01713620400,00000000600,a00,read
1,01713657200,01713658600,00000001400,a0c,brk
1,01713774000,01713774700,00000000700,a00,read
1,01713923600,01713924300,00000000700,a00,read
1,01714082700,01714083500,00000000800,a00,read
1,01714243400,01714244200,00000000800,a00,read
1,01714352400,01714353000,00000000600,a00,read
1,01714383500,01714384100,00000000600,a0c,brk
1,01714491800,01714492500,00000000700,a00,read
1,01714736700,01714737300,00000000600,a00,read
1,01714749100,01714749600,00000000500,a00,read
1,01714793200,01714793500,00000000300,a00,read
1,01714813000,01714813800,00000000800,a00,read
1,01715020000,01715020300,00000000300,a00,read
1,01715049400,01715050300,00000000900,a00,read
1,01715147500,01715148400,00000000900,a00,read
1,01715172300,01715173500,00000001200,a0c,brk
1,01715218300,01715218700,00000000400,a00,read
1,01715293800,01715294600,00000000800,a00,read
1,01715449600,01715450100,00000000500,a00,read
1,01715561800,01715562400,00000000600,a00,read
1,01715655600,01715656100,00000000500,a00,read
1,01715667900,01715668300,00000000400,a00,read
1,01715748200,01715748600,00000000400,a00,read
1,01715771900,01715772200,00000000300,a00,read
1,01715793800,01715794400,00000000600,a00,read
1,01715896100,01715897200,00000001100,a0c,brk
1,01715898900,01715899900,00000001000,a00,read
1,01716103800,01716104300,00000000500,a00,read
1,01716187300,01716187900,00000000600,a00,read
1,01716252600,01716253200,00000000600,a00,read
1,01716381600,01716382100,00000000500,a00,read
1,01716414700,01716415300,00000000600,a00,read
1,01716431700,01716433000,00000001300,a02,open
1,01716544400,01716544900,00000000500,a00,read
1,01716615800,01716616100,00000000300,a00,read
1,01716682500,01716683100,00000000600,a00,read
1,01716793200,01716793800,00000000600,a00,read
1,01716943500,01716944400,00000000900,a00,read
1,01717074100,01717075000,00000000900,a00,read
1,01717132800,01717133400,00000000600,a00,read
1,01717188900,01717189600,00000000700,a00,read
1,01717259100,01717259800,00000000700,a00,read
1,01717312000,01717312700,00000000700,a00,read
1,01717400800,01717401400,00000000600,a0c,brk
1,01717434400,01717438100,00000003700,a0c,brk
1,01717452100,01717452900,00000000800,a00,read
1,01717566800,01717567700,00000000900,a00,read
1,01717726200,01717726900,00000000700,a00,read
1,01717843800,01717844500,00000000700,a00,read
1,01717989500,01717990200,00000000700,a00,read
1,01718107100,01718107700,00000000600,a00,read
1,01718269600,01718270300,00000000700,a00,read
1,01718275200,01718276000,00000000800,a0c,brk
1,01718390700,01718391300,00000000600,a00,read
1,01718511300,01718512000,00000000700,a00,read
1,01718653100,01718653900,00000000800,a00,read
1,01718784300,01718785000,00000000700,a00,read
1,01718878300,01718879000,00000000700,a00,read
1,01718990800,01718991400,00000000600,a00,read
1,01719114600,01719115300,00000000700,a00,read
1,01719226000,01719226600,00000000600,a0c,brk
1,01719249200,01719249800,00000000600,a00,read
1,01719419500,01719420200,00000000700,a00,read
1,01719570000,01719570700,00000000700,a00,read
1,01719681100,01719681800,00000000700,a00,read
1,01719848600,01719849500,00000000900,a00,read
1,01719926000,01719926800,00000000800,a00,read
1,01720008100,01720008800,00000000700,a00,read
1,01720075800,01720076300,00000000500,a0c,brk
1,01720089800,01720090500,00000000700,a00,read
1,01720164300,01720165000,00000000700,a00,read
1,01720265600,01720266200,00000000600,a00,read
1,01720368400,01720369000,00000000600,a00,read
1,01720458300,01720459000,00000000700,a00,read
1,01720539500,01720540000,00000000500,a00,read
1,01720640900,01720641700,00000000800,a00,read
1,01720739400,01720740100,00000000700,a00,read
1,01720848500,01720849100,00000000600,a00,read
1,01720941800,01720942400,00000000600,a00,read
1,01721060600,01721061300,00000000700,a00,read
1,01721174100,01721174700,00000000600,a00,read
1,01721277500,01721278100,00000000600,a00,read
1,01721379900,01721380300,00000000400,a0c,brk
1,01721740100,01721743700,00000003600,a57,unlink
1,01721768800,01721769400,00000000600,a48,fcntl
1,01721815500,01721831500,00000016000,a01,write
1,01721849200,01721851700,00000002500,a01,write
1,01721867800,01721871500,00000003700,a01,write
1,01708486100,01722111500,00013625400,a17,select
1,01722136300,01722136500,00000000200,a2f,recvmsg
1,01722139900,01722161300,00000021400,a17,select
1,01722165200,01722165400,00000000200,a2f,recvmsg
1,01722166100,01722180100,00000014000,a17,select
1,01722183500,01722183700,00000000200,a2f,recvmsg
1,01722184300,01722199500,00000015200,a17,select
1,01722203300,01722203500,00000000200,a2f,recvmsg
1,01722204000,01722217700,00000013700,a17,select
1,01722221700,01722221900,00000000200,a2f,recvmsg
1,01722222400,01722236300,00000013900,a17,select
1,01722239500,01722239700,00000000200,a2f,recvmsg
1,01722240100,01722264800,00000024700,a17,select
1,01722268700,01722268900,00000000200,a2f,recvmsg
1,01722269400,01722280000,00000010600,a17,select
1,01722283700,01722283800,00000000100,a2f,recvmsg
1,01722284300,01722291800,00000007500,a17,select
1,01722295400,01722295500,00000000100,a2f,recvmsg
1,01722296100,01722303500,00000007400,a17,select
1,01722307100,01722307300,00000000200,a2f,recvmsg
1,01722307800,01722315300,00000007500,a17,select
1,01722319000,01722319200,00000000200,a2f,recvmsg
1,01722319900,01722327200,00000007300,a17,select
1,01722330700,01722330900,00000000200,a2f,recvmsg
1,01722331300,01722338600,00000007300,a17,select
1,01722342400,01722342600,00000000200,a2f,recvmsg
1,01722343000,01722350100,00000007100,a17,select
1,01722353600,01722353800,00000000200,a2f,recvmsg
1,01722354200,01722362600,00000008400,a17,select
1,01722366300,01722366500,00000000200,a2f,recvmsg
1,01722367000,01722374500,00000007500,a17,select
1,01722378300,01722378500,00000000200,a2f,recvmsg
1,01722378900,01722386500,00000007600,a17,select
1,01722390200,01722390200,00000000000,a2f,recvmsg
1,01722390800,01722398000,00000007200,a17,select
1,01722401700,01722401900,00000000200,a2f,recvmsg
1,01722402400,01722409700,00000007300,a17,select
1,01722413200,01722413400,00000000200,a2f,recvmsg
1,01722413900,01722421300,00000007400,a17,select
1,01722424900,01722425100,00000000200,a2f,recvmsg
1,01722425600,01722432900,00000007300,a17,select
1,01722436500,01722436600,00000000100,a2f,recvmsg
1,01722437200,01722444100,00000006900,a17,select
1,01722447900,01722448100,00000000200,a2f,recvmsg
1,01722448600,01722457300,00000008700,a17,select
1,01722460800,01722461000,00000000200,a2f,recvmsg
1,01722461500,01722468200,00000006700,a17,select
1,01722471900,01722472100,00000000200,a2f,recvmsg
1,01722472700,01722479500,00000006800,a17,select
1,01722483000,01722483100,00000000100,a2f,recvmsg
1,01722483600,01722490700,00000007100,a17,select
1,01722494200,01722494400,00000000200,a2f,recvmsg
1,01722494800,01722502000,00000007200,a17,select
1,01722505600,01722505800,00000000200,a2f,recvmsg
1,01722506200,01722513200,00000007000,a17,select
1,01722516900,01722517100,00000000200,a2f,recvmsg
1,01722517500,01722525100,00000007600,a17,select
1,01722528700,01722528900,00000000200,a2f,recvmsg
1,01722529300,01722536900,00000007600,a17,select
1,01722540600,01722540700,00000000100,a2f,recvmsg
1,01722541300,01722549000,00000007700,a17,select
1,01722552900,01722553000,00000000100,a2f,recvmsg
1,01722553600,01722561100,00000007500,a17,select
1,01722564700,01722564800,00000000100,a2f,recvmsg
1,01722565300,01722572800,00000007500,a17,select
1,01722576500,01722576700,00000000200,a2f,recvmsg
1,01722577200,01722586800,00000009600,a17,select
1,01722590500,01722590700,00000000200,a2f,recvmsg
1,01722591200,01722598400,00000007200,a17,select
1,01722601900,01722602100,00000000200,a2f,recvmsg
1,01722602600,01722609700,00000007100,a17,select
1,01722613400,01722613600,00000000200,a2f,recvmsg
1,01722614100,01722622000,00000007900,a17,select
1,01722625800,01722625900,00000000100,a2f,recvmsg
1,01722626500,01722635800,00000009300,a17,select
1,01722639500,01722639700,00000000200,a2f,recvmsg
1,01722640200,01722648000,00000007800,a17,select
1,01722651700,01722651800,00000000100,a2f,recvmsg
1,01722652400,01722659900,00000007500,a17,select
1,01722663700,01722663800,00000000100,a2f,recvmsg
1,01722664300,01722671400,00000007100,a17,select
1,01722674900,01722675100,00000000200,a2f,recvmsg
1,01722675500,01722682500,00000007000,a17,select
1,01722686100,01722686200,00000000100,a2f,recvmsg
1,01722686700,01722694200,00000007500,a17,select
1,01722697900,01722698000,00000000100,a2f,recvmsg
1,01722698500,01722714300,00000015800,a17,select
1,01722717900,01722718100,00000000200,a2f,recvmsg
1,01722718600,01722748500,00000029900,a17,select
1,01722752100,01722752200,00000000100,a2f,recvmsg
1,01722752800,01722770400,00000017600,a17,select
1,01722774200,01722774300,00000000100,a2f,recvmsg
1,01722774900,01722782000,00000007100,a17,select
1,01722785400,01722785600,00000000200,a2f,recvmsg
1,01722786100,01722793000,00000006900,a17,select
1,01722796500,01722796600,00000000100,a2f,recvmsg
1,01722797100,01722804000,00000006900,a17,select
1,01722807500,01722807700,00000000200,a2f,recvmsg
1,01722808200,01722815100,00000006900,a17,select
1,01722818600,01722818800,00000000200,a2f,recvmsg
1,01722819300,01722826400,00000007100,a17,select
1,01722829900,01722830100,00000000200,a2f,recvmsg
1,01722830600,01722837600,00000007000,a17,select
1,01722841100,01722841300,00000000200,a2f,recvmsg
1,01722841800,01722849300,00000007500,a17,select
1,01722852900,01722853100,00000000200,a2f,recvmsg
1,01722853600,01722860500,00000006900,a17,select
1,01722864100,01722864300,00000000200,a2f,recvmsg
1,01722864800,01722873300,00000008500,a17,select
1,01722876800,01722877000,00000000200,a2f,recvmsg
1,01722877500,01722886900,00000009400,a17,select
1,01722890500,01722890700,00000000200,a2f,recvmsg
1,01722891200,01722898800,00000007600,a17,select
1,01722902200,01722902400,00000000200,a2f,recvmsg
1,01722902900,01722910200,00000007300,a17,select
1,01722913900,01722914000,00000000100,a2f,recvmsg
1,01722914600,01722921600,00000007000,a17,select
1,01722925000,01722925200,00000000200,a2f,recvmsg
1,01722925700,01722932800,00000007100,a17,select
1,01722936400,01722936600,00000000200,a2f,recvmsg
1,01722937100,01722944600,00000007500,a17,select
1,01722948200,01722948400,00000000200,a2f,recvmsg
1,01722948800,01722956100,00000007300,a17,select
1,01722959700,01722959900,00000000200,a2f,recvmsg
1,01722960300,01722967600,00000007300,a17,select
1,01722971000,01722971200,00000000200,a2f,recvmsg
1,01722971700,01722979000,00000007300,a17,select
1,01722982700,01722982800,00000000100,a2f,recvmsg
1,01722983300,01722990600,00000007300,a17,select
1,01722994100,01722994300,00000000200,a2f,recvmsg
1,01722994700,01723002000,00000007300,a17,select
1,01723005600,01723005800,00000000200,a2f,recvmsg
1,01723006200,01723013800,00000007600,a17,select
1,01723017500,01723017700,00000000200,a2f,recvmsg
1,01723018200,01723025300,00000007100,a17,select
1,01723028800,01723029000,00000000200,a2f,recvmsg
1,01723029600,01723036600,00000007000,a17,select
1,01723040000,01723040200,00000000200,a2f,recvmsg
1,01723040700,01723047800,00000007100,a17,select
1,01723051500,01723051700,00000000200,a2f,recvmsg
1,01723052200,01723064600,00000012400,a17,select
1,01723068100,01723068300,00000000200,a2f,recvmsg
1,01723068700,01723076100,00000007400,a17,select
1,01723079600,01723079800,00000000200,a2f,recvmsg
1,01723080200,01723087400,00000007200,a17,select
1,01723091000,01723091200,00000000200,a2f,recvmsg
1,01723091600,01723098900,00000007300,a17,select
1,01723102500,01723102700,00000000200,a2f,recvmsg
1,01723103100,01723110300,00000007200,a17,select
1,01723113800,01723114000,00000000200,a2f,recvmsg
1,01723114400,01723169800,00000055400,a17,select
1,01723170700,01723172000,00000001300,a2f,recvmsg
1,01723266200,01723270700,00000004500,a14,writev
1,01723347200,01723349100,00000001900,a14,writev
1,01723406700,01723408600,00000001900,a14,writev
1,01723465000,01723466300,00000001300,a14,writev
1,01723521500,01723523100,00000001600,a14,writev
1,01723577700,01723579000,00000001300,a14,writev
1,01723582100,01723582900,00000000800,a2f,recvmsg
1,01723633100,01723634600,00000001500,a14,writev
1,01723679300,01723680600,00000001300,a14,writev
1,01723723700,01723725100,00000001400,a14,writev
1,01723768300,01723770000,00000001700,a14,writev
1,01723813400,01723814800,00000001400,a14,writev
1,01723857500,01723858900,00000001400,a14,writev
1,01723883800,01723885700,00000001900,a2f,recvmsg
1,01723912500,01723914000,00000001500,a14,writev
1,01723933000,01723934600,00000001600,a14,writev
1,01723951400,01723953300,00000001900,a14,writev
1,01723967800,01723969500,00000001700,a14,writev
1,01723984300,01723985700,00000001400,a14,writev
1,01723999700,01724001500,00000001800,a14,writev
1,01724006500,01724006700,00000000200,a2f,recvmsg
1,01724007300,01724007600,00000000300,a14,writev
1,01724025600,01724027500,00000001900,a14,writev
1,01724027800,01724029100,00000001300,a14,writev
1,01724029600,01724029800,00000000200,a2f,recvmsg
1,01724040800,01724042300,00000001500,a14,writev
1,01724042500,01724043500,00000001000,a14,writev
1,01724043800,01724044000,00000000200,a2f,recvmsg
1,01711473800,01724051800,00012578000,a07,poll
1,01724057800,01724060300,00000002500,a2f,recvmsg
1,01724065500,01724065700,00000000200,a2f,recvmsg
1,01724069200,01724069400,00000000200,a2f,recvmsg
1,01724069700,01724069800,00000000100,a2f,recvmsg
1,01724074200,01724074400,00000000200,a2f,recvmsg
1,01724074500,01724074700,00000000200,a2f,recvmsg
1,01724075400,01724080200,00000004800,a07,poll
1,01724085700,01724091600,00000005900,a2f,recvmsg
1,01724105100,01724105300,00000000200,a2f,recvmsg
1,01724130600,01724134900,00000004300,a07,poll
1,01724140400,01724146300,00000005900,a2f,recvmsg
1,01724159400,01724159600,00000000200,a2f,recvmsg
1,01724044500,01724189300,00000144800,a17,select
1,01724204300,01724205700,00000001400,a14,writev
1,01724206200,01724206400,00000000200,a2f,recvmsg
1,01724222600,01724222800,00000000200,a2f,recvmsg
1,01724235300,01724236200,00000000900,a14,writev
1,01724236500,01724236700,00000000200,a2f,recvmsg
1,01724183600,01724241200,00000057600,a07,poll
1,01724244500,01724244600,00000000100,a2f,recvmsg
1,01724246000,01724246200,00000000200,a2f,recvmsg
1,01724246400,01724246500,00000000100,a2f,recvmsg
1,01724247800,01724247900,00000000100,a2f,recvmsg
1,01724248100,01724248300,00000000200,a2f,recvmsg
1,01724248600,01724250000,00000001400,a07,poll
1,01724250400,01724251400,00000001000,a2f,recvmsg
1,01724256400,01724257300,00000000900,a2d,recvfrom
1,01724258200,01724258300,00000000100,a2f,recvmsg
1,01724259000,01724259200,00000000200,a2f,recvmsg
1,01724287900,01724288100,00000000200,a2f,recvmsg
1,01724289900,01724290000,00000000100,a2f,recvmsg
1,01724237200,01726097100,00001859900,a17,select
1,01726108800,01726109000,00000000200,a2f,recvmsg
1,01726110500,01726120300,00000009800,a17,select
1,01726124300,01726124500,00000000200,a2f,recvmsg
1,01726125100,01726182300,00000057200,a17,select
1,01726185700,01726185900,00000000200,a2f,recvmsg
1,01711822100,01736707000,00024884900,a3d,wait4
1,01736729600,01736734500,00000004900,a00,read
1,01736736700,01736737100,00000000400,a00,read
1,01736757300,01736821200,00000063900,a07,poll
1,01736826800,01736827000,00000000200,a2f,recvmsg
1,01736828000,01736828200,00000000200,a2f,recvmsg
1,01736837300,01736847100,00000009800,a07,poll
1,01736848900,01736849100,00000000200,a2f,recvmsg
1,01736849300,01736849500,00000000200,a2f,recvmsg
1,01736853700,01736867200,00000013500,a07,poll
1,01736869200,01736869400,00000000200,a2f,recvmsg
1,01736869800,01736870000,00000000200,a2f,recvmsg
1,01736873900,01736887200,00000013300,a07,poll
1,01736889100,01736889300,00000000200,a2f,recvmsg
1,01736889700,01736889900,00000000200,a2f,recvmsg
1,01736894700,01736908000,00000013300,a07,poll
1,01736909900,01736910000,00000000100,a2f,recvmsg
1,01736910400,01736910600,00000000200,a2f,recvmsg
1,01736914800,01736921600,00000006800,a07,poll
1,01736922900,01736923100,00000000200,a2f,recvmsg
1,01736923300,01736923500,00000000200,a2f,recvmsg
1,01736924400,01736924700,00000000300,a08,lseek
1,01736945500,01736945600,00000000100,a08,lseek
1,01736948900,01736955600,00000006700,a07,poll
1,01736957100,01736957200,00000000100,a2f,recvmsg
1,01736957500,01736957700,00000000200,a2f,recvmsg
1,01736963200,01736969800,00000006600,a07,poll
1,01736971000,01736971200,00000000200,a2f,recvmsg
1,01736971500,01736971700,00000000200,a2f,recvmsg
1,01736975000,01736981600,00000006600,a07,poll
1,01736982700,01736982900,00000000200,a2f,recvmsg
1,01736983200,01736983400,00000000200,a2f,recvmsg
1,01736987000,01736993600,00000006600,a07,poll
1,01736994800,01736994900,00000000100,a2f,recvmsg
1,01736995300,01736995500,00000000200,a2f,recvmsg
1,01736998500,01737005300,00000006800,a07,poll
1,01737006500,01737006700,00000000200,a2f,recvmsg
1,01737006900,01737007100,00000000200,a2f,recvmsg
1,01737010600,01737017200,00000006600,a07,poll
1,01737018300,01737018500,00000000200,a2f,recvmsg
1,01737018800,01737019000,00000000200,a2f,recvmsg
1,01737023000,01737029900,00000006900,a07,poll
1,01737031200,01737031300,00000000100,a2f,recvmsg
1,01737031600,01737031700,00000000100,a2f,recvmsg
1,01737034500,01737041100,00000006600,a07,poll
1,01737043100,01737043300,00000000200,a2f,recvmsg
1,01737043600,01737043800,00000000200,a2f,recvmsg
1,01737047900,01737054800,00000006900,a07,poll
1,01737055900,01737056100,00000000200,a2f,recvmsg
1,01737056300,01737056500,00000000200,a2f,recvmsg
1,01737059900,01737066700,00000006800,a07,poll
1,01737067800,01737068000,00000000200,a2f,recvmsg
1,01737068300,01737068500,00000000200,a2f,recvmsg
1,01737071500,01737078300,00000006800,a07,poll
1,01737079300,01737079500,00000000200,a2f,recvmsg
1,01737079800,01737080000,00000000200,a2f,recvmsg
1,01737083000,01737089900,00000006900,a07,poll
1,01737090900,01737091100,00000000200,a2f,recvmsg
1,01737091400,01737091600,00000000200,a2f,recvmsg
1,01737094500,01737101300,00000006800,a07,poll
1,01737102500,01737102700,00000000200,a2f,recvmsg
1,01737103000,01737103200,00000000200,a2f,recvmsg
1,01737107200,01737113800,00000006600,a07,poll
1,01737115000,01737115200,00000000200,a2f,recvmsg
1,01737115400,01737115600,00000000200,a2f,recvmsg
1,01737118700,01737125400,00000006700,a07,poll
1,01737126600,01737126600,00000000000,a2f,recvmsg
1,01737126900,01737127100,00000000200,a2f,recvmsg
1,01737129900,01737136700,00000006800,a07,poll
1,01737137800,01737138000,00000000200,a2f,recvmsg
1,01737138200,01737138400,00000000200,a2f,recvmsg
1,01737143200,01737149800,00000006600,a07,poll
1,01737151800,01737152000,00000000200,a2f,recvmsg
1,01737152300,01737152500,00000000200,a2f,recvmsg
1,01737155100,01737161800,00000006700,a07,poll
1,01737162900,01737163000,00000000100,a2f,recvmsg
1,01737163300,01737163500,00000000200,a2f,recvmsg
1,01737166200,01737173000,00000006800,a07,poll
1,01737174100,01737174300,00000000200,a2f,recvmsg
1,01737174600,01737174700,00000000100,a2f,recvmsg
1,01737177400,01737184200,00000006800,a07,poll
1,01737185300,01737185500,00000000200,a2f,recvmsg
1,01737185700,01737185900,00000000200,a2f,recvmsg
1,01737188900,01737195500,00000006600,a07,poll
1,01737196700,01737196900,00000000200,a2f,recvmsg
1,01737197100,01737197300,00000000200,a2f,recvmsg
1,01737200000,01737206600,00000006600,a07,poll
1,01737207800,01737207900,00000000100,a2f,recvmsg
1,01737208200,01737208300,00000000100,a2f,recvmsg
1,01737211600,01737218300,00000006700,a07,poll
1,01737219400,01737219600,00000000200,a2f,recvmsg
1,01737219800,01737220000,00000000200,a2f,recvmsg
1,01737223400,01737230200,00000006800,a07,poll
1,01737231200,01737231400,00000000200,a2f,recvmsg
1,01737231700,01737231900,00000000200,a2f,recvmsg
1,01737235600,01737242600,00000007000,a07,poll
1,01737243700,01737243900,00000000200,a2f,recvmsg
1,01737244200,01737244400,00000000200,a2f,recvmsg
1,01737247800,01737254400,00000006600,a07,poll
1,01737255500,01737255700,00000000200,a2f,recvmsg
1,01737255900,01737256100,00000000200,a2f,recvmsg
1,01737259400,01737266400,00000007000,a07,poll
1,01737267500,01737267700,00000000200,a2f,recvmsg
1,01737268000,01737268200,00000000200,a2f,recvmsg
1,01737273500,01737280400,00000006900,a07,poll
1,01737281400,01737281600,00000000200,a2f,recvmsg
1,01737281900,01737282100,00000000200,a2f,recvmsg
1,01737285000,01737291800,00000006800,a07,poll
1,01737292800,01737293000,00000000200,a2f,recvmsg
1,01737293300,01737293500,00000000200,a2f,recvmsg
1,01737296400,01737303300,00000006900,a07,poll
1,01737304300,01737304500,00000000200,a2f,recvmsg
1,01737304800,01737305000,00000000200,a2f,recvmsg
1,01737309000,01737316000,00000007000,a07,poll
1,01737317100,01737317200,00000000100,a2f,recvmsg
1,01737317500,01737317700,00000000200,a2f,recvmsg
1,01737321000,01737327800,00000006800,a07,poll
1,01737328800,01737329000,00000000200,a2f,recvmsg
1,01737329300,01737329500,00000000200,a2f,recvmsg
1,01737333100,01737339800,00000006700,a07,poll
1,01737341000,01737341200,00000000200,a2f,recvmsg
1,01737341400,01737341600,00000000200,a2f,recvmsg
1,01737344900,01737351900,00000007000,a07,poll
1,01737353000,01737353200,00000000200,a2f,recvmsg
1,01737353500,01737353700,00000000200,a2f,recvmsg
1,01737356600,01737363300,00000006700,a07,poll
1,01737364400,01737364600,00000000200,a2f,recvmsg
1,01737364900,01737365100,00000000200,a2f,recvmsg
1,01737367900,01737374600,00000006700,a07,poll
1,01737375600,01737375800,00000000200,a2f,recvmsg
1,01737376100,01737376300,00000000200,a2f,recvmsg
1,01737379500,01737386300,00000006800,a07,poll
1,01737387400,01737387600,00000000200,a2f,recvmsg
1,01737387900,01737388100,00000000200,a2f,recvmsg
1,01737389000,01737389100,00000000100,a08,lseek
1,01737391700,01737393000,00000001300,a00,read
1,01737396900,01737397000,00000000100,a08,lseek
1,01737400100,01737406700,00000006600,a07,poll
1,01737407900,01737408100,00000000200,a2f,recvmsg
1,01737408400,01737408600,00000000200,a2f,recvmsg
1,01737434900,01737441600,00000006700,a07,poll
1,01737442800,01737443000,00000000200,a2f,recvmsg
1,01737443300,01737443500,00000000200,a2f,recvmsg
1,01737447300,01737448100,00000000800,a00,read
1,01737453400,01737453500,00000000100,a08,lseek
1,01737456900,01737463600,00000006700,a07,poll
1,01737464800,01737465000,00000000200,a2f,recvmsg
1,01737465300,01737465500,00000000200,a2f,recvmsg
1,01737468200,01737474900,00000006700,a07,poll
1,01737476000,01737476100,00000000100,a2f,recvmsg
1,01737476300,01737476500,00000000200,a2f,recvmsg
1,01737479100,01737485700,00000006600,a07,poll
1,01737486900,01737487100,00000000200,a2f,recvmsg
1,01737487400,01737487600,00000000200,a2f,recvmsg
1,01737490200,01737496900,00000006700,a07,poll
1,01737498000,01737498200,00000000200,a2f,recvmsg
1,01737498500,01737498700,00000000200,a2f,recvmsg
1,01737501200,01737508000,00000006800,a07,poll
1,01737509100,01737509200,00000000100,a2f,recvmsg
1,01737509500,01737509700,00000000200,a2f,recvmsg
1,01737512500,01737519200,00000006700,a07,poll
1,01737520200,01737520400,00000000200,a2f,recvmsg
1,01737520700,01737520900,00000000200,a2f,recvmsg
1,01737523500,01737530200,00000006700,a07,poll
1,01737531300,01737531400,00000000100,a2f,recvmsg
1,01737531700,01737531900,00000000200,a2f,recvmsg
1,01737535200,01737542000,00000006800,a07,poll
1,01737543000,01737543200,00000000200,a2f,recvmsg
1,01737543500,01737543700,00000000200,a2f,recvmsg
1,01737546500,01737553200,00000006700,a07,poll
1,01737554200,01737554400,00000000200,a2f,recvmsg
1,01737554700,01737554900,00000000200,a2f,recvmsg
1,01737555300,01737555400,00000000100,a08,lseek
1,01737559400,01737566100,00000006700,a07,poll
1,01737567300,01737567400,00000000100,a2f,recvmsg
1,01737567700,01737567900,00000000200,a2f,recvmsg
1,01737572800,01737579600,00000006800,a07,poll
1,01737580700,01737580900,00000000200,a2f,recvmsg
1,01737581200,01737581400,00000000200,a2f,recvmsg
1,01737584700,01737591300,00000006600,a07,poll
1,01737592400,01737592600,00000000200,a2f,recvmsg
1,01737592900,01737593000,00000000100,a2f,recvmsg
1,01737596100,01737602900,00000006800,a07,poll
1,01737604000,01737604100,00000000100,a2f,recvmsg
1,01737604400,01737604600,00000000200,a2f,recvmsg
1,01737607600,01737614200,00000006600,a07,poll
1,01737615300,01737615500,00000000200,a2f,recvmsg
1,01737615800,01737616000,00000000200,a2f,recvmsg
1,01737619000,01737625900,00000006900,a07,poll
1,01737627000,01737627200,00000000200,a2f,recvmsg
1,01737627500,01737627700,00000000200,a2f,recvmsg
1,01737631200,01737637800,00000006600,a07,poll
1,01737638900,01737639100,00000000200,a2f,recvmsg
1,01737639400,01737639600,00000000200,a2f,recvmsg
1,01737642500,01737649300,00000006800,a07,poll
1,01737650500,01737650600,00000000100,a2f,recvmsg
1,01737650900,01737651000,00000000100,a2f,recvmsg
1,01737654000,01737660600,00000006600,a07,poll
1,01737661800,01737662000,00000000200,a2f,recvmsg
1,01737662300,01737662400,00000000100,a2f,recvmsg
1,01737665400,01737672000,00000006600,a07,poll
1,01737673100,01737673300,00000000200,a2f,recvmsg
1,01737673600,01737673800,00000000200,a2f,recvmsg
1,01737676700,01737683500,00000006800,a07,poll
1,01737684700,01737684800,00000000100,a2f,recvmsg
1,01737685100,01737685200,00000000100,a2f,recvmsg
1,01737688100,01737694800,00000006700,a07,poll
1,01737695900,01737696100,00000000200,a2f,recvmsg
1,01737696400,01737696500,00000000100,a2f,recvmsg
1,01737699900,01737706800,00000006900,a07,poll
1,01737707900,01737708000,00000000100,a2f,recvmsg
1,01737708300,01737708500,00000000200,a2f,recvmsg
1,01737711400,01737718100,00000006700,a07,poll
1,01737719200,01737719400,00000000200,a2f,recvmsg
1,01737719600,01737719800,00000000200,a2f,recvmsg
1,01737722800,01737729300,00000006500,a07,poll
1,01737730500,01737730700,00000000200,a2f,recvmsg
1,01737730900,01737731000,00000000100,a2f,recvmsg
1,01737734200,01737741000,00000006800,a07,poll
1,01737742100,01737742200,00000000100,a2f,recvmsg
1,01737742500,01737742700,00000000200,a2f,recvmsg
1,01737750900,01737757600,00000006700,a07,poll
1,01737758700,01737758900,00000000200,a2f,recvmsg
1,01737759200,01737759300,00000000100,a2f,recvmsg
1,01737762700,01737769300,00000006600,a07,poll
1,01737770400,01737770600,00000000200,a2f,recvmsg
1,01737770800,01737771000,00000000200,a2f,recvmsg
1,01737774100,01737780700,00000006600,a07,poll
1,01737781900,01737782100,00000000200,a2f,recvmsg
1,01737782300,01737782500,00000000200,a2f,recvmsg
1,01737785700,01737792200,00000006500,a07,poll
1,01737793300,01737793500,00000000200,a2f,recvmsg
1,01737793700,01737793900,00000000200,a2f,recvmsg
1,01737796900,01737803600,00000006700,a07,poll
1,01737804700,01737804800,00000000100,a2f,recvmsg
1,01737805000,01737805200,00000000200,a2f,recvmsg
1,01737825500,01737851900,00000026400,a57,unlink
1,01737853100,01737856900,00000003800,a14,writev
1,01737857500,01737956200,00000098700,a07,poll
1,01737971900,01737972100,00000000200,a2f,recvmsg
1,01738013400,01738036900,00000023500,a07,poll
1,01738038300,01738095500,00000057200,a07,poll
1,01738096500,01738151300,00000054800,a07,poll
1,01738152400,01738208200,00000055800,a07,poll
1,01738209200,01738264000,00000054800,a07,poll
1,01738265300,01738319800,00000054500,a07,poll
1,01738320800,01738364600,00000043800,a07,poll
1,01738365600,01738408100,00000042500,a07,poll
1,01738409100,01738451700,00000042600,a07,poll
1,01738454200,01738496000,00000041800,a07,poll
1,01738497200,01738540700,00000043500,a07,poll
1,01738542000,01738594600,00000052600,a07,poll
1,01738595700,01738613800,00000018100,a07,poll
1,01738614800,01738631100,00000016300,a07,poll
1,01738632100,01738646500,00000014400,a07,poll
1,01738647700,01738661100,00000013400,a07,poll
1,01738662100,01738676900,00000014800,a07,poll
1,01738678600,01738682400,00000003800,a07,poll
1,01738684600,01738684800,00000000200,a2f,recvmsg
1,01738685300,01738685500,00000000200,a2f,recvmsg
1,01738702700,01738705700,00000003000,a07,poll
1,01738706200,01738707500,00000001300,a2f,recvmsg
1,01738709500,01738710900,00000001400,a2d,recvfrom
1,01738715400,01738715700,00000000300,a2f,recvmsg
1,01738716200,01738716400,00000000200,a2f,recvmsg
1,01738773900,01738774200,00000000300,a2f,recvmsg
1,01738776400,01738776600,00000000200,a2f,recvmsg
1,01738787900,01738916600,00000128700,a07,poll
1,01738917400,01738919200,00000001800,a2f,recvmsg
1,01738925500,01738926200,00000000700,a2d,recvfrom
1,01738927200,01738927400,00000000200,a2f,recvmsg
1,01738928000,01738928200,00000000200,a2f,recvmsg
1,01738960000,01738960200,00000000200,a2f,recvmsg
1,01738962700,01738962900,00000000200,a2f,recvmsg
1,01738965900,01738968700,00000002800,a07,poll
1,01738971400,01738971500,00000000100,a2f,recvmsg
1,01738972100,01738972300,00000000200,a2f,recvmsg
1,01710003900,01739554500,00029550600,ae8,epoll_wait
1,01739568300,01739570800,00000002500,a2f,recvmsg
1,01739585200,01739585400,00000000200,a2f,recvmsg
1,01739642600,01739647400,00000004800,a2e,sendmsg
1,01739709000,01739737700,00000028700,a07,poll
1,01739652900,01739920000,00000267100,ae8,epoll_wait
1,01739923600,01739925500,00000001900,a2f,recvmsg
1,01739934700,01739934800,00000000100,a2f,recvmsg
1,01739969500,01739972500,00000003000,a2e,sendmsg
1,01739977700,01739978700,00000001000,a2f,recvmsg
1,01740001300,01740001300,00000000000,a2f,recvmsg
1,01740022700,01740024700,00000002000,a2e,sendmsg
1,01739916600,01740029400,00000112800,a07,poll
1,01740137700,01740140200,00000002500,a01,write
1,01740026800,01740154200,00000127400,ae8,epoll_wait
1,01740157400,01740159000,00000001600,a2f,recvmsg
1,01740176100,01740176300,00000000200,a2f,recvmsg
1,01740199200,01740200800,00000001600,a2e,sendmsg
1,01740144900,01740374800,00000229900,a07,poll
1,01740733400,01740741900,00000008500,a02,open
1,01740754000,01740757200,00000003200,a00,read
1,01740811900,01740812700,00000000800,a00,read
1,01740865400,01740866100,00000000700,a00,read
1,01740916800,01740917400,00000000600,a00,read
1,01740968300,01740969000,00000000700,a00,read
1,01741018800,01741019500,00000000700,a00,read
1,01741067100,01741067800,00000000700,a00,read
1,01741116500,01741117200,00000000700,a00,read
1,01741169600,01741170200,00000000600,a00,read
1,01741221100,01741221800,00000000700,a00,read
1,01741270600,01741271200,00000000600,a00,read
1,01741299100,01741301000,00000001900,a02,open
1,01741304500,01741305400,00000000900,a00,read
1,01741360100,01741361100,00000001000,a00,read
1,01741444700,01741445400,00000000700,a00,read
1,01741518300,01741519100,00000000800,a00,read
1,01741596500,01741597300,00000000800,a00,read
1,01741676200,01741676900,00000000700,a00,read
1,01741755300,01741756200,00000000900,a00,read
1,01741841300,01741841900,00000000600,a00,read
1,01741907900,01741908600,00000000700,a00,read
1,01741966400,01741967100,00000000700,a00,read
1,01742045400,01742077000,00000031600,a07,poll
1,01742080800,01742081100,00000000300,a2f,recvmsg
1,01742081900,01742082100,00000000200,a2f,recvmsg
1,01742085600,01742093200,00000007600,a07,poll
1,01742094300,01742094400,00000000100,a2f,recvmsg
1,01742094800,01742095000,00000000200,a2f,recvmsg
1,01742100000,01742106500,00000006500,a06,lstat
1,01742107300,01742108600,00000001300,a06,lstat
1,01742131500,01742146700,00000015200,a01,write
1,01742152800,01742159700,00000006900,a07,poll
1,01742161700,01742161900,00000000200,a2f,recvmsg
1,01742162400,01742162600,00000000200,a2f,recvmsg
1,01742164000,01742469400,00000305400,a38,clone
1,01742947800,01742948000,00000000200,a0c,brk
1,01742958100,01742960900,00000002800,a15,access
1,01742961500,01742962400,00000000900,a09,mmap
1,01742966000,01742966900,00000000900,a15,access
1,01742972800,01742973700,00000000900,a09,mmap
1,01742977700,01742978300,00000000600,a15,access
1,01742985100,01742986200,00000001100,a00,read
1,01742987600,01742989100,00000001500,a09,mmap
1,01742992900,01742995200,00000002300,a09,mmap
1,01743006900,01743007500,00000000600,a15,access
1,01743010900,01743011500,00000000600,a00,read
1,01743012300,01743013200,00000000900,a09,mmap
1,01743015600,01743016900,00000001300,a09,mmap
1,01743025200,01743025800,00000000600,a15,access
1,01743028700,01743029300,00000000600,a00,read
1,01743029900,01743030800,00000000900,a09,mmap
1,01743032600,01743034700,00000002100,a09,mmap
1,01743038700,01743041700,00000003000,a09,mmap
1,01743044200,01743045300,00000001100,a09,mmap
1,01743054900,01743055500,00000000600,a15,access
1,01743058100,01743058600,00000000500,a00,read
1,01743059300,01743060800,00000001500,a09,mmap
1,01743063500,01743065200,00000001700,a09,mmap
1,01743073500,01743074000,00000000500,a15,access
1,01743077700,01743078300,00000000600,a00,read
1,01743079000,01743080400,00000001400,a09,mmap
1,01743084100,01743086300,00000002200,a09,mmap
1,01743095000,01743095600,00000000600,a15,access
1,01743098200,01743098600,00000000400,a00,read
1,01743105700,01743107100,00000001400,a09,mmap
1,01743113400,01743113900,00000000500,a15,access
1,01743116200,01743116700,00000000500,a00,read
1,01743117300,01743118800,00000001500,a09,mmap
1,01743120900,01743122700,00000001800,a09,mmap
1,01743136500,01743137300,00000000800,a09,mmap
1,01743141000,01743141300,00000000300,a09,mmap
1,01743142300,01743142600,00000000300,a09,mmap
1,01743322300,01743322500,00000000200,a0c,brk
1,01743322500,01743323300,00000000800,a0c,brk
1,01743358600,01743359500,00000000900,a00,read
1,01743371300,01743372700,00000001400,a00,read
1,01743410000,01743410900,00000000900,a00,read
1,01743532500,01743533300,00000000800,a00,read
1,01743603900,01743604400,00000000500,a00,read
1,01743692100,01743692800,00000000700,a00,read
1,01743823300,01743824100,00000000800,a00,read
1,01743952500,01743953200,00000000700,a00,read
1,01744107900,01744108700,00000000800,a00,read
1,01744258800,01744259400,00000000600,a00,read
1,01744412300,01744413000,00000000700,a00,read
1,01744560500,01744561200,00000000700,a00,read
1,01744742900,01744743800,00000000900,a00,read
1,01744902900,01744903500,00000000600,a00,read
1,01745011600,01745012200,00000000600,a00,read
1,01745043000,01745043900,00000000900,a0c,brk
1,01745152700,01745153600,00000000900,a00,read
1,01745393600,01745394400,00000000800,a00,read
1,01745406400,01745406800,00000000400,a00,read
1,01745451100,01745451500,00000000400,a00,read
1,01745471200,01745471900,00000000700,a00,read
1,01745677900,01745678400,00000000500,a00,read
1,01745707400,01745708600,00000001200,a00,read
1,01745805500,01745806200,00000000700,a00,read
1,01745829900,01745831000,00000001100,a0c,brk
1,01745876100,01745876600,00000000500,a00,read
1,01745953000,01745953800,00000000800,a00,read
1,01746107100,01746107600,00000000500,a00,read
1,01746219400,01746220000,00000000600,a00,read
1,01746313400,01746313900,00000000500,a00,read
1,01746326100,01746326600,00000000500,a00,read
1,01746407900,01746408200,00000000300,a00,read
1,01746431900,01746432200,00000000300,a00,read
1,01746454100,01746454700,00000000600,a00,read
1,01746558400,01746559600,00000001200,a0c,brk
1,01746561400,01746562400,00000001000,a00,read
1,01746763400,01746763700,00000000300,a00,read
1,01746846000,01746846700,00000000700,a00,read
1,01746910300,01746911000,00000000700,a00,read
1,01747038800,01747039200,00000000400,a00,read
1,01747071600,01747072200,00000000600,a00,read
1,01747088200,01747089600,00000001400,a02,open
1,01747201400,01747202000,00000000600,a00,read
1,01747275500,01747276000,00000000500,a00,read
1,01747328200,01747329300,00000001100,a0c,brk
1,01747335500,01747336200,00000000700,a00,read
1,01747443700,01747444400,00000000700,a00,read
1,01747595100,01747596000,00000000900,a00,read
1,01747726300,01747726800,00000000500,a00,read
1,01747784400,01747785100,00000000700,a00,read
1,01747840400,01747841000,00000000600,a00,read
1,01747911400,01747912100,00000000700,a00,read
1,01747964500,01747965300,00000000800,a00,read
1,01748054100,01748054900,00000000800,a0c,brk
1,01748086200,01748089800,00000003600,a0c,brk
1,01748104100,01748105000,00000000900,a00,read
1,01748220100,01748220800,00000000700,a00,read
1,01748379800,01748380400,00000000600,a00,read
1,01748497400,01748498100,00000000700,a00,read
1,01748643200,01748643900,00000000700,a00,read
1,01748769200,01748769900,00000000700,a00,read
1,01748934200,01748935000,00000000800,a00,read
1,01748939800,01748940700,00000000900,a0c,brk
1,01749055900,01749056600,00000000700,a00,read
1,01749174200,01749174700,00000000500,a00,read
1,01749316000,01749316800,00000000800,a00,read
1,01749448000,01749448700,00000000700,a00,read
1,01749541700,01749542400,00000000700,a00,read
1,01749654600,01749655200,00000000600,a00,read
1,01749780700,01749781500,00000000800,a00,read
1,01749893300,01749893900,00000000600,a0c,brk
1,01749916600,01749917300,00000000700,a00,read
1,01750086300,01750086900,00000000600,a00,read
1,01750237300,01750238000,00000000700,a00,read
1,01750348100,01750348800,00000000700,a00,read
1,01750517900,01750518900,00000001000,a00,read
1,01750595600,01750596200,00000000600,a00,read
1,01750677500,01750678300,00000000800,a00,read
1,01750745000,01750745800,00000000800,a0c,brk
1,01750759400,01750760100,00000000700,a00,read
1,01750832400,01750833000,00000000600,a00,read
1,01750933900,01750934700,00000000800,a00,read
1,01751037800,01751038400,00000000600,a00,read
1,01751127200,01751127800,00000000600,a00,read
1,01751209400,01751210000,00000000600,a00,read
1,01751310300,01751310900,00000000600,a00,read
1,01751391200,01751391700,00000000500,a0c,brk
1,01751394000,01751394800,00000000800,a00,read
1,01751501100,01751501800,00000000700,a00,read
1,01751593600,01751594200,00000000600,a00,read
1,01751712500,01751713000,00000000500,a00,read
1,01751827200,01751827900,00000000700,a00,read
1,01751930400,01751931100,00000000700,a00,read
1,01752030800,01752031300,00000000500,a0c,brk
1,01752387300,01752390800,00000003500,a57,unlink
1,01752415500,01752415900,00000000400,a48,fcntl
1,01752461200,01752476900,00000015700,a01,write
1,01752494700,01752497300,00000002600,a01,write
1,01752513400,01752515900,00000002500,a01,write
1,01742490600,01752697800,00010207200,a3d,wait4
1,01752718100,01752721300,00000003200,a00,read
1,01752723400,01752723700,00000000300,a00,read
1,01752744200,01752785400,00000041200,a07,poll
1,01752790200,01752790300,00000000100,a2f,recvmsg
1,01752791200,01752791400,00000000200,a2f,recvmsg
1,01752796000,01752813100,00000017100,a07,poll
1,01752814300,01752814500,00000000200,a2f,recvmsg
1,01752814800,01752814900,00000000100,a2f,recvmsg
1,01752818500,01752835800,00000017300,a07,poll
1,01752837000,01752837200,00000000200,a2f,recvmsg
1,01752837500,01752837700,00000000200,a2f,recvmsg
1,01752840900,01752859100,00000018200,a07,poll
1,01752860300,01752860400,00000000100,a2f,recvmsg
1,01752860600,01752860800,00000000200,a2f,recvmsg
1,01752864700,01752882200,00000017500,a07,poll
1,01752883300,01752883400,00000000100,a2f,recvmsg
1,01752883800,01752884000,00000000200,a2f,recvmsg
1,01752886700,01752895100,00000008400,a07,poll
1,01752896400,01752896600,00000000200,a2f,recvmsg
1,01752896800,01752897000,00000000200,a2f,recvmsg
1,01752897500,01752897700,00000000200,a08,lseek
1,01752907600,01752907700,00000000100,a08,lseek
1,01752910500,01752917400,00000006900,a07,poll
1,01752918500,01752918700,00000000200,a2f,recvmsg
1,01752919100,01752919200,00000000100,a2f,recvmsg
1,01752924400,01752931100,00000006700,a07,poll
1,01752932300,01752932500,00000000200,a2f,recvmsg
1,01752932700,01752932900,00000000200,a2f,recvmsg
1,01752936100,01752942800,00000006700,a07,poll
1,01752944000,01752944100,00000000100,a2f,recvmsg
1,01752944400,01752944600,00000000200,a2f,recvmsg
1,01752948000,01752954400,00000006400,a07,poll
1,01752955600,01752955800,00000000200,a2f,recvmsg
1,01752956100,01752956300,00000000200,a2f,recvmsg
1,01752960700,01752967300,00000006600,a07,poll
1,01752968500,01752968700,00000000200,a2f,recvmsg
1,01752968900,01752969100,00000000200,a2f,recvmsg
1,01752972600,01752979200,00000006600,a07,poll
1,01752980300,01752980500,00000000200,a2f,recvmsg
1,01752980800,01752981000,00000000200,a2f,recvmsg
1,01752984200,01752991100,00000006900,a07,poll
1,01752992200,01752992400,00000000200,a2f,recvmsg
1,01752992700,01752992900,00000000200,a2f,recvmsg
1,01752995600,01753002100,00000006500,a07,poll
1,01753003200,01753003400,00000000200,a2f,recvmsg
1,01753003700,01753003900,00000000200,a2f,recvmsg
1,01753008200,01753015000,00000006800,a07,poll
1,01753016200,01753016300,00000000100,a2f,recvmsg
1,01753016600,01753016800,00000000200,a2f,recvmsg
1,01753020300,01753027300,00000007000,a07,poll
1,01753028500,01753028600,00000000100,a2f,recvmsg
1,01753029000,01753029100,00000000100,a2f,recvmsg
1,01753033400,01753039000,00000005600,a07,poll
1,01753040100,01753040300,00000000200,a2f,recvmsg
1,01753040600,01753040800,00000000200,a2f,recvmsg
1,01753043900,01753050600,00000006700,a07,poll
1,01753051800,01753052000,00000000200,a2f,recvmsg
1,01753052300,01753052400,00000000100,a2f,recvmsg
1,01753055500,01753062000,00000006500,a07,poll
1,01753063200,01753063400,00000000200,a2f,recvmsg
1,01753063700,01753063800,00000000100,a2f,recvmsg
1,01753067300,01753074000,00000006700,a07,poll
1,01753075200,01753075300,00000000100,a2f,recvmsg
1,01753075600,01753075800,00000000200,a2f,recvmsg
1,01753079000,01753085700,00000006700,a07,poll
1,01753086800,01753086900,00000000100,a2f,recvmsg
1,01753087300,01753087400,00000000100,a2f,recvmsg
1,01753090200,01753097000,00000006800,a07,poll
1,01753098000,01753098200,00000000200,a2f,recvmsg
1,01753098500,01753098700,00000000200,a2f,recvmsg
1,01753103300,01753109800,00000006500,a07,poll
1,01753111000,01753111200,00000000200,a2f,recvmsg
1,01753111400,01753111600,00000000200,a2f,recvmsg
1,01753114300,01753121000,00000006700,a07,poll
1,01753122200,01753122300,00000000100,a2f,recvmsg
1,01753122600,01753122700,00000000100,a2f,recvmsg
1,01753125500,01753132100,00000006600,a07,poll
1,01753133200,01753133400,00000000200,a2f,recvmsg
1,01753133700,01753133900,00000000200,a2f,recvmsg
1,01753136600,01753143400,00000006800,a07,poll
1,01753144500,01753144700,00000000200,a2f,recvmsg
1,01753145000,01753145200,00000000200,a2f,recvmsg
1,01753148300,01753155000,00000006700,a07,poll
1,01753156900,01753157100,00000000200,a2f,recvmsg
1,01753157400,01753157600,00000000200,a2f,recvmsg
1,01753160500,01753167100,00000006600,a07,poll
1,01753168300,01753168400,00000000100,a2f,recvmsg
1,01753168700,01753168900,00000000200,a2f,recvmsg
1,01753172200,01753178900,00000006700,a07,poll
1,01753180000,01753180100,00000000100,a2f,recvmsg
1,01753180400,01753180600,00000000200,a2f,recvmsg
1,01753183900,01753190700,00000006800,a07,poll
1,01753191700,01753191900,00000000200,a2f,recvmsg
1,01753192200,01753192400,00000000200,a2f,recvmsg
1,01753196100,01753203000,00000006900,a07,poll
1,01753204300,01753204400,00000000100,a2f,recvmsg
1,01753204600,01753204800,00000000200,a2f,recvmsg
1,01753208500,01753215300,00000006800,a07,poll
1,01753216400,01753216500,00000000100,a2f,recvmsg
1,01753216800,01753217000,00000000200,a2f,recvmsg
1,01753220500,01753227200,00000006700,a07,poll
1,01753228400,01753228500,00000000100,a2f,recvmsg
1,01753228800,01753229000,00000000200,a2f,recvmsg
1,01753234500,01753241300,00000006800,a07,poll
1,01753242400,01753242600,00000000200,a2f,recvmsg
1,01753242900,01753243100,00000000200,a2f,recvmsg
1,01753246200,01753252900,00000006700,a07,poll
1,01753253900,01753254100,00000000200,a2f,recvmsg
1,01753254400,01753254600,00000000200,a2f,recvmsg
1,01753257600,01753264400,00000006800,a07,poll
1,01753265500,01753265700,00000000200,a2f,recvmsg
1,01753266000,01753266200,00000000200,a2f,recvmsg
1,01753270000,01753276700,00000006700,a07,poll
1,01753278100,01753278200,00000000100,a2f,recvmsg
1,01753278500,01753278600,00000000100,a2f,recvmsg
1,01753282100,01753288700,00000006600,a07,poll
1,01753289900,01753290000,00000000100,a2f,recvmsg
1,01753290300,01753290500,00000000200,a2f,recvmsg
1,01753294100,01753301100,00000007000,a07,poll
1,01753302200,01753302400,00000000200,a2f,recvmsg
1,01753302700,01753302900,00000000200,a2f,recvmsg
1,01753306200,01753313100,00000006900,a07,poll
1,01753314300,01753314400,00000000100,a2f,recvmsg
1,01753314600,01753314800,00000000200,a2f,recvmsg
1,01753318100,01753324700,00000006600,a07,poll
1,01753325900,01753326000,00000000100,a2f,recvmsg
1,01753326200,01753326400,00000000200,a2f,recvmsg
1,01753329600,01753336200,00000006600,a07,poll
1,01753337300,01753337400,00000000100,a2f,recvmsg
1,01753337700,01753337900,00000000200,a2f,recvmsg
1,01753341200,01753348100,00000006900,a07,poll
1,01753349200,01753349400,00000000200,a2f,recvmsg
1,01753349700,01753349900,00000000200,a2f,recvmsg
1,01753350800,01753350900,00000000100,a08,lseek
1,01753354400,01753355100,00000000700,a00,read
1,01753358800,01753358900,00000000100,a08,lseek
1,01753361800,01753368400,00000006600,a07,poll
1,01753369700,01753369900,00000000200,a2f,recvmsg
1,01753370200,01753370400,00000000200,a2f,recvmsg
1,01753396400,01753403100,00000006700,a07,poll
1,01753404400,01753404600,00000000200,a2f,recvmsg
1,01753404900,01753405100,00000000200,a2f,recvmsg
1,01753408800,01753409600,00000000800,a00,read
1,01753415100,01753415200,00000000100,a08,lseek
1,01753418600,01753425200,00000006600,a07,poll
1,01753426400,01753426600,00000000200,a2f,recvmsg
1,01753426800,01753427000,00000000200,a2f,recvmsg
1,01753429900,01753436500,00000006600,a07,poll
1,01753437600,01753437800,00000000200,a2f,recvmsg
1,01753438100,01753438200,00000000100,a2f,recvmsg
1,01753441100,01753447800,00000006700,a07,poll
1,01753448900,01753449100,00000000200,a2f,recvmsg
1,01753449400,01753449500,00000000100,a2f,recvmsg
1,01753452300,01753458900,00000006600,a07,poll
1,01753460000,01753460200,00000000200,a2f,recvmsg
1,01753460500,01753460700,00000000200,a2f,recvmsg
1,01753463400,01753470100,00000006700,a07,poll
1,01753471000,01753471200,00000000200,a2f,recvmsg
1,01753471500,01753471700,00000000200,a2f,recvmsg
1,01753474300,01753481100,00000006800,a07,poll
1,01753482100,01753482300,00000000200,a2f,recvmsg
1,01753482600,01753482800,00000000200,a2f,recvmsg
1,01753485600,01753492200,00000006600,a07,poll
1,01753493300,01753493500,00000000200,a2f,recvmsg
1,01753493800,01753494000,00000000200,a2f,recvmsg
1,01753497300,01753504200,00000006900,a07,poll
1,01753505200,01753505400,00000000200,a2f,recvmsg
1,01753505700,01753505900,00000000200,a2f,recvmsg
1,01753508700,01753515300,00000006600,a07,poll
1,01753516400,01753516600,00000000200,a2f,recvmsg
1,01753516900,01753517100,00000000200,a2f,recvmsg
1,01753517500,01753517600,00000000100,a08,lseek
1,01753521700,01753528300,00000006600,a07,poll
1,01753529300,01753529500,00000000200,a2f,recvmsg
1,01753529800,01753530000,00000000200,a2f,recvmsg
1,01753535000,01753541800,00000006800,a07,poll
1,01753543000,01753543200,00000000200,a2f,recvmsg
1,01753543500,01753543700,00000000200,a2f,recvmsg
1,01753547000,01753553500,00000006500,a07,poll
1,01753554600,01753554800,00000000200,a2f,recvmsg
1,01753555100,01753555300,00000000200,a2f,recvmsg
1,01753558300,01753565100,00000006800,a07,poll
1,01753566100,01753566300,00000000200,a2f,recvmsg
1,01753566600,01753566800,00000000200,a2f,recvmsg
1,01753569800,01753576400,00000006600,a07,poll
1,01753577400,01753577600,00000000200,a2f,recvmsg
1,01753577900,01753578100,00000000200,a2f,recvmsg
1,01753581000,01753587900,00000006900,a07,poll
1,01753589000,01753589200,00000000200,a2f,recvmsg
1,01753589500,01753589700,00000000200,a2f,recvmsg
1,01753593100,01753599800,00000006700,a07,poll
1,01753600900,01753601100,00000000200,a2f,recvmsg
1,01753601400,01753601500,00000000100,a2f,recvmsg
1,01753604500,01753611300,00000006800,a07,poll
1,01753612400,01753612600,00000000200,a2f,recvmsg
1,01753612900,01753613000,00000000100,a2f,recvmsg
1,01753616000,01753622600,00000006600,a07,poll
1,01753623800,01753624000,00000000200,a2f,recvmsg
1,01753624300,01753624400,00000000100,a2f,recvmsg
1,01753627500,01753634200,00000006700,a07,poll
1,01753635400,01753635500,00000000100,a2f,recvmsg
1,01753635700,01753635900,00000000200,a2f,recvmsg
1,01753639000,01753645600,00000006600,a07,poll
1,01753646800,01753647000,00000000200,a2f,recvmsg
1,01753647200,01753647400,00000000200,a2f,recvmsg
1,01753650500,01753657000,00000006500,a07,poll
1,01753658200,01753658400,00000000200,a2f,recvmsg
1,01753658600,01753658800,00000000200,a2f,recvmsg
1,01753662500,01753669200,00000006700,a07,poll
1,01753670300,01753670400,00000000100,a2f,recvmsg
1,01753670700,01753670900,00000000200,a2f,recvmsg
1,01753674000,01753680700,00000006700,a07,poll
1,01753681800,01753682000,00000000200,a2f,recvmsg
1,01753682300,01753682500,00000000200,a2f,recvmsg
1,01753685900,01753692500,00000006600,a07,poll
1,01753693600,01753693800,00000000200,a2f,recvmsg
1,01753694100,01753694300,00000000200,a2f,recvmsg
1,01753697300,01753704000,00000006700,a07,poll
1,01753705100,01753705300,00000000200,a2f,recvmsg
1,01753705600,01753705800,00000000200,a2f,recvmsg
1,01753714000,01753720900,00000006900,a07,poll
1,01753722000,01753722200,00000000200,a2f,recvmsg
1,01753722500,01753722700,00000000200,a2f,recvmsg
1,01753726000,01753732600,00000006600,a07,poll
1,01753733800,01753734000,00000000200,a2f,recvmsg
1,01753734300,01753734500,00000000200,a2f,recvmsg
1,01753737500,01753744100,00000006600,a07,poll
1,01753745400,01753745500,00000000100,a2f,recvmsg
1,01753745800,01753745900,00000000100,a2f,recvmsg
1,01753749300,01753755800,00000006500,a07,poll
1,01753757000,01753757200,00000000200,a2f,recvmsg
1,01753757400,01753757600,00000000200,a2f,recvmsg
1,01753760800,01753767400,00000006600,a07,poll
1,01753768600,01753768700,00000000100,a2f,recvmsg
1,01753768900,01753769100,00000000200,a2f,recvmsg
1,01753811900,01753816000,00000004100,a14,writev
1,01753816500,01753911800,00000095300,a07,poll
1,01753927300,01753927500,00000000200,a2f,recvmsg
1,01753962800,01753967700,00000004900,a07,poll
1,01753978300,01753978500,00000000200,a2f,recvmsg
1,01753998000,01753999700,00000001700,a07,poll
1,01754002700,01754046500,00000043800,a07,poll
1,01754047700,01754051600,00000003900,a07,poll
1,01754053200,01754104700,00000051500,a07,poll
1,01754105900,01754109600,00000003700,a07,poll
1,01754111000,01754161800,00000050800,a07,poll
1,01754163100,01754166600,00000003500,a07,poll
1,01754168000,01754219100,00000051100,a07,poll
1,01754220400,01754223500,00000003100,a07,poll
1,01754224600,01754273900,00000049300,a07,poll
1,01754275500,01754278200,00000002700,a07,poll
1,01754279800,01754319800,00000040000,a07,poll
1,01754321400,01754323500,00000002100,a07,poll
1,01754324900,01754364600,00000039700,a07,poll
1,01754365800,01754368400,00000002600,a07,poll
1,01754369600,01754409000,00000039400,a07,poll
1,01754410200,01754412700,00000002500,a07,poll
1,01754413900,01754453200,00000039300,a07,poll
1,01754454500,01754457000,00000002500,a07,poll
1,01754458300,01754497300,00000039000,a07,poll
1,01754498600,01754501800,00000003200,a07,poll
1,01754503100,01754551100,00000048000,a07,poll
1,01754552300,01754555600,00000003300,a07,poll
1,01754557000,01754571000,00000014000,a07,poll
1,01754572200,01754575100,00000002900,a07,poll
1,01754576400,01754587600,00000011200,a07,poll
1,01754588900,01754592200,00000003300,a07,poll
1,01754593600,01754604200,00000010600,a07,poll
1,01754605300,01754607800,00000002500,a07,poll
1,01754609000,01754620100,00000011100,a07,poll
1,01754621300,01754624000,00000002700,a07,poll
1,01754625200,01754635500,00000010300,a07,poll
1,01754636900,01754639900,00000003000,a07,poll
1,01754641500,01754643100,00000001600,a07,poll
1,01754645800,01754646000,00000000200,a2f,recvmsg
1,01754646500,01754646600,00000000100,a2f,recvmsg
1,01754641500,01754664500,00000023000,a07,poll
1,01754664900,01754666300,00000001400,a2f,recvmsg
1,01754667600,01754668900,00000001300,a2d,recvfrom
1,01754673100,01754673300,00000000200,a2f,recvmsg
1,01754673800,01754674000,00000000200,a2f,recvmsg
1,01754729300,01754729600,00000000300,a2f,recvmsg
1,01754731800,01754732000,00000000200,a2f,recvmsg
1,01754735200,01754739200,00000004000,a07,poll
1,01754739700,01754741400,00000001700,a2f,recvmsg
1,01754743200,01754743700,00000000500,a2d,recvfrom
1,01754748600,01754748800,00000000200,a2f,recvmsg
1,01754749200,01754749400,00000000200,a2f,recvmsg
1,01754777600,01754777800,00000000200,a2f,recvmsg
1,01754779900,01754780100,00000000200,a2f,recvmsg
1,01754792800,01754833100,00000040300,a07,poll
1,01754834000,01754835800,00000001800,a2f,recvmsg
1,01754842200,01754843000,00000000800,a2d,recvfrom
1,01754844100,01754844300,00000000200,a2f,recvmsg
1,01754845200,01754845400,00000000200,a2f,recvmsg
1,01754878400,01754878700,00000000300,a2f,recvmsg
1,01754881000,01754881100,00000000100,a2f,recvmsg
1,01754884900,01754925600,00000040700,a07,poll
1,01754930300,01754930400,00000000100,a2f,recvmsg
1,01754932200,01754932400,00000000200,a2f,recvmsg
1,01754932600,01754932800,00000000200,a2f,recvmsg
1,01754934500,01754934700,00000000200,a2f,recvmsg
1,01754934900,01754935100,00000000200,a2f,recvmsg
1,01754935500,01754937300,00000001800,a07,poll
1,01754939600,01754939800,00000000200,a2f,recvmsg
1,01754940400,01754940500,00000000100,a2f,recvmsg
1,01740203500,01755610000,00015406500,ae8,epoll_wait
1,01755621800,01755625000,00000003200,a2f,recvmsg
1,01755640600,01755640900,00000000300,a2f,recvmsg
1,01755664100,01755668600,00000004500,a2e,sendmsg
1,01755781400,01755791500,00000010100,a02,open
1,01755804400,01755807800,00000003400,a00,read
1,01755862700,01755863600,00000000900,a00,read
1,01755914200,01755915000,00000000800,a00,read
1,01755671800,01755954300,00000282500,ae8,epoll_wait
1,01755958700,01755960600,00000001900,a2f,recvmsg
1,01755973400,01755973700,00000000300,a2f,recvmsg
1,01755986000,01755989800,00000003800,a2e,sendmsg
1,01756008500,01756009700,00000001200,a00,read
1,01756059800,01756060500,00000000700,a00,read
1,01756110100,01756110900,00000000800,a00,read
1,01756158100,01756158900,00000000800,a00,read
1,01756206800,01756207700,00000000900,a00,read
1,01756259200,01756259800,00000000600,a00,read
1,01756311100,01756311800,00000000700,a00,read
1,01756361300,01756362000,00000000700,a00,read
1,01756392200,01756395400,00000003200,a02,open
1,01756400700,01756401700,00000001000,a00,read
1,01756457800,01756458700,00000000900,a00,read
1,01756542500,01756543200,00000000700,a00,read
1,01756615300,01756616000,00000000700,a00,read
1,01756713500,01756714400,00000000900,a00,read
1,01756823200,01756824200,00000001000,a00,read
1,01756903500,01756904400,00000000900,a00,read
1,01755992500,01756910200,00000917700,ae8,epoll_wait
1,01756928000,01756928300,00000000300,a2f,recvmsg
1,01756948500,01756971200,00000022700,ae8,epoll_wait
1,01756972500,01756973600,00000001100,a2f,recvmsg
1,01756979800,01756980000,00000000200,a2f,recvmsg
1,01756999700,01757000800,00000001100,a2e,sendmsg
1,01757074300,01757075500,00000001200,a00,read
1,01757144400,01757145200,00000000800,a00,read
1,01757203600,01757204300,00000000700,a00,read
1,01757250000,01757251000,00000001000,a03,close
1,01754935500,01757254100,00002318600,a07,poll
1,01757305100,01757309700,00000004600,aca,futex
1,01757315500,01757315800,00000000300,a00,read
1,01757002400,01757366300,00000363900,ae8,epoll_wait
1,01757370900,01757372700,00000001800,a2f,recvmsg
1,01757381800,01757382000,00000000200,a2f,recvmsg
1,01757404700,01757407900,00000003200,a2e,sendmsg
1,01757477400,01757529100,00000051700,a07,poll
1,01757532500,01757532700,00000000200,a2f,recvmsg
1,01757533500,01757533700,00000000200,a2f,recvmsg
1,01757537600,01757545700,00000008100,a07,poll
1,01757546800,01757547000,00000000200,a2f,recvmsg
1,01757547400,01757547500,00000000100,a2f,recvmsg
1,01757554700,01757559200,00000004500,a06,lstat
1,01757560000,01757560900,00000000900,a06,lstat
1,01757562100,01757755300,00000193200,a02,open
1,01757761200,01757770700,00000009500,a01,write
1,01757777400,01757785400,00000008000,a07,poll
1,01757787400,01757787600,00000000200,a2f,recvmsg
1,01757788100,01757788300,00000000200,a2f,recvmsg
1,01757789500,01758100700,00000311200,a38,clone
1,01758577000,01758577100,00000000100,a0c,brk
1,01758588300,01758590900,00000002600,a15,access
1,01758597500,01758598200,00000000700,a15,access
1,01758603800,01758604800,00000001000,a09,mmap
1,01758608500,01758609000,00000000500,a15,access
1,01758615700,01758616900,00000001200,a00,read
1,01758618400,01758619900,00000001500,a09,mmap
1,01758624000,01758626200,00000002200,a09,mmap
1,01758638200,01758639200,00000001000,a15,access
1,01758642800,01758643600,00000000800,a00,read
1,01758644300,01758645200,00000000900,a09,mmap
1,01758647000,01758648300,00000001300,a09,mmap
1,01758656300,01758657000,00000000700,a15,access
1,01758659900,01758660500,00000000600,a00,read
1,01758661100,01758661800,00000000700,a09,mmap
1,01758663300,01758665300,00000002000,a09,mmap
1,01758669300,01758672200,00000002900,a09,mmap
1,01758674300,01758675400,00000001100,a09,mmap
1,01758684000,01758684400,00000000400,a15,access
1,01758687200,01758687800,00000000600,a00,read
1,01758688500,01758689800,00000001300,a09,mmap
1,01758691900,01758693600,00000001700,a09,mmap
1,01758701700,01758702200,00000000500,a15,access
1,01758706100,01758706700,00000000600,a00,read
1,01758707300,01758708700,00000001400,a09,mmap
1,01758722200,01758722800,00000000600,a15,access
1,01758725100,01758725700,00000000600,a00,read
1,01758726100,01758727100,00000001000,a09,mmap
1,01758728500,01758729900,00000001400,a09,mmap
1,01758732300,01758733600,00000001300,a09,mmap
1,01758740100,01758740700,00000000600,a15,access
1,01758743000,01758743500,00000000500,a00,read
1,01758744200,01758745500,00000001300,a09,mmap
1,01758747300,01758748900,00000001600,a09,mmap
1,01758762800,01758763400,00000000600,a09,mmap
1,01758767000,01758767400,00000000400,a09,mmap
1,01758768400,01758768700,00000000300,a09,mmap
1,01758943800,01758943900,00000000100,a0c,brk
1,01758944000,01758944700,00000000700,a0c,brk
1,01758979100,01758980100,00000001000,a00,read
1,01758991400,01758992800,00000001400,a00,read
1,01759028600,01759029600,00000001000,a00,read
1,01759151900,01759152700,00000000800,a00,read
1,01759223600,01759223900,00000000300,a00,read
1,01759309200,01759309900,00000000700,a00,read
1,01759443800,01759444600,00000000800,a00,read
1,01759573200,01759573800,00000000600,a00,read
1,01759729700,01759730400,00000000700,a00,read
1,01759880900,01759881400,00000000500,a00,read
1,01760034400,01760035000,00000000600,a00,read
1,01760183300,01760184000,00000000700,a00,read
1,01760342600,01760343200,00000000600,a00,read
1,01760502700,01760503400,00000000700,a00,read
1,01760612100,01760612600,00000000500,a00,read
1,01760680900,01760681700,00000000800,a0c,brk
1,01760790900,01760791700,00000000800,a00,read
1,01761038000,01761038700,00000000700,a00,read
1,01761051700,01761052100,00000000400,a00,read
1,01761096500,01761096900,00000000400,a00,read
1,01761117200,01761117900,00000000700,a00,read
1,01761325500,01761325900,00000000400,a00,read
1,01761355300,01761356100,00000000800,a00,read
1,01761453300,01761454100,00000000800,a00,read
1,01761478000,01761479200,00000001200,a0c,brk
1,01761524200,01761524500,00000000300,a00,read
1,01761603000,01761603800,00000000800,a00,read
1,01761756100,01761756500,00000000400,a00,read
1,01761868200,01761868800,00000000600,a00,read
1,01761963400,01761963800,00000000400,a00,read
1,01761976000,01761976600,00000000600,a00,read
1,01762057200,01762057600,00000000400,a00,read
1,01762081900,01762082300,00000000400,a00,read
1,01762104700,01762105200,00000000500,a00,read
1,01762206500,01762207600,00000001100,a0c,brk
1,01762209500,01762210500,00000001000,a00,read
1,01762412300,01762412800,00000000500,a00,read
1,01762495500,01762496200,00000000700,a00,read
1,01762560200,01762560900,00000000700,a00,read
1,01762688200,01762688600,00000000400,a00,read
1,01762721000,01762721500,00000000500,a00,read
1,01762738600,01762739900,00000001300,a02,open
1,01762850500,01762850800,00000000300,a00,read
1,01762921600,01762922000,00000000400,a00,read
1,01762974400,01762975500,00000001100,a0c,brk
1,01762983800,01762984500,00000000700,a00,read
1,01763103700,01763104400,00000000700,a00,read
1,01763260900,01763261700,00000000800,a00,read
1,01763405600,01763406200,00000000600,a00,read
1,01763466800,01763467500,00000000700,a00,read
1,01763528100,01763528800,00000000700,a00,read
1,01763605600,01763606400,00000000800,a00,read
1,01763663500,01763664100,00000000600,a00,read
1,01763761300,01763762000,00000000700,a0c,brk
1,01763794900,01763799100,00000004200,a0c,brk
1,01763813200,01763814000,00000000800,a00,read
1,01763935900,01763936800,00000000900,a00,read
1,01764118800,01764119500,00000000700,a00,read
1,01764251400,01764252100,00000000700,a00,read
1,01764419300,01764420000,00000000700,a00,read
1,01764554200,01764554900,00000000700,a00,read
1,01764752900,01764753700,00000000800,a00,read
1,01764759600,01764760400,00000000800,a0c,brk
1,01764892600,01764893300,00000000700,a00,read
1,01765027200,01765027900,00000000700,a00,read
0,01720668400,01696613600,-0024054800,a3d,wait4
0,01696637200,01696639300,00000002100,a00,read
0,01696641400,01696641800,00000000400,a00,read
0,01696660900,01696708100,00000047200,a07,poll
0,01696712900,01696713100,00000000200,a2f,recvmsg
0,01696714000,01696714200,00000000200,a2f,recvmsg
0,01696720200,01696731900,00000011700,a07,poll
0,01696734100,01696734300,00000000200,a2f,recvmsg
0,01696734700,01696734900,00000000200,a2f,recvmsg
0,01696739300,01696750800,00000011500,a07,poll
0,01696753000,01696753200,00000000200,a2f,recvmsg
0,01696753500,01696753700,00000000200,a2f,recvmsg
0,01696757600,01696769200,00000011600,a07,poll
0,01696771300,01696771500,00000000200,a2f,recvmsg
0,01696771800,01696772000,00000000200,a2f,recvmsg
0,01696776100,01696787700,00000011600,a07,poll
0,01696789700,01696789900,00000000200,a2f,recvmsg
0,01696790300,01696790500,00000000200,a2f,recvmsg
0,01696794900,01696806700,00000011800,a07,poll
0,01696808800,01696808900,00000000100,a2f,recvmsg
0,01696809400,01696809600,00000000200,a2f,recvmsg
0,01696810200,01696810500,00000000300,a08,lseek
0,01696821800,01696821900,00000000100,a08,lseek
0,01696825000,01696832000,00000007000,a07,poll
0,01696833400,01696833600,00000000200,a2f,recvmsg
0,01696833900,01696834100,00000000200,a2f,recvmsg
0,01696839800,01696846400,00000006600,a07,poll
0,01696847600,01696847800,00000000200,a2f,recvmsg
0,01696848100,01696848300,00000000200,a2f,recvmsg
0,01696851400,01696857900,00000006500,a07,poll
0,01696859100,01696859300,00000000200,a2f,recvmsg
0,01696859600,01696859800,00000000200,a2f,recvmsg
0,01696863200,01696869800,00000006600,a07,poll
0,01696871100,01696871300,00000000200,a2f,recvmsg
0,01696871600,01696871800,00000000200,a2f,recvmsg
0,01696874900,01696881700,00000006800,a07,poll
0,01696882800,01696883000,00000000200,a2f,recvmsg
0,01696883300,01696883500,00000000200,a2f,recvmsg
0,01696887000,01696893400,00000006400,a07,poll
0,01696894700,01696894900,00000000200,a2f,recvmsg
0,01696895100,01696895300,00000000200,a2f,recvmsg
0,01696898600,01696905500,00000006900,a07,poll
0,01696907500,01696907700,00000000200,a2f,recvmsg
0,01696908100,01696908200,00000000100,a2f,recvmsg
0,01696910900,01696917600,00000006700,a07,poll
0,01696918700,01696918900,00000000200,a2f,recvmsg
0,01696919200,01696919400,00000000200,a2f,recvmsg
0,01696924500,01696931400,00000006900,a07,poll
0,01696932600,01696932700,00000000100,a2f,recvmsg
0,01696933100,01696933200,00000000100,a2f,recvmsg
0,01696936400,01696943400,00000007000,a07,poll
0,01696944500,01696944700,00000000200,a2f,recvmsg
0,01696945000,01696945200,00000000200,a2f,recvmsg
0,01696948400,01696955100,00000006700,a07,poll
0,01696956100,01696956300,00000000200,a2f,recvmsg
0,01696956600,01696956800,00000000200,a2f,recvmsg
0,01696959800,01696966600,00000006800,a07,poll
0,01696967700,01696967900,00000000200,a2f,recvmsg
0,01696968200,01696968400,00000000200,a2f,recvmsg
0,01696971300,01696978100,00000006800,a07,poll
0,01696979200,01696979400,00000000200,a2f,recvmsg
0,01696979700,01696979900,00000000200,a2f,recvmsg
0,01696983400,01696990000,00000006600,a07,poll
0,01696991200,01696991300,00000000100,a2f,recvmsg
0,01696991700,01696991800,00000000100,a2f,recvmsg
0,01696995000,01697001700,00000006700,a07,poll
0,01697002900,01697003000,00000000100,a2f,recvmsg
0,01697003300,01697003400,00000000100,a2f,recvmsg
0,01697006100,01697012900,00000006800,a07,poll
0,01697014100,01697014300,00000000200,a2f,recvmsg
0,01697014600,01697014800,00000000200,a2f,recvmsg
0,01697019300,01697025800,00000006500,a07,poll
0,01697027100,01697027300,00000000200,a2f,recvmsg
0,01697027600,01697027800,00000000200,a2f,recvmsg
0,01697030300,01697037100,00000006800,a07,poll
0,01697038200,01697038300,00000000100,a2f,recvmsg
0,01697038700,01697038900,00000000200,a2f,recvmsg
0,01697041600,01697048400,00000006800,a07,poll
0,01697049600,01697049700,00000000100,a2f,recvmsg
0,01697050100,01697050300,00000000200,a2f,recvmsg
0,01697052800,01697059500,00000006700,a07,poll
0,01697060600,01697060800,00000000200,a2f,recvmsg
0,01697061100,01697061300,00000000200,a2f,recvmsg
0,01697064200,01697070900,00000006700,a07,poll
0,01697072000,01697072200,00000000200,a2f,recvmsg
0,01697072500,01697072700,00000000200,a2f,recvmsg
0,01697075500,01697082200,00000006700,a07,poll
0,01697083300,01697083500,00000000200,a2f,recvmsg
0,01697083800,01697084000,00000000200,a2f,recvmsg
0,01697087300,01697094100,00000006800,a07,poll
0,01697095100,01697095300,00000000200,a2f,recvmsg
0,01697095600,01697095800,00000000200,a2f,recvmsg
0,01697099400,01697106100,00000006700,a07,poll
0,01697107300,01697107500,00000000200,a2f,recvmsg
0,01697107800,01697107900,00000000100,a2f,recvmsg
0,01697111600,01697118600,00000007000,a07,poll
0,01697119700,01697119900,00000000200,a2f,recvmsg
0,01697120300,01697120400,00000000100,a2f,recvmsg
0,01697123900,01697130600,00000006700,a07,poll
0,01697131700,01697131800,00000000100,a2f,recvmsg
0,01697132200,01697132300,00000000100,a2f,recvmsg
0,01697135800,01697142700,00000006900,a07,poll
0,01697143900,01697144000,00000000100,a2f,recvmsg
0,01697144300,01697144500,00000000200,a2f,recvmsg
0,01697149700,01697156500,00000006800,a07,poll
0,01697157600,01697157800,00000000200,a2f,recvmsg
0,01697158100,01697158300,00000000200,a2f,recvmsg
0,01697161300,01697168100,00000006800,a07,poll
0,01697169300,01697169500,00000000200,a2f,recvmsg
0,01697169800,01697170000,00000000200,a2f,recvmsg
0,01697172800,01697179500,00000006700,a07,poll
0,01697180600,01697180800,00000000200,a2f,recvmsg
0,01697181100,01697181300,00000000200,a2f,recvmsg
0,01697185100,01697192000,00000006900,a07,poll
0,01697193200,01697193400,00000000200,a2f,recvmsg
0,01697193600,01697193800,00000000200,a2f,recvmsg
0,01697197200,01697203800,00000006600,a07,poll
0,01697204900,01697205100,00000000200,a2f,recvmsg
0,01697205400,01697205600,00000000200,a2f,recvmsg
0,01697209400,01697216200,00000006800,a07,poll
0,01697217400,01697217600,00000000200,a2f,recvmsg
0,01697217900,01697218100,00000000200,a2f,recvmsg
0,01697221300,01697228000,00000006700,a07,poll
0,01697229300,01697229500,00000000200,a2f,recvmsg
0,01697229700,01697229900,00000000200,a2f,recvmsg
0,01697232900,01697239700,00000006800,a07,poll
0,01697240900,01697241000,00000000100,a2f,recvmsg
0,01697241300,01697241500,00000000200,a2f,recvmsg
0,01697244300,01697250900,00000006600,a07,poll
0,01697252100,01697252200,00000000100,a2f,recvmsg
0,01697252500,01697252600,00000000100,a2f,recvmsg
0,01697255900,01697262600,00000006700,a07,poll
0,01697263700,01697263800,00000000100,a2f,recvmsg
0,01697264200,01697264400,00000000200,a2f,recvmsg
0,01697265400,01697265500,00000000100,a08,lseek
0,01697268300,01697269200,00000000900,a00,read
0,01697273000,01697273100,00000000100,a08,lseek
0,01697275800,01697282500,00000006700,a07,poll
0,01697283700,01697283900,00000000200,a2f,recvmsg
0,01697284200,01697284400,00000000200,a2f,recvmsg
0,01697310500,01697317300,00000006800,a07,poll
0,01697318700,01697318800,00000000100,a2f,recvmsg
0,01697319100,01697319300,00000000200,a2f,recvmsg
0,01697323000,01697323800,00000000800,a00,read
0,01697329400,01697329500,00000000100,a08,lseek
0,01697332700,01697339400,00000006700,a07,poll
0,01697340700,01697340900,00000000200,a2f,recvmsg
0,01697341200,01697341400,00000000200,a2f,recvmsg
0,01697344200,01697350800,00000006600,a07,poll
0,01697351900,01697352100,00000000200,a2f,recvmsg
0,01697352400,01697352600,00000000200,a2f,recvmsg
0,01697355200,01697361700,00000006500,a07,poll
0,01697362800,01697363000,00000000200,a2f,recvmsg
0,01697363300,01697363500,00000000200,a2f,recvmsg
0,01697366300,01697373000,00000006700,a07,poll
0,01697374200,01697374400,00000000200,a2f,recvmsg
0,01697374700,01697374900,00000000200,a2f,recvmsg
0,01697377600,01697384300,00000006700,a07,poll
0,01697385400,01697385500,00000000100,a2f,recvmsg
0,01697385900,01697386100,00000000200,a2f,recvmsg
0,01697388700,01697395300,00000006600,a07,poll
0,01697396500,01697396600,00000000100,a2f,recvmsg
0,01697396900,01697397100,00000000200,a2f,recvmsg
0,01697399700,01697406300,00000006600,a07,poll
0,01697407600,01697407700,00000000100,a2f,recvmsg
0,01697408100,01697408100,00000000000,a2f,recvmsg
0,01697411700,01697418500,00000006800,a07,poll
0,01697419600,01697419700,00000000100,a2f,recvmsg
0,01697420000,01697420200,00000000200,a2f,recvmsg
0,01697423000,01697429500,00000006500,a07,poll
0,01697430700,01697430800,00000000100,a2f,recvmsg
0,01697431000,01697431200,00000000200,a2f,recvmsg
0,01697431700,01697431700,00000000000,a08,lseek
0,01697435700,01697442300,00000006600,a07,poll
0,01697443600,01697443800,00000000200,a2f,recvmsg
0,01697444100,01697444200,00000000100,a2f,recvmsg
0,01697449300,01697456000,00000006700,a07,poll
0,01697457200,01697457400,00000000200,a2f,recvmsg
0,01697457600,01697457800,00000000200,a2f,recvmsg
0,01697461200,01697467600,00000006400,a07,poll
0,01697468800,01697468900,00000000100,a2f,recvmsg
0,01697469200,01697469400,00000000200,a2f,recvmsg
0,01697472400,01697479000,00000006600,a07,poll
0,01697480300,01697480400,00000000100,a2f,recvmsg
0,01697480700,01697480900,00000000200,a2f,recvmsg
0,01697483900,01697490300,00000006400,a07,poll
0,01697491500,01697491600,00000000100,a2f,recvmsg
0,01697491900,01697492100,00000000200,a2f,recvmsg
0,01697495000,01697501500,00000006500,a07,poll
0,01697502700,01697502900,00000000200,a2f,recvmsg
0,01697503100,01697503300,00000000200,a2f,recvmsg
0,01697506900,01697513600,00000006700,a07,poll
0,01697514700,01697514900,00000000200,a2f,recvmsg
0,01697515200,01697515400,00000000200,a2f,recvmsg
0,01697518300,01697524900,00000006600,a07,poll
0,01697526000,01697526100,00000000100,a2f,recvmsg
0,01697526400,01697526600,00000000200,a2f,recvmsg
0,01697529600,01697536100,00000006500,a07,poll
0,01697537300,01697537300,00000000000,a2f,recvmsg
0,01697537700,01697537900,00000000200,a2f,recvmsg
0,01697541000,01697547500,00000006500,a07,poll
0,01697548700,01697548900,00000000200,a2f,recvmsg
0,01697549200,01697549400,00000000200,a2f,recvmsg
0,01697552500,01697559100,00000006600,a07,poll
0,01697560200,01697560400,00000000200,a2f,recvmsg
0,01697560700,01697560900,00000000200,a2f,recvmsg
0,01697563800,01697570400,00000006600,a07,poll
0,01697571600,01697571700,00000000100,a2f,recvmsg
0,01697572100,01697572200,00000000100,a2f,recvmsg
0,01697575800,01697582600,00000006800,a07,poll
0,01697583700,01697583900,00000000200,a2f,recvmsg
0,01697584200,01697584400,00000000200,a2f,recvmsg
0,01697587300,01697594000,00000006700,a07,poll
0,01697595300,01697595500,00000000200,a2f,recvmsg
0,01697595800,01697596000,00000000200,a2f,recvmsg
0,01697599000,01697605700,00000006700,a07,poll
0,01697606800,01697607000,00000000200,a2f,recvmsg
0,01697607300,01697607500,00000000200,a2f,recvmsg
0,01697610400,01697617100,00000006700,a07,poll
0,01697618300,01697618500,00000000200,a2f,recvmsg
0,01697618800,01697619000,00000000200,a2f,recvmsg
0,01697627000,01697633700,00000006700,a07,poll
0,01697634800,01697634900,00000000100,a2f,recvmsg
0,01697635200,01697635400,00000000200,a2f,recvmsg
0,01697638800,01697645300,00000006500,a07,poll
0,01697646400,01697646600,00000000200,a2f,recvmsg
0,01697646900,01697647000,00000000100,a2f,recvmsg
0,01697650100,01697656900,00000006800,a07,poll
0,01697658000,01697658200,00000000200,a2f,recvmsg
0,01697658500,01697658700,00000000200,a2f,recvmsg
0,01697661800,01697668400,00000006600,a07,poll
0,01697669500,01697669700,00000000200,a2f,recvmsg
0,01697670000,01697670100,00000000100,a2f,recvmsg
0,01697673100,01697679700,00000006600,a07,poll
0,01697680700,01697680900,00000000200,a2f,recvmsg
0,01697681200,01697681400,00000000200,a2f,recvmsg
0,01697701300,01697727700,00000026400,a57,unlink
0,01697729000,01697733000,00000004000,a14,writev
0,01697733600,01697830800,00000097200,a07,poll
0,01697733600,01697838400,00000104800,a07,poll
0,01697850100,01697850300,00000000200,a2f,recvmsg
0,01697883900,01697885000,00000001100,a00,read
0,01697895500,01697895800,00000000300,a2f,recvmsg
0,01697881800,01697913500,00000031700,a07,poll
0,01697932500,01697969300,00000036800,a07,poll
0,01697970500,01697972500,00000002000,a07,poll
0,01697974400,01698027800,00000053400,a07,poll
0,01697974400,01698030100,00000055700,a07,poll
0,01698032800,01698083300,00000050500,a07,poll
0,01698084400,01698086500,00000002100,a07,poll
0,01698088100,01698141300,00000053200,a07,poll
0,01698142400,01698143900,00000001500,a07,poll
0,01698145300,01698198800,00000053500,a07,poll
0,01698145300,01698200500,00000055200,a07,poll
0,01698200700,01698203100,00000002400,a2f,recvmsg
0,01698203800,01698243100,00000039300,a07,poll
0,01698243200,01698244200,00000001000,a2f,recvmsg
0,01698203800,01698245100,00000041300,a07,poll
0,01698247500,01698287800,00000040300,a07,poll
0,01698287900,01698288900,00000001000,a2f,recvmsg
0,01698247500,01698289800,00000042300,a07,poll
0,01698292200,01698332200,00000040000,a07,poll
0,01698332400,01698333400,00000001000,a2f,recvmsg
0,01698292200,01698334300,00000042100,a07,poll
0,01698338000,01698377500,00000039500,a07,poll
0,01698377600,01698378700,00000001100,a2f,recvmsg
0,01698338000,01698379600,00000041600,a07,poll
0,01698382200,01698422900,00000040700,a07,poll
0,01698423100,01698424700,00000001600,a2f,recvmsg
0,01698382200,01698425700,00000043500,a07,poll
0,01698428800,01698479100,00000050300,a07,poll
0,01698479300,01698480200,00000000900,a2f,recvmsg
0,01698428800,01698481200,00000052400,a07,poll
0,01698483700,01698498500,00000014800,a07,poll
0,01698498700,01698499700,00000001000,a2f,recvmsg
0,01698483700,01698500600,00000016900,a07,poll
0,01698503200,01698515900,00000012700,a07,poll
0,01698516000,01698517400,00000001400,a2f,recvmsg
0,01698503200,01698518300,00000015100,a07,poll
0,01698521400,01698532700,00000011300,a07,poll
0,01698521400,01698534800,00000013400,a07,poll
0,01698537200,01698548800,00000011600,a07,poll
0,01698548900,01698550000,00000001100,a2f,recvmsg
0,01698537200,01698550800,00000013600,a07,poll
0,01698553600,01698566000,00000012400,a07,poll
0,01698566200,01698567300,00000001100,a2f,recvmsg
0,01698553600,01698568200,00000014600,a07,poll
0,01698570800,01698572900,00000002100,a07,poll
0,01698575400,01698575600,00000000200,a2f,recvmsg
0,01698576200,01698576400,00000000200,a2f,recvmsg
0,01698570800,01698594500,00000023700,a07,poll
0,01698594900,01698596500,00000001600,a2f,recvmsg
0,01698600300,01698601400,00000001100,a2d,recvfrom
0,01698605600,01698605800,00000000200,a2f,recvmsg
0,01698606400,01698606600,00000000200,a2f,recvmsg
0,01698570800,01698609500,00000038700,a07,poll
0,01698610000,01698611700,00000001700,a2f,recvmsg
0,01698613200,01698614000,00000000800,a2d,recvfrom
0,01698618300,01698618400,00000000100,a2f,recvmsg
0,01698619000,01698619200,00000000200,a2f,recvmsg
0,01698660100,01698660400,00000000300,a2f,recvmsg
0,01698662900,01698663000,00000000100,a2f,recvmsg
0,01698724900,01698725200,00000000300,a2f,recvmsg
0,01698727500,01698727800,00000000300,a2f,recvmsg
0,01698741100,01698772900,00000031800,a07,poll
0,01698773700,01698775400,00000001700,a2f,recvmsg
0,01698781800,01698782500,00000000700,a2d,recvfrom
0,01698783500,01698783700,00000000200,a2f,recvmsg
0,01698784400,01698784500,00000000100,a2f,recvmsg
0,01698816000,01698816100,00000000100,a2f,recvmsg
0,01698818500,01698818700,00000000200,a2f,recvmsg
0,01698822000,01698824400,00000002400,a07,poll
0,01698827100,01698827300,00000000200,a2f,recvmsg
0,01698827800,01698828000,00000000200,a2f,recvmsg
0,01699312700,01699316900,00000004200,a09,mmap
0,01699486500,01699491400,00000004900,a02,open
0,01699498700,01699500700,00000002000,a00,read
0,01699551800,01699552600,00000000800,a00,read
0,01699601400,01699602200,00000000800,a00,read
0,01699648100,01699648800,00000000700,a00,read
0,01699695600,01699696300,00000000700,a00,read
0,01699742300,01699743100,00000000800,a00,read
0,01699786900,01699787600,00000000700,a00,read
0,01699832700,01699833500,00000000800,a00,read
0,01699880600,01699881300,00000000700,a00,read
0,01699929600,01699930500,00000000900,a00,read
0,01699977900,01699978600,00000000700,a00,read
0,01700005300,01700007300,00000002000,a02,open
0,01700010200,01700011100,00000000900,a00,read
0,01700065600,01700066300,00000000700,a00,read
0,01700147900,01700149000,00000001100,a00,read
0,01700250000,01700250900,00000000900,a00,read
0,01700326500,01700327300,00000000800,a00,read
0,01700404800,01700405500,00000000700,a00,read
0,01700481300,01700482300,00000001000,a00,read
0,01700565100,01700565800,00000000700,a00,read
0,01700631000,01700631700,00000000700,a00,read
0,01700688700,01700689400,00000000700,a00,read
0,01700766400,01700787800,00000021400,a07,poll
0,01700791300,01700791500,00000000200,a2f,recvmsg
0,01700792100,01700792300,00000000200,a2f,recvmsg
0,01700795300,01700802700,00000007400,a07,poll
0,01700803800,01700804000,00000000200,a2f,recvmsg
0,01700804300,01700804500,00000000200,a2f,recvmsg
0,01700809400,01700814500,00000005100,a06,lstat
0,01700815200,01700816400,00000001200,a06,lstat
0,01700834100,01700845900,00000011800,a01,write
0,01700851000,01700857700,00000006700,a07,poll
0,01700859700,01700859900,00000000200,a2f,recvmsg
0,01700860400,01700860400,00000000000,a2f,recvmsg
0,01700861800,01701178700,00000316900,a38,clone
0,01701645900,01701646100,00000000200,a0c,brk
0,01701656400,01701659000,00000002600,a15,access
0,01701660000,01701660900,00000000900,a09,mmap
0,01701665500,01701667300,00000001800,a15,access
0,01701673500,01701674600,00000001100,a09,mmap
0,01701678300,01701678800,00000000500,a15,access
0,01701686200,01701687500,00000001300,a00,read
0,01701689100,01701690700,00000001600,a09,mmap
0,01701694400,01701696500,00000002100,a09,mmap
0,01701708300,01701709000,00000000700,a15,access
0,01701712900,01701713500,00000000600,a00,read
0,01701714300,01701715100,00000000800,a09,mmap
0,01701717300,01701718500,00000001200,a09,mmap
0,01701726900,01701727500,00000000600,a15,access
0,01701730400,01701730900,00000000500,a00,read
0,01701731600,01701732400,00000000800,a09,mmap
0,01701734000,01701736100,00000002100,a09,mmap
0,01701740100,01701743100,00000003000,a09,mmap
0,01701745200,01701746300,00000001100,a09,mmap
0,01701754800,01701755300,00000000500,a15,access
0,01701757800,01701758400,00000000600,a00,read
0,01701759100,01701760600,00000001500,a09,mmap
0,01701763300,01701764900,00000001600,a09,mmap
0,01701773000,01701773500,00000000500,a15,access
0,01701776500,01701777100,00000000600,a00,read
0,01701777700,01701779200,00000001500,a09,mmap
0,01701782600,01701784600,00000002000,a09,mmap
0,01701793700,01701794300,00000000600,a15,access
0,01701797100,01701797700,00000000600,a00,read
0,01701798100,01701799200,00000001100,a09,mmap
0,01701800500,01701801800,00000001300,a09,mmap
0,01701804700,01701806000,00000001300,a09,mmap
0,01701812300,01701812800,00000000500,a15,access
0,01701815100,01701815600,00000000500,a00,read
0,01701816200,01701817700,00000001500,a09,mmap
0,01701819900,01701821700,00000001800,a09,mmap
0,01701835900,01701836600,00000000700,a09,mmap
0,01701840400,01701840700,00000000300,a09,mmap
0,01701841800,01701842100,00000000300,a09,mmap
0,01702014600,01702014700,00000000100,a0c,brk
0,01702014800,01702015600,00000000800,a0c,brk
0,01702052800,01702053900,00000001100,a00,read
0,01702066400,01702067700,00000001300,a00,read
0,01702100700,01702101500,00000000800,a00,read
0,01702223800,01702224600,00000000800,a00,read
0,01702295500,01702296100,00000000600,a00,read
0,01702381200,01702381900,00000000700,a00,read
0,01702513400,01702514100,00000000700,a00,read
0,01702642500,01702643200,00000000700,a00,read
0,01702798200,01702798800,00000000600,a00,read
0,01702948500,01702949300,00000000800,a00,read
0,01702986200,01702987400,00000001200,a0c,brk
0,01703102600,01703103300,00000000700,a00,read
0,01703251600,01703252400,00000000800,a00,read
0,01703408300,01703409000,00000000700,a00,read
0,01703568600,01703569200,00000000600,a00,read
0,01703678500,01703679200,00000000700,a00,read
0,01703709900,01703710400,00000000500,a0c,brk
0,01703819500,01703820200,00000000700,a00,read
0,01704064000,01704064600,00000000600,a00,read
0,01704076800,01704077200,00000000400,a00,read
0,01704121100,01704121500,00000000400,a00,read
0,01704141600,01704142200,00000000600,a00,read
0,01704375800,01704376200,00000000400,a00,read
0,01704406300,01704407200,00000000900,a00,read
0,01704503700,01704504600,00000000900,a00,read
0,01704528200,01704529400,00000001200,a0c,brk
0,01704574600,01704574900,00000000300,a00,read
0,01704654100,01704654800,00000000700,a00,read
0,01704807900,01704808500,00000000600,a00,read
0,01704920200,01704920800,00000000600,a00,read
0,01705015000,01705015500,00000000500,a00,read
0,01705027400,01705027900,00000000500,a00,read
0,01705107700,01705108100,00000000400,a00,read
0,01705131700,01705132000,00000000300,a00,read
0,01705154300,01705154700,00000000400,a00,read
0,01705256100,01705257100,00000001000,a0c,brk
0,01705259100,01705260300,00000001200,a00,read
0,01705462100,01705462400,00000000300,a00,read
0,01705545400,01705545900,00000000500,a00,read
0,01705609600,01705610300,00000000700,a00,read
0,01705738700,01705738700,00000000000,a00,read
0,01705770500,01705771100,00000000600,a00,read
0,01705788000,01705789300,00000001300,a02,open
0,01705900000,01705900500,00000000500,a00,read
0,01705970900,01705971300,00000000400,a00,read
0,01706030300,01706031000,00000000700,a00,read
0,01706139400,01706140000,00000000600,a00,read
0,01706289600,01706290500,00000000900,a00,read
0,01706421100,01706421700,00000000600,a00,read
0,01706478800,01706479500,00000000700,a00,read
0,01706535300,01706536000,00000000700,a00,read
0,01706605400,01706606100,00000000700,a00,read
0,01706658300,01706659200,00000000900,a00,read
0,01706746900,01706747600,00000000700,a0c,brk
0,01706779900,01706783700,00000003800,a0c,brk
0,01706798100,01706798900,00000000800,a00,read
0,01706913200,01706914000,00000000800,a00,read
0,01707072000,01707072900,00000000900,a00,read
0,01707189100,01707189700,00000000600,a00,read
0,01707334600,01707335300,00000000700,a00,read
0,01707452200,01707452800,00000000600,a00,read
0,01707613700,01707614400,00000000700,a00,read
0,01707619300,01707620000,00000000700,a0c,brk
0,01707735700,01707736600,00000000900,a00,read
0,01707854300,01707855000,00000000700,a00,read
0,01707995100,01707996000,00000000900,a00,read
0,01708126800,01708127500,00000000700,a00,read
0,01708228500,01708229200,00000000700,a00,read
0,01708341000,01708341700,00000000700,a00,read
0,01708464600,01708465300,00000000700,a00,read
0,01708576400,01708577100,00000000700,a0c,brk
0,01708599700,01708600400,00000000700,a00,read
0,01708770400,01708771200,00000000800,a00,read
0,01708920900,01708921600,00000000700,a00,read
0,01709031700,01709032400,00000000700,a00,read
0,01709198900,01709199900,00000001000,a00,read
0,01709276300,01709277000,00000000700,a00,read
0,01709357900,01709358600,00000000700,a00,read
0,01709424800,01709425400,00000000600,a0c,brk
0,01709440200,01709440900,00000000700,a00,read
0,01709512900,01709513500,00000000600,a00,read
0,01709613800,01709614600,00000000800,a00,read
0,01709716000,01709716600,00000000600,a00,read
0,01709805500,01709806100,00000000600,a00,read
0,01709886200,01709886900,00000000700,a00,read
0,01709986600,01709987300,00000000700,a00,read
0,01710071400,01710072000,00000000600,a00,read
0,01710178700,01710179300,00000000600,a00,read
0,01710270900,01710271400,00000000500,a00,read
0,01710389200,01710389900,00000000700,a00,read
0,01710502700,01710503300,00000000600,a00,read
0,01710605700,01710606300,00000000600,a00,read
0,01710708100,01710708400,00000000300,a0c,brk
0,01711067700,01711070900,00000003200,a57,unlink
0,01711093800,01711094300,00000000500,a48,fcntl
0,01711140700,01711156100,00000015400,a01,write
0,01711174100,01711176700,00000002600,a01,write
0,01711193300,01711195800,00000002500,a01,write
0,01667547500,01711443700,00043896200,a17,select
0,01711468300,01711468500,00000000200,a2f,recvmsg
0,01711472200,01711501600,00000029400,a17,select
0,01711505900,01711506100,00000000200,a2f,recvmsg
0,01711506600,01711523700,00000017100,a17,select
0,01711527400,01711527500,00000000100,a2f,recvmsg
0,01711528100,01711544900,00000016800,a17,select
0,01711548800,01711549000,00000000200,a2f,recvmsg
0,01711549500,01711564800,00000015300,a17,select
0,01711568600,01711568800,00000000200,a2f,recvmsg
0,01711569200,01711584300,00000015100,a17,select
0,01711587700,01711587800,00000000100,a2f,recvmsg
0,01711588300,01711614900,00000026600,a17,select
0,01711618700,01711618900,00000000200,a2f,recvmsg
0,01711619400,01711630600,00000011200,a17,select
0,01711634200,01711634400,00000000200,a2f,recvmsg
0,01711634900,01711642300,00000007400,a17,select
0,01711645700,01711645900,00000000200,a2f,recvmsg
0,01711646400,01711654700,00000008300,a17,select
0,01711658100,01711658300,00000000200,a2f,recvmsg
0,01711658800,01711666400,00000007600,a17,select
0,01711670200,01711670400,00000000200,a2f,recvmsg
0,01711670900,01711678600,00000007700,a17,select
0,01711682100,01711682300,00000000200,a2f,recvmsg
0,01711682800,01711690200,00000007400,a17,select
0,01711694000,01711694200,00000000200,a2f,recvmsg
0,01711694600,01711701700,00000007100,a17,select
0,01711705200,01711705400,00000000200,a2f,recvmsg
0,01711705800,01711714200,00000008400,a17,select
0,01711717900,01711718100,00000000200,a2f,recvmsg
0,01711718600,01711726100,00000007500,a17,select
0,01711729900,01711730100,00000000200,a2f,recvmsg
0,01711730500,01711737900,00000007400,a17,select
0,01711741700,01711741700,00000000000,a2f,recvmsg
0,01711742300,01711749600,00000007300,a17,select
0,01711753100,01711753300,00000000200,a2f,recvmsg
0,01711753800,01711761100,00000007300,a17,select
0,01711764700,01711764900,00000000200,a2f,recvmsg
0,01711765400,01711773000,00000007600,a17,select
0,01711776700,01711776800,00000000100,a2f,recvmsg
0,01711777400,01711784600,00000007200,a17,select
0,01711788300,01711788400,00000000100,a2f,recvmsg
0,01711789100,01711795900,00000006800,a17,select
0,01711799600,01711799800,00000000200,a2f,recvmsg
0,01711800300,01711809200,00000008900,a17,select
0,01711812600,01711812800,00000000200,a2f,recvmsg
0,01711813300,01711820200,00000006900,a17,select
0,01711823800,01711824000,00000000200,a2f,recvmsg
0,01711824500,01711831400,00000006900,a17,select
0,01711835300,01711835400,00000000100,a2f,recvmsg
0,01711836000,01711843500,00000007500,a17,select
0,01711847000,01711847200,00000000200,a2f,recvmsg
0,01711847700,01711855100,00000007400,a17,select
0,01711858800,01711859000,00000000200,a2f,recvmsg
0,01711859500,01711866500,00000007000,a17,select
0,01711870000,01711870200,00000000200,a2f,recvmsg
0,01711870700,01711878300,00000007600,a17,select
0,01711881900,01711882100,00000000200,a2f,recvmsg
0,01711882500,01711890100,00000007600,a17,select
0,01711893700,01711893800,00000000100,a2f,recvmsg
0,01711894300,01711902400,00000008100,a17,select
0,01711906300,01711906500,00000000200,a2f,recvmsg
0,01711907000,01711914700,00000007700,a17,select
0,01711918200,01711918400,00000000200,a2f,recvmsg
0,01711918800,01711926400,00000007600,a17,select
0,01711930100,01711930200,00000000100,a2f,recvmsg
0,01711930800,01711941200,00000010400,a17,select
0,01711945000,01711945100,00000000100,a2f,recvmsg
0,01711945600,01711952900,00000007300,a17,select
0,01711956400,01711956600,00000000200,a2f,recvmsg
0,01711957100,01711964300,00000007200,a17,select
0,01711968200,01711968400,00000000200,a2f,recvmsg
0,01711968900,01711976900,00000008000,a17,select
0,01711980700,01711980800,00000000100,a2f,recvmsg
0,01711981300,01711989100,00000007800,a17,select
0,01711992800,01711993000,00000000200,a2f,recvmsg
0,01711993500,01712001400,00000007900,a17,select
0,01712005000,01712005200,00000000200,a2f,recvmsg
0,01712005700,01712013900,00000008200,a17,select
0,01712017600,01712017700,00000000100,a2f,recvmsg
0,01712018300,01712025500,00000007200,a17,select
0,01712029100,01712029200,00000000100,a2f,recvmsg
0,01712029800,01712036800,00000007000,a17,select
0,01712040300,01712040500,00000000200,a2f,recvmsg
0,01712041000,01712048600,00000007600,a17,select
0,01712052200,01712052400,00000000200,a2f,recvmsg
0,01712052900,01712069000,00000016100,a17,select
0,01712072500,01712072700,00000000200,a2f,recvmsg
0,01712073200,01712102700,00000029500,a17,select
0,01712106400,01712106500,00000000100,a2f,recvmsg
0,01712107000,01712124800,00000017800,a17,select
0,01712128400,01712128600,00000000200,a2f,recvmsg
0,01712129100,01712136200,00000007100,a17,select
0,01712139800,01712140000,00000000200,a2f,recvmsg
0,01712140500,01712147400,00000006900,a17,select
0,01712150900,01712151000,00000000100,a2f,recvmsg
0,01712151600,01712158500,00000006900,a17,select
0,01712162100,01712162200,00000000100,a2f,recvmsg
0,01712162800,01712169700,00000006900,a17,select
0,01712173200,01712173300,00000000100,a2f,recvmsg
0,01712173900,01712180700,00000006800,a17,select
0,01712184300,01712184400,00000000100,a2f,recvmsg
0,01712184900,01712192000,00000007100,a17,select
0,01712195500,01712195700,00000000200,a2f,recvmsg
0,01712196100,01712203700,00000007600,a17,select
0,01712207300,01712207500,00000000200,a2f,recvmsg
0,01712208000,01712239300,00000031300,a17,select
0,01712243400,01712243600,00000000200,a2f,recvmsg
0,01712244300,01712252800,00000008500,a17,select
0,01712256600,01712256600,00000000000,a2f,recvmsg
0,01712257200,01712266600,00000009400,a17,select
0,01712270400,01712270500,00000000100,a2f,recvmsg
0,01712271100,01712278700,00000007600,a17,select
0,01712282000,01712282200,00000000200,a2f,recvmsg
0,01712282700,01712290000,00000007300,a17,select
0,01712293600,01712293800,00000000200,a2f,recvmsg
0,01712294300,01712301500,00000007200,a17,select
0,01712305000,01712305200,00000000200,a2f,recvmsg
0,01712305700,01712313100,00000007400,a17,select
0,01712316600,01712316800,00000000200,a2f,recvmsg
0,01712317300,01712325000,00000007700,a17,select
0,01712328700,01712328800,00000000100,a2f,recvmsg
0,01712329300,01712336400,00000007100,a17,select
0,01712340000,01712340200,00000000200,a2f,recvmsg
0,01712340600,01712347800,00000007200,a17,select
0,01712351400,01712351500,00000000100,a2f,recvmsg
0,01712352000,01712359200,00000007200,a17,select
0,01712362800,01712363000,00000000200,a2f,recvmsg
0,01712363400,01712370700,00000007300,a17,select
0,01712374400,01712374500,00000000100,a2f,recvmsg
0,01712375000,01712382100,00000007100,a17,select
0,01712385700,01712385800,00000000100,a2f,recvmsg
0,01712386300,01712394000,00000007700,a17,select
0,01712397600,01712397800,00000000200,a2f,recvmsg
0,01712398300,01712429900,00000031600,a17,select
0,01712433400,01712433600,00000000200,a2f,recvmsg
0,01712434100,01712441700,00000007600,a17,select
0,01712445200,01712445400,00000000200,a2f,recvmsg
0,01712445900,01712453100,00000007200,a17,select
0,01712456700,01712456900,00000000200,a2f,recvmsg
0,01712457400,01712469900,00000012500,a17,select
0,01712473400,01712473600,00000000200,a2f,recvmsg
0,01712474100,01712481500,00000007400,a17,select
0,01712485000,01712485200,00000000200,a2f,recvmsg
0,01712485700,01712493000,00000007300,a17,select
0,01712496500,01712496700,00000000200,a2f,recvmsg
0,01712497200,01712504800,00000007600,a17,select
0,01712508300,01712508500,00000000200,a2f,recvmsg
0,01712509000,01712516300,00000007300,a17,select
0,01712519900,01712520100,00000000200,a2f,recvmsg
0,01712520600,01712586700,00000066100,a17,select
0,01712587600,01712588900,00000001300,a2f,recvmsg
0,01712994700,01712995600,00000000900,a2f,recvmsg
0,01713289800,01713291600,00000001800,a2f,recvmsg
0,01713405500,01713405700,00000000200,a2f,recvmsg
0,01713406300,01713406700,00000000400,a14,writev
0,01713424500,01713427000,00000002500,a14,writev
0,01713427200,01713428700,00000001500,a14,writev
0,01713429100,01713429300,00000000200,a2f,recvmsg
0,01700851000,01713437600,00012586600,a07,poll
0,01713444100,01713446500,00000002400,a2f,recvmsg
0,01713451400,01713451600,00000000200,a2f,recvmsg
0,01713455000,01713455200,00000000200,a2f,recvmsg
0,01713455400,01713455500,00000000100,a2f,recvmsg
0,01713459600,01713459700,00000000100,a2f,recvmsg
0,01713459900,01713460100,00000000200,a2f,recvmsg
0,01713461000,01713464900,00000003900,a07,poll
0,01713469000,01713475000,00000006000,a2f,recvmsg
0,01713486000,01713486100,00000000100,a2f,recvmsg
0,01713512800,01713517500,00000004700,a07,poll
0,01713523200,01713529100,00000005900,a2f,recvmsg
0,01713541500,01713541700,00000000200,a2f,recvmsg
0,01713564200,01713568500,00000004300,a07,poll
0,01713574400,01713580800,00000006400,a2f,recvmsg
0,01713593700,01713593900,00000000200,a2f,recvmsg
0,01713430000,01713622600,00000192600,a17,select
0,01713639300,01713641000,00000001700,a14,writev
0,01713641600,01713641700,00000000100,a2f,recvmsg
0,01713655900,01713656800,00000000900,a14,writev
0,01713657000,01713657200,00000000200,a2f,recvmsg
0,01713669200,01713670200,00000001000,a14,writev
0,01713670300,01713670500,00000000200,a2f,recvmsg
0,01713685300,01713685400,00000000100,a2f,recvmsg
0,01713616300,01713690000,00000073700,a07,poll
0,01713693900,01713694100,00000000200,a2f,recvmsg
0,01713695600,01713695800,00000000200,a2f,recvmsg
0,01713696100,01713696300,00000000200,a2f,recvmsg
0,01713697500,01713697700,00000000200,a2f,recvmsg
0,01713697900,01713698100,00000000200,a2f,recvmsg
0,01713698500,01713700100,00000001600,a07,poll
0,01713700600,01713701700,00000001100,a2f,recvmsg
0,01713706800,01713707900,00000001100,a2d,recvfrom
0,01713708700,01713708900,00000000200,a2f,recvmsg
0,01713709600,01713709700,00000000100,a2f,recvmsg
0,01713751100,01713751400,00000000300,a2f,recvmsg
0,01713753600,01713753700,00000000100,a2f,recvmsg
0,01713755700,01713757700,00000002000,a07,poll
0,01713758400,01713759400,00000001000,a2f,recvmsg
0,01713765200,01713765700,00000000500,a2d,recvfrom
0,01713766800,01713767000,00000000200,a2f,recvmsg
0,01713767500,01713767700,00000000200,a2f,recvmsg
0,01713797300,01713797500,00000000200,a2f,recvmsg
0,01713799600,01713799800,00000000200,a2f,recvmsg
0,01713803200,01714250300,00000447100,a07,poll
0,01714267600,01714273300,00000005700,a2e,sendmsg
0,01714288800,01714375400,00000086600,a07,poll
0,01714392900,01714394400,00000001500,a2f,recvmsg
0,01714469300,01714472300,00000003000,a07,poll
0,01714479100,01714481600,00000002500,a2e,sendmsg
0,01714485000,01714485200,00000000200,a00,read
0,01714492200,01714610200,00000118000,a07,poll
0,01714615600,01714617000,00000001400,a2e,sendmsg
0,01714619600,01714619700,00000000100,a00,read
0,01714638100,01714670700,00000032600,a07,poll
0,01714674500,01714675300,00000000800,a2f,recvmsg
0,01714716700,01714718900,00000002200,a07,poll
0,01714721500,01714723500,00000002000,a2f,recvmsg
0,01714729000,01714730000,00000001000,a2f,recvmsg
0,01714740100,01714833900,00000093800,a07,poll
0,01714839200,01714842500,00000003300,a2e,sendmsg
0,01714845700,01714845900,00000000200,a00,read
0,01714913400,01714914300,00000000900,a2f,recvmsg
0,01714916400,01714916600,00000000200,a00,read
0,01713686000,01716679800,00002993800,a17,select
0,01716699100,01716699300,00000000200,a2f,recvmsg
0,01716712900,01716713100,00000000200,a2f,recvmsg
0,01716713600,01716776700,00000063100,a17,select
0,01716780600,01716780700,00000000100,a2f,recvmsg
0,01701200800,01727356000,00026155200,a3d,wait4
0,01727379100,01727381000,00000001900,a00,read
0,01727383200,01727383600,00000000400,a00,read
0,01727402700,01727452400,00000049700,a07,poll
0,01727457000,01727457200,00000000200,a2f,recvmsg
0,01727458200,01727458400,00000000200,a2f,recvmsg
0,01727464400,01727476200,00000011800,a07,poll
0,01727478300,01727478500,00000000200,a2f,recvmsg
0,01727478900,01727479100,00000000200,a2f,recvmsg
0,01727483400,01727495300,00000011900,a07,poll
0,01727497400,01727497500,00000000100,a2f,recvmsg
0,01727497900,01727498100,00000000200,a2f,recvmsg
0,01727503000,01727514700,00000011700,a07,poll
0,01727516700,01727516900,00000000200,a2f,recvmsg
0,01727517300,01727517400,00000000100,a2f,recvmsg
0,01727521200,01727532900,00000011700,a07,poll
0,01727534900,01727535000,00000000100,a2f,recvmsg
0,01727535500,01727535700,00000000200,a2f,recvmsg
0,01727539900,01727551600,00000011700,a07,poll
0,01727553700,01727553900,00000000200,a2f,recvmsg
0,01727554300,01727554500,00000000200,a2f,recvmsg
0,01727555300,01727555500,00000000200,a08,lseek
0,01727565800,01727565900,00000000100,a08,lseek
0,01727569200,01727576300,00000007100,a07,poll
0,01727577500,01727577700,00000000200,a2f,recvmsg
0,01727578100,01727578200,00000000100,a2f,recvmsg
0,01727584000,01727590800,00000006800,a07,poll
0,01727592100,01727592300,00000000200,a2f,recvmsg
0,01727592600,01727592800,00000000200,a2f,recvmsg
0,01727596000,01727602700,00000006700,a07,poll
0,01727603900,01727604000,00000000100,a2f,recvmsg
0,01727604400,01727604500,00000000100,a2f,recvmsg
0,01727607900,01727614300,00000006400,a07,poll
0,01727615500,01727615600,00000000100,a2f,recvmsg
0,01727616000,01727616100,00000000100,a2f,recvmsg
0,01727619400,01727626200,00000006800,a07,poll
0,01727627500,01727627600,00000000100,a2f,recvmsg
0,01727627900,01727628100,00000000200,a2f,recvmsg
0,01727631500,01727638300,00000006800,a07,poll
0,01727639400,01727639600,00000000200,a2f,recvmsg
0,01727639900,01727640100,00000000200,a2f,recvmsg
0,01727643200,01727650000,00000006800,a07,poll
0,01727651200,01727651400,00000000200,a2f,recvmsg
0,01727651700,01727651900,00000000200,a2f,recvmsg
0,01727654700,01727661400,00000006700,a07,poll
0,01727662500,01727662700,00000000200,a2f,recvmsg
0,01727663000,01727663200,00000000200,a2f,recvmsg
0,01727667300,01727674300,00000007000,a07,poll
0,01727675400,01727675500,00000000100,a2f,recvmsg
0,01727675900,01727676000,00000000100,a2f,recvmsg
0,01727679200,01727686300,00000007100,a07,poll
0,01727687300,01727687500,00000000200,a2f,recvmsg
0,01727687800,01727688000,00000000200,a2f,recvmsg
0,01727691700,01727698700,00000007000,a07,poll
0,01727699800,01727699900,00000000100,a2f,recvmsg
0,01727700200,01727700400,00000000200,a2f,recvmsg
0,01727703500,01727710000,00000006500,a07,poll
0,01727711200,01727711300,00000000100,a2f,recvmsg
0,01727711700,01727711900,00000000200,a2f,recvmsg
0,01727714900,01727721600,00000006700,a07,poll
0,01727722700,01727722800,00000000100,a2f,recvmsg
0,01727723200,01727723300,00000000100,a2f,recvmsg
0,01727726500,01727733200,00000006700,a07,poll
0,01727734300,01727734500,00000000200,a2f,recvmsg
0,01727734800,01727735000,00000000200,a2f,recvmsg
0,01727738000,01727745000,00000007000,a07,poll
0,01727746000,01727746200,00000000200,a2f,recvmsg
0,01727746500,01727746700,00000000200,a2f,recvmsg
0,01727749300,01727756300,00000007000,a07,poll
0,01727757300,01727757500,00000000200,a2f,recvmsg
0,01727757800,01727758000,00000000200,a2f,recvmsg
0,01727762700,01727769600,00000006900,a07,poll
0,01727770700,01727770900,00000000200,a2f,recvmsg
0,01727771200,01727771400,00000000200,a2f,recvmsg
0,01727774100,01727781100,00000007000,a07,poll
0,01727782100,01727782300,00000000200,a2f,recvmsg
0,01727782600,01727782800,00000000200,a2f,recvmsg
0,01727785300,01727792100,00000006800,a07,poll
0,01727793200,01727793400,00000000200,a2f,recvmsg
0,01727793700,01727793900,00000000200,a2f,recvmsg
0,01727796600,01727803400,00000006800,a07,poll
0,01727804500,01727804700,00000000200,a2f,recvmsg
0,01727805000,01727805200,00000000200,a2f,recvmsg
0,01727808100,01727814900,00000006800,a07,poll
0,01727816000,01727816100,00000000100,a2f,recvmsg
0,01727816500,01727816600,00000000100,a2f,recvmsg
0,01727819300,01727826000,00000006700,a07,poll
0,01727827100,01727827200,00000000100,a2f,recvmsg
0,01727827500,01727827700,00000000200,a2f,recvmsg
0,01727831200,01727838200,00000007000,a07,poll
0,01727839200,01727839400,00000000200,a2f,recvmsg
0,01727839700,01727839900,00000000200,a2f,recvmsg
0,01727843100,01727850000,00000006900,a07,poll
0,01727851200,01727851300,00000000100,a2f,recvmsg
0,01727851700,01727851800,00000000100,a2f,recvmsg
0,01727855400,01727862400,00000007000,a07,poll
0,01727863500,01727863700,00000000200,a2f,recvmsg
0,01727864000,01727864200,00000000200,a2f,recvmsg
0,01727867600,01727874400,00000006800,a07,poll
0,01727875400,01727875600,00000000200,a2f,recvmsg
0,01727875900,01727876100,00000000200,a2f,recvmsg
0,01727879400,01727886300,00000006900,a07,poll
0,01727887400,01727887600,00000000200,a2f,recvmsg
0,01727887900,01727888000,00000000100,a2f,recvmsg
0,01727893500,01727900300,00000006800,a07,poll
0,01727901300,01727901500,00000000200,a2f,recvmsg
0,01727901800,01727902000,00000000200,a2f,recvmsg
0,01727905000,01727911700,00000006700,a07,poll
0,01727912800,01727913000,00000000200,a2f,recvmsg
0,01727913300,01727913500,00000000200,a2f,recvmsg
0,01727916400,01727923300,00000006900,a07,poll
0,01727924400,01727924500,00000000100,a2f,recvmsg
0,01727924900,01727925100,00000000200,a2f,recvmsg
0,01727928700,01727935400,00000006700,a07,poll
0,01727936600,01727936800,00000000200,a2f,recvmsg
0,01727937100,01727937300,00000000200,a2f,recvmsg
0,01727940500,01727947400,00000006900,a07,poll
0,01727949400,01727949600,00000000200,a2f,recvmsg
0,01727949900,01727950100,00000000200,a2f,recvmsg
0,01727953900,01727960900,00000007000,a07,poll
0,01727962000,01727962100,00000000100,a2f,recvmsg
0,01727962400,01727962600,00000000200,a2f,recvmsg
0,01727965800,01727972800,00000007000,a07,poll
0,01727973900,01727974100,00000000200,a2f,recvmsg
0,01727974400,01727974600,00000000200,a2f,recvmsg
0,01727977500,01727984400,00000006900,a07,poll
0,01727985400,01727985600,00000000200,a2f,recvmsg
0,01727985900,01727986100,00000000200,a2f,recvmsg
0,01727988800,01727995500,00000006700,a07,poll
0,01727996500,01727996700,00000000200,a2f,recvmsg
0,01727997000,01727997200,00000000200,a2f,recvmsg
0,01728000500,01728007300,00000006800,a07,poll
0,01728008300,01728008500,00000000200,a2f,recvmsg
0,01728008800,01728009000,00000000200,a2f,recvmsg
0,01728010000,01728010100,00000000100,a08,lseek
0,01728012800,01728013800,00000001000,a00,read
0,01728017400,01728017500,00000000100,a08,lseek
0,01728020500,01728027100,00000006600,a07,poll
0,01728028500,01728028500,00000000000,a2f,recvmsg
0,01728028900,01728029100,00000000200,a2f,recvmsg
0,01728054300,01728061000,00000006700,a07,poll
0,01728062400,01728062600,00000000200,a2f,recvmsg
0,01728062800,01728063000,00000000200,a2f,recvmsg
0,01728066700,01728067600,00000000900,a00,read
0,01728073000,01728073100,00000000100,a08,lseek
0,01728076200,01728083100,00000006900,a07,poll
0,01728084200,01728084400,00000000200,a2f,recvmsg
0,01728084800,01728085000,00000000200,a2f,recvmsg
0,01728087600,01728094300,00000006700,a07,poll
0,01728095400,01728095500,00000000100,a2f,recvmsg
0,01728095900,01728096000,00000000100,a2f,recvmsg
0,01728098700,01728105400,00000006700,a07,poll
0,01728106500,01728106700,00000000200,a2f,recvmsg
0,01728107000,01728107200,00000000200,a2f,recvmsg
0,01728110100,01728116700,00000006600,a07,poll
0,01728117800,01728118000,00000000200,a2f,recvmsg
0,01728118300,01728118500,00000000200,a2f,recvmsg
0,01728121200,01728127800,00000006600,a07,poll
0,01728129000,01728129200,00000000200,a2f,recvmsg
0,01728129400,01728129600,00000000200,a2f,recvmsg
0,01728132300,01728139000,00000006700,a07,poll
0,01728140100,01728140300,00000000200,a2f,recvmsg
0,01728140600,01728140700,00000000100,a2f,recvmsg
0,01728143400,01728150100,00000006700,a07,poll
0,01728151100,01728151300,00000000200,a2f,recvmsg
0,01728151600,01728151800,00000000200,a2f,recvmsg
0,01728155100,01728161900,00000006800,a07,poll
0,01728163100,01728163300,00000000200,a2f,recvmsg
0,01728163500,01728163700,00000000200,a2f,recvmsg
0,01728166600,01728173100,00000006500,a07,poll
0,01728174200,01728174400,00000000200,a2f,recvmsg
0,01728174700,01728174800,00000000100,a2f,recvmsg
0,01728175200,01728175400,00000000200,a08,lseek
0,01728180200,01728186800,00000006600,a07,poll
0,01728188100,01728188200,00000000100,a2f,recvmsg
0,01728188500,01728188700,00000000200,a2f,recvmsg
0,01728193900,01728200700,00000006800,a07,poll
0,01728201800,01728202000,00000000200,a2f,recvmsg
0,01728202300,01728202500,00000000200,a2f,recvmsg
0,01728204100,01728232000,00000027900,a14,writev
0,01728232500,01728240100,00000007600,a07,poll
0,01728241400,01728241600,00000000200,a2f,recvmsg
0,01728242000,01728242200,00000000200,a2f,recvmsg
0,01728245400,01728252100,00000006700,a07,poll
0,01728253300,01728253500,00000000200,a2f,recvmsg
0,01728253800,01728254000,00000000200,a2f,recvmsg
0,01728257100,01728263800,00000006700,a07,poll
0,01728264900,01728265000,00000000100,a2f,recvmsg
0,01728265300,01728265500,00000000200,a2f,recvmsg
0,01728268400,01728275200,00000006800,a07,poll
0,01728276200,01728276400,00000000200,a2f,recvmsg
0,01728276700,01728276900,00000000200,a2f,recvmsg
0,01728280300,01728287000,00000006700,a07,poll
0,01728288200,01728288300,00000000100,a2f,recvmsg
0,01728288700,01728288800,00000000100,a2f,recvmsg
0,01728291600,01728298300,00000006700,a07,poll
0,01728299400,01728299600,00000000200,a2f,recvmsg
0,01728299900,01728300100,00000000200,a2f,recvmsg
0,01728302900,01728309600,00000006700,a07,poll
0,01728310700,01728310800,00000000100,a2f,recvmsg
0,01728311100,01728311300,00000000200,a2f,recvmsg
0,01728314200,01728321000,00000006800,a07,poll
0,01728322000,01728322200,00000000200,a2f,recvmsg
0,01728322500,01728322700,00000000200,a2f,recvmsg
0,01728325500,01728332400,00000006900,a07,poll
0,01728333500,01728333600,00000000100,a2f,recvmsg
0,01728334000,01728334100,00000000100,a2f,recvmsg
0,01728337100,01728343900,00000006800,a07,poll
0,01728345100,01728345200,00000000100,a2f,recvmsg
0,01728345600,01728345700,00000000100,a2f,recvmsg
0,01728349100,01728355800,00000006700,a07,poll
0,01728356900,01728357100,00000000200,a2f,recvmsg
0,01728357300,01728357500,00000000200,a2f,recvmsg
0,01728360400,01728367100,00000006700,a07,poll
0,01728368300,01728368400,00000000100,a2f,recvmsg
0,01728368700,01728368900,00000000200,a2f,recvmsg
0,01728371900,01728378600,00000006700,a07,poll
0,01728379700,01728379900,00000000200,a2f,recvmsg
0,01728380100,01728380300,00000000200,a2f,recvmsg
0,01728383200,01728390000,00000006800,a07,poll
0,01728391400,01728391500,00000000100,a2f,recvmsg
0,01728391800,01728392000,00000000200,a2f,recvmsg
0,01728403200,01728410000,00000006800,a07,poll
0,01728411200,01728411400,00000000200,a2f,recvmsg
0,01728411700,01728411900,00000000200,a2f,recvmsg
0,01728414900,01728421600,00000006700,a07,poll
0,01728422700,01728422900,00000000200,a2f,recvmsg
0,01728423200,01728423400,00000000200,a2f,recvmsg
0,01728426300,01728433100,00000006800,a07,poll
0,01728434100,01728434300,00000000200,a2f,recvmsg
0,01728434600,01728434800,00000000200,a2f,recvmsg
0,01728438000,01728444600,00000006600,a07,poll
0,01728445700,01728445900,00000000200,a2f,recvmsg
0,01728446200,01728446400,00000000200,a2f,recvmsg
0,01728449500,01728456300,00000006800,a07,poll
0,01728457400,01728457600,00000000200,a2f,recvmsg
0,01728457900,01728458000,00000000100,a2f,recvmsg
0,01728478900,01728506700,00000027800,a57,unlink
0,01728507800,01728511400,00000003600,a14,writev
0,01728512100,01728611100,00000099000,a07,poll
0,01728512100,01728614900,00000102800,a07,poll
0,01728626000,01728626200,00000000200,a2f,recvmsg
0,01728632000,01728632200,00000000200,a2f,recvmsg
0,01728632500,01728632700,00000000200,a2f,recvmsg
0,01728632900,01728633000,00000000100,a2f,recvmsg
0,01728638200,01728638300,00000000100,a2f,recvmsg
0,01728638400,01728638600,00000000200,a2f,recvmsg
0,01728639400,01728644100,00000004700,a07,poll
0,01728653100,01728653400,00000000300,a2f,recvmsg
0,01728682000,01728691600,00000009600,a07,poll
0,01728694400,01728694600,00000000200,a2f,recvmsg
0,01728695400,01728695500,00000000100,a2f,recvmsg
0,01728695700,01728695900,00000000200,a2f,recvmsg
0,01728696900,01728697100,00000000200,a2f,recvmsg
0,01728697300,01728697400,00000000100,a2f,recvmsg
0,01728697700,01728699200,00000001500,a07,poll
0,01728707700,01728708000,00000000300,a2f,recvmsg
0,01728738200,01728742600,00000004400,a07,poll
0,01728756200,01728756400,00000000200,a2f,recvmsg
0,01728773200,01728775200,00000002000,a07,poll
0,01728777900,01728778100,00000000200,a2f,recvmsg
0,01728779000,01728779200,00000000200,a2f,recvmsg
0,01728779400,01728779500,00000000100,a2f,recvmsg
0,01728780700,01728781000,00000000300,a2f,recvmsg
0,01728781200,01728781400,00000000200,a2f,recvmsg
0,01728781600,01728783100,00000001500,a07,poll
0,01728784800,01728785900,00000001100,a07,poll
0,01728787500,01728807500,00000020000,a07,poll
0,01728807600,01728808800,00000001200,a2f,recvmsg
0,01728787500,01728810100,00000022600,a07,poll
0,01728811800,01728812000,00000000200,a2f,recvmsg
0,01728812500,01728812700,00000000200,a2f,recvmsg
0,01728812900,01728813100,00000000200,a2f,recvmsg
0,01728813700,01728813800,00000000100,a2f,recvmsg
0,01728814000,01728814200,00000000200,a2f,recvmsg
0,01728814400,01728815800,00000001400,a07,poll
0,01728818800,01728866300,00000047500,a07,poll
0,01728866400,01728867500,00000001100,a2f,recvmsg
0,01728818800,01728868600,00000049800,a07,poll
0,01728870300,01728870500,00000000200,a2f,recvmsg
0,01728871000,01728871200,00000000200,a2f,recvmsg
0,01728871400,01728871500,00000000100,a2f,recvmsg
0,01728872100,01728872100,00000000000,a2f,recvmsg
0,01728872300,01728872500,00000000200,a2f,recvmsg
0,01728872700,01728874100,00000001400,a07,poll
0,01728876700,01728923100,00000046400,a07,poll
0,01728876700,01728925400,00000048700,a07,poll
0,01728927200,01728927300,00000000100,a2f,recvmsg
0,01728927800,01728928000,00000000200,a2f,recvmsg
0,01728928200,01728928400,00000000200,a2f,recvmsg
0,01728928900,01728929100,00000000200,a2f,recvmsg
0,01728929200,01728929400,00000000200,a2f,recvmsg
0,01728929600,01728931000,00000001400,a07,poll
0,01728933600,01728980900,00000047300,a07,poll
0,01728981000,01728982100,00000001100,a2f,recvmsg
0,01728933600,01728982900,00000049300,a07,poll
0,01728986100,01729026900,00000040800,a07,poll
0,01729027000,01729028200,00000001200,a2f,recvmsg
0,01728986100,01729029200,00000043100,a07,poll
0,01729031700,01729072600,00000040900,a07,poll
0,01729072700,01729073800,00000001100,a2f,recvmsg
0,01729031700,01729074800,00000043100,a07,poll
0,01729077100,01729117700,00000040600,a07,poll
0,01729117900,01729119100,00000001200,a2f,recvmsg
0,01729077100,01729119900,00000042800,a07,poll
0,01729122700,01729163400,00000040700,a07,poll
0,01729163500,01729164700,00000001200,a2f,recvmsg
0,01729122700,01729165600,00000042900,a07,poll
0,01729169200,01729208900,00000039700,a07,poll
0,01729169200,01729211200,00000042000,a07,poll
0,01729214000,01729265400,00000051400,a07,poll
0,01729214000,01729267600,00000053600,a07,poll
0,01729270500,01729286000,00000015500,a07,poll
0,01729286200,01729287200,00000001000,a2f,recvmsg
0,01729270500,01729288200,00000017700,a07,poll
0,01729290900,01729303300,00000012400,a07,poll
0,01729303400,01729305000,00000001600,a2f,recvmsg
0,01729290900,01729305900,00000015000,a07,poll
0,01729308500,01729319300,00000010800,a07,poll
0,01729319500,01729320500,00000001000,a2f,recvmsg
0,01729308500,01729321400,00000012900,a07,poll
0,01729324100,01729335800,00000011700,a07,poll
0,01729335900,01729337000,00000001100,a2f,recvmsg
0,01729324100,01729337900,00000013800,a07,poll
0,01729340400,01729351200,00000010800,a07,poll
0,01729351300,01729352300,00000001000,a2f,recvmsg
0,01729340400,01729353200,00000012800,a07,poll
0,01729355900,01729357700,00000001800,a07,poll
0,01729360500,01729360600,00000000100,a2f,recvmsg
0,01729361300,01729361500,00000000200,a2f,recvmsg
0,01729355900,01729380200,00000024300,a07,poll
0,01729380500,01729382100,00000001600,a2f,recvmsg
0,01729384500,01729385700,00000001200,a2d,recvfrom
0,01729389800,01729390100,00000000300,a2f,recvmsg
0,01729390700,01729390800,00000000100,a2f,recvmsg
0,01729355900,01729409000,00000053100,a07,poll
0,01729409500,01729411200,00000001700,a2f,recvmsg
0,01729412600,01729413600,00000001000,a2d,recvfrom
0,01729418200,01729418400,00000000200,a2f,recvmsg
0,01729418900,01729419100,00000000200,a2f,recvmsg
0,01729459800,01729460100,00000000300,a2f,recvmsg
0,01729462400,01729462600,00000000200,a2f,recvmsg
0,01729510400,01729510700,00000000300,a2f,recvmsg
0,01729513000,01729513200,00000000200,a2f,recvmsg
0,01729526700,01729552700,00000026000,a07,poll
0,01729553500,01729555100,00000001600,a2f,recvmsg
0,01729561500,01729562300,00000000800,a2d,recvfrom
0,01729563200,01729563400,00000000200,a2f,recvmsg
0,01729564100,01729564300,00000000200,a2f,recvmsg
0,01729595000,01729595300,00000000300,a2f,recvmsg
0,01729597500,01729597700,00000000200,a2f,recvmsg
0,01729600600,01729603000,00000002400,a07,poll
0,01729605700,01729605900,00000000200,a2f,recvmsg
0,01729606500,01729606700,00000000200,a2f,recvmsg
0,01730357800,01730367400,00000009600,a02,open
0,01730379200,01730382400,00000003200,a00,read
0,01730435900,01730436800,00000000900,a00,read
0,01730488400,01730489100,00000000700,a00,read
0,01730537300,01730538200,00000000900,a00,read
0,01730587900,01730588600,00000000700,a00,read
0,01730637700,01730638500,00000000800,a00,read
0,01730686700,01730687500,00000000800,a00,read
0,01730736000,01730736700,00000000700,a00,read
0,01730787100,01730787900,00000000800,a00,read
0,01730839700,01730840500,00000000800,a00,read
0,01730890100,01730890800,00000000700,a00,read
0,01730920300,01730922600,00000002300,a02,open
0,01730926900,01730928000,00000001100,a00,read
0,01730983400,01730984300,00000000900,a00,read
0,01731068100,01731068900,00000000800,a00,read
0,01731083400,01731084700,00000001300,aca,futex
0,01731146100,01731146800,00000000700,a00,read
0,01731224800,01731225600,00000000800,a00,read
0,01731304700,01731305500,00000000800,a00,read
0,01731382500,01731383400,00000000900,a00,read
0,01731468100,01731468900,00000000800,a00,read
0,01731535200,01731535900,00000000700,a00,read
0,01731593000,01731593800,00000000800,a00,read
0,01730354400,01758543000,00028188600,60e,page_fault
0,01758548500,01758549200,00000000700,a00,read
0,01758656300,01758656800,00000000500,a00,read
0,01758805600,01758806500,00000000900,a00,read
0,01758936200,01758937000,00000000800,a00,read
0,01758994200,01758994800,00000000600,a00,read
0,01759050200,01759051000,00000000800,a00,read
0,01759120800,01759121500,00000000700,a00,read
0,01759174100,01759174900,00000000800,a00,read
0,01759293800,01759298400,00000004600,a0c,brk
0,01759312300,01759313200,00000000900,a00,read
0,01759427400,01759428100,00000000700,a00,read
0,01759585900,01759586700,00000000800,a00,read
0,01759703300,01759703900,00000000600,a00,read
0,01759841300,01759847800,00000006500,60e,page_fault
0,01759854900,01759855700,00000000800,a00,read
0,01759972300,01759973100,00000000800,a00,read
0,01760133500,01760134200,00000000700,a00,read
0,01760139200,01760140100,00000000900,a0c,brk
0,01760254400,01760255200,00000000800,a00,read
0,01760372800,01760373600,00000000800,a00,read
0,01760514500,01760515200,00000000700,a00,read
0,01760646100,01760646800,00000000700,a00,read
0,01760739200,01760739900,00000000700,a00,read
0,01760851100,01760851800,00000000700,a00,read
0,01760975100,01760975900,00000000800,a00,read
0,01761086600,01761087100,00000000500,a0c,brk
0,01761109800,01761110500,00000000700,a00,read
0,01761279600,01761280300,00000000700,a00,read
0,01761429800,01761430500,00000000700,a00,read
0,01761540700,01761541400,00000000700,a00,read
0,01761709700,01761710600,00000000900,a00,read
0,01761786900,01761787600,00000000700,a00,read
0,01761868600,01761869300,00000000700,a00,read
0,01761935700,01761936200,00000000500,a0c,brk
0,01761949700,01761950500,00000000800,a00,read
0,01762022900,01762023600,00000000700,a00,read
0,01762126700,01762127400,00000000700,a00,read
0,01762228900,01762229700,00000000800,a00,read
0,01762318600,01762319300,00000000700,a00,read
0,01762399400,01762400100,00000000700,a00,read
0,01762500600,01762501200,00000000600,a00,read
0,01762581400,01762581800,00000000400,a0c,brk
0,01762584200,01762584900,00000000700,a00,read
0,01762692800,01762693500,00000000700,a00,read
0,01762785300,01762785900,00000000600,a00,read
0,01762904400,01762904900,00000000500,a00,read
0,01763017600,01763018300,00000000700,a00,read
0,01763120800,01763121400,00000000600,a00,read
0,01763220700,01763221100,00000000400,a0c,brk
0,01763581600,01763585200,00000003600,a57,unlink
0,01763608100,01763608700,00000000600,a48,fcntl
0,01763655600,01763671000,00000015400,a01,write
0,01763689000,01763691500,00000002500,a01,write
0,01763707800,01763710200,00000002400,a01,write
0,01716781300,01763960900,00047179600,a17,select
0,01763983700,01763988100,00000004400,a14,writev
0,01763988500,01763988700,00000000200,a2f,recvmsg
0,01763993800,01764029500,00000035700,a17,select
0,01764034000,01764034200,00000000200,a2f,recvmsg
0,01764034800,01764045900,00000011100,a17,select
0,01764049700,01764049800,00000000100,a2f,recvmsg
0,01764050300,01764066000,00000015700,a17,select
0,01764069900,01764070100,00000000200,a2f,recvmsg
0,01764070600,01764086800,00000016200,a17,select
0,01764090900,01764091100,00000000200,a2f,recvmsg
0,01764091600,01764107100,00000015500,a17,select
0,01764110700,01764110900,00000000200,a2f,recvmsg
0,01764111400,01764141000,00000029600,a17,select
0,01764144800,01764144900,00000000100,a2f,recvmsg
0,01764145500,01764155200,00000009700,a17,select
0,01764158900,01764159000,00000000100,a2f,recvmsg
0,01764159500,01764167100,00000007600,a17,select
0,01764170600,01764170800,00000000200,a2f,recvmsg
0,01764171300,01764179200,00000007900,a17,select
0,01764182700,01764182800,00000000100,a2f,recvmsg
0,01764183300,01764190800,00000007500,a17,select
0,01764194500,01764194600,00000000100,a2f,recvmsg
0,01764195000,01764202700,00000007700,a17,select
0,01764206400,01764206500,00000000100,a2f,recvmsg
0,01764207000,01764215200,00000008200,a17,select
0,01764219100,01764219300,00000000200,a2f,recvmsg
0,01764219700,01764226800,00000007100,a17,select
0,01764230300,01764230400,00000000100,a2f,recvmsg
0,01764230900,01764240100,00000009200,a17,select
0,01764244000,01764244100,00000000100,a2f,recvmsg
0,01764244600,01764252000,00000007400,a17,select
0,01764255800,01764256000,00000000200,a2f,recvmsg
0,01764256600,01764263700,00000007100,a17,select
0,01764267300,01764267500,00000000200,a2f,recvmsg
0,01764268000,01764275400,00000007400,a17,select
0,01764279000,01764279100,00000000100,a2f,recvmsg
0,01764279600,01764286800,00000007200,a17,select
0,01764290400,01764290600,00000000200,a2f,recvmsg
0,01764291100,01764299400,00000008300,a17,select
0,01764303000,01764303100,00000000100,a2f,recvmsg
0,01764303600,01764310900,00000007300,a17,select
0,01764314500,01764314700,00000000200,a2f,recvmsg
0,01764315100,01764322100,00000007000,a17,select
0,01764325900,01764326100,00000000200,a2f,recvmsg
0,01764326500,01764335400,00000008900,a17,select
0,01764338900,01764339100,00000000200,a2f,recvmsg
0,01764339500,01764347300,00000007800,a17,select
0,01764350900,01764351100,00000000200,a2f,recvmsg
0,01764351600,01764358400,00000006800,a17,select
0,01764362100,01764362200,00000000100,a2f,recvmsg
0,01764362700,01764369700,00000007000,a17,select
0,01764373400,01764373500,00000000100,a2f,recvmsg
0,01764374000,01764381200,00000007200,a17,select
0,01764384700,01764384900,00000000200,a2f,recvmsg
0,01764385300,01764392300,00000007000,a17,select
0,01764395800,01764396000,00000000200,a2f,recvmsg
0,01764396400,01764404000,00000007600,a17,select
0,01764407400,01764407600,00000000200,a2f,recvmsg
0,01764408000,01764415600,00000007600,a17,select
0,01764419300,01764419400,00000000100,a2f,recvmsg
0,01764420000,01764427800,00000007800,a17,select
0,01764431800,01764431900,00000000100,a2f,recvmsg
0,01764432500,01764440100,00000007600,a17,select
0,01764443500,01764443700,00000000200,a2f,recvmsg
0,01764444100,01764451600,00000007500,a17,select
0,01764455500,01764455700,00000000200,a2f,recvmsg
0,01764456200,01764465800,00000009600,a17,select
0,01764469400,01764469600,00000000200,a2f,recvmsg
0,01764470100,01764477300,00000007200,a17,select
0,01764480900,01764481100,00000000200,a2f,recvmsg
0,01764481600,01764488800,00000007200,a17,select
0,01764492400,01764492500,00000000100,a2f,recvmsg
0,01764493000,01764501300,00000008300,a17,select
0,01764505100,01764505200,00000000100,a2f,recvmsg
0,01764505800,01764513200,00000007400,a17,select
0,01764516900,01764517000,00000000100,a2f,recvmsg
0,01764517600,01764525300,00000007700,a17,select
0,01764529000,01764529100,00000000100,a2f,recvmsg
0,01764529500,01764537100,00000007600,a17,select
0,01764540900,01764541100,00000000200,a2f,recvmsg
0,01764541600,01764548900,00000007300,a17,select
0,01764552400,01764552600,00000000200,a2f,recvmsg
0,01764553100,01764560200,00000007100,a17,select
0,01764563700,01764563900,00000000200,a2f,recvmsg
0,01764564400,01764571800,00000007400,a17,select
0,01764575400,01764575600,00000000200,a2f,recvmsg
0,01764576100,01764592200,00000016100,a17,select
0,01764595900,01764595900,00000000000,a2f,recvmsg
0,01764596500,01764627100,00000030600,a17,select
0,01764630600,01764630800,00000000200,a2f,recvmsg
0,01764631300,01764649100,00000017800,a17,select
0,01764652800,01764652900,00000000100,a2f,recvmsg
0,01764653400,01764660500,00000007100,a17,select
0,01764664000,01764664200,00000000200,a2f,recvmsg
0,01764664600,01764671400,00000006800,a17,select
0,01764674900,01764675000,00000000100,a2f,recvmsg
0,01764675600,01764682500,00000006900,a17,select
0,01764686000,01764686200,00000000200,a2f,recvmsg
0,01764686700,01764693500,00000006800,a17,select
0,01764697100,01764697200,00000000100,a2f,recvmsg
0,01764697700,01764704700,00000007000,a17,select
0,01764708300,01764708400,00000000100,a2f,recvmsg
0,01764708900,01764715700,00000006800,a17,select
0,01764719400,01764719400,00000000000,a2f,recvmsg
0,01764720000,01764727400,00000007400,a17,select
0,01764731000,01764731200,00000000200,a2f,recvmsg
0,01764731700,01764738600,00000006900,a17,select
0,01764742200,01764742400,00000000200,a2f,recvmsg
0,01764742900,01764751600,00000008700,a17,select
0,01764755300,01764755500,00000000200,a2f,recvmsg
0,01764755900,01764765000,00000009100,a17,select
0,01764768700,01764768800,00000000100,a2f,recvmsg
0,01764769300,01764776900,00000007600,a17,select
0,01764780400,01764780500,00000000100,a2f,recvmsg
0,01764781100,01764788300,00000007200,a17,select
0,01764792000,01764792200,00000000200,a2f,recvmsg
0,01764792700,01764799800,00000007100,a17,select
0,01764803300,01764803500,00000000200,a2f,recvmsg
0,01764804000,01764811400,00000007400,a17,select
0,01764815000,01764815200,00000000200,a2f,recvmsg
0,01764815700,01764823300,00000007600,a17,select
0,01764827000,01764827200,00000000200,a2f,recvmsg
0,01764827700,01764834900,00000007200,a17,select
0,01764838500,01764838700,00000000200,a2f,recvmsg
0,01764839100,01764846200,00000007100,a17,select
0,01764849700,01764849900,00000000200,a2f,recvmsg
0,01764850400,01764857600,00000007200,a17,select
0,01764861200,01764861400,00000000200,a2f,recvmsg
0,01764861900,01764869100,00000007200,a17,select
0,01764872700,01764872900,00000000200,a2f,recvmsg
0,01764873300,01764880400,00000007100,a17,select
0,01764883900,01764884100,00000000200,a2f,recvmsg
0,01764884600,01764892200,00000007600,a17,select
0,01764895900,01764896100,00000000200,a2f,recvmsg
0,01764896500,01764903700,00000007200,a17,select
0,01764907300,01764907500,00000000200,a2f,recvmsg
0,01764907900,01764915100,00000007200,a17,select
0,01764918500,01764918700,00000000200,a2f,recvmsg
0,01764919100,01764926500,00000007400,a17,select
0,01764930100,01764930300,00000000200,a2f,recvmsg
0,01764930700,01764943200,00000012500,a17,select
0,01764946800,01764946900,00000000100,a2f,recvmsg
0,01764947400,01764954900,00000007500,a17,select
0,01764958400,01764958600,00000000200,a2f,recvmsg
0,01764959000,01764966300,00000007300,a17,select
0,01764969900,01764970100,00000000200,a2f,recvmsg
0,01764970500,01764977800,00000007300,a17,select
0,01764981400,01764981600,00000000200,a2f,recvmsg
0,01764982000,01764989200,00000007200,a17,select
0,01764992700,01764992900,00000000200,a2f,recvmsg
0,01764993300,01765049500,00000056200,a17,select
0,01765050400,01765051600,00000001200,a2f,recvmsg
0,01765457800,01765458500,00000000700,a2f,recvmsg
0,01765755000,01765757000,00000002000,a2f,recvmsg
0,01765871300,01765871500,00000000200,a2f,recvmsg
0,01765872100,01765872600,00000000500,a14,writev
0,01765890800,01765893200,00000002400,a14,writev
0,01765893500,01765894800,00000001300,a14,writev
0,01765895300,01765895500,00000000200,a2f,recvmsg
0,01731664000,01765903600,00034239600,a07,poll
0,01765909500,01765912200,00000002700,a2f,recvmsg
0,01765917500,01765917600,00000000100,a2f,recvmsg
0,01765921200,01765921400,00000000200,a2f,recvmsg
0,01765921700,01765921800,00000000100,a2f,recvmsg
0,01765926300,01765926500,00000000200,a2f,recvmsg
0,01765926700,01765926900,00000000200,a2f,recvmsg
0,01765927800,01765931800,00000004000,a07,poll
0,01765935900,01765941600,00000005700,a2f,recvmsg
0,01765952700,01765952900,00000000200,a2f,recvmsg
0,01765978700,01765983400,00000004700,a07,poll
0,01765989200,01765996000,00000006800,a2f,recvmsg
0,01766008200,01766008400,00000000200,a2f,recvmsg
0,01766031500,01766035800,00000004300,a07,poll
0,01766041700,01766047600,00000005900,a2f,recvmsg
0,01766060000,01766060200,00000000200,a2f,recvmsg
0,01765896200,01766088100,00000191900,a17,select
0,01766104800,01766106400,00000001600,a14,writev
0,01766106800,01766107000,00000000200,a2f,recvmsg
0,01766121000,01766121900,00000000900,a14,writev
0,01766122200,01766122400,00000000200,a2f,recvmsg
0,01766138800,01766139900,00000001100,a14,writev
0,01766140200,01766140400,00000000200,a2f,recvmsg
0,01766155200,01766155400,00000000200,a2f,recvmsg
0,01766082700,01766160000,00000077300,a07,poll
0,01766163700,01766163900,00000000200,a2f,recvmsg
0,01766165300,01766165500,00000000200,a2f,recvmsg
0,01766165700,01766165900,00000000200,a2f,recvmsg
0,01766167200,01766167400,00000000200,a2f,recvmsg
0,01766167600,01766167800,00000000200,a2f,recvmsg
0,01766168200,01766169900,00000001700,a07,poll
0,01766170500,01766171500,00000001000,a2f,recvmsg
0,01766177000,01766178000,00000001000,a2d,recvfrom
0,01766178900,01766179100,00000000200,a2f,recvmsg
0,01766179800,01766180000,00000000200,a2f,recvmsg
0,01766221300,01766221600,00000000300,a2f,recvmsg
0,01766223800,01766224000,00000000200,a2f,recvmsg
0,01766226100,01766228000,00000001900,a07,poll
0,01766228900,01766229900,00000001000,a2f,recvmsg
0,01766235700,01766236400,00000000700,a2d,recvfrom
0,01766237500,01766237500,00000000000,a2f,recvmsg
0,01766238200,01766238400,00000000200,a2f,recvmsg
0,01766268500,01766268800,00000000300,a2f,recvmsg
0,01766270700,01766270900,00000000200,a2f,recvmsg
0,01766274600,01766714600,00000440000,a07,poll
0,01766732800,01766738800,00000006000,a2e,sendmsg
0,01766743400,01766840800,00000097400,a07,poll
0,01766842900,01766843600,00000000700,a00,read
0,01766860300,01766862100,00000001800,a2f,recvmsg
0,01766751200,01766939200,00000188000,aca,futex
0,01766950000,01766952800,00000002800,a2e,sendmsg
0,01766955600,01766955700,00000000100,a00,read
0,01766958100,01767102500,00000144400,a07,poll
0,01767108000,01767109600,00000001600,a2e,sendmsg
0,01767112100,01767112200,00000000100,a00,read
0,01767130100,01767163700,00000033600,a07,poll
0,01767167500,01767168400,00000000900,a2f,recvmsg
0,01767210200,01767216500,00000006300,a07,poll
0,01767219200,01767221500,00000002300,a2f,recvmsg
0,01767228100,01767229100,00000001000,a2f,recvmsg
0,01767240100,01767333300,00000093200,a07,poll
0,01767338800,01767342200,00000003400,a2e,sendmsg
0,01767345200,01767345300,00000000100,a00,read
0,01767329900,01767365800,00000035900,60e,page_fault
0,01767477400,01767478300,00000000900,a2f,recvmsg
0,01767480300,01767480500,00000000200,a00,read
0,01766155800,01769245600,00003089800,a17,select
0,01769266000,01769266100,00000000100,a2f,recvmsg
0,01769269300,01769277700,00000008400,a17,select
0,01769282300,01769282400,00000000100,a2f,recvmsg
0,01769283100,01769344800,00000061700,a17,select
0,01769348500,01769348700,00000000200,a2f,recvmsg
0,01769349400,01779954200,00010604800,a17,select
0,01779974300,01779974500,00000000200,a2f,recvmsg
0,01779977900,01779996400,00000018500,a17,select
0,01780002100,01780002300,00000000200,a2f,recvmsg
0,01780003000,01780019500,00000016500,a17,select
0,01780025000,01780025200,00000000200,a2f,recvmsg
0,01780025800,01780042200,00000016400,a17,select
0,01780048300,01780048400,00000000100,a2f,recvmsg
0,01780049000,01780065600,00000016600,a17,select
0,01780071400,01780071500,00000000100,a2f,recvmsg
0,01780072100,01780080000,00000007900,a17,select
0,01780084300,01780084400,00000000100,a2f,recvmsg
0,01780084900,01780102700,00000017800,a17,select
0,01780106400,01780106600,00000000200,a2f,recvmsg
0,01780107100,01780116500,00000009400,a17,select
0,01780120300,01780120400,00000000100,a2f,recvmsg
0,01780120900,01780128300,00000007400,a17,select
0,01780132000,01780132200,00000000200,a2f,recvmsg
0,01780132600,01780140100,00000007500,a17,select
0,01780143600,01780143600,00000000000,a2f,recvmsg
0,01780144200,01780152700,00000008500,a17,select
0,01780156400,01780156600,00000000200,a2f,recvmsg
0,01780157000,01780164700,00000007700,a17,select
0,01780168300,01780168400,00000000100,a2f,recvmsg
0,01780169000,01780176400,00000007400,a17,select
0,01780180100,01780180300,00000000200,a2f,recvmsg
0,01780180800,01780187800,00000007000,a17,select
0,01780191200,01780191400,00000000200,a2f,recvmsg
0,01780191900,01780200400,00000008500,a17,select
0,01780204200,01780204300,00000000100,a2f,recvmsg
0,01780204700,01780212600,00000007900,a17,select
0,01780216400,01780216600,00000000200,a2f,recvmsg
0,01780217100,01780224400,00000007300,a17,select
0,01780228100,01780228300,00000000200,a2f,recvmsg
0,01780228800,01780236200,00000007400,a17,select
0,01780239800,01780240000,00000000200,a2f,recvmsg
0,01780240500,01780247600,00000007100,a17,select
0,01780251200,01780251300,00000000100,a2f,recvmsg
0,01780251900,01780259500,00000007600,a17,select
0,01780263200,01780263300,00000000100,a2f,recvmsg
0,01780263800,01780271100,00000007300,a17,select
0,01780274700,01780274900,00000000200,a2f,recvmsg
0,01780275400,01780282300,00000006900,a17,select
0,01780286100,01780286200,00000000100,a2f,recvmsg
0,01780286700,01780295500,00000008800,a17,select
0,01780299000,01780299200,00000000200,a2f,recvmsg
0,01780299600,01780306500,00000006900,a17,select
0,01780310200,01780310400,00000000200,a2f,recvmsg
0,01780310800,01780317700,00000006900,a17,select
0,01780321200,01780321400,00000000200,a2f,recvmsg
0,01780321900,01780328800,00000006900,a17,select
0,01780332500,01780332700,00000000200,a2f,recvmsg
0,01780333200,01780340600,00000007400,a17,select
0,01780344100,01780344300,00000000200,a2f,recvmsg
0,01780344800,01780352700,00000007900,a17,select
0,01780356300,01780356400,00000000100,a2f,recvmsg
0,01780356900,01780364500,00000007600,a17,select
0,01780368000,01780368100,00000000100,a2f,recvmsg
0,01780368700,01780376200,00000007500,a17,select
0,01780379800,01780379900,00000000100,a2f,recvmsg
0,01780380500,01780388400,00000007900,a17,select
0,01780392200,01780392400,00000000200,a2f,recvmsg
0,01780392800,01780400700,00000007900,a17,select
0,01780404300,01780404500,00000000200,a2f,recvmsg
0,01780405100,01780412700,00000007600,a17,select
0,01780416400,01780416600,00000000200,a2f,recvmsg
0,01780417100,01780426700,00000009600,a17,select
0,01780430400,01780430500,00000000100,a2f,recvmsg
0,01780431000,01780438300,00000007300,a17,select
0,01780441900,01780442100,00000000200,a2f,recvmsg
0,01780442600,01780449700,00000007100,a17,select
0,01780453500,01780453600,00000000100,a2f,recvmsg
0,01780454100,01780462200,00000008100,a17,select
0,01780465900,01780466100,00000000200,a2f,recvmsg
0,01780466600,01780474200,00000007600,a17,select
0,01780477900,01780478000,00000000100,a2f,recvmsg
0,01780478500,01780486400,00000007900,a17,select
0,01780490200,01780490400,00000000200,a2f,recvmsg
0,01780490900,01780498600,00000007700,a17,select
0,01780502300,01780502500,00000000200,a2f,recvmsg
0,01780502900,01780510300,00000007400,a17,select
0,01780514000,01780514100,00000000100,a2f,recvmsg
0,01780514600,01780521700,00000007100,a17,select
0,01780525300,01780525500,00000000200,a2f,recvmsg
0,01780525900,01780533500,00000007600,a17,select
0,01780537200,01780537300,00000000100,a2f,recvmsg
0,01780537900,01780554000,00000016100,a17,select
0,01780557600,01780557800,00000000200,a2f,recvmsg
0,01780558200,01780588600,00000030400,a17,select
0,01780592200,01780592300,00000000100,a2f,recvmsg
0,01780592900,01780610700,00000017800,a17,select
0,01780614400,01780614500,00000000100,a2f,recvmsg
0,01780615000,01780622200,00000007200,a17,select
0,01780625700,01780625800,00000000100,a2f,recvmsg
0,01780626300,01780633300,00000007000,a17,select
0,01780636900,01780637100,00000000200,a2f,recvmsg
0,01780637600,01780644600,00000007000,a17,select
0,01780648000,01780648200,00000000200,a2f,recvmsg
0,01780648700,01780655600,00000006900,a17,select
0,01780659200,01780659300,00000000100,a2f,recvmsg
0,01780659900,01780666600,00000006700,a17,select
0,01780670200,01780670400,00000000200,a2f,recvmsg
0,01780670900,01780677700,00000006800,a17,select
0,01780681300,01780681500,00000000200,a2f,recvmsg
0,01780682000,01780689600,00000007600,a17,select
0,01780693200,01780693400,00000000200,a2f,recvmsg
0,01780694000,01780700900,00000006900,a17,select
0,01780704400,01780704600,00000000200,a2f,recvmsg
0,01780705100,01780713800,00000008700,a17,select
0,01780717400,01780717500,00000000100,a2f,recvmsg
0,01780718000,01780727200,00000009200,a17,select
0,01780730900,01780731100,00000000200,a2f,recvmsg
0,01780731600,01780739200,00000007600,a17,select
0,01780742600,01780742800,00000000200,a2f,recvmsg
0,01780743300,01780750600,00000007300,a17,select
0,01780754100,01780754300,00000000200,a2f,recvmsg
0,01780754800,01780762000,00000007200,a17,select
0,01780765400,01780765600,00000000200,a2f,recvmsg
0,01780766100,01780773300,00000007200,a17,select
0,01780777000,01780777200,00000000200,a2f,recvmsg
0,01780777700,01780785400,00000007700,a17,select
0,01780788900,01780789100,00000000200,a2f,recvmsg
0,01780789600,01780796900,00000007300,a17,select
0,01780800400,01780800600,00000000200,a2f,recvmsg
0,01780801000,01780808300,00000007300,a17,select
0,01780811800,01780812000,00000000200,a2f,recvmsg
0,01780812400,01780819700,00000007300,a17,select
0,01780823300,01780823500,00000000200,a2f,recvmsg
0,01780823900,01780831200,00000007300,a17,select
0,01780834800,01780834900,00000000100,a2f,recvmsg
0,01780835400,01780842700,00000007300,a17,select
0,01780846200,01780846400,00000000200,a2f,recvmsg
0,01780846800,01780854700,00000007900,a17,select
0,01780858300,01780858400,00000000100,a2f,recvmsg
0,01780859000,01780866200,00000007200,a17,select
0,01780869800,01780869900,00000000100,a2f,recvmsg
0,01780870500,01780878000,00000007500,a17,select
0,01780881500,01780881700,00000000200,a2f,recvmsg
0,01780882200,01780889500,00000007300,a17,select
0,01780893100,01780893200,00000000100,a2f,recvmsg
0,01780893800,01780906300,00000012500,a17,select
0,01780909900,01780910100,00000000200,a2f,recvmsg
0,01780910600,01780918200,00000007600,a17,select
0,01780921800,01780922000,00000000200,a2f,recvmsg
0,01780922500,01780929800,00000007300,a17,select
0,01780933300,01780933500,00000000200,a2f,recvmsg
0,01780934000,01780941500,00000007500,a17,select
0,01780945000,01780945200,00000000200,a2f,recvmsg
0,01780945600,01780953000,00000007400,a17,select
0,01780956500,01780956700,00000000200,a2f,recvmsg
0,01780957200,01781008400,00000051200,a17,select
0,01781009300,01781010600,00000001300,a2f,recvmsg
0,01781413100,01781413900,00000000800,a2f,recvmsg
0,01781712600,01781714600,00000002000,a2f,recvmsg
0,01781831200,01781831400,00000000200,a2f,recvmsg
0,01781831900,01781832300,00000000400,a14,writev
0,01781849300,01781851800,00000002500,a14,writev
0,01781852000,01781853600,00000001600,a14,writev
0,01781854000,01781854200,00000000200,a2f,recvmsg
0,01781867600,01781868700,00000001100,a14,writev
0,01781868900,01781869100,00000000200,a2f,recvmsg
0,01767575300,01781876700,00014301400,a07,poll
0,01781882000,01781884500,00000002500,a2f,recvmsg
0,01781889500,01781889700,00000000200,a2f,recvmsg
0,01781892900,01781893100,00000000200,a2f,recvmsg
0,01781893300,01781893500,00000000200,a2f,recvmsg
0,01781897700,01781897900,00000000200,a2f,recvmsg
0,01781898100,01781898200,00000000100,a2f,recvmsg
0,01781898900,01781903000,00000004100,a07,poll
0,01781907000,01781912400,00000005400,a2f,recvmsg
0,01781923400,01781923600,00000000200,a2f,recvmsg
0,01781950800,01781955000,00000004200,a07,poll
0,01781960900,01781966400,00000005500,a2f,recvmsg
0,01781978800,01781979000,00000000200,a2f,recvmsg
0,01781869600,01782006700,00000137100,a17,select
0,01782021300,01782022700,00000001400,a14,writev
0,01782023100,01782023300,00000000200,a2f,recvmsg
0,01782001300,01782038200,00000036900,a07,poll
0,01782043900,01782044200,00000000300,a2d,recvfrom
0,01782045900,01782047400,00000001500,a14,writev
0,01782044500,01782048100,00000003600,a07,poll
0,01782048400,01782049400,00000001000,a2d,recvfrom
0,01782050500,01782050700,00000000200,a2f,recvmsg
0,01782051200,01782051400,00000000200,a2f,recvmsg
0,01782091100,01782091300,00000000200,a2f,recvmsg
0,01782093600,01782093700,00000000100,a2f,recvmsg
0,01782098400,01782098600,00000000200,a2f,recvmsg
0,01782115800,01782116000,00000000200,a2f,recvmsg
0,01782095700,01782767900,00000672200,a07,poll
0,01782789300,01782794100,00000004800,a2e,sendmsg
0,01782800000,01782800200,00000000200,a00,read
0,01782810400,01782862000,00000051600,a07,poll
0,01782863600,01782864400,00000000800,a00,read
0,01782879300,01782880400,00000001100,a2f,recvmsg
0,01782959400,01782964000,00000004600,a07,poll
0,01783116100,01783117000,00000000900,a2f,recvmsg
0,01783123200,01783123400,00000000200,a2f,recvmsg
0,01783123900,01783128300,00000004400,a07,poll
0,01783137200,01783141200,00000004000,a2e,sendmsg
0,01783156800,01783181900,00000025100,a07,poll
0,01783182500,01783182600,00000000100,a00,read
0,01783190100,01783191200,00000001100,a2f,recvmsg
0,01783254400,01783257000,00000002600,a07,poll
0,01783570300,01783571300,00000001000,a2f,recvmsg
0,01664070800,01783941900,00119871100,a4a,fsync
0,01784001400,01784008100,00000006700,a09,mmap
0,01783573700,01784074200,00000500500,a07,poll
0,01784077700,01784079500,00000001800,aca,futex
0,01784082500,01784083500,00000001000,aca,futex
0,01784085300,01784086100,00000000800,aca,futex
0,01784091300,01784096900,00000005600,a2e,sendmsg
0,01784100500,01784100700,00000000200,a00,read
0,01784104800,01784148700,00000043900,a07,poll
0,01784150000,01784150900,00000000900,aca,futex
0,01784152500,01784153300,00000000800,aca,futex
0,01784154500,01784155300,00000000800,aca,futex
0,01784157300,01784159700,00000002400,a2e,sendmsg
0,01784312800,01784322800,00000010000,a01,write
0,01784178400,01784355700,00000177300,a07,poll
0,01784356900,01784357300,00000000400,a00,read
0,01784437600,01784440300,00000002700,a01,write
0,01784449900,01784450800,00000000900,a2f,recvmsg
0,01784453000,01784453200,00000000200,a00,read
0,01784465600,01784488200,00000022600,aca,futex
0,01784495700,01784498300,00000002600,aca,futex
0,01784533200,01784546500,00000013300,a07,poll
0,01784550200,01784553900,00000003700,a2e,sendmsg
0,01784556300,01784556500,00000000200,a00,read
0,01784563000,01784612100,00000049100,a07,poll
0,01784612800,01784613200,00000000400,a00,read
0,01784622300,01784623400,00000001100,a2f,recvmsg
0,01782116500,01784696500,00002580000,a17,select
0,01784718300,01784718500,00000000200,a2f,recvmsg
0,01784721800,01784730200,00000008400,a17,select
0,01784734800,01784735000,00000000200,a2f,recvmsg
0,01784735600,01784969800,00000234200,a17,select
0,01784974400,01784974500,00000000100,a2f,recvmsg
1,01765065100,01728645100,-0036420000,60e,page_fault
1,01728674200,01728674900,00000000700,a00,read
1,01728799100,01728799900,00000000800,a00,read
1,01728983200,01728984200,00000001000,a00,read
1,01729074400,01729075100,00000000700,a00,read
1,01729174100,01729174900,00000000800,a00,read
1,01729254300,01729255000,00000000700,a0c,brk
1,01729271200,01729271900,00000000700,a00,read
1,01729359000,01729359600,00000000600,a00,read
1,01729481100,01729481900,00000000800,a00,read
1,01729604200,01729604800,00000000600,a00,read
1,01729710700,01729711400,00000000700,a00,read
1,01729807000,01729807800,00000000800,a00,read
1,01729929300,01729930100,00000000800,a00,read
1,01730026800,01730027300,00000000500,a0c,brk
1,01730029900,01730030500,00000000600,a00,read
1,01730158300,01730159000,00000000700,a00,read
1,01730268500,01730269200,00000000700,a00,read
1,01730412200,01730413000,00000000800,a00,read
1,01730548500,01730549000,00000000500,a00,read
1,01730673600,01730674200,00000000600,a00,read
1,01730787700,01730788100,00000000400,a0c,brk
1,01731168100,01731171400,00000003300,a57,unlink
1,01731196200,01731196900,00000000700,a48,fcntl
1,01731242800,01731257400,00000014600,a01,write
1,01731275500,01731278000,00000002500,a01,write
1,01731294300,01731296600,00000002300,a01,write
1,01726186400,01731536700,00005350300,a17,select
1,01731561600,01731561900,00000000300,a2f,recvmsg
1,01731565800,01731586700,00000020900,a17,select
1,01731590700,01731590900,00000000200,a2f,recvmsg
1,01731591600,01731605500,00000013900,a17,select
1,01731609000,01731609200,00000000200,a2f,recvmsg
1,01731609800,01731623900,00000014100,a17,select
1,01731627800,01731627900,00000000100,a2f,recvmsg
1,01731628400,01731642300,00000013900,a17,select
1,01731646300,01731646500,00000000200,a2f,recvmsg
1,01731647000,01731661100,00000014100,a17,select
1,01731664700,01731664900,00000000200,a2f,recvmsg
1,01731665400,01731691100,00000025700,a17,select
1,01731695100,01731695200,00000000100,a2f,recvmsg
1,01731695800,01731705900,00000010100,a17,select
1,01731709600,01731709700,00000000100,a2f,recvmsg
1,01731710200,01731717600,00000007400,a17,select
1,01731721100,01731721200,00000000100,a2f,recvmsg
1,01731721800,01731729400,00000007600,a17,select
1,01731732900,01731733100,00000000200,a2f,recvmsg
1,01731733600,01731741200,00000007600,a17,select
1,01731744800,01731744900,00000000100,a2f,recvmsg
1,01731745500,01731753200,00000007700,a17,select
1,01731756600,01731756800,00000000200,a2f,recvmsg
1,01731757300,01731764800,00000007500,a17,select
1,01731768600,01731768800,00000000200,a2f,recvmsg
1,01731769300,01731777200,00000007900,a17,select
1,01731780700,01731780900,00000000200,a2f,recvmsg
1,01731781400,01731790700,00000009300,a17,select
1,01731794600,01731794800,00000000200,a2f,recvmsg
1,01731795200,01731802700,00000007500,a17,select
1,01731806600,01731806600,00000000000,a2f,recvmsg
1,01731807200,01731814600,00000007400,a17,select
1,01731818200,01731818400,00000000200,a2f,recvmsg
1,01731818900,01731826100,00000007200,a17,select
1,01731829700,01731829900,00000000200,a2f,recvmsg
1,01731830400,01731837600,00000007200,a17,select
1,01731841200,01731841400,00000000200,a2f,recvmsg
1,01731841900,01731849600,00000007700,a17,select
1,01731853200,01731853300,00000000100,a2f,recvmsg
1,01731853900,01731861300,00000007400,a17,select
1,01731864800,01731865000,00000000200,a2f,recvmsg
1,01731865500,01731872300,00000006800,a17,select
1,01731876100,01731876300,00000000200,a2f,recvmsg
1,01731876800,01731885500,00000008700,a17,select
1,01731889000,01731889200,00000000200,a2f,recvmsg
1,01731889700,01731896600,00000006900,a17,select
1,01731900200,01731900400,00000000200,a2f,recvmsg
1,01731901000,01731907800,00000006800,a17,select
1,01731911500,01731911700,00000000200,a2f,recvmsg
1,01731912200,01731919000,00000006800,a17,select
1,01731922600,01731922800,00000000200,a2f,recvmsg
1,01731923300,01731930600,00000007300,a17,select
1,01731934100,01731934200,00000000100,a2f,recvmsg
1,01731934800,01731941600,00000006800,a17,select
1,01731945300,01731945400,00000000100,a2f,recvmsg
1,01731946000,01731953600,00000007600,a17,select
1,01731957200,01731957300,00000000100,a2f,recvmsg
1,01731957900,01731965800,00000007900,a17,select
1,01731969300,01731969500,00000000200,a2f,recvmsg
1,01731970000,01731977800,00000007800,a17,select
1,01731981700,01731981900,00000000200,a2f,recvmsg
1,01731982400,01731990100,00000007700,a17,select
1,01731993700,01731993800,00000000100,a2f,recvmsg
1,01731994400,01732002100,00000007700,a17,select
1,01732005900,01732006000,00000000100,a2f,recvmsg
1,01732006500,01732015900,00000009400,a17,select
1,01732019600,01732019700,00000000100,a2f,recvmsg
1,01732020300,01732027600,00000007300,a17,select
1,01732031200,01732031400,00000000200,a2f,recvmsg
1,01732031900,01732039100,00000007200,a17,select
1,01732042600,01732042800,00000000200,a2f,recvmsg
1,01732043300,01732051400,00000008100,a17,select
1,01732055200,01732055400,00000000200,a2f,recvmsg
1,01732055800,01732063400,00000007600,a17,select
1,01732066900,01732067100,00000000200,a2f,recvmsg
1,01732067600,01732075700,00000008100,a17,select
1,01732079500,01732079700,00000000200,a2f,recvmsg
1,01732080200,01732087600,00000007400,a17,select
1,01732091200,01732091400,00000000200,a2f,recvmsg
1,01732091900,01732099200,00000007300,a17,select
1,01732102900,01732103000,00000000100,a2f,recvmsg
1,01732103500,01732110600,00000007100,a17,select
1,01732114100,01732114300,00000000200,a2f,recvmsg
1,01732114700,01732122100,00000007400,a17,select
1,01732125800,01732125900,00000000100,a2f,recvmsg
1,01732126400,01732141900,00000015500,a17,select
1,01732145500,01732145700,00000000200,a2f,recvmsg
1,01732146200,01732176800,00000030600,a17,select
1,01732180500,01732180700,00000000200,a2f,recvmsg
1,01732181100,01732198900,00000017800,a17,select
1,01732202500,01732202700,00000000200,a2f,recvmsg
1,01732203200,01732210400,00000007200,a17,select
1,01732213900,01732214100,00000000200,a2f,recvmsg
1,01732214600,01732221400,00000006800,a17,select
1,01732224800,01732225000,00000000200,a2f,recvmsg
1,01732225500,01732232500,00000007000,a17,select
1,01732236100,01732236300,00000000200,a2f,recvmsg
1,01732236800,01732243800,00000007000,a17,select
1,01732247400,01732247600,00000000200,a2f,recvmsg
1,01732248100,01732255000,00000006900,a17,select
1,01732258500,01732258700,00000000200,a2f,recvmsg
1,01732259100,01732266100,00000007000,a17,select
1,01732269500,01732269700,00000000200,a2f,recvmsg
1,01732270200,01732277900,00000007700,a17,select
1,01732281600,01732281800,00000000200,a2f,recvmsg
1,01732282300,01732289200,00000006900,a17,select
1,01732292700,01732292900,00000000200,a2f,recvmsg
1,01732293300,01732301900,00000008600,a17,select
1,01732305500,01732305700,00000000200,a2f,recvmsg
1,01732306200,01732315500,00000009300,a17,select
1,01732319200,01732319300,00000000100,a2f,recvmsg
1,01732319800,01732327300,00000007500,a17,select
1,01732330900,01732331000,00000000100,a2f,recvmsg
1,01732331500,01732338600,00000007100,a17,select
1,01732342200,01732342400,00000000200,a2f,recvmsg
1,01732342800,01732350000,00000007200,a17,select
1,01732353500,01732353600,00000000100,a2f,recvmsg
1,01732354100,01732361300,00000007200,a17,select
1,01732364700,01732364900,00000000200,a2f,recvmsg
1,01732365300,01732373100,00000007800,a17,select
1,01732376700,01732376900,00000000200,a2f,recvmsg
1,01732377400,01732384500,00000007100,a17,select
1,01732388000,01732388200,00000000200,a2f,recvmsg
1,01732388700,01732395700,00000007000,a17,select
1,01732399300,01732399400,00000000100,a2f,recvmsg
1,01732399900,01732407100,00000007200,a17,select
1,01732410700,01732410800,00000000100,a2f,recvmsg
1,01732411300,01732418800,00000007500,a17,select
1,01732422200,01732422400,00000000200,a2f,recvmsg
1,01732422900,01732430100,00000007200,a17,select
1,01732433600,01732433700,00000000100,a2f,recvmsg
1,01732434300,01732442100,00000007800,a17,select
1,01732445700,01732445800,00000000100,a2f,recvmsg
1,01732446400,01732453600,00000007200,a17,select
1,01732457100,01732457300,00000000200,a2f,recvmsg
1,01732457800,01732465200,00000007400,a17,select
1,01732468800,01732469000,00000000200,a2f,recvmsg
1,01732469500,01732476600,00000007100,a17,select
1,01732480200,01732480400,00000000200,a2f,recvmsg
1,01732480900,01732493200,00000012300,a17,select
1,01732496800,01732496900,00000000100,a2f,recvmsg
1,01732497500,01732505000,00000007500,a17,select
1,01732508400,01732508600,00000000200,a2f,recvmsg
1,01732509100,01732516300,00000007200,a17,select
1,01732520000,01732520200,00000000200,a2f,recvmsg
1,01732520700,01732528000,00000007300,a17,select
1,01732531500,01732531700,00000000200,a2f,recvmsg
1,01732532200,01732539400,00000007200,a17,select
1,01732542800,01732543000,00000000200,a2f,recvmsg
1,01732543500,01732599600,00000056100,a17,select
1,01732600500,01732601700,00000001200,a2f,recvmsg
1,01732693800,01732697700,00000003900,a14,writev
1,01732774100,01732775800,00000001700,a14,writev
1,01732833500,01732835000,00000001500,a14,writev
1,01732891600,01732893100,00000001500,a14,writev
1,01733005100,01733006700,00000001600,a14,writev
1,01733010100,01733011000,00000000900,a2f,recvmsg
1,01733061800,01733063200,00000001400,a14,writev
1,01733106200,01733107600,00000001400,a14,writev
1,01733150800,01733152200,00000001400,a14,writev
1,01733195400,01733197100,00000001700,a14,writev
1,01733240600,01733242100,00000001500,a14,writev
1,01733286100,01733287800,00000001700,a14,writev
1,01733312900,01733314800,00000001900,a2f,recvmsg
1,01733342300,01733343800,00000001500,a14,writev
1,01733361600,01733363300,00000001700,a14,writev
1,01733379100,01733380600,00000001500,a14,writev
1,01733395800,01733397600,00000001800,a14,writev
1,01733411900,01733413600,00000001700,a14,writev
1,01733429200,01733430600,00000001400,a14,writev
1,01733435800,01733436100,00000000300,a2f,recvmsg
1,01733436800,01733437100,00000000300,a14,writev
1,01733455200,01733456900,00000001700,a14,writev
1,01733457100,01733458600,00000001500,a14,writev
1,01733459100,01733459300,00000000200,a2f,recvmsg
1,01733470800,01733472300,00000001500,a14,writev
1,01733472500,01733473800,00000001300,a14,writev
1,01733474200,01733474400,00000000200,a2f,recvmsg
1,01757777400,01733482100,-0024295300,a07,poll
1,01733488600,01733491600,00000003000,a2f,recvmsg
1,01733496800,01733496900,00000000100,a2f,recvmsg
1,01733500600,01733500800,00000000200,a2f,recvmsg
1,01733501000,01733501200,00000000200,a2f,recvmsg
1,01733505500,01733505700,00000000200,a2f,recvmsg
1,01733505800,01733506000,00000000200,a2f,recvmsg
1,01733506800,01733511700,00000004900,a07,poll
1,01733517200,01733523500,00000006300,a2f,recvmsg
1,01733537100,01733537300,00000000200,a2f,recvmsg
1,01733561600,01733565900,00000004300,a07,poll
1,01733571800,01733577600,00000005800,a2f,recvmsg
1,01733590000,01733590200,00000000200,a2f,recvmsg
1,01733474900,01733619600,00000144700,a17,select
1,01733634900,01733636300,00000001400,a14,writev
1,01733636700,01733636900,00000000200,a2f,recvmsg
1,01733653500,01733653600,00000000100,a2f,recvmsg
1,01733666100,01733667000,00000000900,a14,writev
1,01733667300,01733667500,00000000200,a2f,recvmsg
1,01733614500,01733672400,00000057900,a07,poll
1,01733675900,01733676000,00000000100,a2f,recvmsg
1,01733677600,01733677800,00000000200,a2f,recvmsg
1,01733678000,01733678100,00000000100,a2f,recvmsg
1,01733679300,01733679500,00000000200,a2f,recvmsg
1,01733679600,01733679800,00000000200,a2f,recvmsg
1,01733680100,01733681600,00000001500,a07,poll
1,01733682000,01733683100,00000001100,a2f,recvmsg
1,01733688000,01733689000,00000001000,a2d,recvfrom
1,01733689800,01733690000,00000000200,a2f,recvmsg
1,01733690600,01733690800,00000000200,a2f,recvmsg
1,01733719100,01733719300,00000000200,a2f,recvmsg
1,01733720900,01733721000,00000000100,a2f,recvmsg
1,01733668000,01735637200,00001969200,a17,select
1,01735650400,01735650600,00000000200,a2f,recvmsg
1,01735652400,01735661700,00000009300,a17,select
1,01735665800,01735666000,00000000200,a2f,recvmsg
1,01735666600,01735716900,00000050300,a17,select
1,01735720700,01735720900,00000000200,a2f,recvmsg
1,01758120700,01746244800,-0011875900,a3d,wait4
1,01746267400,01746269300,00000001900,a00,read
1,01746271300,01746271700,00000000400,a00,read
1,01746294200,01746346300,00000052100,a07,poll
1,01746352500,01746352700,00000000200,a2f,recvmsg
1,01746353500,01746353700,00000000200,a2f,recvmsg
1,01746363400,01746378900,00000015500,a07,poll
1,01746381000,01746381100,00000000100,a2f,recvmsg
1,01746381500,01746381700,00000000200,a2f,recvmsg
1,01746385300,01746398900,00000013600,a07,poll
1,01746400900,01746401100,00000000200,a2f,recvmsg
1,01746401500,01746401700,00000000200,a2f,recvmsg
1,01746406600,01746419900,00000013300,a07,poll
1,01746422000,01746422200,00000000200,a2f,recvmsg
1,01746422500,01746422700,00000000200,a2f,recvmsg
1,01746426500,01746440100,00000013600,a07,poll
1,01746442200,01746442300,00000000100,a2f,recvmsg
1,01746442600,01746442800,00000000200,a2f,recvmsg
1,01746446100,01746459400,00000013300,a07,poll
1,01746461500,01746461700,00000000200,a2f,recvmsg
1,01746462100,01746462300,00000000200,a2f,recvmsg
1,01746463200,01746463600,00000000400,a08,lseek
1,01746473500,01746473600,00000000100,a08,lseek
1,01746476800,01746483600,00000006800,a07,poll
1,01746484800,01746485000,00000000200,a2f,recvmsg
1,01746485300,01746485500,00000000200,a2f,recvmsg
1,01746492500,01746499100,00000006600,a07,poll
1,01746500300,01746500500,00000000200,a2f,recvmsg
1,01746500800,01746501000,00000000200,a2f,recvmsg
1,01746504200,01746510600,00000006400,a07,poll
1,01746511700,01746511900,00000000200,a2f,recvmsg
1,01746512200,01746512400,00000000200,a2f,recvmsg
1,01746516500,01746523000,00000006500,a07,poll
1,01746524200,01746524400,00000000200,a2f,recvmsg
1,01746524700,01746524900,00000000200,a2f,recvmsg
1,01746528300,01746535100,00000006800,a07,poll
1,01746536300,01746536400,00000000100,a2f,recvmsg
1,01746536800,01746536900,00000000100,a2f,recvmsg
1,01746540400,01746546900,00000006500,a07,poll
1,01746548100,01746548300,00000000200,a2f,recvmsg
1,01746548600,01746548700,00000000100,a2f,recvmsg
1,01746552000,01746558800,00000006800,a07,poll
1,01746560000,01746560100,00000000100,a2f,recvmsg
1,01746560400,01746560600,00000000200,a2f,recvmsg
1,01746563500,01746570000,00000006500,a07,poll
1,01746571200,01746571300,00000000100,a2f,recvmsg
1,01746571600,01746571700,00000000100,a2f,recvmsg
1,01746576100,01746582800,00000006700,a07,poll
1,01746583900,01746584100,00000000200,a2f,recvmsg
1,01746584400,01746584600,00000000200,a2f,recvmsg
1,01746587900,01746594700,00000006800,a07,poll
1,01746595900,01746596100,00000000200,a2f,recvmsg
1,01746596300,01746596500,00000000200,a2f,recvmsg
1,01746599800,01746606500,00000006700,a07,poll
1,01746607600,01746607700,00000000100,a2f,recvmsg
1,01746608100,01746608300,00000000200,a2f,recvmsg
1,01746611400,01746618100,00000006700,a07,poll
1,01746619100,01746619300,00000000200,a2f,recvmsg
1,01746619600,01746619800,00000000200,a2f,recvmsg
1,01746622900,01746629700,00000006800,a07,poll
1,01746630800,01746630900,00000000100,a2f,recvmsg
1,01746631300,01746631500,00000000200,a2f,recvmsg
1,01746634800,01746641600,00000006800,a07,poll
1,01746642700,01746642800,00000000100,a2f,recvmsg
1,01746643200,01746643400,00000000200,a2f,recvmsg
1,01746646400,01746653200,00000006800,a07,poll
1,01746654400,01746654500,00000000100,a2f,recvmsg
1,01746654900,01746655000,00000000100,a2f,recvmsg
1,01746657700,01746664500,00000006800,a07,poll
1,01746665600,01746665800,00000000200,a2f,recvmsg
1,01746666100,01746666300,00000000200,a2f,recvmsg
1,01746671000,01746677600,00000006600,a07,poll
1,01746678700,01746678900,00000000200,a2f,recvmsg
1,01746679200,01746679400,00000000200,a2f,recvmsg
1,01746682000,01746688700,00000006700,a07,poll
1,01746689800,01746690000,00000000200,a2f,recvmsg
1,01746690300,01746690500,00000000200,a2f,recvmsg
1,01746693200,01746700200,00000007000,a07,poll
1,01746701200,01746701400,00000000200,a2f,recvmsg
1,01746701700,01746701900,00000000200,a2f,recvmsg
1,01746705300,01746711900,00000006600,a07,poll
1,01746713000,01746713200,00000000200,a2f,recvmsg
1,01746713500,01746713700,00000000200,a2f,recvmsg
1,01746716900,01746723700,00000006800,a07,poll
1,01746724800,01746725000,00000000200,a2f,recvmsg
1,01746725300,01746725400,00000000100,a2f,recvmsg
1,01746728300,01746734900,00000006600,a07,poll
1,01746736000,01746736200,00000000200,a2f,recvmsg
1,01746736500,01746736700,00000000200,a2f,recvmsg
1,01746740100,01746746800,00000006700,a07,poll
1,01746747900,01746748100,00000000200,a2f,recvmsg
1,01746748300,01746748500,00000000200,a2f,recvmsg
1,01746751900,01746758600,00000006700,a07,poll
1,01746759600,01746759800,00000000200,a2f,recvmsg
1,01746760100,01746760300,00000000200,a2f,recvmsg
1,01746764200,01746771100,00000006900,a07,poll
1,01746772300,01746772500,00000000200,a2f,recvmsg
1,01746772800,01746772900,00000000100,a2f,recvmsg
1,01746776500,01746783100,00000006600,a07,poll
1,01746784200,01746784300,00000000100,a2f,recvmsg
1,01746784600,01746784800,00000000200,a2f,recvmsg
1,01746788100,01746795000,00000006900,a07,poll
1,01746796100,01746796200,00000000100,a2f,recvmsg
1,01746796600,01746796700,00000000100,a2f,recvmsg
1,01746803000,01746809800,00000006800,a07,poll
1,01746811000,01746811100,00000000100,a2f,recvmsg
1,01746811500,01746811700,00000000200,a2f,recvmsg
1,01746814700,01746821300,00000006600,a07,poll
1,01746822400,01746822600,00000000200,a2f,recvmsg
1,01746822900,01746823100,00000000200,a2f,recvmsg
1,01746826100,01746833100,00000007000,a07,poll
1,01746834100,01746834300,00000000200,a2f,recvmsg
1,01746834600,01746834800,00000000200,a2f,recvmsg
1,01746838600,01746845500,00000006900,a07,poll
1,01746846700,01746846900,00000000200,a2f,recvmsg
1,01746847100,01746847300,00000000200,a2f,recvmsg
1,01746850900,01746857700,00000006800,a07,poll
1,01746858800,01746858900,00000000100,a2f,recvmsg
1,01746859200,01746859400,00000000200,a2f,recvmsg
1,01746863100,01746869800,00000006700,a07,poll
1,01746871000,01746871200,00000000200,a2f,recvmsg
1,01746871500,01746871700,00000000200,a2f,recvmsg
1,01746875700,01746882500,00000006800,a07,poll
1,01746883600,01746883800,00000000200,a2f,recvmsg
1,01746884100,01746884300,00000000200,a2f,recvmsg
1,01746887300,01746894000,00000006700,a07,poll
1,01746895100,01746895300,00000000200,a2f,recvmsg
1,01746895600,01746895800,00000000200,a2f,recvmsg
1,01746898600,01746905200,00000006600,a07,poll
1,01746906300,01746906500,00000000200,a2f,recvmsg
1,01746906800,01746907000,00000000200,a2f,recvmsg
1,01746910300,01746917200,00000006900,a07,poll
1,01746918300,01746918400,00000000100,a2f,recvmsg
1,01746918700,01746918900,00000000200,a2f,recvmsg
1,01746919900,01746920000,00000000100,a08,lseek
1,01746922800,01746924100,00000001300,a00,read
1,01746927800,01746927900,00000000100,a08,lseek
1,01746930800,01746937400,00000006600,a07,poll
1,01746938700,01746938900,00000000200,a2f,recvmsg
1,01746939200,01746939400,00000000200,a2f,recvmsg
1,01746964600,01746971200,00000006600,a07,poll
1,01746972500,01746972600,00000000100,a2f,recvmsg
1,01746973000,01746973200,00000000200,a2f,recvmsg
1,01746976900,01746977800,00000000900,a00,read
1,01746983200,01746983300,00000000100,a08,lseek
1,01746986600,01746993300,00000006700,a07,poll
1,01746994500,01746994700,00000000200,a2f,recvmsg
1,01746995000,01746995200,00000000200,a2f,recvmsg
1,01746998000,01747004700,00000006700,a07,poll
1,01747005800,01747006000,00000000200,a2f,recvmsg
1,01747006300,01747006500,00000000200,a2f,recvmsg
1,01747009100,01747015800,00000006700,a07,poll
1,01747016900,01747017000,00000000100,a2f,recvmsg
1,01747017400,01747017500,00000000100,a2f,recvmsg
1,01747020200,01747027000,00000006800,a07,poll
1,01747028100,01747028200,00000000100,a2f,recvmsg
1,01747028600,01747028700,00000000100,a2f,recvmsg
1,01747031400,01747038100,00000006700,a07,poll
1,01747039100,01747039300,00000000200,a2f,recvmsg
1,01747039600,01747039800,00000000200,a2f,recvmsg
1,01747042600,01747049100,00000006500,a07,poll
1,01747050300,01747050400,00000000100,a2f,recvmsg
1,01747050700,01747050900,00000000200,a2f,recvmsg
1,01747053700,01747060300,00000006600,a07,poll
1,01747061500,01747061700,00000000200,a2f,recvmsg
1,01747061900,01747062100,00000000200,a2f,recvmsg
1,01747065500,01747072200,00000006700,a07,poll
1,01747073300,01747073400,00000000100,a2f,recvmsg
1,01747097200,01747097500,00000000300,a2f,recvmsg
1,01747100900,01747108300,00000007400,a07,poll
1,01747109400,01747109600,00000000200,a2f,recvmsg
1,01747109900,01747110100,00000000200,a2f,recvmsg
1,01747110600,01747110700,00000000100,a08,lseek
1,01747114800,01747121400,00000006600,a07,poll
1,01747122500,01747122700,00000000200,a2f,recvmsg
1,01747123000,01747123200,00000000200,a2f,recvmsg
1,01747128500,01747135300,00000006800,a07,poll
1,01747136400,01747136600,00000000200,a2f,recvmsg
1,01747136900,01747137100,00000000200,a2f,recvmsg
1,01747140500,01747146900,00000006400,a07,poll
1,01747148000,01747148200,00000000200,a2f,recvmsg
1,01747148500,01747148700,00000000200,a2f,recvmsg
1,01747151800,01747158500,00000006700,a07,poll
1,01747159700,01747159900,00000000200,a2f,recvmsg
1,01747160200,01747160400,00000000200,a2f,recvmsg
1,01747163400,01747170000,00000006600,a07,poll
1,01747171100,01747171300,00000000200,a2f,recvmsg
1,01747171600,01747171800,00000000200,a2f,recvmsg
1,01747174800,01747181400,00000006600,a07,poll
1,01747182800,01747182900,00000000100,a2f,recvmsg
1,01747183300,01747183300,00000000000,a2f,recvmsg
1,01747186900,01747193500,00000006600,a07,poll
1,01747194600,01747194700,00000000100,a2f,recvmsg
1,01747195000,01747195200,00000000200,a2f,recvmsg
1,01747198300,01747204800,00000006500,a07,poll
1,01747206000,01747206100,00000000100,a2f,recvmsg
1,01747206400,01747206600,00000000200,a2f,recvmsg
1,01747209700,01747216200,00000006500,a07,poll
1,01747217400,01747217500,00000000100,a2f,recvmsg
1,01747217800,01747217900,00000000100,a2f,recvmsg
1,01747221100,01747227700,00000006600,a07,poll
1,01747228800,01747228900,00000000100,a2f,recvmsg
1,01747229200,01747229400,00000000200,a2f,recvmsg
1,01747232600,01747239200,00000006600,a07,poll
1,01747240300,01747240500,00000000200,a2f,recvmsg
1,01747240800,01747241000,00000000200,a2f,recvmsg
1,01747244000,01747250500,00000006500,a07,poll
1,01747251700,01747251700,00000000000,a2f,recvmsg
1,01747252000,01747252200,00000000200,a2f,recvmsg
1,01747255700,01747262500,00000006800,a07,poll
1,01747263600,01747263800,00000000200,a2f,recvmsg
1,01747264100,01747264300,00000000200,a2f,recvmsg
1,01747265600,01747291500,00000025900,a14,writev
1,01747294900,01747298300,00000003400,a07,poll
1,01747299600,01747299800,00000000200,a2f,recvmsg
1,01747300100,01747300300,00000000200,a2f,recvmsg
1,01747303500,01747310100,00000006600,a07,poll
1,01747311200,01747311400,00000000200,a2f,recvmsg
1,01747311700,01747311900,00000000200,a2f,recvmsg
1,01747314900,01747321600,00000006700,a07,poll
1,01747322700,01747322900,00000000200,a2f,recvmsg
1,01747323200,01747323400,00000000200,a2f,recvmsg
1,01747331600,01747338400,00000006800,a07,poll
1,01747339400,01747339600,00000000200,a2f,recvmsg
1,01747339900,01747340100,00000000200,a2f,recvmsg
1,01747343300,01747349900,00000006600,a07,poll
1,01747351000,01747351200,00000000200,a2f,recvmsg
1,01747351500,01747351700,00000000200,a2f,recvmsg
1,01747354800,01747361400,00000006600,a07,poll
1,01747362500,01747362700,00000000200,a2f,recvmsg
1,01747363000,01747363200,00000000200,a2f,recvmsg
1,01747366500,01747373200,00000006700,a07,poll
1,01747374300,01747374500,00000000200,a2f,recvmsg
1,01747374700,01747374900,00000000200,a2f,recvmsg
1,01747378100,01747384700,00000006600,a07,poll
1,01747385900,01747386100,00000000200,a2f,recvmsg
1,01747386400,01747386600,00000000200,a2f,recvmsg
1,01747415200,01747442500,00000027300,a57,unlink
1,01747443700,01747448100,00000004400,a14,writev
1,01747448700,01747547500,00000098800,a07,poll
1,01747562500,01747562700,00000000200,a2f,recvmsg
1,01747598700,01747625700,00000027000,a07,poll
1,01747627100,01747684300,00000057200,a07,poll
1,01747685400,01747742200,00000056800,a07,poll
1,01747743400,01747798400,00000055000,a07,poll
1,01747799500,01747854400,00000054900,a07,poll
1,01747855500,01747910200,00000054700,a07,poll
1,01747911800,01747954500,00000042700,a07,poll
1,01747955700,01747997800,00000042100,a07,poll
1,01747999100,01748041300,00000042200,a07,poll
1,01748042300,01748084700,00000042400,a07,poll
1,01748085800,01748129000,00000043200,a07,poll
1,01748130100,01748183700,00000053600,a07,poll
1,01748185500,01748203400,00000017900,a07,poll
1,01748204500,01748219800,00000015300,a07,poll
1,01748220700,01748235000,00000014300,a07,poll
1,01748236100,01748250600,00000014500,a07,poll
1,01748251600,01748265300,00000013700,a07,poll
1,01748266600,01748270600,00000004000,a07,poll
1,01748273100,01748273200,00000000100,a2f,recvmsg
1,01748273800,01748273900,00000000100,a2f,recvmsg
1,01748266600,01748293100,00000026500,a07,poll
1,01748293600,01748295100,00000001500,a2f,recvmsg
1,01748296700,01748297900,00000001200,a2d,recvfrom
1,01748302000,01748302200,00000000200,a2f,recvmsg
1,01748302700,01748302900,00000000200,a2f,recvmsg
1,01748358200,01748358500,00000000300,a2f,recvmsg
1,01748360800,01748361100,00000000300,a2f,recvmsg
1,01748372800,01748505300,00000132500,a07,poll
1,01748506000,01748507600,00000001600,a2f,recvmsg
1,01748514600,01748515400,00000000800,a2d,recvfrom
1,01748516400,01748516600,00000000200,a2f,recvmsg
1,01748517200,01748517400,00000000200,a2f,recvmsg
1,01748549900,01748550200,00000000300,a2f,recvmsg
1,01748552700,01748552900,00000000200,a2f,recvmsg
1,01748556300,01748558900,00000002600,a07,poll
1,01748561500,01748561700,00000000200,a2f,recvmsg
1,01748562300,01748562500,00000000200,a2f,recvmsg
1,01757412500,01749142900,-0008269600,ae8,epoll_wait
1,01749156200,01749158600,00000002400,a2f,recvmsg
1,01749173400,01749173700,00000000300,a2f,recvmsg
1,01749231800,01749236200,00000004400,a2e,sendmsg
1,01749305200,01749324300,00000019100,a07,poll
1,01749241700,01749480900,00000239200,ae8,epoll_wait
1,01749484700,01749486700,00000002000,a2f,recvmsg
1,01749495600,01749495700,00000000100,a2f,recvmsg
1,01749530500,01749533300,00000002800,a2e,sendmsg
1,01749537800,01749538800,00000001000,a2f,recvmsg
1,01749555700,01749555900,00000000200,a2f,recvmsg
1,01749578000,01749580300,00000002300,a2e,sendmsg
1,01749477800,01749585000,00000107200,a07,poll
1,01749693000,01749695100,00000002100,a01,write
1,01749582400,01749708700,00000126300,ae8,epoll_wait
1,01749712200,01749713800,00000001600,a2f,recvmsg
1,01749731000,01749731200,00000000200,a2f,recvmsg
1,01749754200,01749755900,00000001700,a2e,sendmsg
1,01749699800,01749868100,00000168300,a07,poll
1,01750204400,01750213200,00000008800,a02,open
1,01750226200,01750229300,00000003100,a00,read
1,01750283700,01750284500,00000000800,a00,read
1,01750335900,01750336700,00000000800,a00,read
1,01750386100,01750386900,00000000800,a00,read
1,01750436900,01750437600,00000000700,a00,read
1,01750486800,01750487400,00000000600,a00,read
1,01750534600,01750535300,00000000700,a00,read
1,01750583600,01750584300,00000000700,a00,read
1,01750635100,01750635800,00000000700,a00,read
1,01750686100,01750686800,00000000700,a00,read
1,01750735500,01750736200,00000000700,a00,read
1,01750763200,01750764900,00000001700,a02,open
1,01750768600,01750769500,00000000900,a00,read
1,01750824700,01750825600,00000000900,a00,read
1,01750910000,01750910800,00000000800,a00,read
1,01750983700,01750984400,00000000700,a00,read
1,01751062900,01751063500,00000000600,a00,read
1,01751162900,01751163800,00000000900,a00,read
1,01751241300,01751241900,00000000600,a00,read
1,01751327800,01751328500,00000000700,a00,read
1,01751395400,01751396000,00000000600,a00,read
1,01751453500,01751454200,00000000700,a00,read
1,01751533500,01751564100,00000030600,a07,poll
1,01751567900,01751568100,00000000200,a2f,recvmsg
1,01751568800,01751569000,00000000200,a2f,recvmsg
1,01751571600,01751577900,00000006300,a07,poll
1,01751578900,01751579100,00000000200,a2f,recvmsg
1,01751579400,01751579600,00000000200,a2f,recvmsg
1,01751584400,01751591400,00000007000,a06,lstat
1,01751592200,01751593400,00000001200,a06,lstat
1,01751616800,01751632300,00000015500,a01,write
1,01751638200,01751645700,00000007500,a07,poll
1,01751647800,01751648000,00000000200,a2f,recvmsg
1,01751648400,01751648600,00000000200,a2f,recvmsg
1,01751650100,01751961400,00000311300,a38,clone
1,01752455700,01752458600,00000002900,a15,access
1,01752459400,01752460200,00000000800,a09,mmap
1,01752464800,01752466600,00000001800,a15,access
1,01752473600,01752474600,00000001000,a09,mmap
1,01752478500,01752478900,00000000400,a15,access
1,01752486500,01752487700,00000001200,a00,read
1,01752489200,01752490700,00000001500,a09,mmap
1,01752494500,01752496600,00000002100,a09,mmap
1,01752508700,01752509300,00000000600,a15,access
1,01752513100,01752513800,00000000700,a00,read
1,01752514600,01752515400,00000000800,a09,mmap
1,01752517700,01752518900,00000001200,a09,mmap
1,01752527200,01752527900,00000000700,a15,access
1,01752530900,01752531600,00000000700,a00,read
1,01752532200,01752533200,00000001000,a09,mmap
1,01752534800,01752536900,00000002100,a09,mmap
1,01752541300,01752544300,00000003000,a09,mmap
1,01752546500,01752547500,00000001000,a09,mmap
1,01752556300,01752556800,00000000500,a15,access
1,01752559500,01752560300,00000000800,a00,read
1,01752560900,01752562400,00000001500,a09,mmap
1,01752565300,01752567200,00000001900,a09,mmap
1,01752575500,01752576100,00000000600,a15,access
1,01752579500,01752580200,00000000700,a00,read
1,01752580900,01752582300,00000001400,a09,mmap
1,01752586000,01752588300,00000002300,a09,mmap
1,01752596700,01752597400,00000000700,a15,access
1,01752600100,01752600700,00000000600,a00,read
1,01752601200,01752602100,00000000900,a09,mmap
1,01752603500,01752604800,00000001300,a09,mmap
1,01752607500,01752608800,00000001300,a09,mmap
1,01752615100,01752615800,00000000700,a15,access
1,01752618100,01752618700,00000000600,a00,read
1,01752619300,01752620800,00000001500,a09,mmap
1,01752623000,01752624700,00000001700,a09,mmap
1,01752638400,01752639100,00000000700,a09,mmap
1,01752642900,01752643300,00000000400,a09,mmap
1,01752644500,01752644800,00000000300,a09,mmap
1,01752820900,01752821700,00000000800,a0c,brk
1,01752859200,01752860300,00000001100,a00,read
1,01752872400,01752873800,00000001400,a00,read
1,01752909000,01752910100,00000001100,a00,read
1,01753030800,01753031500,00000000700,a00,read
1,01753102600,01753103100,00000000500,a00,read
1,01753188200,01753188800,00000000600,a00,read
1,01753320500,01753321400,00000000900,a00,read
1,01753451700,01753452500,00000000800,a00,read
1,01753608800,01753609400,00000000600,a00,read
1,01753761000,01753761600,00000000600,a00,read
1,01753798600,01753799800,00000001200,a0c,brk
1,01753916100,01753916800,00000000700,a00,read
1,01754066400,01754067000,00000000600,a00,read
1,01754223700,01754224600,00000000900,a00,read
1,01754384800,01754385500,00000000700,a00,read
1,01754495000,01754495600,00000000600,a00,read
1,01754526800,01754527400,00000000600,a0c,brk
1,01754635900,01754636700,00000000800,a00,read
1,01754883100,01754883900,00000000800,a00,read
1,01754896000,01754896400,00000000400,a00,read
1,01754940400,01754940800,00000000400,a00,read
1,01754960800,01754961600,00000000800,a00,read
1,01755191700,01755192100,00000000400,a00,read
1,01755221100,01755222000,00000000900,a00,read
1,01755319400,01755320300,00000000900,a00,read
1,01755344100,01755345600,00000001500,a0c,brk
1,01755390800,01755391200,00000000400,a00,read
1,01755469400,01755470300,00000000900,a00,read
1,01755623200,01755623700,00000000500,a00,read
1,01755735900,01755736600,00000000700,a00,read
1,01755830900,01755831400,00000000500,a00,read
1,01755843400,01755843800,00000000400,a00,read
1,01755925200,01755925600,00000000400,a00,read
1,01755949700,01755950000,00000000300,a00,read
1,01755972200,01755972700,00000000500,a00,read
1,01756074200,01756075300,00000001100,a0c,brk
1,01756076400,01756077400,00000001000,a00,read
1,01756281600,01756282100,00000000500,a00,read
1,01756365200,01756365800,00000000600,a00,read
1,01756429400,01756430100,00000000700,a00,read
1,01756560000,01756560400,00000000400,a00,read
1,01756593800,01756594300,00000000500,a00,read
1,01756610700,01756612000,00000001300,a02,open
1,01756723500,01756724100,00000000600,a00,read
1,01756795700,01756796100,00000000400,a00,read
1,01756848900,01756850000,00000001100,a0c,brk
1,01756856100,01756856800,00000000700,a00,read
1,01756965700,01756966400,00000000700,a00,read
1,01757116700,01757117600,00000000900,a00,read
1,01757247600,01757248200,00000000600,a00,read
1,01757305800,01757306400,00000000600,a00,read
1,01757362000,01757362700,00000000700,a00,read
1,01757432300,01757433000,00000000700,a00,read
1,01757485500,01757486300,00000000800,a00,read
1,01757574200,01757575000,00000000800,a0c,brk
1,01757606700,01757610500,00000003800,a0c,brk
1,01757624800,01757625700,00000000900,a00,read
1,01757740300,01757741100,00000000800,a00,read
1,01757899900,01757900700,00000000800,a00,read
1,01758018500,01758019100,00000000600,a00,read
1,01758165400,01758166200,00000000800,a00,read
1,01758283100,01758283700,00000000600,a00,read
1,01758445800,01758446500,00000000700,a00,read
1,01758451400,01758452100,00000000700,a0c,brk
1,01758566700,01758567400,00000000700,a00,read
1,01758686900,01758687500,00000000600,a00,read
1,01758828400,01758829200,00000000800,a00,read
1,01758960200,01758960900,00000000700,a00,read
1,01759053100,01759053700,00000000600,a00,read
1,01759174400,01759175200,00000000800,a00,read
1,01759298200,01759298900,00000000700,a00,read
1,01759410400,01759411000,00000000600,a0c,brk
1,01759433700,01759434400,00000000700,a00,read
1,01759604400,01759605200,00000000800,a00,read
1,01759755100,01759755600,00000000500,a00,read
1,01759866100,01759867000,00000000900,a00,read
1,01760034800,01760035500,00000000700,a00,read
1,01760111600,01760112200,00000000600,a00,read
1,01760193100,01760193900,00000000800,a00,read
1,01760260500,01760261100,00000000600,a0c,brk
1,01760274600,01760275200,00000000600,a00,read
1,01760349000,01760349800,00000000800,a00,read
1,01760450400,01760451000,00000000600,a00,read
1,01760552800,01760553600,00000000800,a00,read
1,01760642500,01760643000,00000000500,a00,read
1,01760723400,01760724000,00000000600,a00,read
1,01760824700,01760825300,00000000600,a00,read
1,01760907000,01760907500,00000000500,a0c,brk
1,01760910000,01760910800,00000000800,a00,read
1,01761017100,01761017700,00000000600,a00,read
1,01761109900,01761110500,00000000600,a00,read
1,01761228800,01761229600,00000000800,a00,read
1,01761342200,01761342900,00000000700,a00,read
1,01761445700,01761446400,00000000700,a00,read
1,01761547500,01761548100,00000000600,a0c,brk
1,01761908900,01761912600,00000003700,a57,unlink
1,01761936700,01761937200,00000000500,a48,fcntl
1,01761984000,01762000800,00000016800,a01,write
1,01762018400,01762021300,00000002900,a01,write
1,01762037400,01762039800,00000002400,a01,write
1,01735721400,01762279900,00026558500,a17,select
1,01762305900,01762306100,00000000200,a2f,recvmsg
1,01762310100,01762331200,00000021100,a17,select
1,01762335400,01762335600,00000000200,a2f,recvmsg
1,01762336200,01762349800,00000013600,a17,select
1,01762353400,01762353600,00000000200,a2f,recvmsg
1,01762354100,01762369300,00000015200,a17,select
1,01762373000,01762373200,00000000200,a2f,recvmsg
1,01762373700,01762387500,00000013800,a17,select
1,01762391200,01762391400,00000000200,a2f,recvmsg
1,01762391900,01762406100,00000014200,a17,select
1,01762409500,01762409700,00000000200,a2f,recvmsg
1,01762410100,01762435400,00000025300,a17,select
1,01762439400,01762439600,00000000200,a2f,recvmsg
1,01762440100,01762450200,00000010100,a17,select
1,01762453900,01762454000,00000000100,a2f,recvmsg
1,01762454600,01762462300,00000007700,a17,select
1,01762465800,01762466000,00000000200,a2f,recvmsg
1,01762466500,01762474000,00000007500,a17,select
1,01762477400,01762477600,00000000200,a2f,recvmsg
1,01762478100,01762485700,00000007600,a17,select
1,01762489500,01762489700,00000000200,a2f,recvmsg
1,01762490100,01762497700,00000007600,a17,select
1,01762501400,01762501600,00000000200,a2f,recvmsg
1,01762502100,01762509400,00000007300,a17,select
1,01762513100,01762513300,00000000200,a2f,recvmsg
1,01762513800,01762521000,00000007200,a17,select
1,01762524500,01762524700,00000000200,a2f,recvmsg
1,01762525300,01762533400,00000008100,a17,select
1,01762537400,01762537500,00000000100,a2f,recvmsg
1,01762538100,01762545500,00000007400,a17,select
1,01762549300,01762549500,00000000200,a2f,recvmsg
1,01762550100,01762558100,00000008000,a17,select
1,01762561900,01762561900,00000000000,a2f,recvmsg
1,01762562500,01762569700,00000007200,a17,select
1,01762573300,01762573400,00000000100,a2f,recvmsg
1,01762573900,01762581100,00000007200,a17,select
1,01762584700,01762584900,00000000200,a2f,recvmsg
1,01762585400,01762592700,00000007300,a17,select
1,01762596400,01762596600,00000000200,a2f,recvmsg
1,01762597100,01762604300,00000007200,a17,select
1,01762608100,01762608200,00000000100,a2f,recvmsg
1,01762608800,01762615600,00000006800,a17,select
1,01762619400,01762619600,00000000200,a2f,recvmsg
1,01762620100,01762629000,00000008900,a17,select
1,01762632700,01762632800,00000000100,a2f,recvmsg
1,01762633400,01762640400,00000007000,a17,select
1,01762644200,01762644400,00000000200,a2f,recvmsg
1,01762644900,01762651700,00000006800,a17,select
1,01762655300,01762655500,00000000200,a2f,recvmsg
1,01762656000,01762662800,00000006800,a17,select
1,01762666500,01762666700,00000000200,a2f,recvmsg
1,01762667200,01762674400,00000007200,a17,select
1,01762678000,01762678100,00000000100,a2f,recvmsg
1,01762678700,01762685500,00000006800,a17,select
1,01762689200,01762689300,00000000100,a2f,recvmsg
1,01762689800,01762697500,00000007700,a17,select
1,01762701300,01762701500,00000000200,a2f,recvmsg
1,01762702000,01762709400,00000007400,a17,select
1,01762713200,01762713400,00000000200,a2f,recvmsg
1,01762713900,01762721700,00000007800,a17,select
1,01762725600,01762725700,00000000100,a2f,recvmsg
1,01762726300,01762733800,00000007500,a17,select
1,01762737500,01762737700,00000000200,a2f,recvmsg
1,01762738200,01762745800,00000007600,a17,select
1,01762749500,01762749600,00000000100,a2f,recvmsg
1,01762750100,01762759700,00000009600,a17,select
1,01762763400,01762763600,00000000200,a2f,recvmsg
1,01762764200,01762771300,00000007100,a17,select
1,01762774800,01762775000,00000000200,a2f,recvmsg
1,01762775600,01762782700,00000007100,a17,select
1,01762786400,01762786600,00000000200,a2f,recvmsg
1,01762787200,01762795000,00000007800,a17,select
1,01762798700,01762798900,00000000200,a2f,recvmsg
1,01762799400,01762806900,00000007500,a17,select
1,01762810700,01762810800,00000000100,a2f,recvmsg
1,01762811300,01762820200,00000008900,a17,select
1,01762824100,01762824200,00000000100,a2f,recvmsg
1,01762824700,01762832100,00000007400,a17,select
1,01762836000,01762836100,00000000100,a2f,recvmsg
1,01762836700,01762843800,00000007100,a17,select
1,01762847500,01762847700,00000000200,a2f,recvmsg
1,01762848300,01762855100,00000006800,a17,select
1,01762858600,01762858800,00000000200,a2f,recvmsg
1,01762859300,01762866900,00000007600,a17,select
1,01762870500,01762870600,00000000100,a2f,recvmsg
1,01762871200,01762886600,00000015400,a17,select
1,01762890200,01762890400,00000000200,a2f,recvmsg
1,01762890900,01762920400,00000029500,a17,select
1,01762924200,01762924300,00000000100,a2f,recvmsg
1,01762924800,01762942500,00000017700,a17,select
1,01762946200,01762946400,00000000200,a2f,recvmsg
1,01762946900,01762953800,00000006900,a17,select
1,01762957400,01762957600,00000000200,a2f,recvmsg
1,01762958200,01762964900,00000006700,a17,select
1,01762968500,01762968700,00000000200,a2f,recvmsg
1,01762969200,01762976300,00000007100,a17,select
1,01762979900,01762979900,00000000000,a2f,recvmsg
1,01762980500,01762987400,00000006900,a17,select
1,01762991000,01762991200,00000000200,a2f,recvmsg
1,01762991700,01762998600,00000006900,a17,select
1,01763002200,01763002400,00000000200,a2f,recvmsg
1,01763002800,01763009700,00000006900,a17,select
1,01763013200,01763013400,00000000200,a2f,recvmsg
1,01763013900,01763021400,00000007500,a17,select
1,01763025200,01763025400,00000000200,a2f,recvmsg
1,01763025800,01763032800,00000007000,a17,select
1,01763036300,01763036500,00000000200,a2f,recvmsg
1,01763037000,01763046400,00000009400,a17,select
1,01763050000,01763050200,00000000200,a2f,recvmsg
1,01763050700,01763060100,00000009400,a17,select
1,01763063800,01763064000,00000000200,a2f,recvmsg
1,01763064600,01763098900,00000034300,a17,select
1,01763103400,01763103400,00000000000,a2f,recvmsg
1,01763104200,01763111500,00000007300,a17,select
1,01763115200,01763115300,00000000100,a2f,recvmsg
1,01763115900,01763123300,00000007400,a17,select
1,01763126900,01763127000,00000000100,a2f,recvmsg
1,01763127600,01763134700,00000007100,a17,select
1,01763138200,01763138400,00000000200,a2f,recvmsg
1,01763138900,01763146600,00000007700,a17,select
1,01763150200,01763150400,00000000200,a2f,recvmsg
1,01763150900,01763157900,00000007000,a17,select
1,01763161500,01763161700,00000000200,a2f,recvmsg
1,01763162200,01763169200,00000007000,a17,select
1,01763172800,01763173000,00000000200,a2f,recvmsg
1,01763173500,01763180500,00000007000,a17,select
1,01763184000,01763184200,00000000200,a2f,recvmsg
1,01763184700,01763191800,00000007100,a17,select
1,01763195500,01763195700,00000000200,a2f,recvmsg
1,01763196200,01763203400,00000007200,a17,select
1,01763207100,01763207300,00000000200,a2f,recvmsg
1,01763207900,01763215400,00000007500,a17,select
1,01763219000,01763219200,00000000200,a2f,recvmsg
1,01763219700,01763226800,00000007100,a17,select
1,01763230300,01763230500,00000000200,a2f,recvmsg
1,01763231000,01763238300,00000007300,a17,select
1,01763241800,01763242000,00000000200,a2f,recvmsg
1,01763242400,01763249500,00000007100,a17,select
1,01763253200,01763253400,00000000200,a2f,recvmsg
1,01763253800,01763269400,00000015600,a17,select
1,01763273100,01763273300,00000000200,a2f,recvmsg
1,01763273800,01763281100,00000007300,a17,select
1,01763284700,01763284900,00000000200,a2f,recvmsg
1,01763285400,01763292500,00000007100,a17,select
1,01763296200,01763296300,00000000100,a2f,recvmsg
1,01763296900,01763304300,00000007400,a17,select
1,01763307800,01763308000,00000000200,a2f,recvmsg
1,01763308600,01763315800,00000007200,a17,select
1,01763319500,01763319600,00000000100,a2f,recvmsg
1,01763320100,01763378100,00000058000,a17,select
1,01763378900,01763380200,00000001300,a2f,recvmsg
1,01763469800,01763474500,00000004700,a14,writev
1,01763551800,01763553700,00000001900,a14,writev
1,01763670300,01763672000,00000001700,a14,writev
1,01763729400,01763730900,00000001500,a14,writev
1,01763786200,01763788100,00000001900,a14,writev
1,01763793100,01763793800,00000000700,a2f,recvmsg
1,01763844000,01763845500,00000001500,a14,writev
1,01763890000,01763891300,00000001300,a14,writev
1,01763935700,01763937000,00000001300,a14,writev
1,01763980800,01763982400,00000001600,a14,writev
1,01764026600,01764028100,00000001500,a14,writev
1,01764072000,01764074100,00000002100,a14,writev
1,01764099200,01764101000,00000001800,a2f,recvmsg
1,01764128500,01764130300,00000001800,a14,writev
1,01764149100,01764150600,00000001500,a14,writev
1,01764166400,01764167900,00000001500,a14,writev
1,01764182400,01764184000,00000001600,a14,writev
1,01764199000,01764200400,00000001400,a14,writev
1,01764214300,01764215800,00000001500,a14,writev
1,01764220800,01764221000,00000000200,a2f,recvmsg
1,01764221700,01764222100,00000000400,a14,writev
1,01764240600,01764242400,00000001800,a14,writev
1,01764242600,01764244600,00000002000,a14,writev
1,01764245200,01764245300,00000000100,a2f,recvmsg
1,01764258200,01764259400,00000001200,a14,writev
1,01764259700,01764259900,00000000200,a2f,recvmsg
1,01764270000,01764271500,00000001500,a14,writev
1,01764271700,01764272600,00000000900,a14,writev
1,01764272900,01764273100,00000000200,a2f,recvmsg
1,01751638200,01764281400,00012643200,a07,poll
1,01764288200,01764294400,00000006200,a2f,recvmsg
1,01764306900,01764307100,00000000200,a2f,recvmsg
1,01764330700,01764332700,00000002000,a07,poll
1,01764333700,01764338900,00000005200,a2f,recvmsg
1,01764347100,01764348000,00000000900,a2d,recvfrom
1,01764352700,01764352900,00000000200,a2f,recvmsg
1,01764353600,01764353800,00000000200,a2f,recvmsg
1,01764385700,01764385900,00000000200,a2f,recvmsg
1,01764388300,01764388500,00000000200,a2f,recvmsg
1,01764273600,01764399800,00000126200,a17,select
1,01764415000,01764416300,00000001300,a14,writev
1,01764416800,01764417000,00000000200,a2f,recvmsg
1,01764434000,01764434100,00000000100,a2f,recvmsg
1,01764392700,01764439200,00000046500,a07,poll
1,01764444100,01764444300,00000000200,a2f,recvmsg
1,01764446100,01764446300,00000000200,a2f,recvmsg
1,01764446600,01764446700,00000000100,a2f,recvmsg
1,01764448600,01764448700,00000000100,a2f,recvmsg
1,01764448900,01764449100,00000000200,a2f,recvmsg
1,01764449600,01765106800,00000657200,a07,poll
1,01765128400,01765132800,00000004400,a2e,sendmsg
1,01749758400,01765136100,00015377700,ae8,epoll_wait
1,01765147200,01765149000,00000001800,a2f,recvmsg
1,01765163900,01765164200,00000000300,a2f,recvmsg
1,01765188400,01765191600,00000003200,a2e,sendmsg
1,01764449600,01765199300,00000749700,a07,poll
1,01765200900,01765201900,00000001000,a00,read
1,01765219200,01765220500,00000001300,a2f,recvmsg
1,01765303300,01765307700,00000004400,a07,poll
1,01765457100,01765458300,00000001200,a2f,recvmsg
1,01765464500,01765464800,00000000300,a2f,recvmsg
1,01765481500,01765482000,00000000500,a00,read
1,01765488000,01765491700,00000003700,a2e,sendmsg
1,01765194900,01765493700,00000298800,ae8,epoll_wait
1,01765498300,01765499700,00000001400,a2f,recvmsg
1,01765512400,01765512600,00000000200,a2f,recvmsg
1,01765525600,01765527400,00000001800,a2e,sendmsg
1,01765480600,01765532600,00000052000,a07,poll
1,01765533200,01765533500,00000000300,a00,read
1,01765541700,01765542500,00000000800,a2f,recvmsg
1,01765606900,01765609500,00000002600,a07,poll
1,01765924300,01765925300,00000001000,a2f,recvmsg
1,01764434800,01766547900,00002113100,a17,select
1,01766568200,01766568500,00000000300,a2f,recvmsg
1,01766581400,01766581600,00000000200,a2f,recvmsg
1,01766582200,01766645200,00000063000,a17,select
1,01766649200,01766649400,00000000200,a2f,recvmsg
1,01610034900,01768283500,00158248600,a4a,fsync
1,01768342000,01768346300,00000004300,a09,mmap
1,01768417300,01768421500,00000004200,a01,write
1,01768464800,01768466100,00000001300,aca,futex
1,01768468500,01768471300,00000002800,aca,futex
1,01768619600,01768628100,00000008500,a01,write
1,01765530000,01768660600,00003130600,ae8,epoll_wait
1,01768672500,01768677000,00000004500,a2f,recvmsg
1,01768696400,01768696700,00000000300,a2f,recvmsg
1,01768739900,01768740800,00000000900,a2e,sendmsg
1,01768484600,01768749700,00000265100,a07,poll
1,01768957300,01768958300,00000001000,a2f,recvmsg
1,01768960700,01768960900,00000000200,a00,read
1,01769017700,01769021300,00000003600,a07,poll
1,01769068700,01769068900,00000000200,a00,read
1,01769105600,01769108900,00000003300,a07,poll
1,01769112700,01769116000,00000003300,a2e,sendmsg
1,01768742900,01769118000,00000375100,ae8,epoll_wait
1,01769123000,01769124200,00000001200,a2f,recvmsg
1,01769132900,01769133100,00000000200,a2f,recvmsg
1,01769145600,01769148600,00000003000,a2e,sendmsg
1,01769159700,01769160100,00000000400,a00,read
1,01751982200,01777453700,00025471500,a3d,wait4
1,01777476300,01777478300,00000002000,a00,read
1,01777480600,01777480800,00000000200,a00,read
1,01777499800,01777548800,00000049000,a07,poll
1,01777554000,01777554200,00000000200,a2f,recvmsg
1,01777555000,01777555200,00000000200,a2f,recvmsg
1,01777560200,01777571900,00000011700,a07,poll
1,01777574200,01777574400,00000000200,a2f,recvmsg
1,01777574800,01777575000,00000000200,a2f,recvmsg
1,01777579700,01777591500,00000011800,a07,poll
1,01777593700,01777593900,00000000200,a2f,recvmsg
1,01777594300,01777594500,00000000200,a2f,recvmsg
1,01777599600,01777611400,00000011800,a07,poll
1,01777613500,01777613600,00000000100,a2f,recvmsg
1,01777613900,01777614100,00000000200,a2f,recvmsg
1,01777619000,01777630700,00000011700,a07,poll
1,01777632700,01777632700,00000000000,a2f,recvmsg
1,01777633100,01777633300,00000000200,a2f,recvmsg
1,01777637800,01777644500,00000006700,a07,poll
1,01777645800,01777646000,00000000200,a2f,recvmsg
1,01777646200,01777646400,00000000200,a2f,recvmsg
1,01777647000,01777647200,00000000200,a08,lseek
1,01777656800,01777656900,00000000100,a08,lseek
1,01777660100,01777667400,00000007300,a07,poll
1,01777668700,01777668800,00000000100,a2f,recvmsg
1,01777669200,01777669400,00000000200,a2f,recvmsg
1,01777674700,01777681500,00000006800,a07,poll
1,01777682700,01777682800,00000000100,a2f,recvmsg
1,01777683200,01777683300,00000000100,a2f,recvmsg
1,01777686600,01777693200,00000006600,a07,poll
1,01777694300,01777694500,00000000200,a2f,recvmsg
1,01777694800,01777695000,00000000200,a2f,recvmsg
1,01777698300,01777704900,00000006600,a07,poll
1,01777706000,01777706200,00000000200,a2f,recvmsg
1,01777706500,01777706700,00000000200,a2f,recvmsg
1,01777710000,01777716700,00000006700,a07,poll
1,01777718000,01777718200,00000000200,a2f,recvmsg
1,01777718400,01777718600,00000000200,a2f,recvmsg
1,01777722100,01777728700,00000006600,a07,poll
1,01777730000,01777730100,00000000100,a2f,recvmsg
1,01777730400,01777730600,00000000200,a2f,recvmsg
1,01777734500,01777741500,00000007000,a07,poll
1,01777742800,01777742900,00000000100,a2f,recvmsg
1,01777743100,01777743300,00000000200,a2f,recvmsg
1,01777746200,01777752800,00000006600,a07,poll
1,01777754000,01777754100,00000000100,a2f,recvmsg
1,01777754300,01777754500,00000000200,a2f,recvmsg
1,01777758900,01777765900,00000007000,a07,poll
1,01777767100,01777767300,00000000200,a2f,recvmsg
1,01777767600,01777767700,00000000100,a2f,recvmsg
1,01777770900,01777777800,00000006900,a07,poll
1,01777779000,01777779000,00000000000,a2f,recvmsg
1,01777779300,01777779500,00000000200,a2f,recvmsg
1,01777782800,01777789300,00000006500,a07,poll
1,01777790400,01777790500,00000000100,a2f,recvmsg
1,01777790800,01777791000,00000000200,a2f,recvmsg
1,01777794200,01777800900,00000006700,a07,poll
1,01777802000,01777802200,00000000200,a2f,recvmsg
1,01777802500,01777802700,00000000200,a2f,recvmsg
1,01777805700,01777812400,00000006700,a07,poll
1,01777813500,01777813700,00000000200,a2f,recvmsg
1,01777814000,01777814200,00000000200,a2f,recvmsg
1,01777817300,01777824100,00000006800,a07,poll
1,01777825200,01777825400,00000000200,a2f,recvmsg
1,01777825700,01777825900,00000000200,a2f,recvmsg
1,01777829000,01777835600,00000006600,a07,poll
1,01777836700,01777836800,00000000100,a2f,recvmsg
1,01777837100,01777837300,00000000200,a2f,recvmsg
1,01777839900,01777846800,00000006900,a07,poll
1,01777847900,01777848000,00000000100,a2f,recvmsg
1,01777848300,01777848500,00000000200,a2f,recvmsg
1,01777854200,01777860800,00000006600,a07,poll
1,01777862000,01777862200,00000000200,a2f,recvmsg
1,01777862500,01777862600,00000000100,a2f,recvmsg
1,01777865400,01777872100,00000006700,a07,poll
1,01777873200,01777873400,00000000200,a2f,recvmsg
1,01777873700,01777873900,00000000200,a2f,recvmsg
1,01777876500,01777883200,00000006700,a07,poll
1,01777884300,01777884500,00000000200,a2f,recvmsg
1,01777884700,01777884900,00000000200,a2f,recvmsg
1,01777887500,01777894400,00000006900,a07,poll
1,01777895400,01777895600,00000000200,a2f,recvmsg
1,01777895900,01777896100,00000000200,a2f,recvmsg
1,01777899200,01777905800,00000006600,a07,poll
1,01777906900,01777907100,00000000200,a2f,recvmsg
1,01777907400,01777907600,00000000200,a2f,recvmsg
1,01777910300,01777917100,00000006800,a07,poll
1,01777918200,01777918400,00000000200,a2f,recvmsg
1,01777918700,01777918900,00000000200,a2f,recvmsg
1,01777922200,01777928900,00000006700,a07,poll
1,01777930000,01777930100,00000000100,a2f,recvmsg
1,01777930400,01777930600,00000000200,a2f,recvmsg
1,01777933900,01777940600,00000006700,a07,poll
1,01777941800,01777942000,00000000200,a2f,recvmsg
1,01777942300,01777942400,00000000100,a2f,recvmsg
1,01777948400,01777955400,00000007000,a07,poll
1,01777956500,01777956700,00000000200,a2f,recvmsg
1,01777957000,01777957200,00000000200,a2f,recvmsg
1,01777960700,01777967200,00000006500,a07,poll
1,01777968400,01777968500,00000000100,a2f,recvmsg
1,01777968800,01777969000,00000000200,a2f,recvmsg
1,01777972500,01777979300,00000006800,a07,poll
1,01777980400,01777980600,00000000200,a2f,recvmsg
1,01777980900,01777981100,00000000200,a2f,recvmsg
1,01777986400,01777993200,00000006800,a07,poll
1,01777994300,01777994500,00000000200,a2f,recvmsg
1,01777994800,01777995000,00000000200,a2f,recvmsg
1,01777998000,01778004700,00000006700,a07,poll
1,01778005800,01778005900,00000000100,a2f,recvmsg
1,01778006200,01778006400,00000000200,a2f,recvmsg
1,01778009500,01778016200,00000006700,a07,poll
1,01778017200,01778017400,00000000200,a2f,recvmsg
1,01778017700,01778017900,00000000200,a2f,recvmsg
1,01778022600,01778029400,00000006800,a07,poll
1,01778030500,01778030700,00000000200,a2f,recvmsg
1,01778031000,01778031200,00000000200,a2f,recvmsg
1,01778034600,01778041300,00000006700,a07,poll
1,01778042500,01778042600,00000000100,a2f,recvmsg
1,01778042900,01778043100,00000000200,a2f,recvmsg
1,01778046900,01778053700,00000006800,a07,poll
1,01778054800,01778055000,00000000200,a2f,recvmsg
1,01778055300,01778055500,00000000200,a2f,recvmsg
1,01778059000,01778065800,00000006800,a07,poll
1,01778066900,01778067100,00000000200,a2f,recvmsg
1,01778067400,01778067600,00000000200,a2f,recvmsg
1,01778070500,01778077200,00000006700,a07,poll
1,01778078200,01778078400,00000000200,a2f,recvmsg
1,01778078700,01778078900,00000000200,a2f,recvmsg
1,01778081800,01778088500,00000006700,a07,poll
1,01778089600,01778089700,00000000100,a2f,recvmsg
1,01778090000,01778090200,00000000200,a2f,recvmsg
1,01778093600,01778100400,00000006800,a07,poll
1,01778101600,01778101800,00000000200,a2f,recvmsg
1,01778102000,01778102200,00000000200,a2f,recvmsg
1,01778103200,01778103300,00000000100,a08,lseek
1,01778105700,01778106600,00000000900,a00,read
1,01778110300,01778110400,00000000100,a08,lseek
1,01778113300,01778119800,00000006500,a07,poll
1,01778121100,01778121300,00000000200,a2f,recvmsg
1,01778121600,01778121800,00000000200,a2f,recvmsg
1,01778147600,01778154200,00000006600,a07,poll
1,01778155400,01778155600,00000000200,a2f,recvmsg
1,01778155900,01778156100,00000000200,a2f,recvmsg
1,01778159800,01778160600,00000000800,a00,read
1,01778166000,01778166100,00000000100,a08,lseek
1,01778169300,01778176100,00000006800,a07,poll
1,01778177300,01778177500,00000000200,a2f,recvmsg
1,01778177800,01778178000,00000000200,a2f,recvmsg
1,01778180800,01778187500,00000006700,a07,poll
1,01778188600,01778188800,00000000200,a2f,recvmsg
1,01778189100,01778189300,00000000200,a2f,recvmsg
1,01778192000,01778198700,00000006700,a07,poll
1,01778199700,01778199900,00000000200,a2f,recvmsg
1,01778200300,01778200500,00000000200,a2f,recvmsg
1,01778203100,01778209800,00000006700,a07,poll
1,01778210900,01778211100,00000000200,a2f,recvmsg
1,01778211400,01778211600,00000000200,a2f,recvmsg
1,01778214300,01778220900,00000006600,a07,poll
1,01778221900,01778222100,00000000200,a2f,recvmsg
1,01778222500,01778222600,00000000100,a2f,recvmsg
1,01778225500,01778232100,00000006600,a07,poll
1,01778233200,01778233300,00000000100,a2f,recvmsg
1,01778233700,01778233900,00000000200,a2f,recvmsg
1,01778236500,01778243100,00000006600,a07,poll
1,01778244300,01778244500,00000000200,a2f,recvmsg
1,01778244700,01778244900,00000000200,a2f,recvmsg
1,01778248200,01778254900,00000006700,a07,poll
1,01778256000,01778256200,00000000200,a2f,recvmsg
1,01778256500,01778256700,00000000200,a2f,recvmsg
1,01778259600,01778266200,00000006600,a07,poll
1,01778267300,01778267400,00000000100,a2f,recvmsg
1,01778267700,01778267900,00000000200,a2f,recvmsg
1,01778268400,01778268400,00000000000,a08,lseek
1,01778272600,01778279100,00000006500,a07,poll
1,01778280400,01778280500,00000000100,a2f,recvmsg
1,01778280800,01778281000,00000000200,a2f,recvmsg
1,01778286100,01778292700,00000006600,a07,poll
1,01778293900,01778294000,00000000100,a2f,recvmsg
1,01778294300,01778294500,00000000200,a2f,recvmsg
1,01778297900,01778304500,00000006600,a07,poll
1,01778305600,01778305800,00000000200,a2f,recvmsg
1,01778306100,01778306300,00000000200,a2f,recvmsg
1,01778309400,01778316200,00000006800,a07,poll
1,01778317300,01778317500,00000000200,a2f,recvmsg
1,01778317800,01778318000,00000000200,a2f,recvmsg
1,01778321000,01778327600,00000006600,a07,poll
1,01778328600,01778328800,00000000200,a2f,recvmsg
1,01778329100,01778329300,00000000200,a2f,recvmsg
1,01778332300,01778339100,00000006800,a07,poll
1,01778340200,01778340300,00000000100,a2f,recvmsg
1,01778340700,01778340800,00000000100,a2f,recvmsg
1,01778344200,01778350900,00000006700,a07,poll
1,01778352000,01778352200,00000000200,a2f,recvmsg
1,01778352500,01778352700,00000000200,a2f,recvmsg
1,01778355800,01778362300,00000006500,a07,poll
1,01778363300,01778363500,00000000200,a2f,recvmsg
1,01778363800,01778364000,00000000200,a2f,recvmsg
1,01778367000,01778373700,00000006700,a07,poll
1,01778374700,01778374900,00000000200,a2f,recvmsg
1,01778375200,01778375400,00000000200,a2f,recvmsg
1,01778378300,01778385100,00000006800,a07,poll
1,01778386300,01778386400,00000000100,a2f,recvmsg
1,01778386800,01778387000,00000000200,a2f,recvmsg
1,01778389900,01778396500,00000006600,a07,poll
1,01778397500,01778397700,00000000200,a2f,recvmsg
1,01778398000,01778398200,00000000200,a2f,recvmsg
1,01778401200,01778407900,00000006700,a07,poll
1,01778409000,01778409100,00000000100,a2f,recvmsg
1,01778409500,01778409700,00000000200,a2f,recvmsg
1,01778413500,01778420200,00000006700,a07,poll
1,01778421300,01778421500,00000000200,a2f,recvmsg
1,01778421800,01778422000,00000000200,a2f,recvmsg
1,01778424900,01778431500,00000006600,a07,poll
1,01778432600,01778432800,00000000200,a2f,recvmsg
1,01778433100,01778433300,00000000200,a2f,recvmsg
1,01778436400,01778442900,00000006500,a07,poll
1,01778444000,01778444200,00000000200,a2f,recvmsg
1,01778444500,01778444700,00000000200,a2f,recvmsg
1,01778447600,01778454200,00000006600,a07,poll
1,01778455400,01778455400,00000000000,a2f,recvmsg
1,01778455800,01778455900,00000000100,a2f,recvmsg
1,01778464400,01778471100,00000006700,a07,poll
1,01778472300,01778472400,00000000100,a2f,recvmsg
1,01778472600,01778472800,00000000200,a2f,recvmsg
1,01778476200,01778482700,00000006500,a07,poll
1,01778483900,01778484000,00000000100,a2f,recvmsg
1,01778484300,01778484500,00000000200,a2f,recvmsg
1,01778487500,01778494200,00000006700,a07,poll
1,01778495300,01778495500,00000000200,a2f,recvmsg
1,01778495800,01778496000,00000000200,a2f,recvmsg
1,01778499100,01778505700,00000006600,a07,poll
1,01778506800,01778506900,00000000100,a2f,recvmsg
1,01778507200,01778507400,00000000200,a2f,recvmsg
1,01778510600,01778517400,00000006800,a07,poll
1,01778518400,01778518600,00000000200,a2f,recvmsg
1,01778518900,01778519100,00000000200,a2f,recvmsg
1,01778539400,01778565100,00000025700,a57,unlink
1,01778566200,01778570400,00000004200,a14,writev
1,01778571100,01778667900,00000096800,a07,poll
1,01778670600,01778671500,00000000900,a00,read
1,01778686400,01778686600,00000000200,a2f,recvmsg
1,01778721600,01778748600,00000027000,a07,poll
1,01778750400,01778805700,00000055300,a07,poll
1,01778806900,01778862900,00000056000,a07,poll
1,01778864100,01778920700,00000056600,a07,poll
1,01778921800,01778977200,00000055400,a07,poll
1,01778978400,01779032600,00000054200,a07,poll
1,01779034200,01779093800,00000059600,a07,poll
1,01779095000,01779138300,00000043300,a07,poll
1,01779139500,01779182700,00000043200,a07,poll
1,01779184100,01779227400,00000043300,a07,poll
1,01779228500,01779272200,00000043700,a07,poll
1,01779273200,01779326500,00000053300,a07,poll
1,01779327600,01779345000,00000017400,a07,poll
1,01779346100,01779362800,00000016700,a07,poll
1,01779363900,01779378200,00000014300,a07,poll
1,01779379100,01779392600,00000013500,a07,poll
1,01779393700,01779407700,00000014000,a07,poll
1,01779408800,01779413800,00000005000,a07,poll
1,01779416600,01779416800,00000000200,a2f,recvmsg
1,01779417300,01779417500,00000000200,a2f,recvmsg
1,01779408800,01779437200,00000028400,a07,poll
1,01779437700,01779439200,00000001500,a2f,recvmsg
1,01779442300,01779443700,00000001400,a2d,recvfrom
1,01779448400,01779448600,00000000200,a2f,recvmsg
1,01779449200,01779449300,00000000100,a2f,recvmsg
1,01779505400,01779505700,00000000300,a2f,recvmsg
1,01779508200,01779508500,00000000300,a2f,recvmsg
1,01779521100,01779649100,00000128000,a07,poll
1,01779649900,01779651500,00000001600,a2f,recvmsg
1,01779658800,01779659600,00000000800,a2d,recvfrom
1,01779660600,01779660800,00000000200,a2f,recvmsg
1,01779661600,01779661800,00000000200,a2f,recvmsg
1,01779693500,01779693700,00000000200,a2f,recvmsg
1,01779696000,01779696100,00000000100,a2f,recvmsg
1,01779699400,01779701800,00000002400,a07,poll
1,01779704400,01779704600,00000000200,a2f,recvmsg
1,01779705200,01779705300,00000000100,a2f,recvmsg
1,01780179600,01780183900,00000004300,a09,mmap
1,01780340500,01780345700,00000005200,a02,open
1,01780353200,01780355200,00000002000,a00,read
1,01780406200,01780406900,00000000700,a00,read
1,01780455500,01780456300,00000000800,a00,read
1,01780502100,01780502900,00000000800,a00,read
1,01780550100,01780550800,00000000700,a00,read
1,01780596500,01780597400,00000000900,a00,read
1,01780641400,01780642100,00000000700,a00,read
1,01780687300,01780687900,00000000600,a00,read
1,01780735500,01780736300,00000000800,a00,read
1,01780784400,01780785000,00000000600,a00,read
1,01780832600,01780833200,00000000600,a00,read
1,01780859400,01780860900,00000001500,a02,open
1,01780863800,01780864700,00000000900,a00,read
1,01780918700,01780919600,00000000900,a00,read
1,01781001600,01781002400,00000000800,a00,read
1,01781073200,01781073900,00000000700,a00,read
1,01781150000,01781150600,00000000600,a00,read
1,01781227500,01781228200,00000000700,a00,read
1,01781303700,01781304400,00000000700,a00,read
1,01781387800,01781388600,00000000800,a00,read
1,01781453100,01781453800,00000000700,a00,read
1,01781510700,01781511400,00000000700,a00,read
1,01781588400,01781610700,00000022300,a07,poll
1,01781613900,01781614200,00000000300,a2f,recvmsg
1,01781614800,01781615000,00000000200,a2f,recvmsg
1,01781618000,01781625600,00000007600,a07,poll
1,01781626900,01781627000,00000000100,a2f,recvmsg
1,01781627400,01781627600,00000000200,a2f,recvmsg
1,01781631900,01781637300,00000005400,a06,lstat
1,01781638000,01781639200,00000001200,a06,lstat
1,01781656900,01781667200,00000010300,a01,write
1,01781672300,01781679300,00000007000,a07,poll
1,01781681300,01781681500,00000000200,a2f,recvmsg
1,01781681800,01781682000,00000000200,a2f,recvmsg
1,01781683400,01781999400,00000316000,a38,clone
1,01782473900,01782474000,00000000100,a0c,brk
1,01782484700,01782487200,00000002500,a15,access
1,01782487800,01782488700,00000000900,a09,mmap
1,01782492400,01782494400,00000002000,a15,access
1,01782500500,01782501700,00000001200,a09,mmap
1,01782505400,01782505900,00000000500,a15,access
1,01782513600,01782514700,00000001100,a00,read
1,01782516000,01782517600,00000001600,a09,mmap
1,01782521700,01782523900,00000002200,a09,mmap
1,01782535700,01782536400,00000000700,a15,access
1,01782540100,01782540700,00000000600,a00,read
1,01782545400,01782546600,00000001200,a09,mmap
1,01782554700,01782555300,00000000600,a15,access
1,01782558300,01782558900,00000000600,a00,read
1,01782559400,01782560200,00000000800,a09,mmap
1,01782561800,01782563900,00000002100,a09,mmap
1,01782568400,01782571400,00000003000,a09,mmap
1,01782573600,01782574700,00000001100,a09,mmap
1,01782582800,01782583400,00000000600,a15,access
1,01782586500,01782587100,00000000600,a00,read
1,01782587800,01782589200,00000001400,a09,mmap
1,01782591700,01782593400,00000001700,a09,mmap
1,01782601400,01782602000,00000000600,a15,access
1,01782605200,01782605900,00000000700,a00,read
1,01782606600,01782608000,00000001400,a09,mmap
1,01782611700,01782614000,00000002300,a09,mmap
1,01782622700,01782623300,00000000600,a15,access
1,01782625800,01782626400,00000000600,a00,read
1,01782626900,01782628000,00000001100,a09,mmap
1,01782629300,01782630700,00000001400,a09,mmap
1,01782634000,01782635400,00000001400,a09,mmap
1,01782641800,01782642900,00000001100,a15,access
1,01782645200,01782645700,00000000500,a00,read
1,01782646400,01782647800,00000001400,a09,mmap
1,01782650600,01782652200,00000001600,a09,mmap
1,01782666400,01782667000,00000000600,a09,mmap
1,01782670800,01782671200,00000000400,a09,mmap
1,01782672300,01782672600,00000000300,a09,mmap
1,01782850300,01782850400,00000000100,a0c,brk
1,01782850600,01782851400,00000000800,a0c,brk
1,01782886200,01782887200,00000001000,a00,read
1,01782898700,01782900400,00000001700,a00,read
1,01782937900,01782938800,00000000900,a00,read
1,01783061200,01783071800,00000010600,a00,read
1,01783143100,01783143500,00000000400,a00,read
1,01783229500,01783230100,00000000600,a00,read
1,01783360500,01783361300,00000000800,a00,read
1,01783490100,01783490700,00000000600,a00,read
1,01783646100,01783646600,00000000500,a00,read
1,01783796200,01783796800,00000000600,a00,read
1,01783833700,01783835000,00000001300,a0c,brk
1,01783950200,01783950900,00000000700,a00,read
1,01784098700,01784099400,00000000700,a00,read
1,01784254000,01784254700,00000000700,a00,read
1,01784413400,01784414000,00000000600,a00,read
1,01784522200,01784522900,00000000700,a00,read
1,01784662500,01784663200,00000000700,a00,read
1,01784907200,01784907800,00000000600,a00,read
1,01784919500,01784919900,00000000400,a00,read
1,01784964200,01784964600,00000000400,a00,read
1,01784984400,01784985200,00000000800,a00,read
1,01785191700,01785192200,00000000500,a00,read
1,01785221700,01785222500,00000000800,a00,read
1,01785319100,01785320000,00000000900,a00,read
1,01785343500,01785344800,00000001300,a0c,brk
1,01785389800,01785390200,00000000400,a00,read
1,01785468800,01785469700,00000000900,a00,read
1,01785622100,01785622500,00000000400,a00,read
1,01785735900,01785736500,00000000600,a00,read
1,01785830400,01785831000,00000000600,a00,read
1,01785842600,01785843000,00000000400,a00,read
1,01785924300,01785924600,00000000300,a00,read
1,01785948700,01785949000,00000000300,a00,read
1,01785971100,01785971700,00000000600,a00,read
1,01786074400,01786075400,00000001000,a0c,brk
1,01786077400,01786078600,00000001200,a00,read
1,01786281200,01786281500,00000000300,a00,read
1,01786364800,01786365400,00000000600,a00,read
1,01786429800,01786430700,00000000900,a00,read
1,01786558700,01786559100,00000000400,a00,read
1,01786591200,01786591700,00000000500,a00,read
1,01786608400,01786609900,00000001500,a02,open
1,01786721200,01786721700,00000000500,a00,read
1,01786792600,01786793000,00000000400,a00,read
1,01786845600,01786846700,00000001100,a0c,brk
1,01786854700,01786855400,00000000700,a00,read
1,01786963600,01786964200,00000000600,a00,read
1,01787135200,01787136200,00000001000,a00,read
1,01787268100,01787268800,00000000700,a00,read
1,01787326600,01787327400,00000000800,a00,read
1,01787383600,01787384300,00000000700,a00,read
1,01787454800,01787455600,00000000800,a00,read
1,01787508700,01787509200,00000000500,a00,read
1,01787598500,01787599600,00000001100,a0c,brk
1,01787631900,01787635700,00000003800,a0c,brk
1,01787650000,01787650900,00000000900,a00,read
1,01787766000,01787767200,00000001200,a00,read
1,01787928300,01787928900,00000000600,a00,read
1,01788047200,01788048000,00000000800,a00,read
1,01788196000,01788196700,00000000700,a00,read
1,01788314500,01788315300,00000000800,a00,read
1,01788479400,01788480000,00000000600,a00,read
1,01788485100,01788485700,00000000600,a0c,brk
1,01788601700,01788602600,00000000900,a00,read
1,01788722000,01788722700,00000000700,a00,read
1,01788865200,01788865900,00000000700,a00,read
1,01788998100,01788998700,00000000600,a00,read
1,01789092300,01789093000,00000000700,a00,read
1,01789205800,01789206500,00000000700,a00,read
1,01789331100,01789331800,00000000700,a00,read
1,01789444400,01789444900,00000000500,a0c,brk
1,01789467900,01789468500,00000000600,a00,read
1,01789639100,01789639800,00000000700,a00,read
1,01789792300,01789792900,00000000600,a00,read
1,01789904500,01789905200,00000000700,a00,read
1,01790075900,01790076700,00000000800,a00,read
1,01790155200,01790155800,00000000600,a00,read
1,01790239500,01790240200,00000000700,a00,read
1,01790308300,01790308900,00000000600,a0c,brk
1,01790322700,01790323300,00000000600,a00,read
1,01790397100,01790397800,00000000700,a00,read
1,01790500800,01790501400,00000000600,a00,read
1,01790606200,01790606800,00000000600,a00,read
1,01790699500,01790700200,00000000700,a00,read
1,01790781600,01790782300,00000000700,a00,read
1,01790884800,01790885300,00000000500,a00,read
1,01790967500,01790967800,00000000300,a0c,brk
1,01790970300,01790970900,00000000600,a00,read
1,01791094200,01791095000,00000000800,a00,read
1,01791189000,01791189600,00000000600,a00,read
1,01791312300,01791312900,00000000600,a00,read
1,01791428400,01791429000,00000000600,a00,read
1,01791533500,01791534200,00000000700,a00,read
1,01791635900,01791636300,00000000400,a0c,brk
1,01791997300,01792001300,00000004000,a57,unlink
1,01792025300,01792026000,00000000700,a48,fcntl
1,01792076200,01792091200,00000015000,a01,write
1,01792109100,01792111700,00000002600,a01,write
1,01792127500,01792129800,00000002300,a01,write
1,01766650000,01792378600,00025728600,a17,select
1,01792404200,01792404400,00000000200,a2f,recvmsg
1,01792407800,01792437200,00000029400,a17,select
1,01792441400,01792441600,00000000200,a2f,recvmsg
1,01792442200,01792460200,00000018000,a17,select
1,01792463700,01792463900,00000000200,a2f,recvmsg
1,01792464300,01792481100,00000016800,a17,select
1,01792484900,01792485000,00000000100,a2f,recvmsg
1,01792485500,01792501000,00000015500,a17,select
1,01792505200,01792505400,00000000200,a2f,recvmsg
1,01792505900,01792521200,00000015300,a17,select
1,01792524600,01792524800,00000000200,a2f,recvmsg
1,01792525200,01792553000,00000027800,a17,select
1,01792557000,01792557200,00000000200,a2f,recvmsg
1,01792557600,01792567500,00000009900,a17,select
1,01792571000,01792571200,00000000200,a2f,recvmsg
1,01792571700,01792579200,00000007500,a17,select
1,01792582800,01792583000,00000000200,a2f,recvmsg
1,01792583500,01792591200,00000007700,a17,select
1,01792594500,01792594700,00000000200,a2f,recvmsg
1,01792595200,01792602800,00000007600,a17,select
1,01792606400,01792606600,00000000200,a2f,recvmsg
1,01792607000,01792615400,00000008400,a17,select
1,01792618900,01792619000,00000000100,a2f,recvmsg
1,01792619600,01792627600,00000008000,a17,select
1,01792631400,01792631600,00000000200,a2f,recvmsg
1,01792632100,01792639200,00000007100,a17,select
1,01792642700,01792642800,00000000100,a2f,recvmsg
1,01792643300,01792651700,00000008400,a17,select
1,01792655600,01792655800,00000000200,a2f,recvmsg
1,01792656200,01792663800,00000007600,a17,select
1,01792667500,01792667600,00000000100,a2f,recvmsg
1,01792668200,01792675400,00000007200,a17,select
1,01792679200,01792679400,00000000200,a2f,recvmsg
1,01792679900,01792687900,00000008000,a17,select
1,01792691500,01792691700,00000000200,a2f,recvmsg
1,01792692100,01792699400,00000007300,a17,select
1,01792703000,01792703100,00000000100,a2f,recvmsg
1,01792703500,01792711100,00000007600,a17,select
1,01792714600,01792714700,00000000100,a2f,recvmsg
1,01792715100,01792722500,00000007400,a17,select
1,01792726100,01792726300,00000000200,a2f,recvmsg
1,01792726700,01792733800,00000007100,a17,select
1,01792737500,01792737600,00000000100,a2f,recvmsg
1,01792738000,01792747000,00000009000,a17,select
1,01792750500,01792750700,00000000200,a2f,recvmsg
1,01792751100,01792758000,00000006900,a17,select
1,01792761600,01792761700,00000000100,a2f,recvmsg
1,01792762200,01792769100,00000006900,a17,select
1,01792772600,01792772800,00000000200,a2f,recvmsg
1,01792773300,01792780300,00000007000,a17,select
1,01792783800,01792784000,00000000200,a2f,recvmsg
1,01792784500,01792792500,00000008000,a17,select
1,01792796100,01792796300,00000000200,a2f,recvmsg
1,01792796700,01792803800,00000007100,a17,select
1,01792807200,01792807400,00000000200,a2f,recvmsg
1,01792807900,01792815300,00000007400,a17,select
1,01792819000,01792819100,00000000100,a2f,recvmsg
1,01792819500,01792827200,00000007700,a17,select
1,01792830800,01792831000,00000000200,a2f,recvmsg
1,01792831500,01792841000,00000009500,a17,select
1,01792844900,01792845000,00000000100,a2f,recvmsg
1,01792845600,01792853300,00000007700,a17,select
1,01792856700,01792856900,00000000200,a2f,recvmsg
1,01792857400,01792864800,00000007400,a17,select
1,01792868500,01792868700,00000000200,a2f,recvmsg
1,01792869100,01792878700,00000009600,a17,select
1,01792882400,01792882500,00000000100,a2f,recvmsg
1,01792883100,01792890300,00000007200,a17,select
1,01792893700,01792893900,00000000200,a2f,recvmsg
1,01792894400,01792901700,00000007300,a17,select
1,01792905300,01792905500,00000000200,a2f,recvmsg
1,01792906000,01792914000,00000008000,a17,select
1,01792917700,01792917900,00000000200,a2f,recvmsg
1,01792918300,01792926800,00000008500,a17,select
1,01792930400,01792930600,00000000200,a2f,recvmsg
1,01792931100,01792939000,00000007900,a17,select
1,01792942700,01792942900,00000000200,a2f,recvmsg
1,01792943300,01792951000,00000007700,a17,select
1,01792954500,01792954600,00000000100,a2f,recvmsg
1,01792955200,01792962300,00000007100,a17,select
1,01792966000,01792966200,00000000200,a2f,recvmsg
1,01792966700,01792973800,00000007100,a17,select
1,01792977300,01792977500,00000000200,a2f,recvmsg
1,01792978000,01792985500,00000007500,a17,select
1,01792989100,01792989300,00000000200,a2f,recvmsg
1,01792989800,01793005900,00000016100,a17,select
1,01793009400,01793009500,00000000100,a2f,recvmsg
1,01793010000,01793039700,00000029700,a17,select
1,01793043300,01793043500,00000000200,a2f,recvmsg
1,01793043900,01793061600,00000017700,a17,select
1,01793065200,01793065400,00000000200,a2f,recvmsg
1,01793065900,01793072800,00000006900,a17,select
1,01793076400,01793076500,00000000100,a2f,recvmsg
1,01793077000,01793084000,00000007000,a17,select
1,01793087400,01793087600,00000000200,a2f,recvmsg
1,01793088100,01793094900,00000006800,a17,select
1,01793098600,01793098700,00000000100,a2f,recvmsg
1,01793099200,01793106200,00000007000,a17,select
1,01793109600,01793109800,00000000200,a2f,recvmsg
1,01793110200,01793117200,00000007000,a17,select
1,01793120800,01793121000,00000000200,a2f,recvmsg
1,01793121500,01793128400,00000006900,a17,select
1,01793131800,01793132000,00000000200,a2f,recvmsg
1,01793132500,01793139900,00000007400,a17,select
1,01793143600,01793143800,00000000200,a2f,recvmsg
1,01793144300,01793151400,00000007100,a17,select
1,01793155000,01793155100,00000000100,a2f,recvmsg
1,01793155600,01793164300,00000008700,a17,select
1,01793167800,01793167900,00000000100,a2f,recvmsg
1,01793168400,01793177600,00000009200,a17,select
1,01793181300,01793181500,00000000200,a2f,recvmsg
1,01793182000,01793189400,00000007400,a17,select
1,01793192900,01793193100,00000000200,a2f,recvmsg
1,01793193600,01793200900,00000007300,a17,select
1,01793204300,01793204500,00000000200,a2f,recvmsg
1,01793205000,01793212100,00000007100,a17,select
1,01793215500,01793215700,00000000200,a2f,recvmsg
1,01793216200,01793223400,00000007200,a17,select
1,01793226900,01793227100,00000000200,a2f,recvmsg
1,01793227600,01793235100,00000007500,a17,select
1,01793238600,01793238800,00000000200,a2f,recvmsg
1,01793239300,01793246400,00000007100,a17,select
1,01793249900,01793250100,00000000200,a2f,recvmsg
1,01793250600,01793257700,00000007100,a17,select
1,01793261300,01793261400,00000000100,a2f,recvmsg
1,01793261900,01793269300,00000007400,a17,select
1,01793272600,01793272800,00000000200,a2f,recvmsg
1,01793273300,01793280500,00000007200,a17,select
1,01793284200,01793284300,00000000100,a2f,recvmsg
1,01793284800,01793292200,00000007400,a17,select
1,01793295800,01793295900,00000000100,a2f,recvmsg
1,01793296300,01793304400,00000008100,a17,select
1,01793307900,01793308100,00000000200,a2f,recvmsg
1,01793308600,01793315800,00000007200,a17,select
1,01793319200,01793319400,00000000200,a2f,recvmsg
1,01793319900,01793327000,00000007100,a17,select
1,01793330500,01793330700,00000000200,a2f,recvmsg
1,01793331200,01793338300,00000007100,a17,select
1,01793341900,01793342100,00000000200,a2f,recvmsg
1,01793342600,01793355200,00000012600,a17,select
1,01793358900,01793359000,00000000100,a2f,recvmsg
1,01793359500,01793366800,00000007300,a17,select
1,01793370300,01793370400,00000000100,a2f,recvmsg
1,01793370900,01793378100,00000007200,a17,select
1,01793381700,01793381800,00000000100,a2f,recvmsg
1,01793382200,01793389700,00000007500,a17,select
1,01793393200,01793393300,00000000100,a2f,recvmsg
1,01793393800,01793401100,00000007300,a17,select
1,01793404600,01793404700,00000000100,a2f,recvmsg
1,01793405200,01793462200,00000057000,a17,select
1,01793463200,01793464300,00000001100,a2f,recvmsg
1,01793558300,01793562200,00000003900,a14,writev
1,01793640000,01793641500,00000001500,a14,writev
1,01793698900,01793700500,00000001600,a14,writev
1,01793759100,01793760500,00000001400,a14,writev
1,01793875400,01793877000,00000001600,a14,writev
1,01793880400,01793881200,00000000800,a2f,recvmsg
1,01793931500,01793933200,00000001700,a14,writev
1,01793977700,01793979300,00000001600,a14,writev
1,01794023600,01794025200,00000001600,a14,writev
1,01794068700,01794070400,00000001700,a14,writev
1,01794114500,01794116300,00000001800,a14,writev
1,01794159700,01794161300,00000001600,a14,writev
1,01794186200,01794188200,00000002000,a2f,recvmsg
1,01794215400,01794217000,00000001600,a14,writev
1,01794235600,01794237000,00000001400,a14,writev
1,01794253600,01794255000,00000001400,a14,writev
1,01794270600,01794272200,00000001600,a14,writev
1,01794286900,01794288400,00000001500,a14,writev
1,01794302900,01794304400,00000001500,a14,writev
1,01794309200,01794309400,00000000200,a2f,recvmsg
1,01794310100,01794310500,00000000400,a14,writev
1,01794329100,01794331000,00000001900,a14,writev
1,01794331200,01794333000,00000001800,a14,writev
1,01794333500,01794333700,00000000200,a2f,recvmsg
1,01794345100,01794346600,00000001500,a14,writev
1,01794346800,01794347800,00000001000,a14,writev
0,01784975300,01766475300,-0018500000,a17,select
0,01766490000,01766490200,00000000200,a2f,recvmsg
0,01766492100,01766501100,00000009000,a17,select
0,01766505200,01766505400,00000000200,a2f,recvmsg
0,01766505900,01766554800,00000048900,a17,select
0,01766558500,01766558700,00000000200,a2f,recvmsg
0,01701200800,01777090900,00075890100,a3d,wait4
0,01777114800,01777116700,00000001900,a00,read
0,01777118800,01777119100,00000000300,a00,read
0,01777139800,01777193500,00000053700,a07,poll
0,01777200000,01777200200,00000000200,a2f,recvmsg
0,01777201000,01777201200,00000000200,a2f,recvmsg
0,01777210600,01777225900,00000015300,a07,poll
0,01777228100,01777228300,00000000200,a2f,recvmsg
0,01777228800,01777229000,00000000200,a2f,recvmsg
0,01777233700,01777247200,00000013500,a07,poll
0,01777249300,01777249500,00000000200,a2f,recvmsg
0,01777249900,01777250100,00000000200,a2f,recvmsg
0,01777254000,01777267200,00000013200,a07,poll
0,01777269300,01777269400,00000000100,a2f,recvmsg
0,01777269700,01777269900,00000000200,a2f,recvmsg
0,01777275000,01777288300,00000013300,a07,poll
0,01777290300,01777290400,00000000100,a2f,recvmsg
0,01777290800,01777291000,00000000200,a2f,recvmsg
0,01777294300,01777301700,00000007400,a07,poll
0,01777303200,01777303300,00000000100,a2f,recvmsg
0,01777303600,01777303800,00000000200,a2f,recvmsg
0,01777304600,01777304900,00000000300,a08,lseek
0,01777315000,01777315000,00000000000,a08,lseek
0,01777318100,01777325100,00000007000,a07,poll
0,01777325200,01777345400,00000020200,a2f,recvmsg
0,01777353900,01777354100,00000000200,a2f,recvmsg
0,01777354500,01777354700,00000000200,a2f,recvmsg
0,01777360600,01777367800,00000007200,a07,poll
0,01777369200,01777369400,00000000200,a2f,recvmsg
0,01777369700,01777369900,00000000200,a2f,recvmsg
0,01777373000,01777379600,00000006600,a07,poll
0,01777380800,01777381000,00000000200,a2f,recvmsg
0,01777381300,01777381500,00000000200,a2f,recvmsg
0,01777385600,01777392400,00000006800,a07,poll
0,01777393600,01777393800,00000000200,a2f,recvmsg
0,01777394100,01777394300,00000000200,a2f,recvmsg
0,01777398200,01777404900,00000006700,a07,poll
0,01777406100,01777406200,00000000100,a2f,recvmsg
0,01777406600,01777406700,00000000100,a2f,recvmsg
0,01777410200,01777416900,00000006700,a07,poll
0,01777418200,01777418300,00000000100,a2f,recvmsg
0,01777418700,01777418900,00000000200,a2f,recvmsg
0,01777422000,01777429000,00000007000,a07,poll
0,01777430200,01777430400,00000000200,a2f,recvmsg
0,01777430700,01777430900,00000000200,a2f,recvmsg
0,01777433700,01777440300,00000006600,a07,poll
0,01777441400,01777441600,00000000200,a2f,recvmsg
0,01777441900,01777442100,00000000200,a2f,recvmsg
0,01777446200,01777453200,00000007000,a07,poll
0,01777454300,01777454500,00000000200,a2f,recvmsg
0,01777454800,01777455000,00000000200,a2f,recvmsg
0,01777458200,01777465100,00000006900,a07,poll
0,01777466300,01777466500,00000000200,a2f,recvmsg
0,01777466800,01777467000,00000000200,a2f,recvmsg
0,01777471100,01777477800,00000006700,a07,poll
0,01777478900,01777479100,00000000200,a2f,recvmsg
0,01777479400,01777479600,00000000200,a2f,recvmsg
0,01777482600,01777489500,00000006900,a07,poll
0,01777490500,01777490700,00000000200,a2f,recvmsg
0,01777491000,01777491200,00000000200,a2f,recvmsg
0,01777494100,01777500700,00000006600,a07,poll
0,01777501900,01777502000,00000000100,a2f,recvmsg
0,01777502400,01777502500,00000000100,a2f,recvmsg
0,01777505600,01777512500,00000006900,a07,poll
0,01777513600,01777513800,00000000200,a2f,recvmsg
0,01777514100,01777514300,00000000200,a2f,recvmsg
0,01777517400,01777524100,00000006700,a07,poll
0,01777525300,01777525500,00000000200,a2f,recvmsg
0,01777525800,01777525900,00000000100,a2f,recvmsg
0,01777528500,01777535400,00000006900,a07,poll
0,01777536500,01777536700,00000000200,a2f,recvmsg
0,01777537000,01777537200,00000000200,a2f,recvmsg
0,01777542700,01777549200,00000006500,a07,poll
0,01777550400,01777550600,00000000200,a2f,recvmsg
0,01777550800,01777551000,00000000200,a2f,recvmsg
0,01777553600,01777560300,00000006700,a07,poll
0,01777561500,01777561700,00000000200,a2f,recvmsg
0,01777562000,01777562100,00000000100,a2f,recvmsg
0,01777564800,01777571500,00000006700,a07,poll
0,01777572700,01777572900,00000000200,a2f,recvmsg
0,01777573200,01777573400,00000000200,a2f,recvmsg
0,01777576000,01777582900,00000006900,a07,poll
0,01777584000,01777584200,00000000200,a2f,recvmsg
0,01777584500,01777584700,00000000200,a2f,recvmsg
0,01777587600,01777594200,00000006600,a07,poll
0,01777595300,01777595500,00000000200,a2f,recvmsg
0,01777595800,01777595900,00000000100,a2f,recvmsg
0,01777598600,01777605200,00000006600,a07,poll
0,01777606300,01777606500,00000000200,a2f,recvmsg
0,01777606800,01777607000,00000000200,a2f,recvmsg
0,01777610300,01777617100,00000006800,a07,poll
0,01777618100,01777618300,00000000200,a2f,recvmsg
0,01777618600,01777618800,00000000200,a2f,recvmsg
0,01777622100,01777628700,00000006600,a07,poll
0,01777629800,01777630000,00000000200,a2f,recvmsg
0,01777630300,01777630400,00000000100,a2f,recvmsg
0,01777634300,01777641200,00000006900,a07,poll
0,01777642400,01777642600,00000000200,a2f,recvmsg
0,01777642900,01777643100,00000000200,a2f,recvmsg
0,01777646600,01777653200,00000006600,a07,poll
0,01777654300,01777654500,00000000200,a2f,recvmsg
0,01777654800,01777655000,00000000200,a2f,recvmsg
0,01777658300,01777665100,00000006800,a07,poll
0,01777666200,01777666400,00000000200,a2f,recvmsg
0,01777666600,01777666800,00000000200,a2f,recvmsg
0,01777672200,01777678800,00000006600,a07,poll
0,01777679900,01777680100,00000000200,a2f,recvmsg
0,01777680400,01777680600,00000000200,a2f,recvmsg
0,01777684200,01777690800,00000006600,a07,poll
0,01777692000,01777692100,00000000100,a2f,recvmsg
0,01777692400,01777692600,00000000200,a2f,recvmsg
0,01777695400,01777702200,00000006800,a07,poll
0,01777703200,01777703400,00000000200,a2f,recvmsg
0,01777703700,01777703900,00000000200,a2f,recvmsg
0,01777709200,01777715900,00000006700,a07,poll
0,01777717200,01777717400,00000000200,a2f,recvmsg
0,01777717700,01777717800,00000000100,a2f,recvmsg
0,01777721100,01777727700,00000006600,a07,poll
0,01777728900,01777729100,00000000200,a2f,recvmsg
0,01777729300,01777729500,00000000200,a2f,recvmsg
0,01777733100,01777739900,00000006800,a07,poll
0,01777741000,01777741100,00000000100,a2f,recvmsg
0,01777741400,01777741600,00000000200,a2f,recvmsg
0,01777745700,01777752500,00000006800,a07,poll
0,01777753800,01777753900,00000000100,a2f,recvmsg
0,01777754100,01777754300,00000000200,a2f,recvmsg
0,01777757500,01777764200,00000006700,a07,poll
0,01777765300,01777765500,00000000200,a2f,recvmsg
0,01777765800,01777766000,00000000200,a2f,recvmsg
0,01777769000,01777775500,00000006500,a07,poll
0,01777776700,01777776800,00000000100,a2f,recvmsg
0,01777777100,01777777300,00000000200,a2f,recvmsg
0,01777780500,01777787400,00000006900,a07,poll
0,01777788500,01777788700,00000000200,a2f,recvmsg
0,01777789000,01777789200,00000000200,a2f,recvmsg
0,01777790200,01777790400,00000000200,a08,lseek
0,01777793900,01777798300,00000004400,a00,read
0,01777802100,01777802200,00000000100,a08,lseek
0,01777805200,01777811800,00000006600,a07,poll
0,01777813200,01777813400,00000000200,a2f,recvmsg
0,01777813700,01777813900,00000000200,a2f,recvmsg
0,01777839500,01777846400,00000006900,a07,poll
0,01777847700,01777847900,00000000200,a2f,recvmsg
0,01777848200,01777848400,00000000200,a2f,recvmsg
0,01777852100,01777852900,00000000800,a00,read
0,01777858400,01777858400,00000000000,a08,lseek
0,01777861900,01777868700,00000006800,a07,poll
0,01777869900,01777870100,00000000200,a2f,recvmsg
0,01777870400,01777870600,00000000200,a2f,recvmsg
0,01777873300,01777880000,00000006700,a07,poll
0,01777881100,01777881200,00000000100,a2f,recvmsg
0,01777881500,01777881700,00000000200,a2f,recvmsg
0,01777884400,01777891000,00000006600,a07,poll
0,01777892100,01777892300,00000000200,a2f,recvmsg
0,01777892600,01777892700,00000000100,a2f,recvmsg
0,01777895500,01777902100,00000006600,a07,poll
0,01777903300,01777903400,00000000100,a2f,recvmsg
0,01777903700,01777903900,00000000200,a2f,recvmsg
0,01777906400,01777913200,00000006800,a07,poll
0,01777914200,01777914400,00000000200,a2f,recvmsg
0,01777914700,01777914900,00000000200,a2f,recvmsg
0,01777917400,01777924100,00000006700,a07,poll
0,01777925200,01777925400,00000000200,a2f,recvmsg
0,01777925700,01777925900,00000000200,a2f,recvmsg
0,01777928500,01777935200,00000006700,a07,poll
0,01777936300,01777936500,00000000200,a2f,recvmsg
0,01777936800,01777936900,00000000100,a2f,recvmsg
0,01777940200,01777947100,00000006900,a07,poll
0,01777948100,01777948300,00000000200,a2f,recvmsg
0,01777948600,01777948800,00000000200,a2f,recvmsg
0,01777951500,01777958300,00000006800,a07,poll
0,01777959400,01777959600,00000000200,a2f,recvmsg
0,01777959900,01777960100,00000000200,a2f,recvmsg
0,01777960500,01777960600,00000000100,a08,lseek
0,01777964800,01777971500,00000006700,a07,poll
0,01777972700,01777972900,00000000200,a2f,recvmsg
0,01777973200,01777973400,00000000200,a2f,recvmsg
0,01777978100,01777984900,00000006800,a07,poll
0,01777986000,01777986200,00000000200,a2f,recvmsg
0,01777986500,01777986700,00000000200,a2f,recvmsg
0,01777990100,01777996800,00000006700,a07,poll
0,01777997800,01777998000,00000000200,a2f,recvmsg
0,01777998300,01777998500,00000000200,a2f,recvmsg
0,01778001400,01778008200,00000006800,a07,poll
0,01778009300,01778009500,00000000200,a2f,recvmsg
0,01778009800,01778010000,00000000200,a2f,recvmsg
0,01778012800,01778019300,00000006500,a07,poll
0,01778020600,01778020800,00000000200,a2f,recvmsg
0,01778021100,01778021300,00000000200,a2f,recvmsg
0,01778024100,01778030900,00000006800,a07,poll
0,01778032000,01778032200,00000000200,a2f,recvmsg
0,01778032500,01778032700,00000000200,a2f,recvmsg
0,01778036100,01778042800,00000006700,a07,poll
0,01778044000,01778044200,00000000200,a2f,recvmsg
0,01778044500,01778044600,00000000100,a2f,recvmsg
0,01778047600,01778054200,00000006600,a07,poll
0,01778055400,01778055500,00000000100,a2f,recvmsg
0,01778055900,01778056000,00000000100,a2f,recvmsg
0,01778058900,01778065500,00000006600,a07,poll
0,01778066700,01778066900,00000000200,a2f,recvmsg
0,01778067200,01778067400,00000000200,a2f,recvmsg
0,01778070300,01778076900,00000006600,a07,poll
0,01778078200,01778078300,00000000100,a2f,recvmsg
0,01778078700,01778078800,00000000100,a2f,recvmsg
0,01778081800,01778088300,00000006500,a07,poll
0,01778089400,01778089500,00000000100,a2f,recvmsg
0,01778089900,01778090100,00000000200,a2f,recvmsg
0,01778093100,01778099600,00000006500,a07,poll
0,01778100600,01778100800,00000000200,a2f,recvmsg
0,01778101100,01778101300,00000000200,a2f,recvmsg
0,01778104800,01778111700,00000006900,a07,poll
0,01778112900,01778113000,00000000100,a2f,recvmsg
0,01778113300,01778113500,00000000200,a2f,recvmsg
0,01778116600,01778123200,00000006600,a07,poll
0,01778124300,01778124400,00000000100,a2f,recvmsg
0,01778124700,01778124900,00000000200,a2f,recvmsg
0,01778127900,01778134600,00000006700,a07,poll
0,01778135700,01778135800,00000000100,a2f,recvmsg
0,01778136100,01778136300,00000000200,a2f,recvmsg
0,01778139300,01778145900,00000006600,a07,poll
0,01778147200,01778147200,00000000000,a2f,recvmsg
0,01778147500,01778147700,00000000200,a2f,recvmsg
0,01778154900,01804426300,00026271400,a07,poll
0,01804433400,01804466100,00000032700,a07,poll
0,01804469400,01804469700,00000000300,a2f,recvmsg
0,01804470200,01804470400,00000000200,a2f,recvmsg
0,01804472600,01804479300,00000006700,a07,poll
0,01804480500,01804480700,00000000200,a2f,recvmsg
0,01804481000,01804481200,00000000200,a2f,recvmsg
0,01804486900,01804494300,00000007400,a06,lstat
0,01804495100,01804496100,00000001000,a06,lstat
0,01804519000,01804533800,00000014800,a01,write
0,01804540100,01804547300,00000007200,a07,poll
0,01804549300,01804549500,00000000200,a2f,recvmsg
0,01804549900,01804550100,00000000200,a2f,recvmsg
0,01804551500,01804864800,00000313300,a38,clone
0,01805392200,01805392400,00000000200,a0c,brk
0,01805402800,01805405700,00000002900,a15,access
0,01805406400,01805407500,00000001100,a09,mmap
0,01805412500,01805413300,00000000800,a15,access
0,01805420100,01805421200,00000001100,a09,mmap
0,01805425000,01805425500,00000000500,a15,access
0,01805432400,01805433700,00000001300,a00,read
0,01805435300,01805436800,00000001500,a09,mmap
0,01805440700,01805442800,00000002100,a09,mmap
0,01805453100,01805453800,00000000700,a15,access
0,01805456900,01805457600,00000000700,a00,read
0,01805458300,01805459200,00000000900,a09,mmap
0,01805461900,01805463200,00000001300,a09,mmap
0,01805471200,01805471700,00000000500,a15,access
0,01805474200,01805474700,00000000500,a00,read
0,01805475300,01805476200,00000000900,a09,mmap
0,01805484100,01805487000,00000002900,a09,mmap
0,01805489100,01805490100,00000001000,a09,mmap
0,01805498900,01805499500,00000000600,a15,access
0,01805501900,01805502600,00000000700,a00,read
0,01805503300,01805504800,00000001500,a09,mmap
0,01805508100,01805509800,00000001700,a09,mmap
0,01805518000,01805518500,00000000500,a15,access
0,01805521700,01805522300,00000000600,a00,read
0,01805522900,01805524400,00000001500,a09,mmap
0,01805528300,01805530300,00000002000,a09,mmap
0,01805538700,01805539300,00000000600,a15,access
0,01805541900,01805542500,00000000600,a00,read
0,01805543000,01805544000,00000001000,a09,mmap
0,01805545200,01805546600,00000001400,a09,mmap
0,01805550200,01805551400,00000001200,a09,mmap
0,01805557500,01805558100,00000000600,a15,access
0,01805560600,01805561100,00000000500,a00,read
0,01805566000,01805567700,00000001700,a09,mmap
0,01805585100,01805585600,00000000500,a09,mmap
0,01805589500,01805589800,00000000300,a09,mmap
0,01805591000,01805591200,00000000200,a09,mmap
0,01805767800,01805767900,00000000100,a0c,brk
0,01805768000,01805769000,00000001000,a0c,brk
0,01805797200,01805802700,00000005500,a00,read
0,01805814500,01805815900,00000001400,a00,read
0,01805852900,01805853800,00000000900,a00,read
0,01805974000,01805974600,00000000600,a00,read
0,01806046200,01806046700,00000000500,a00,read
0,01806132200,01806132800,00000000600,a00,read
0,01806263600,01806264700,00000001100,a00,read
0,01804540100,01806325700,00001785600,a07,poll
0,01806354900,01806355100,00000000200,a00,read
0,01806364900,01806369700,00000004800,aca,futex
0,01806373600,01806375000,00000001400,a2e,sendmsg
0,01806463200,01806464400,00000001200,a00,read
0,01806621500,01806622400,00000000900,a00,read
0,01806773700,01806774600,00000000900,a00,read
0,01806812400,01806814600,00000002200,a0c,brk
0,01806931200,01806932000,00000000800,a00,read
0,01806382100,01807048200,00000666100,a07,poll
0,01807048800,01807049000,00000000200,a00,read
0,01807056900,01807058200,00000001300,a2f,recvmsg
0,01807162400,01807163800,00000001400,a00,read
0,01807321900,01807322700,00000000800,a00,read
0,01807482700,01807483300,00000000600,a00,read
0,01807592400,01807593100,00000000700,a00,read
0,01807623800,01807625500,00000001700,a0c,brk
0,01807733800,01807734500,00000000700,a00,read
0,01807993400,01807994100,00000000700,a00,read
0,01808005900,01808006300,00000000400,a00,read
0,01808051000,01808051300,00000000300,a00,read
0,01808070800,01808071500,00000000700,a00,read
0,01808282200,01808282700,00000000500,a00,read
0,01808312300,01808313300,00000001000,a00,read
0,01808410600,01808411400,00000000800,a00,read
0,01808435300,01808436600,00000001300,a0c,brk
0,01808481800,01808482200,00000000400,a00,read
0,01808557700,01808558600,00000000900,a00,read
0,01808711800,01808712300,00000000500,a00,read
0,01808826100,01808826800,00000000700,a00,read
0,01808920800,01808921300,00000000500,a00,read
0,01808933600,01808934100,00000000500,a00,read
0,01809046800,01809047200,00000000400,a00,read
0,01809071600,01809071800,00000000200,a00,read
0,01809094200,01809094600,00000000400,a00,read
0,01809197200,01809198500,00000001300,a0c,brk
0,01809200000,01809201000,00000001000,a00,read
0,01809401900,01809402200,00000000300,a00,read
0,01809484900,01809485500,00000000600,a00,read
0,01809549200,01809549900,00000000700,a00,read
0,01809680900,01809681300,00000000400,a00,read
0,01809713200,01809713800,00000000600,a00,read
0,01809731100,01809732500,00000001400,a02,open
0,01809847400,01809847900,00000000500,a00,read
0,01809918300,01809918800,00000000500,a00,read
0,01809971200,01809972200,00000001000,a0c,brk
0,01809978100,01809978900,00000000800,a00,read
0,01810085900,01810086500,00000000600,a00,read
0,01810239700,01810240700,00000001000,a00,read
0,01810371400,01810372100,00000000700,a00,read
0,01810429600,01810430300,00000000700,a00,read
0,01810485900,01810486600,00000000700,a00,read
0,01810556400,01810557100,00000000700,a00,read
0,01810609600,01810610400,00000000800,a00,read
0,01810698400,01810699200,00000000800,a0c,brk
0,01810729200,01810734700,00000005500,a0c,brk
0,01810748700,01810749500,00000000800,a00,read
0,01810864100,01810865100,00000001000,a00,read
0,01811022400,01811023000,00000000600,a00,read
0,01811139900,01811140600,00000000700,a00,read
0,01811287200,01811287900,00000000700,a00,read
0,01811404800,01811405400,00000000600,a00,read
0,01811566700,01811567600,00000000900,a00,read
0,01811572600,01811573400,00000000800,a0c,brk
0,01811688200,01811688900,00000000700,a00,read
0,01811806500,01811807200,00000000700,a00,read
0,01811947900,01811948600,00000000700,a00,read
0,01812080300,01812081000,00000000700,a00,read
0,01812173500,01812174200,00000000700,a00,read
0,01812286000,01812286700,00000000700,a00,read
0,01812410100,01812410700,00000000600,a00,read
0,01812521400,01812522000,00000000600,a0c,brk
0,01812544600,01812545100,00000000500,a00,read
0,01812713900,01812714500,00000000600,a00,read
0,01812866200,01812866800,00000000600,a00,read
0,01812994000,01812994800,00000000800,a00,read
0,01813163200,01813164100,00000000900,a00,read
0,01813240700,01813241500,00000000800,a00,read
0,01813322900,01813323600,00000000700,a00,read
0,01813404700,01813405300,00000000600,a00,read
0,01813477300,01813477900,00000000600,a00,read
0,01813578900,01813579600,00000000700,a00,read
0,01813683400,01813684100,00000000700,a00,read
0,01813773400,01813774000,00000000600,a00,read
0,01813854700,01813855300,00000000600,a00,read
0,01813956300,01813956900,00000000600,a00,read
0,01814037800,01814038200,00000000400,a0c,brk
0,01814042000,01814042800,00000000800,a00,read
0,01814149100,01814149800,00000000700,a00,read
0,01814243400,01814244000,00000000600,a00,read
0,01814362700,01814363300,00000000600,a00,read
0,01814476500,01814477100,00000000600,a00,read
0,01814579500,01814580100,00000000600,a00,read
0,01814679300,01814679600,00000000300,a0c,brk
0,01815040000,01815043800,00000003800,a57,unlink
0,01815068400,01815069000,00000000600,a48,fcntl
0,01815117400,01815131800,00000014400,a01,write
0,01815149600,01815152100,00000002500,a01,write
0,01815168100,01815170200,00000002100,a01,write
0,01766559200,01815410500,00048851300,a17,select
0,01815435800,01815436000,00000000200,a2f,recvmsg
0,01815439400,01815459700,00000020300,a17,select
0,01815463600,01815463800,00000000200,a2f,recvmsg
0,01815464400,01815479000,00000014600,a17,select
0,01815482700,01815482900,00000000200,a2f,recvmsg
0,01815483500,01815498800,00000015300,a17,select
0,01815502600,01815502700,00000000100,a2f,recvmsg
0,01815503200,01815518200,00000015000,a17,select
0,01815522100,01815522200,00000000100,a2f,recvmsg
0,01815522700,01815537000,00000014300,a17,select
0,01815540600,01815540800,00000000200,a2f,recvmsg
0,01815541300,01815559200,00000017900,a17,select
0,01815563400,01815563600,00000000200,a2f,recvmsg
0,01815564000,01815573800,00000009800,a17,select
0,01815577500,01815577700,00000000200,a2f,recvmsg
0,01815578200,01815585800,00000007600,a17,select
0,01815589200,01815589400,00000000200,a2f,recvmsg
0,01815589900,01815597500,00000007600,a17,select
0,01815600900,01815601100,00000000200,a2f,recvmsg
0,01815601600,01815609200,00000007600,a17,select
0,01815612900,01815613100,00000000200,a2f,recvmsg
0,01815613500,01815621300,00000007800,a17,select
0,01815624800,01815625000,00000000200,a2f,recvmsg
0,01815625500,01815633700,00000008200,a17,select
0,01815637700,01815637900,00000000200,a2f,recvmsg
0,01815638300,01815645500,00000007200,a17,select
0,01815648900,01815649100,00000000200,a2f,recvmsg
0,01815649600,01815658100,00000008500,a17,select
0,01815662000,01815662200,00000000200,a2f,recvmsg
0,01815662700,01815670200,00000007500,a17,select
0,01815673900,01815674100,00000000200,a2f,recvmsg
0,01815674600,01815681800,00000007200,a17,select
0,01815685500,01815685600,00000000100,a2f,recvmsg
0,01815686100,01815693300,00000007200,a17,select
0,01815697000,01815697100,00000000100,a2f,recvmsg
0,01815697700,01815704900,00000007200,a17,select
0,01815708500,01815708600,00000000100,a2f,recvmsg
0,01815709200,01815716500,00000007300,a17,select
0,01815720200,01815720300,00000000100,a2f,recvmsg
0,01815720900,01815728200,00000007300,a17,select
0,01815731700,01815731900,00000000200,a2f,recvmsg
0,01815732400,01815739100,00000006700,a17,select
0,01815742900,01815743100,00000000200,a2f,recvmsg
0,01815743600,01815753400,00000009800,a17,select
0,01815757000,01815757200,00000000200,a2f,recvmsg
0,01815757700,01815764600,00000006900,a17,select
0,01815768200,01815768400,00000000200,a2f,recvmsg
0,01815768900,01815775700,00000006800,a17,select
0,01815779300,01815779500,00000000200,a2f,recvmsg
0,01815780000,01815786800,00000006800,a17,select
0,01815790500,01815790600,00000000100,a2f,recvmsg
0,01815791200,01815798400,00000007200,a17,select
0,01815801900,01815802100,00000000200,a2f,recvmsg
0,01815802600,01815809700,00000007100,a17,select
0,01815813200,01815813400,00000000200,a2f,recvmsg
0,01815813900,01815821400,00000007500,a17,select
0,01815825000,01815825100,00000000100,a2f,recvmsg
0,01815825700,01815833200,00000007500,a17,select
0,01815836800,01815837000,00000000200,a2f,recvmsg
0,01815837500,01815847600,00000010100,a17,select
0,01815851500,01815851600,00000000100,a2f,recvmsg
0,01815852200,01815859900,00000007700,a17,select
0,01815863400,01815863500,00000000100,a2f,recvmsg
0,01815864100,01815871700,00000007600,a17,select
0,01815875500,01815875600,00000000100,a2f,recvmsg
0,01815876100,01815885600,00000009500,a17,select
0,01815889300,01815889500,00000000200,a2f,recvmsg
0,01815890000,01815897200,00000007200,a17,select
0,01815900700,01815900900,00000000200,a2f,recvmsg
0,01815901400,01815908700,00000007300,a17,select
0,01815912300,01815912500,00000000200,a2f,recvmsg
0,01815913000,01815921800,00000008800,a17,select
0,01815925500,01815925700,00000000200,a2f,recvmsg
0,01815926200,01815933700,00000007500,a17,select
0,01815937400,01815937600,00000000200,a2f,recvmsg
0,01815938200,01815946100,00000007900,a17,select
0,01815949700,01815949900,00000000200,a2f,recvmsg
0,01815950500,01815958200,00000007700,a17,select
0,01815961900,01815962100,00000000200,a2f,recvmsg
0,01815962600,01815969700,00000007100,a17,select
0,01815973300,01815973400,00000000100,a2f,recvmsg
0,01815974000,01815981000,00000007000,a17,select
0,01815984500,01815984700,00000000200,a2f,recvmsg
0,01815985200,01815992900,00000007700,a17,select
0,01815996600,01815996800,00000000200,a2f,recvmsg
0,01815997200,01816012300,00000015100,a17,select
0,01816015900,01816016100,00000000200,a2f,recvmsg
0,01816016600,01816046600,00000030000,a17,select
0,01816050300,01816050400,00000000100,a2f,recvmsg
0,01816051000,01816068500,00000017500,a17,select
0,01816072100,01816072300,00000000200,a2f,recvmsg
0,01816072800,01816080000,00000007200,a17,select
0,01816083600,01816083800,00000000200,a2f,recvmsg
0,01816084400,01816091200,00000006800,a17,select
0,01816094700,01816094900,00000000200,a2f,recvmsg
0,01816095400,01816102400,00000007000,a17,select
0,01816105900,01816106100,00000000200,a2f,recvmsg
0,01816106600,01816113500,00000006900,a17,select
0,01816116900,01816117100,00000000200,a2f,recvmsg
0,01816117600,01816124600,00000007000,a17,select
0,01816128200,01816128400,00000000200,a2f,recvmsg
0,01816128900,01816135700,00000006800,a17,select
0,01816139200,01816139400,00000000200,a2f,recvmsg
0,01816139800,01816147400,00000007600,a17,select
0,01816151000,01816151200,00000000200,a2f,recvmsg
0,01816151700,01816158700,00000007000,a17,select
0,01816162300,01816162400,00000000100,a2f,recvmsg
0,01816163000,01816171700,00000008700,a17,select
0,01816175300,01816175400,00000000100,a2f,recvmsg
0,01816175900,01816185200,00000009300,a17,select
0,01816188800,01816189000,00000000200,a2f,recvmsg
0,01816189400,01816197100,00000007700,a17,select
0,01816200500,01816200700,00000000200,a2f,recvmsg
0,01816201200,01816208600,00000007400,a17,select
0,01816212300,01816212400,00000000100,a2f,recvmsg
0,01816213000,01816220200,00000007200,a17,select
0,01816223600,01816223800,00000000200,a2f,recvmsg
0,01816224400,01816231600,00000007200,a17,select
0,01816235100,01816235300,00000000200,a2f,recvmsg
0,01816235900,01816243400,00000007500,a17,select
0,01816247000,01816247100,00000000100,a2f,recvmsg
0,01816247700,01816254900,00000007200,a17,select
0,01816258300,01816258500,00000000200,a2f,recvmsg
0,01816259000,01816266200,00000007200,a17,select
0,01816269700,01816269900,00000000200,a2f,recvmsg
0,01816270500,01816277700,00000007200,a17,select
0,01816281300,01816281400,00000000100,a2f,recvmsg
0,01816282000,01816289100,00000007100,a17,select
0,01816292500,01816292700,00000000200,a2f,recvmsg
0,01816293200,01816300400,00000007200,a17,select
0,01816303900,01816304100,00000000200,a2f,recvmsg
0,01816304600,01816312600,00000008000,a17,select
0,01816316300,01816316400,00000000100,a2f,recvmsg
0,01816317000,01816324100,00000007100,a17,select
0,01816327700,01816327800,00000000100,a2f,recvmsg
0,01816328300,01816335500,00000007200,a17,select
0,01816339100,01816339100,00000000000,a2f,recvmsg
0,01816339700,01816346700,00000007000,a17,select
0,01816350400,01816350500,00000000100,a2f,recvmsg
0,01816351000,01816363700,00000012700,a17,select
0,01816367300,01816367400,00000000100,a2f,recvmsg
0,01816367900,01816375300,00000007400,a17,select
0,01816378900,01816379000,00000000100,a2f,recvmsg
0,01816379500,01816386600,00000007100,a17,select
0,01816390400,01816390400,00000000000,a2f,recvmsg
0,01816391000,01816398300,00000007300,a17,select
0,01816401800,01816401900,00000000100,a2f,recvmsg
0,01816402500,01816409900,00000007400,a17,select
0,01816413500,01816413700,00000000200,a2f,recvmsg
0,01816414200,01816469900,00000055700,a17,select
0,01816470800,01816472100,00000001300,a2f,recvmsg
0,01816878600,01816879300,00000000700,a2f,recvmsg
0,01817193700,01817195800,00000002100,a2f,recvmsg
0,01817309700,01817309900,00000000200,a2f,recvmsg
0,01817310400,01817310900,00000000500,a14,writev
0,01817329100,01817331400,00000002300,a14,writev
0,01817331700,01817333100,00000001400,a14,writev
0,01817333600,01817333800,00000000200,a2f,recvmsg
0,01807118500,01817342300,00010223800,a07,poll
0,01817348100,01817350900,00000002800,a2f,recvmsg
0,01817356400,01817356600,00000000200,a2f,recvmsg
0,01817360000,01817360200,00000000200,a2f,recvmsg
0,01817360500,01817360600,00000000100,a2f,recvmsg
0,01817365100,01817365200,00000000100,a2f,recvmsg
0,01817365300,01817365500,00000000200,a2f,recvmsg
0,01817366200,01817370300,00000004100,a07,poll
0,01817374400,01817380900,00000006500,a2f,recvmsg
0,01817391900,01817392000,00000000100,a2f,recvmsg
0,01817418600,01817423400,00000004800,a07,poll
0,01817429000,01817435300,00000006300,a2f,recvmsg
0,01817448100,01817448300,00000000200,a2f,recvmsg
0,01817470600,01817474800,00000004200,a07,poll
0,01817480500,01817487100,00000006600,a2f,recvmsg
0,01817499300,01817499500,00000000200,a2f,recvmsg
0,01817334600,01817527600,00000193000,a17,select
0,01817544300,01817545800,00000001500,a14,writev
0,01817546400,01817546600,00000000200,a2f,recvmsg
0,01817561100,01817562100,00000001000,a14,writev
0,01817562500,01817562700,00000000200,a2f,recvmsg
0,01817574600,01817575500,00000000900,a14,writev
0,01817575800,01817576000,00000000200,a2f,recvmsg
0,01817590700,01817590900,00000000200,a2f,recvmsg
0,01817522000,01817595500,00000073500,a07,poll
0,01817599000,01817599200,00000000200,a2f,recvmsg
0,01817600800,01817600900,00000000100,a2f,recvmsg
0,01817601200,01817601400,00000000200,a2f,recvmsg
0,01817602600,01817602800,00000000200,a2f,recvmsg
0,01817603000,01817603100,00000000100,a2f,recvmsg
0,01817603600,01817605000,00000001400,a07,poll
0,01817606000,01817607100,00000001100,a2f,recvmsg
0,01817612100,01817612900,00000000800,a2d,recvfrom
0,01817613800,01817614000,00000000200,a2f,recvmsg
0,01817614700,01817614800,00000000100,a2f,recvmsg
0,01817656000,01817656200,00000000200,a2f,recvmsg
0,01817658400,01817658600,00000000200,a2f,recvmsg
0,01817660700,01817662900,00000002200,a07,poll
0,01817663400,01817664600,00000001200,a2f,recvmsg
0,01817670600,01817671200,00000000600,a2d,recvfrom
0,01817672200,01817672400,00000000200,a2f,recvmsg
0,01817673000,01817673200,00000000200,a2f,recvmsg
0,01817703600,01817703800,00000000200,a2f,recvmsg
0,01817705700,01817705900,00000000200,a2f,recvmsg
0,01817591400,01819493100,00001901700,a17,select
0,01819506400,01819506600,00000000200,a2f,recvmsg
0,01819508300,01819517600,00000009300,a17,select
0,01819521600,01819521800,00000000200,a2f,recvmsg
0,01819522300,01819571500,00000049200,a17,select
0,01819575200,01819575300,00000000100,a2f,recvmsg
0,01804884600,01830214500,00025329900,a3d,wait4
0,01830237400,01830239400,00000002000,a00,read
0,01830241400,01830241700,00000000300,a00,read
0,01830262300,01830315000,00000052700,a07,poll
0,01830321000,01830321200,00000000200,a2f,recvmsg
0,01830322100,01830322300,00000000200,a2f,recvmsg
0,01830332000,01830347300,00000015300,a07,poll
0,01830349500,01830349700,00000000200,a2f,recvmsg
0,01830350000,01830350200,00000000200,a2f,recvmsg
0,01830354800,01830368200,00000013400,a07,poll
0,01830370300,01830370400,00000000100,a2f,recvmsg
0,01830370700,01830370900,00000000200,a2f,recvmsg
0,01830375800,01830389100,00000013300,a07,poll
0,01830391100,01830391200,00000000100,a2f,recvmsg
0,01830391500,01830391700,00000000200,a2f,recvmsg
0,01830395700,01830408900,00000013200,a07,poll
0,01830410900,01830411100,00000000200,a2f,recvmsg
0,01830411500,01830411600,00000000100,a2f,recvmsg
0,01830416000,01830429100,00000013100,a07,poll
0,01830431200,01830431400,00000000200,a2f,recvmsg
0,01830431700,01830431900,00000000200,a2f,recvmsg
0,01830433700,01830434000,00000000300,a08,lseek
0,01830444600,01830444700,00000000100,a08,lseek
0,01830447800,01830454900,00000007100,a07,poll
0,01830456100,01830456300,00000000200,a2f,recvmsg
0,01830456600,01830456800,00000000200,a2f,recvmsg
0,01830462300,01830468900,00000006600,a07,poll
0,01830470100,01830470300,00000000200,a2f,recvmsg
0,01830470600,01830470800,00000000200,a2f,recvmsg
0,01830474000,01830480700,00000006700,a07,poll
0,01830481900,01830482100,00000000200,a2f,recvmsg
0,01830482400,01830482600,00000000200,a2f,recvmsg
0,01830486000,01830492400,00000006400,a07,poll
0,01830493700,01830493800,00000000100,a2f,recvmsg
0,01830494100,01830494300,00000000200,a2f,recvmsg
0,01830497600,01830504200,00000006600,a07,poll
0,01830505400,01830505500,00000000100,a2f,recvmsg
0,01830505800,01830506000,00000000200,a2f,recvmsg
0,01830510400,01830516800,00000006400,a07,poll
0,01830517900,01830518100,00000000200,a2f,recvmsg
0,01830518400,01830518600,00000000200,a2f,recvmsg
0,01830522400,01830529300,00000006900,a07,poll
0,01830530400,01830530600,00000000200,a2f,recvmsg
0,01830530900,01830531100,00000000200,a2f,recvmsg
0,01830534000,01830540600,00000006600,a07,poll
0,01830541700,01830541900,00000000200,a2f,recvmsg
0,01830542200,01830542400,00000000200,a2f,recvmsg
0,01830546500,01830553400,00000006900,a07,poll
0,01830554600,01830554800,00000000200,a2f,recvmsg
0,01830555000,01830555200,00000000200,a2f,recvmsg
0,01830558600,01830565400,00000006800,a07,poll
0,01830566500,01830566600,00000000100,a2f,recvmsg
0,01830567000,01830567100,00000000100,a2f,recvmsg
0,01830571100,01830577100,00000006000,a07,poll
0,01830578200,01830578400,00000000200,a2f,recvmsg
0,01830578700,01830578900,00000000200,a2f,recvmsg
0,01830582700,01830589300,00000006600,a07,poll
0,01830590500,01830590700,00000000200,a2f,recvmsg
0,01830591000,01830591100,00000000100,a2f,recvmsg
0,01830594200,01830600800,00000006600,a07,poll
0,01830601900,01830602100,00000000200,a2f,recvmsg
0,01830602400,01830602500,00000000100,a2f,recvmsg
0,01830605800,01830612400,00000006600,a07,poll
0,01830613500,01830613700,00000000200,a2f,recvmsg
0,01830613900,01830614100,00000000200,a2f,recvmsg
0,01830617300,01830623900,00000006600,a07,poll
0,01830625200,01830625300,00000000100,a2f,recvmsg
0,01830625600,01830625700,00000000100,a2f,recvmsg
0,01830628500,01830635300,00000006800,a07,poll
0,01830636400,01830636600,00000000200,a2f,recvmsg
0,01830636800,01830637000,00000000200,a2f,recvmsg
0,01830641600,01830648300,00000006700,a07,poll
0,01830649500,01830649600,00000000100,a2f,recvmsg
0,01830649900,01830650000,00000000100,a2f,recvmsg
0,01830652700,01830659400,00000006700,a07,poll
0,01830660500,01830660700,00000000200,a2f,recvmsg
0,01830661000,01830661200,00000000200,a2f,recvmsg
0,01830663800,01830670600,00000006800,a07,poll
0,01830671700,01830671900,00000000200,a2f,recvmsg
0,01830672200,01830672400,00000000200,a2f,recvmsg
0,01830675000,01830681700,00000006700,a07,poll
0,01830682800,01830683000,00000000200,a2f,recvmsg
0,01830683300,01830683500,00000000200,a2f,recvmsg
0,01830687200,01830693900,00000006700,a07,poll
0,01830695100,01830695300,00000000200,a2f,recvmsg
0,01830695500,01830695700,00000000200,a2f,recvmsg
0,01830698500,01830705000,00000006500,a07,poll
0,01830706100,01830706300,00000000200,a2f,recvmsg
0,01830706600,01830706800,00000000200,a2f,recvmsg
0,01830710000,01830716800,00000006800,a07,poll
0,01830718000,01830718200,00000000200,a2f,recvmsg
0,01830718400,01830718600,00000000200,a2f,recvmsg
0,01830722000,01830728700,00000006700,a07,poll
0,01830729800,01830730000,00000000200,a2f,recvmsg
0,01830730300,01830730500,00000000200,a2f,recvmsg
0,01830735700,01830742800,00000007100,a07,poll
0,01830743800,01830744000,00000000200,a2f,recvmsg
0,01830744300,01830744500,00000000200,a2f,recvmsg
0,01830748100,01830754500,00000006400,a07,poll
0,01830755700,01830755800,00000000100,a2f,recvmsg
0,01830756100,01830756300,00000000200,a2f,recvmsg
0,01830759600,01830766300,00000006700,a07,poll
0,01830767600,01830767700,00000000100,a2f,recvmsg
0,01830767900,01830768100,00000000200,a2f,recvmsg
0,01830773500,01830780300,00000006800,a07,poll
0,01830781400,01830781500,00000000100,a2f,recvmsg
0,01830781900,01830782100,00000000200,a2f,recvmsg
0,01830785000,01830791700,00000006700,a07,poll
0,01830792700,01830792900,00000000200,a2f,recvmsg
0,01830793200,01830793400,00000000200,a2f,recvmsg
0,01830796500,01830803200,00000006700,a07,poll
0,01830804300,01830804500,00000000200,a2f,recvmsg
0,01830804800,01830805000,00000000200,a2f,recvmsg
0,01830808800,01830815500,00000006700,a07,poll
0,01830816800,01830817000,00000000200,a2f,recvmsg
0,01830817200,01830817400,00000000200,a2f,recvmsg
0,01830821500,01830828300,00000006800,a07,poll
0,01830829400,01830829500,00000000100,a2f,recvmsg
0,01830829800,01830830000,00000000200,a2f,recvmsg
0,01830833600,01830840500,00000006900,a07,poll
0,01830841700,01830841800,00000000100,a2f,recvmsg
0,01830842100,01830842300,00000000200,a2f,recvmsg
0,01830845800,01830852400,00000006600,a07,poll
0,01830853400,01830853600,00000000200,a2f,recvmsg
0,01830853900,01830854100,00000000200,a2f,recvmsg
0,01830857100,01830863900,00000006800,a07,poll
0,01830865000,01830865200,00000000200,a2f,recvmsg
0,01830865500,01830865700,00000000200,a2f,recvmsg
0,01830868500,01830875200,00000006700,a07,poll
0,01830876300,01830876400,00000000100,a2f,recvmsg
0,01830876700,01830876900,00000000200,a2f,recvmsg
0,01830880200,01830887000,00000006800,a07,poll
0,01830888000,01830888200,00000000200,a2f,recvmsg
0,01830888500,01830888700,00000000200,a2f,recvmsg
0,01830889600,01830889700,00000000100,a08,lseek
0,01830892700,01830894100,00000001400,a00,read
0,01830897800,01830897900,00000000100,a08,lseek
0,01830900700,01830907300,00000006600,a07,poll
0,01830908500,01830908700,00000000200,a2f,recvmsg
0,01830909000,01830909200,00000000200,a2f,recvmsg
0,01830934500,01830941100,00000006600,a07,poll
0,01830942500,01830942500,00000000000,a2f,recvmsg
0,01830942900,01830943000,00000000100,a2f,recvmsg
0,01830946800,01830947600,00000000800,a00,read
0,01830953000,01830953100,00000000100,a08,lseek
0,01830956400,01830963100,00000006700,a07,poll
0,01830964200,01830964400,00000000200,a2f,recvmsg
0,01830964800,01830965000,00000000200,a2f,recvmsg
0,01830967600,01830974300,00000006700,a07,poll
0,01830975300,01830975500,00000000200,a2f,recvmsg
0,01830975800,01830976000,00000000200,a2f,recvmsg
0,01830978700,01830985300,00000006600,a07,poll
0,01830986300,01830986500,00000000200,a2f,recvmsg
0,01830986800,01830987000,00000000200,a2f,recvmsg
0,01830989600,01830996400,00000006800,a07,poll
0,01830997600,01830997700,00000000100,a2f,recvmsg
0,01830998000,01830998200,00000000200,a2f,recvmsg
0,01831000900,01831007400,00000006500,a07,poll
0,01831008600,01831008800,00000000200,a2f,recvmsg
0,01831009000,01831009200,00000000200,a2f,recvmsg
0,01831011900,01831018600,00000006700,a07,poll
0,01831019700,01831019900,00000000200,a2f,recvmsg
0,01831020200,01831020400,00000000200,a2f,recvmsg
0,01831023000,01831029700,00000006700,a07,poll
0,01831030700,01831030900,00000000200,a2f,recvmsg
0,01831031200,01831031400,00000000200,a2f,recvmsg
0,01831034700,01831041400,00000006700,a07,poll
0,01831042700,01831042800,00000000100,a2f,recvmsg
0,01831043100,01831043200,00000000100,a2f,recvmsg
0,01831046100,01831052800,00000006700,a07,poll
0,01831053900,01831054100,00000000200,a2f,recvmsg
0,01831054400,01831054600,00000000200,a2f,recvmsg
0,01831054900,01831055000,00000000100,a08,lseek
0,01831059000,01831065700,00000006700,a07,poll
0,01831066800,01831066900,00000000100,a2f,recvmsg
0,01831067300,01831067400,00000000100,a2f,recvmsg
0,01831072400,01831079200,00000006800,a07,poll
0,01831080300,01831080400,00000000100,a2f,recvmsg
0,01831080800,01831081000,00000000200,a2f,recvmsg
0,01831084200,01831090700,00000006500,a07,poll
0,01831092000,01831092200,00000000200,a2f,recvmsg
0,01831092500,01831092600,00000000100,a2f,recvmsg
0,01831095700,01831102100,00000006400,a07,poll
0,01831103300,01831103400,00000000100,a2f,recvmsg
0,01831103800,01831104000,00000000200,a2f,recvmsg
0,01831106800,01831113400,00000006600,a07,poll
0,01831114500,01831114700,00000000200,a2f,recvmsg
0,01831115000,01831115200,00000000200,a2f,recvmsg
0,01831118200,01831124700,00000006500,a07,poll
0,01831125800,01831125900,00000000100,a2f,recvmsg
0,01831126300,01831126500,00000000200,a2f,recvmsg
0,01831129800,01831136400,00000006600,a07,poll
0,01831137600,01831137800,00000000200,a2f,recvmsg
0,01831138100,01831138200,00000000100,a2f,recvmsg
0,01831141200,01831147700,00000006500,a07,poll
0,01831148900,01831149100,00000000200,a2f,recvmsg
0,01831149400,01831149600,00000000200,a2f,recvmsg
0,01831152500,01831159100,00000006600,a07,poll
0,01831160200,01831160400,00000000200,a2f,recvmsg
0,01831160700,01831160900,00000000200,a2f,recvmsg
0,01831164000,01831170500,00000006500,a07,poll
0,01831171700,01831171900,00000000200,a2f,recvmsg
0,01831172200,01831172400,00000000200,a2f,recvmsg
0,01831175300,01831182000,00000006700,a07,poll
0,01831183200,01831183400,00000000200,a2f,recvmsg
0,01831183700,01831183800,00000000100,a2f,recvmsg
0,01831187000,01831193600,00000006600,a07,poll
0,01831195100,01831195200,00000000100,a2f,recvmsg
0,01831195500,01831195700,00000000200,a2f,recvmsg
0,01831199100,01831205900,00000006800,a07,poll
0,01831206900,01831207100,00000000200,a2f,recvmsg
0,01831207400,01831207600,00000000200,a2f,recvmsg
0,01831210500,01831217100,00000006600,a07,poll
0,01831218200,01831218400,00000000200,a2f,recvmsg
0,01831218700,01831218900,00000000200,a2f,recvmsg
0,01831221800,01831228400,00000006600,a07,poll
0,01831229500,01831229700,00000000200,a2f,recvmsg
0,01831230000,01831230200,00000000200,a2f,recvmsg
0,01831233200,01831239900,00000006700,a07,poll
0,01831240900,01831241000,00000000100,a2f,recvmsg
0,01831241400,01831241600,00000000200,a2f,recvmsg
0,01831250000,01831256700,00000006700,a07,poll
0,01831257900,01831258000,00000000100,a2f,recvmsg
0,01831258300,01831258400,00000000100,a2f,recvmsg
0,01831261700,01831268200,00000006500,a07,poll
0,01831269300,01831269400,00000000100,a2f,recvmsg
0,01831269700,01831269900,00000000200,a2f,recvmsg
0,01831273000,01831279500,00000006500,a07,poll
0,01831280700,01831280800,00000000100,a2f,recvmsg
0,01831281100,01831281300,00000000200,a2f,recvmsg
0,01831284500,01831291100,00000006600,a07,poll
0,01831292100,01831292300,00000000200,a2f,recvmsg
0,01831292600,01831292800,00000000200,a2f,recvmsg
0,01831295900,01831302400,00000006500,a07,poll
0,01831303500,01831303700,00000000200,a2f,recvmsg
0,01831304000,01831304200,00000000200,a2f,recvmsg
0,01831324400,01831351200,00000026800,a57,unlink
0,01831352400,01831356500,00000004100,a14,writev
0,01831357000,01831455900,00000098900,a07,poll
0,01831357000,01831464000,00000107000,a07,poll
0,01831478200,01831478300,00000000100,a2f,recvmsg
0,01831521700,01831521900,00000000200,a2f,recvmsg
0,01831510500,01831540200,00000029700,a07,poll
0,01831559600,01831595900,00000036300,a07,poll
0,01831596900,01831599000,00000002100,a07,poll
0,01831600600,01831656300,00000055700,a07,poll
0,01831600600,01831658800,00000058200,a07,poll
0,01831661600,01831713600,00000052000,a07,poll
0,01831714600,01831717000,00000002400,a07,poll
0,01831718400,01831772300,00000053900,a07,poll
0,01831773500,01831775200,00000001700,a07,poll
0,01831776600,01831829600,00000053000,a07,poll
0,01831829800,01831830800,00000001000,a2f,recvmsg
0,01831776600,01831831700,00000055100,a07,poll
0,01831834300,01831875500,00000041200,a07,poll
0,01831875600,01831876800,00000001200,a2f,recvmsg
0,01831834300,01831877600,00000043300,a07,poll
0,01831880200,01831921500,00000041300,a07,poll
0,01831921700,01831922800,00000001100,a2f,recvmsg
0,01831880200,01831923700,00000043500,a07,poll
0,01831926300,01831966600,00000040300,a07,poll
0,01831966700,01831967800,00000001100,a2f,recvmsg
0,01831926300,01831968700,00000042400,a07,poll
0,01831972800,01832012300,00000039500,a07,poll
0,01831972800,01832014500,00000041700,a07,poll
0,01832017000,01832057700,00000040700,a07,poll
0,01832057800,01832058800,00000001000,a2f,recvmsg
0,01832017000,01832059700,00000042700,a07,poll
0,01832062300,01832113100,00000050800,a07,poll
0,01832113300,01832114300,00000001000,a2f,recvmsg
0,01832062300,01832115200,00000052900,a07,poll
0,01832118200,01832133500,00000015300,a07,poll
0,01832133600,01832134700,00000001100,a2f,recvmsg
0,01832118200,01832135600,00000017400,a07,poll
0,01832138200,01832151400,00000013200,a07,poll
0,01832151500,01832152700,00000001200,a2f,recvmsg
0,01832138200,01832153500,00000015300,a07,poll
0,01832156200,01832168400,00000012200,a07,poll
0,01832168500,01832169700,00000001200,a2f,recvmsg
0,01832156200,01832170600,00000014400,a07,poll
0,01832173100,01832184800,00000011700,a07,poll
0,01832185000,01832186000,00000001000,a2f,recvmsg
0,01832173100,01832186900,00000013800,a07,poll
0,01832189600,01832200800,00000011200,a07,poll
0,01832200900,01832202000,00000001100,a2f,recvmsg
0,01832189600,01832202900,00000013300,a07,poll
0,01832205400,01832207200,00000001800,a07,poll
0,01832209800,01832209900,00000000100,a2f,recvmsg
0,01832210500,01832210600,00000000100,a2f,recvmsg
0,01832205400,01832229700,00000024300,a07,poll
0,01832230100,01832231900,00000001800,a2f,recvmsg
0,01832234000,01832235000,00000001000,a2d,recvfrom
0,01832239100,01832239300,00000000200,a2f,recvmsg
0,01832240000,01832240200,00000000200,a2f,recvmsg
0,01832205400,01832245000,00000039600,a07,poll
0,01832245500,01832246900,00000001400,a2f,recvmsg
0,01832248500,01832249300,00000000800,a2d,recvfrom
0,01832253800,01832254000,00000000200,a2f,recvmsg
0,01832254600,01832254800,00000000200,a2f,recvmsg
0,01832295700,01832296000,00000000300,a2f,recvmsg
0,01832298400,01832298600,00000000200,a2f,recvmsg
0,01832357500,01832357800,00000000300,a2f,recvmsg
0,01832360200,01832360400,00000000200,a2f,recvmsg
0,01832372900,01832409100,00000036200,a07,poll
0,01832409700,01832411500,00000001800,a2f,recvmsg
0,01832418200,01832419000,00000000800,a2d,recvfrom
0,01832420100,01832420300,00000000200,a2f,recvmsg
0,01832421000,01832421100,00000000100,a2f,recvmsg
0,01832453000,01832453200,00000000200,a2f,recvmsg
0,01832455600,01832455800,00000000200,a2f,recvmsg
0,01832459200,01832461700,00000002500,a07,poll
0,01832464100,01832464300,00000000200,a2f,recvmsg
0,01832464800,01832465000,00000000200,a2f,recvmsg
0,01832954800,01832979000,00000024200,60e,page_fault
0,01833100500,01833159400,00000058900,a07,poll
0,01833178300,01833180500,00000002200,a2f,recvmsg
0,01833240700,01833244000,00000003300,a01,write
0,01833252600,01833253200,00000000600,a2f,recvmsg
0,01833255600,01833255800,00000000200,a00,read
0,01833267000,01833268500,00000001500,aca,futex
0,01833297000,01833399700,00000102700,a07,poll
0,01833403400,01833407500,00000004100,a2e,sendmsg
0,01833410200,01833410400,00000000200,a00,read
0,01833431000,01833431200,00000000200,aca,futex
0,01833433900,01833434000,00000000100,aca,futex
0,01833436500,01833518600,00000082100,a07,poll
0,01833520800,01833522000,00000001200,a2e,sendmsg
0,01833540700,01833597100,00000056400,a07,poll
0,01833600300,01833602600,00000002300,a2f,recvmsg
0,01833608700,01833609800,00000001100,a2f,recvmsg
0,01833754100,01833754900,00000000800,a2f,recvmsg
0,01833757100,01833757200,00000000100,a00,read
0,01819575900,01835516700,00015940800,a17,select
0,01835537300,01835537500,00000000200,a2f,recvmsg
0,01835550800,01835551000,00000000200,a2f,recvmsg
0,01835551600,01835624900,00000073300,a17,select
0,01835631200,01835631400,00000000200,a2f,recvmsg
0,01804884600,01846659200,00041774600,a3d,wait4
0,01846683600,01846685300,00000001700,a00,read
0,01846687400,01846687700,00000000300,a00,read
0,01846707800,01846759400,00000051600,a07,poll
0,01846765700,01846765800,00000000100,a2f,recvmsg
0,01846766700,01846766900,00000000200,a2f,recvmsg
0,01846776400,01846791800,00000015400,a07,poll
0,01846794100,01846794200,00000000100,a2f,recvmsg
0,01846794600,01846794800,00000000200,a2f,recvmsg
0,01846799600,01846813200,00000013600,a07,poll
0,01846815200,01846815400,00000000200,a2f,recvmsg
0,01846815800,01846816000,00000000200,a2f,recvmsg
0,01846820900,01846834100,00000013200,a07,poll
0,01846836100,01846836300,00000000200,a2f,recvmsg
0,01846836700,01846836900,00000000200,a2f,recvmsg
0,01846841000,01846854300,00000013300,a07,poll
0,01846856300,01846856500,00000000200,a2f,recvmsg
0,01846856900,01846857000,00000000100,a2f,recvmsg
0,01846861100,01846874300,00000013200,a07,poll
0,01846876400,01846876600,00000000200,a2f,recvmsg
0,01846877000,01846877200,00000000200,a2f,recvmsg
0,01846878100,01846878400,00000000300,a08,lseek
0,01846889900,01846890000,00000000100,a08,lseek
0,01846893200,01846900200,00000007000,a07,poll
0,01846901400,01846901600,00000000200,a2f,recvmsg
0,01846902000,01846902200,00000000200,a2f,recvmsg
0,01846908000,01846914700,00000006700,a07,poll
0,01846916000,01846916200,00000000200,a2f,recvmsg
0,01846916500,01846916700,00000000200,a2f,recvmsg
0,01846919700,01846926400,00000006700,a07,poll
0,01846927500,01846927700,00000000200,a2f,recvmsg
0,01846928000,01846928200,00000000200,a2f,recvmsg
0,01846931800,01846938300,00000006500,a07,poll
0,01846939500,01846939700,00000000200,a2f,recvmsg
0,01846940000,01846940200,00000000200,a2f,recvmsg
0,01846943400,01846950200,00000006800,a07,poll
0,01846951500,01846951700,00000000200,a2f,recvmsg
0,01846951900,01846952100,00000000200,a2f,recvmsg
0,01846955500,01846962100,00000006600,a07,poll
0,01846963300,01846963500,00000000200,a2f,recvmsg
0,01846963800,01846964000,00000000200,a2f,recvmsg
0,01846968000,01846974800,00000006800,a07,poll
0,01846976000,01846976200,00000000200,a2f,recvmsg
0,01846976500,01846976600,00000000100,a2f,recvmsg
0,01846980400,01846986700,00000006300,a07,poll
0,01846987900,01846988000,00000000100,a2f,recvmsg
0,01846988300,01846988500,00000000200,a2f,recvmsg
0,01846992900,01846999800,00000006900,a07,poll
0,01847001000,01847001200,00000000200,a2f,recvmsg
0,01847001400,01847001600,00000000200,a2f,recvmsg
0,01847004800,01847011600,00000006800,a07,poll
0,01847012700,01847012900,00000000200,a2f,recvmsg
0,01847013200,01847013400,00000000200,a2f,recvmsg
0,01847016500,01847023300,00000006800,a07,poll
0,01847024400,01847024500,00000000100,a2f,recvmsg
0,01847024800,01847025000,00000000200,a2f,recvmsg
0,01847028100,01847034800,00000006700,a07,poll
0,01847035900,01847036100,00000000200,a2f,recvmsg
0,01847036400,01847036500,00000000100,a2f,recvmsg
0,01847039800,01847046200,00000006400,a07,poll
0,01847047200,01847047400,00000000200,a2f,recvmsg
0,01847047700,01847047900,00000000200,a2f,recvmsg
0,01847051100,01847058000,00000006900,a07,poll
0,01847059100,01847059200,00000000100,a2f,recvmsg
0,01847059500,01847059700,00000000200,a2f,recvmsg
0,01847063600,01847070300,00000006700,a07,poll
0,01847071500,01847071600,00000000100,a2f,recvmsg
0,01847071800,01847072000,00000000200,a2f,recvmsg
0,01847074600,01847081300,00000006700,a07,poll
0,01847082500,01847082600,00000000100,a2f,recvmsg
0,01847082900,01847083000,00000000100,a2f,recvmsg
0,01847087900,01847094500,00000006600,a07,poll
0,01847095700,01847095800,00000000100,a2f,recvmsg
0,01847096100,01847096300,00000000200,a2f,recvmsg
0,01847098800,01847105700,00000006900,a07,poll
0,01847106700,01847106900,00000000200,a2f,recvmsg
0,01847107200,01847107400,00000000200,a2f,recvmsg
0,01847110000,01847117100,00000007100,a07,poll
0,01847118200,01847118300,00000000100,a2f,recvmsg
0,01847118600,01847118800,00000000200,a2f,recvmsg
0,01847121400,01847128200,00000006800,a07,poll
0,01847129300,01847129500,00000000200,a2f,recvmsg
0,01847129800,01847130000,00000000200,a2f,recvmsg
0,01847132900,01847139700,00000006800,a07,poll
0,01847140700,01847140900,00000000200,a2f,recvmsg
0,01847141200,01847141400,00000000200,a2f,recvmsg
0,01847144100,01847150800,00000006700,a07,poll
0,01847151800,01847152000,00000000200,a2f,recvmsg
0,01847152300,01847152500,00000000200,a2f,recvmsg
0,01847155700,01847162500,00000006800,a07,poll
0,01847163600,01847163800,00000000200,a2f,recvmsg
0,01847164100,01847164300,00000000200,a2f,recvmsg
0,01847167800,01847174500,00000006700,a07,poll
0,01847175700,01847175900,00000000200,a2f,recvmsg
0,01847176100,01847176200,00000000100,a2f,recvmsg
0,01847180700,01847187800,00000007100,a07,poll
0,01847189000,01847189200,00000000200,a2f,recvmsg
0,01847189400,01847189600,00000000200,a2f,recvmsg
0,01847193200,01847199800,00000006600,a07,poll
0,01847200800,01847201000,00000000200,a2f,recvmsg
0,01847201300,01847201500,00000000200,a2f,recvmsg
0,01847205000,01847211900,00000006900,a07,poll
0,01847213000,01847213200,00000000200,a2f,recvmsg
0,01847213500,01847213600,00000000100,a2f,recvmsg
0,01847218900,01847225600,00000006700,a07,poll
0,01847226700,01847226900,00000000200,a2f,recvmsg
0,01847227200,01847227400,00000000200,a2f,recvmsg
0,01847230500,01847237200,00000006700,a07,poll
0,01847239100,01847239200,00000000100,a2f,recvmsg
0,01847239500,01847239700,00000000200,a2f,recvmsg
0,01847242600,01847249500,00000006900,a07,poll
0,01847250500,01847250700,00000000200,a2f,recvmsg
0,01847251000,01847251200,00000000200,a2f,recvmsg
0,01847255000,01847261800,00000006800,a07,poll
0,01847263000,01847263100,00000000100,a2f,recvmsg
0,01847263400,01847263500,00000000100,a2f,recvmsg
0,01847266900,01847273700,00000006800,a07,poll
0,01847274900,01847275100,00000000200,a2f,recvmsg
0,01847275400,01847275600,00000000200,a2f,recvmsg
0,01847279400,01847286200,00000006800,a07,poll
0,01847287300,01847287500,00000000200,a2f,recvmsg
0,01847287800,01847288000,00000000200,a2f,recvmsg
0,01847291200,01847297900,00000006700,a07,poll
0,01847299100,01847299200,00000000100,a2f,recvmsg
0,01847299500,01847299600,00000000100,a2f,recvmsg
0,01847302700,01847309500,00000006800,a07,poll
0,01847310600,01847310800,00000000200,a2f,recvmsg
0,01847311000,01847311200,00000000200,a2f,recvmsg
0,01847314000,01847320800,00000006800,a07,poll
0,01847321900,01847322100,00000000200,a2f,recvmsg
0,01847322400,01847322400,00000000000,a2f,recvmsg
0,01847326200,01847332900,00000006700,a07,poll
0,01847334000,01847334200,00000000200,a2f,recvmsg
0,01847334500,01847334600,00000000100,a2f,recvmsg
0,01847335700,01847335700,00000000000,a08,lseek
0,01847338300,01847339700,00000001400,a00,read
0,01847343400,01847343500,00000000100,a08,lseek
0,01847346400,01847353100,00000006700,a07,poll
0,01847354400,01847354600,00000000200,a2f,recvmsg
0,01847354800,01847355000,00000000200,a2f,recvmsg
0,01847380500,01847387300,00000006800,a07,poll
0,01847388600,01847388800,00000000200,a2f,recvmsg
0,01847389000,01847389200,00000000200,a2f,recvmsg
0,01847393000,01847394000,00000001000,a00,read
0,01847399500,01847399600,00000000100,a08,lseek
0,01847402700,01847409500,00000006800,a07,poll
0,01847410700,01847410900,00000000200,a2f,recvmsg
0,01847411200,01847411400,00000000200,a2f,recvmsg
0,01847414100,01847420800,00000006700,a07,poll
0,01847421900,01847422000,00000000100,a2f,recvmsg
0,01847422300,01847422500,00000000200,a2f,recvmsg
0,01847425200,01847431800,00000006600,a07,poll
0,01847432900,01847433100,00000000200,a2f,recvmsg
0,01847433400,01847433600,00000000200,a2f,recvmsg
0,01847436400,01847443100,00000006700,a07,poll
0,01847444200,01847444300,00000000100,a2f,recvmsg
0,01847444600,01847444800,00000000200,a2f,recvmsg
0,01847447500,01847454300,00000006800,a07,poll
0,01847455400,01847455500,00000000100,a2f,recvmsg
0,01847455800,01847456000,00000000200,a2f,recvmsg
0,01847458800,01847465500,00000006700,a07,poll
0,01847466700,01847466800,00000000100,a2f,recvmsg
0,01847467100,01847467200,00000000100,a2f,recvmsg
0,01847469900,01847476400,00000006500,a07,poll
0,01847477600,01847477800,00000000200,a2f,recvmsg
0,01847478100,01847478200,00000000100,a2f,recvmsg
0,01847481600,01847488400,00000006800,a07,poll
0,01847489600,01847489600,00000000000,a2f,recvmsg
0,01847489900,01847490100,00000000200,a2f,recvmsg
0,01847493100,01847499700,00000006600,a07,poll
0,01847500900,01847501000,00000000100,a2f,recvmsg
0,01847501200,01847501400,00000000200,a2f,recvmsg
0,01847501900,01847502000,00000000100,a08,lseek
0,01847506000,01847512800,00000006800,a07,poll
0,01847514000,01847514200,00000000200,a2f,recvmsg
0,01847514400,01847514600,00000000200,a2f,recvmsg
0,01847519600,01847526400,00000006800,a07,poll
0,01847527600,01847527800,00000000200,a2f,recvmsg
0,01847528100,01847528300,00000000200,a2f,recvmsg
0,01847531700,01847538400,00000006700,a07,poll
0,01847539500,01847539700,00000000200,a2f,recvmsg
0,01847540000,01847540200,00000000200,a2f,recvmsg
0,01847543700,01847550300,00000006600,a07,poll
0,01847551400,01847551600,00000000200,a2f,recvmsg
0,01847551900,01847552100,00000000200,a2f,recvmsg
0,01847555000,01847561700,00000006700,a07,poll
0,01847562800,01847563000,00000000200,a2f,recvmsg
0,01847563300,01847563500,00000000200,a2f,recvmsg
0,01847566500,01847573100,00000006600,a07,poll
0,01847574200,01847574300,00000000100,a2f,recvmsg
0,01847574600,01847574800,00000000200,a2f,recvmsg
0,01847578300,01847585000,00000006700,a07,poll
0,01847586200,01847586400,00000000200,a2f,recvmsg
0,01847586600,01847586800,00000000200,a2f,recvmsg
0,01847589700,01847596300,00000006600,a07,poll
0,01847597500,01847597600,00000000100,a2f,recvmsg
0,01847597900,01847598000,00000000100,a2f,recvmsg
0,01847601100,01847607600,00000006500,a07,poll
0,01847608800,01847609000,00000000200,a2f,recvmsg
0,01847609300,01847609400,00000000100,a2f,recvmsg
0,01847612400,01847619000,00000006600,a07,poll
0,01847620100,01847620300,00000000200,a2f,recvmsg
0,01847620600,01847620700,00000000100,a2f,recvmsg
0,01847623900,01847630600,00000006700,a07,poll
0,01847631700,01847631900,00000000200,a2f,recvmsg
0,01847632100,01847632300,00000000200,a2f,recvmsg
0,01847635200,01847641900,00000006700,a07,poll
0,01847643200,01847643300,00000000100,a2f,recvmsg
0,01847643600,01847643700,00000000100,a2f,recvmsg
0,01847647300,01847654100,00000006800,a07,poll
0,01847655100,01847655300,00000000200,a2f,recvmsg
0,01847655600,01847655800,00000000200,a2f,recvmsg
0,01847658700,01847665400,00000006700,a07,poll
0,01847666500,01847666700,00000000200,a2f,recvmsg
0,01847667000,01847667200,00000000200,a2f,recvmsg
0,01847670100,01847676800,00000006700,a07,poll
0,01847677900,01847678000,00000000100,a2f,recvmsg
0,01847678400,01847678600,00000000200,a2f,recvmsg
0,01847681500,01847688300,00000006800,a07,poll
0,01847689300,01847689500,00000000200,a2f,recvmsg
0,01847689800,01847690000,00000000200,a2f,recvmsg
0,01847698100,01847705000,00000006900,a07,poll
0,01847706200,01847706300,00000000100,a2f,recvmsg
0,01847706600,01847706800,00000000200,a2f,recvmsg
0,01847710000,01847716600,00000006600,a07,poll
0,01847717600,01847717800,00000000200,a2f,recvmsg
0,01847718100,01847718300,00000000200,a2f,recvmsg
0,01847721400,01847728100,00000006700,a07,poll
0,01847729200,01847729400,00000000200,a2f,recvmsg
0,01847729700,01847729900,00000000200,a2f,recvmsg
0,01847733000,01847739600,00000006600,a07,poll
0,01847740700,01847740900,00000000200,a2f,recvmsg
0,01847741200,01847741400,00000000200,a2f,recvmsg
0,01847744600,01847751400,00000006800,a07,poll
0,01847752400,01847752600,00000000200,a2f,recvmsg
0,01847752900,01847753100,00000000200,a2f,recvmsg
0,01847773400,01847800900,00000027500,a57,unlink
0,01847802300,01847806300,00000004000,a14,writev
0,01847806900,01847904000,00000097100,a07,poll
0,01847806900,01847912300,00000105400,a07,poll
0,01847924100,01847924200,00000000100,a2f,recvmsg
0,01847974700,01847974900,00000000200,a2f,recvmsg
0,01847962500,01847987500,00000025000,a07,poll
0,01848006000,01848010600,00000004600,a07,poll
0,01848021600,01848021800,00000000200,a2f,recvmsg
0,01848039600,01848044800,00000005200,a07,poll
0,01848046400,01848048300,00000001900,a07,poll
0,01848050100,01848051500,00000001400,a07,poll
0,01848052900,01848103300,00000050400,a07,poll
0,01848104700,01848106600,00000001900,a07,poll
0,01848107900,01848109800,00000001900,a07,poll
0,01848111000,01848160900,00000049900,a07,poll
0,01848162200,01848163900,00000001700,a07,poll
0,01848165100,01848167300,00000002200,a07,poll
0,01848168700,01848219200,00000050500,a07,poll
0,01848220900,01848222400,00000001500,a07,poll
0,01848224400,01848225600,00000001200,a07,poll
0,01848227100,01848276700,00000049600,a07,poll
0,01848227100,01848279000,00000051900,a07,poll
0,01848282400,01848283600,00000001200,a07,poll
0,01848284900,01848322400,00000037500,a07,poll
0,01848322600,01848323700,00000001100,a2f,recvmsg
0,01848284900,01848324600,00000039700,a07,poll
0,01848327700,01848328800,00000001100,a07,poll
0,01848330100,01848367200,00000037100,a07,poll
0,01848330100,01848369000,00000038900,a07,poll
0,01848369200,01848371600,00000002400,a2f,recvmsg
0,01848372100,01848373300,00000001200,a07,poll
0,01848374800,01848412200,00000037400,a07,poll
0,01848412500,01848413900,00000001400,a2f,recvmsg
0,01848374800,01848414900,00000040100,a07,poll
0,01848417700,01848418700,00000001000,a07,poll
0,01848420100,01848456900,00000036800,a07,poll
0,01848457100,01848458100,00000001000,a2f,recvmsg
0,01848420100,01848459000,00000038900,a07,poll
0,01848462100,01848463200,00000001100,a07,poll
0,01848464700,01848501700,00000037000,a07,poll
0,01848464700,01848503300,00000038600,a07,poll
0,01848503600,01848508400,00000004800,a2f,recvmsg
0,01848509100,01848510200,00000001100,a07,poll
0,01848511700,01848558300,00000046600,a07,poll
0,01848558600,01848559500,00000000900,a2f,recvmsg
0,01848511700,01848560600,00000048900,a07,poll
0,01848563400,01848564600,00000001200,a07,poll
0,01848566000,01848578400,00000012400,a07,poll
0,01848578700,01848579700,00000001000,a2f,recvmsg
0,01848566000,01848580600,00000014600,a07,poll
0,01848583900,01848584900,00000001000,a07,poll
0,01848586300,01848597300,00000011000,a07,poll
0,01848597400,01848598500,00000001100,a2f,recvmsg
0,01848586300,01848599400,00000013100,a07,poll
0,01848602600,01848603700,00000001100,a07,poll
0,01848605000,01848615300,00000010300,a07,poll
0,01848615600,01848616600,00000001000,a2f,recvmsg
0,01848605000,01848617600,00000012600,a07,poll
0,01848620800,01848622000,00000001200,a07,poll
0,01848623300,01848633300,00000010000,a07,poll
0,01848623300,01848634800,00000011500,a07,poll
0,01848635100,01848637500,00000002400,a2f,recvmsg
0,01848638000,01848639300,00000001300,a07,poll
0,01848640700,01848649900,00000009200,a07,poll
0,01848650100,01848651700,00000001600,a2f,recvmsg
0,01848640700,01848652600,00000011900,a07,poll
0,01848655600,01848656800,00000001200,a07,poll
0,01848658100,01848659600,00000001500,a07,poll
0,01848662000,01848662200,00000000200,a2f,recvmsg
0,01848662800,01848663000,00000000200,a2f,recvmsg
0,01848663800,01848678900,00000015100,a57,unlink
0,01848658100,01848680400,00000022300,a07,poll
0,01848680800,01848682300,00000001500,a2f,recvmsg
0,01848683700,01848684900,00000001200,a2d,recvfrom
0,01848689100,01848689300,00000000200,a2f,recvmsg
0,01848689900,01848690100,00000000200,a2f,recvmsg
0,01848658100,01848708700,00000050600,a07,poll
0,01848709200,01848710800,00000001600,a2f,recvmsg
0,01848713000,01848714000,00000001000,a2d,recvfrom
0,01848718200,01848718400,00000000200,a2f,recvmsg
0,01848718900,01848719100,00000000200,a2f,recvmsg
0,01848761500,01848761800,00000000300,a2f,recvmsg
0,01848764200,01848764300,00000000100,a2f,recvmsg
0,01848810800,01848811100,00000000300,a2f,recvmsg
0,01848813300,01848813500,00000000200,a2f,recvmsg
0,01848816300,01848819900,00000003600,a07,poll
0,01848820500,01848822000,00000001500,a2f,recvmsg
0,01848823800,01848824500,00000000700,a2d,recvfrom
0,01848829100,01848829200,00000000100,a2f,recvmsg
0,01848829900,01848830100,00000000200,a2f,recvmsg
0,01848858800,01848859100,00000000300,a2f,recvmsg
0,01848861300,01848861400,00000000100,a2f,recvmsg
0,01848876100,01848893800,00000017700,a07,poll
0,01848898500,01848898700,00000000200,a2f,recvmsg
0,01848900300,01848900400,00000000100,a2f,recvmsg
0,01848900700,01848900900,00000000200,a2f,recvmsg
0,01848902700,01848902900,00000000200,a2f,recvmsg
0,01848903100,01848903200,00000000100,a2f,recvmsg
0,01848903500,01848905200,00000001700,a07,poll
0,01848907200,01848907400,00000000200,a2f,recvmsg
0,01848908000,01848908200,00000000200,a2f,recvmsg
0,01849680900,01849690900,00000010000,a02,open
0,01849703100,01849706700,00000003600,a00,read
0,01849760200,01849761000,00000000800,a00,read
0,01849811300,01849812100,00000000800,a00,read
0,01849860700,01849861400,00000000700,a00,read
0,01849911100,01849912000,00000000900,a00,read
0,01849959900,01849960700,00000000800,a00,read
0,01850008000,01850008900,00000000900,a00,read
0,01850056600,01850057500,00000000900,a00,read
0,01850107800,01850108600,00000000800,a00,read
0,01850158900,01850159600,00000000700,a00,read
0,01850208900,01850209600,00000000700,a00,read
0,01850238800,01850241400,00000002600,a02,open
0,01850245700,01850246700,00000001000,a00,read
0,01850304100,01850305000,00000000900,a00,read
0,01850390800,01850391600,00000000800,a00,read
0,01850467100,01850467900,00000000800,a00,read
0,01850547200,01850548000,00000000800,a00,read
0,01850627500,01850628200,00000000700,a00,read
0,01850706800,01850707700,00000000900,a00,read
0,01850793700,01850794400,00000000700,a00,read
0,01850862400,01850863000,00000000600,a00,read
0,01850921600,01850922400,00000000800,a00,read
0,01851001700,01851033400,00000031700,a07,poll
0,01851036900,01851037100,00000000200,a2f,recvmsg
0,01851037700,01851037900,00000000200,a2f,recvmsg
0,01851040200,01851047000,00000006800,a07,poll
0,01851048300,01851048400,00000000100,a2f,recvmsg
0,01851048700,01851048900,00000000200,a2f,recvmsg
0,01851054900,01851061400,00000006500,a06,lstat
0,01851062100,01851063100,00000001000,a06,lstat
0,01851086200,01851102200,00000016000,a01,write
0,01851108100,01851116300,00000008200,a07,poll
0,01851118400,01851118600,00000000200,a2f,recvmsg
0,01851119000,01851119200,00000000200,a2f,recvmsg
0,01851120500,01851439700,00000319200,a38,clone
0,01851928300,01851928500,00000000200,a0c,brk
0,01851938300,01851941300,00000003000,a15,access
0,01851941900,01851942800,00000000900,a09,mmap
0,01851946400,01851948700,00000002300,a15,access
0,01851955900,01851957100,00000001200,a09,mmap
0,01851960700,01851961200,00000000500,a15,access
0,01851969200,01851970400,00000001200,a00,read
0,01851971800,01851973400,00000001600,a09,mmap
0,01851977100,01851979500,00000002400,a09,mmap
0,01851991200,01851991900,00000000700,a15,access
0,01851995200,01851995900,00000000700,a00,read
0,01851999800,01852000900,00000001100,a09,mmap
0,01852009000,01852009600,00000000600,a15,access
0,01852012900,01852013500,00000000600,a00,read
0,01852014100,01852015000,00000000900,a09,mmap
0,01852016600,01852018400,00000001800,a09,mmap
0,01852022900,01852025700,00000002800,a09,mmap
0,01852028200,01852029200,00000001000,a09,mmap
0,01852037800,01852038300,00000000500,a15,access
0,01852041600,01852042300,00000000700,a00,read
0,01852043100,01852044600,00000001500,a09,mmap
0,01852047600,01852049600,00000002000,a09,mmap
0,01852057600,01852058200,00000000600,a15,access
0,01852061600,01852062300,00000000700,a00,read
0,01852062900,01852064300,00000001400,a09,mmap
0,01852067700,01852070000,00000002300,a09,mmap
0,01852078600,01852079300,00000000700,a15,access
0,01852082000,01852082600,00000000600,a00,read
0,01852083100,01852084200,00000001100,a09,mmap
0,01852085500,01852086800,00000001300,a09,mmap
0,01852089700,01852091100,00000001400,a09,mmap
0,01852097500,01852098200,00000000700,a15,access
0,01852100600,01852101000,00000000400,a00,read
0,01852101600,01852102900,00000001300,a09,mmap
0,01852105300,01852106800,00000001500,a09,mmap
0,01852120700,01852121400,00000000700,a09,mmap
0,01852125300,01852125600,00000000300,a09,mmap
0,01852126600,01852126900,00000000300,a09,mmap
0,01852303600,01852303700,00000000100,a0c,brk
0,01852303800,01852304700,00000000900,a0c,brk
0,01852340100,01852341200,00000001100,a00,read
0,01852353100,01852354500,00000001400,a00,read
0,01852393000,01852394100,00000001100,a00,read
0,01852515000,01852515600,00000000600,a00,read
0,01852587300,01852587700,00000000400,a00,read
0,01852673600,01852674300,00000000700,a00,read
0,01852803800,01852804600,00000000800,a00,read
0,01852933500,01852934300,00000000800,a00,read
0,01853118500,01853119400,00000000900,a00,read
0,01853269600,01853270300,00000000700,a00,read
0,01853307200,01853308800,00000001600,a0c,brk
0,01853424400,01853425200,00000000800,a00,read
0,01853573400,01853574100,00000000700,a00,read
0,01853729800,01853730600,00000000800,a00,read
0,01853889900,01853890700,00000000800,a00,read
0,01853999400,01854000100,00000000700,a00,read
0,01854030900,01854031600,00000000700,a0c,brk
0,01854142100,01854143000,00000000900,a00,read
0,01854387200,01854388000,00000000800,a00,read
0,01854399900,01854400300,00000000400,a00,read
0,01854444900,01854445300,00000000400,a00,read
0,01854465200,01854466000,00000000800,a00,read
0,01854672800,01854673400,00000000600,a00,read
0,01854702900,01854703800,00000000900,a00,read
0,01854800800,01854801700,00000000900,a00,read
0,01854825400,01854826700,00000001300,a0c,brk
0,01854873300,01854873800,00000000500,a00,read
0,01854951700,01854952600,00000000900,a00,read
0,01855106500,01855106900,00000000400,a00,read
0,01855218800,01855219500,00000000700,a00,read
0,01855314600,01855315200,00000000600,a00,read
0,01855327700,01855328300,00000000600,a00,read
0,01855411300,01855411900,00000000600,a00,read
0,01855436800,01855437200,00000000400,a00,read
0,01851108100,01855458700,00004350600,a07,poll
0,01855491100,01855491300,00000000200,a00,read
0,01855492900,01855494500,00000001600,aca,futex
0,01855496200,01855497800,00000001600,a2e,sendmsg
0,01855534800,01855535400,00000000600,a00,read
0,01855648100,01855650100,00000002000,a0c,brk
0,01855651300,01855652900,00000001600,a00,read
0,01855857600,01855858300,00000000700,a00,read
0,01855946300,01855946900,00000000600,a00,read
0,01856011800,01856012600,00000000800,a00,read
0,01856144300,01856144800,00000000500,a00,read
0,01856178800,01856179800,00000001000,a00,read
0,01855513200,01856192000,00000678800,a07,poll
0,01856193100,01856193300,00000000200,a00,read
0,01856203600,01856204900,00000001300,a2f,recvmsg
0,01856286200,01856288800,00000002600,a02,open
0,01856414100,01856414700,00000000600,a00,read
0,01856492800,01856493400,00000000600,a00,read
0,01856547600,01856550500,00000002900,a0c,brk
0,01856558300,01856559100,00000000800,a00,read
0,01856667700,01856668300,00000000600,a00,read
0,01856819100,01856820100,00000001000,a00,read
0,01856961800,01856962700,00000000900,a00,read
0,01857021300,01857022000,00000000700,a00,read
0,01857077200,01857077900,00000000700,a00,read
0,01857147500,01857148200,00000000700,a00,read
0,01857200900,01857201800,00000000900,a00,read
0,01857292100,01857293200,00000001100,a0c,brk
0,01857324500,01857329000,00000004500,a0c,brk
0,01857344100,01857344900,00000000800,a00,read
0,01857459200,01857460100,00000000900,a00,read
0,01857618500,01857619200,00000000700,a00,read
0,01857736000,01857736600,00000000600,a00,read
0,01857882000,01857882600,00000000600,a00,read
0,01857999200,01857999900,00000000700,a00,read
0,01858163100,01858163800,00000000700,a00,read
0,01858168700,01858169600,00000000900,a0c,brk
0,01858284700,01858285400,00000000700,a00,read
0,01858402900,01858403500,00000000600,a00,read
0,01858544400,01858545200,00000000800,a00,read
0,01858676200,01858676800,00000000600,a00,read
0,01858769400,01858770000,00000000600,a00,read
0,01858882000,01858882800,00000000800,a00,read
0,01859008000,01859008600,00000000600,a00,read
0,01859143400,01859144200,00000000800,a00,read
0,01859313100,01859313700,00000000600,a00,read
0,01859463500,01859464100,00000000600,a00,read
0,01859574300,01859575000,00000000700,a00,read
0,01859743000,01859744000,00000001000,a00,read
0,01859820100,01859820800,00000000700,a00,read
0,01859901800,01859902500,00000000700,a00,read
0,01859968800,01859969700,00000000900,a0c,brk
0,01859983400,01859984000,00000000600,a00,read
0,01860056000,01860056700,00000000700,a00,read
0,01860157300,01860158000,00000000700,a00,read
0,01860260400,01860261200,00000000800,a00,read
0,01860351200,01860351900,00000000700,a00,read
0,01860432000,01860432600,00000000600,a00,read
0,01860534600,01860535200,00000000600,a00,read
0,01860615500,01860616100,00000000600,a0c,brk
0,01860618600,01860619400,00000000800,a00,read
0,01860725900,01860726600,00000000700,a00,read
0,01860818500,01860819200,00000000700,a00,read
0,01860937200,01860937800,00000000600,a00,read
0,01861059200,01861059800,00000000600,a00,read
0,01861162500,01861163200,00000000700,a00,read
0,01861263500,01861264100,00000000600,a0c,brk
0,01861626000,01861629800,00000003800,a57,unlink
0,01861654900,01861655500,00000000600,a48,fcntl
0,01861707500,01861721100,00000013600,a01,write
0,01861739200,01861741700,00000002500,a01,write
0,01861757500,01861759900,00000002400,a01,write
0,01835632100,01861996900,00026364800,a17,select
0,01862020500,01862020800,00000000300,a2f,recvmsg
0,01862024400,01862045300,00000020900,a17,select
0,01862049300,01862049500,00000000200,a2f,recvmsg
0,01862050100,01862064100,00000014000,a17,select
0,01862067700,01862067900,00000000200,a2f,recvmsg
0,01862068400,01862083500,00000015100,a17,select
0,01862087100,01862087300,00000000200,a2f,recvmsg
0,01862087800,01862102600,00000014800,a17,select
0,01862106600,01862106700,00000000100,a2f,recvmsg
0,01862107300,01862120400,00000013100,a17,select
0,01862123700,01862123900,00000000200,a2f,recvmsg
0,01862124400,01862149000,00000024600,a17,select
0,01862152900,01862153100,00000000200,a2f,recvmsg
0,01862153600,01862162500,00000008900,a17,select
0,01862166300,01862166400,00000000100,a2f,recvmsg
0,01862167000,01862174400,00000007400,a17,select
0,01862178000,01862178200,00000000200,a2f,recvmsg
0,01862178600,01862186100,00000007500,a17,select
0,01862189800,01862189900,00000000100,a2f,recvmsg
0,01862190400,01862198000,00000007600,a17,select
0,01862201700,01862201900,00000000200,a2f,recvmsg
0,01862202400,01862210000,00000007600,a17,select
0,01862213600,01862213700,00000000100,a2f,recvmsg
0,01862214300,01862221600,00000007300,a17,select
0,01862225300,01862225500,00000000200,a2f,recvmsg
0,01862226000,01862233200,00000007200,a17,select
0,01862236700,01862236900,00000000200,a2f,recvmsg
0,01862237400,01862245800,00000008400,a17,select
0,01862249600,01862249700,00000000100,a2f,recvmsg
0,01862250300,01862257700,00000007400,a17,select
0,01862261300,01862261500,00000000200,a2f,recvmsg
0,01862262100,01862270000,00000007900,a17,select
0,01862273800,01862274000,00000000200,a2f,recvmsg
0,01862274600,01862281800,00000007200,a17,select
0,01862285200,01862285400,00000000200,a2f,recvmsg
0,01862285900,01862293900,00000008000,a17,select
0,01862297500,01862297700,00000000200,a2f,recvmsg
0,01862298200,01862305800,00000007600,a17,select
0,01862309300,01862309500,00000000200,a2f,recvmsg
0,01862309900,01862317200,00000007300,a17,select
0,01862320800,01862321000,00000000200,a2f,recvmsg
0,01862321400,01862328200,00000006800,a17,select
0,01862331900,01862332100,00000000200,a2f,recvmsg
0,01862332500,01862341400,00000008900,a17,select
0,01862345000,01862345200,00000000200,a2f,recvmsg
0,01862345700,01862352600,00000006900,a17,select
0,01862356200,01862356300,00000000100,a2f,recvmsg
0,01862356900,01862363900,00000007000,a17,select
0,01862367400,01862367600,00000000200,a2f,recvmsg
0,01862368100,01862375000,00000006900,a17,select
0,01862378600,01862378800,00000000200,a2f,recvmsg
0,01862379300,01862386500,00000007200,a17,select
0,01862390100,01862390300,00000000200,a2f,recvmsg
0,01862390900,01862398100,00000007200,a17,select
0,01862401700,01862401900,00000000200,a2f,recvmsg
0,01862402400,01862409800,00000007400,a17,select
0,01862413500,01862413700,00000000200,a2f,recvmsg
0,01862414100,01862421600,00000007500,a17,select
0,01862425300,01862425400,00000000100,a2f,recvmsg
0,01862425900,01862434500,00000008600,a17,select
0,01862438300,01862438400,00000000100,a2f,recvmsg
0,01862438900,01862446600,00000007700,a17,select
0,01862450200,01862450400,00000000200,a2f,recvmsg
0,01862450900,01862458300,00000007400,a17,select
0,01862461900,01862462100,00000000200,a2f,recvmsg
0,01862462600,01862472800,00000010200,a17,select
0,01862476300,01862476400,00000000100,a2f,recvmsg
0,01862476900,01862484400,00000007500,a17,select
0,01862487900,01862488100,00000000200,a2f,recvmsg
0,01862488500,01862496500,00000008000,a17,select
0,01862500100,01862500300,00000000200,a2f,recvmsg
0,01862500900,01862508800,00000007900,a17,select
0,01862512600,01862512800,00000000200,a2f,recvmsg
0,01862513200,01862520900,00000007700,a17,select
0,01862524500,01862524700,00000000200,a2f,recvmsg
0,01862525200,01862533300,00000008100,a17,select
0,01862536900,01862537100,00000000200,a2f,recvmsg
0,01862537700,01862545800,00000008100,a17,select
0,01862549400,01862549500,00000000100,a2f,recvmsg
0,01862550100,01862557400,00000007300,a17,select
0,01862561100,01862561200,00000000100,a2f,recvmsg
0,01862561800,01862568900,00000007100,a17,select
0,01862572500,01862572700,00000000200,a2f,recvmsg
0,01862573200,01862580800,00000007600,a17,select
0,01862584400,01862584600,00000000200,a2f,recvmsg
0,01862585100,01862601700,00000016600,a17,select
0,01862605300,01862605500,00000000200,a2f,recvmsg
0,01862606000,01862635000,00000029000,a17,select
0,01862638500,01862638700,00000000200,a2f,recvmsg
0,01862639200,01862656900,00000017700,a17,select
0,01862660600,01862660800,00000000200,a2f,recvmsg
0,01862661300,01862668400,00000007100,a17,select
0,01862672100,01862672300,00000000200,a2f,recvmsg
0,01862672700,01862679600,00000006900,a17,select
0,01862683000,01862683100,00000000100,a2f,recvmsg
0,01862683700,01862690500,00000006800,a17,select
0,01862693900,01862694100,00000000200,a2f,recvmsg
0,01862694600,01862701600,00000007000,a17,select
0,01862705100,01862705200,00000000100,a2f,recvmsg
0,01862705800,01862712500,00000006700,a17,select
0,01862716200,01862716300,00000000100,a2f,recvmsg
0,01862716800,01862723700,00000006900,a17,select
0,01862727200,01862727400,00000000200,a2f,recvmsg
0,01862727800,01862735500,00000007700,a17,select
0,01862739200,01862739400,00000000200,a2f,recvmsg
0,01862739900,01862746900,00000007000,a17,select
0,01862750400,01862750600,00000000200,a2f,recvmsg
0,01862751100,01862761000,00000009900,a17,select
0,01862764600,01862764800,00000000200,a2f,recvmsg
0,01862765300,01862774700,00000009400,a17,select
0,01862778400,01862778600,00000000200,a2f,recvmsg
0,01862779000,01862786800,00000007800,a17,select
0,01862790300,01862790400,00000000100,a2f,recvmsg
0,01862790900,01862798200,00000007300,a17,select
0,01862801700,01862801900,00000000200,a2f,recvmsg
0,01862802400,01862809600,00000007200,a17,select
0,01862813100,01862813300,00000000200,a2f,recvmsg
0,01862813800,01862821100,00000007300,a17,select
0,01862824700,01862824900,00000000200,a2f,recvmsg
0,01862825400,01862833000,00000007600,a17,select
0,01862836500,01862836700,00000000200,a2f,recvmsg
0,01862837200,01862844400,00000007200,a17,select
0,01862848000,01862848200,00000000200,a2f,recvmsg
0,01862848700,01862855900,00000007200,a17,select
0,01862859400,01862859600,00000000200,a2f,recvmsg
0,01862860100,01862867300,00000007200,a17,select
0,01862871100,01862871300,00000000200,a2f,recvmsg
0,01862871800,01862879100,00000007300,a17,select
0,01862882600,01862882800,00000000200,a2f,recvmsg
0,01862883300,01862890500,00000007200,a17,select
0,01862894000,01862894200,00000000200,a2f,recvmsg
0,01862894700,01862902600,00000007900,a17,select
0,01862906200,01862906400,00000000200,a2f,recvmsg
0,01862906900,01862914100,00000007200,a17,select
0,01862917900,01862918100,00000000200,a2f,recvmsg
0,01862918600,01862925700,00000007100,a17,select
0,01862929200,01862929300,00000000100,a2f,recvmsg
0,01862929900,01862937000,00000007100,a17,select
0,01862940700,01862940800,00000000100,a2f,recvmsg
0,01862941400,01862954000,00000012600,a17,select
0,01862957700,01862957900,00000000200,a2f,recvmsg
0,01862958400,01862965800,00000007400,a17,select
0,01862969400,01862969600,00000000200,a2f,recvmsg
0,01862970100,01862977200,00000007100,a17,select
0,01862980700,01862980900,00000000200,a2f,recvmsg
0,01862981400,01862988800,00000007400,a17,select
0,01862992300,01862992500,00000000200,a2f,recvmsg
0,01862993000,01863000200,00000007200,a17,select
0,01863003900,01863004100,00000000200,a2f,recvmsg
0,01863004600,01863059900,00000055300,a17,select
0,01863060700,01863062000,00000001300,a2f,recvmsg
0,01863466000,01863466700,00000000700,a2f,recvmsg
0,01863758400,01863760500,00000002100,a2f,recvmsg
0,01863872700,01863872900,00000000200,a2f,recvmsg
0,01863873500,01863873900,00000000400,a14,writev
0,01863891900,01863894200,00000002300,a14,writev
0,01863894500,01863895800,00000001300,a14,writev
0,01863896300,01863896500,00000000200,a2f,recvmsg
0,01856269500,01863905000,00007635500,a07,poll
0,01863911200,01863913800,00000002600,a2f,recvmsg
0,01863918900,01863919100,00000000200,a2f,recvmsg
0,01863922600,01863922700,00000000100,a2f,recvmsg
0,01863922900,01863923100,00000000200,a2f,recvmsg
0,01863927400,01863927500,00000000100,a2f,recvmsg
0,01863927700,01863927900,00000000200,a2f,recvmsg
0,01863928700,01863932500,00000003800,a07,poll
0,01863936700,01863942300,00000005600,a2f,recvmsg
0,01863953500,01863953700,00000000200,a2f,recvmsg
0,01863980700,01863985400,00000004700,a07,poll
0,01863991000,01863997800,00000006800,a2f,recvmsg
0,01864010200,01864010400,00000000200,a2f,recvmsg
0,01864033400,01864037800,00000004400,a07,poll
0,01864043100,01864048800,00000005700,a2f,recvmsg
0,01864061400,01864061500,00000000100,a2f,recvmsg
0,01863897200,01864089600,00000192400,a17,select
0,01864106900,01864108500,00000001600,a14,writev
0,01864108900,01864109100,00000000200,a2f,recvmsg
0,01864123400,01864124200,00000000800,a14,writev
0,01864124500,01864124600,00000000100,a2f,recvmsg
0,01864141200,01864142100,00000000900,a14,writev
0,01864142400,01864142600,00000000200,a2f,recvmsg
0,01864157000,01864157200,00000000200,a2f,recvmsg
0,01864083900,01864161800,00000077900,a07,poll
0,01864165400,01864165600,00000000200,a2f,recvmsg
0,01864167000,01864167200,00000000200,a2f,recvmsg
0,01864167500,01864167700,00000000200,a2f,recvmsg
0,01864168900,01864169100,00000000200,a2f,recvmsg
0,01864169300,01864169500,00000000200,a2f,recvmsg
0,01864169800,01864171500,00000001700,a07,poll
0,01864172100,01864173100,00000001000,a2f,recvmsg
0,01864178200,01864179200,00000001000,a2d,recvfrom
0,01864180000,01864180200,00000000200,a2f,recvmsg
0,01864180800,01864181000,00000000200,a2f,recvmsg
0,01864222400,01864222700,00000000300,a2f,recvmsg
0,01864224900,01864225100,00000000200,a2f,recvmsg
0,01864227200,01864229400,00000002200,a07,poll
0,01864230100,01864231100,00000001000,a2f,recvmsg
0,01864237000,01864238000,00000001000,a2d,recvfrom
0,01864238900,01864239100,00000000200,a2f,recvmsg
0,01864239900,01864240000,00000000100,a2f,recvmsg
0,01864269500,01864269700,00000000200,a2f,recvmsg
0,01864271600,01864271700,00000000100,a2f,recvmsg
1,01793255400,01793256300,00000000900,a00,read
1,01793302000,01793302700,00000000700,a00,read
1,01793347000,01793347800,00000000800,a00,read
1,01793393100,01793393800,00000000700,a00,read
1,01793441500,01793442300,00000000800,a00,read
1,01793490300,01793491200,00000000900,a00,read
1,01793538600,01793539300,00000000700,a00,read
1,01793566300,01793568200,00000001900,a02,open
1,01793571700,01793572600,00000000900,a00,read
1,01793626900,01793627700,00000000800,a00,read
1,01793710500,01793711400,00000000900,a00,read
1,01793782600,01793783200,00000000600,a00,read
1,01793859100,01793859900,00000000800,a00,read
1,01793937600,01793938400,00000000800,a00,read
1,01794013600,01794014300,00000000700,a00,read
1,01794096900,01794097600,00000000700,a00,read
1,01794162500,01794163400,00000000900,a00,read
1,01794219900,01794220700,00000000800,a00,read
1,01794296700,01794319000,00000022300,a07,poll
1,01794322700,01794322900,00000000200,a2f,recvmsg
1,01794323600,01794323800,00000000200,a2f,recvmsg
1,01794326700,01794334100,00000007400,a07,poll
1,01794335300,01794335500,00000000200,a2f,recvmsg
1,01794335800,01794335900,00000000100,a2f,recvmsg
1,01794340400,01794345500,00000005100,a06,lstat
1,01794346400,01794347600,00000001200,a06,lstat
1,01794364500,01794375600,00000011100,a01,write
1,01794380800,01794387600,00000006800,a07,poll
1,01794389600,01794389800,00000000200,a2f,recvmsg
1,01794390200,01794390400,00000000200,a2f,recvmsg
1,01794391800,01794706400,00000314600,a38,clone
1,01795171800,01795171900,00000000100,a0c,brk
1,01795183000,01795185600,00000002600,a15,access
1,01795186400,01795187100,00000000700,a09,mmap
1,01795192100,01795192800,00000000700,a15,access
1,01795198700,01795199800,00000001100,a09,mmap
1,01795203500,01795204000,00000000500,a15,access
1,01795210700,01795211900,00000001200,a00,read
1,01795219500,01795221600,00000002100,a09,mmap
1,01795234000,01795234600,00000000600,a15,access
1,01795238300,01795238800,00000000500,a00,read
1,01795239500,01795240300,00000000800,a09,mmap
1,01795242100,01795243400,00000001300,a09,mmap
1,01795251600,01795252100,00000000500,a15,access
1,01795255300,01795255900,00000000600,a00,read
1,01795256500,01795257300,00000000800,a09,mmap
1,01795258900,01795260800,00000001900,a09,mmap
1,01795269500,01795270600,00000001100,a09,mmap
1,01795279200,01795279800,00000000600,a15,access
1,01795282200,01795283200,00000001000,a00,read
1,01795283800,01795285300,00000001500,a09,mmap
1,01795287500,01795289100,00000001600,a09,mmap
1,01795297300,01795297900,00000000600,a15,access
1,01795301000,01795301600,00000000600,a00,read
1,01795302300,01795303700,00000001400,a09,mmap
1,01795306700,01795308700,00000002000,a09,mmap
1,01795317200,01795317800,00000000600,a15,access
1,01795320100,01795320800,00000000700,a00,read
1,01795321300,01795322300,00000001000,a09,mmap
1,01795323700,01795325000,00000001300,a09,mmap
1,01795327500,01795328800,00000001300,a09,mmap
1,01795335000,01795335500,00000000500,a15,access
1,01795337700,01795338300,00000000600,a00,read
1,01795339000,01795340300,00000001300,a09,mmap
1,01795342300,01795343900,00000001600,a09,mmap
1,01795358100,01795358800,00000000700,a09,mmap
1,01795362600,01795363000,00000000400,a09,mmap
1,01795364000,01795364300,00000000300,a09,mmap
1,01795545300,01795545400,00000000100,a0c,brk
1,01795545500,01795546200,00000000700,a0c,brk
1,01795577400,01795578400,00000001000,a00,read
1,01795589400,01795590800,00000001400,a00,read
1,01795630500,01795631700,00000001200,a00,read
1,01795751000,01795751700,00000000700,a00,read
1,01795821900,01795822500,00000000600,a00,read
1,01795907800,01795908600,00000000800,a00,read
1,01796039100,01796040000,00000000900,a00,read
1,01796167600,01796168400,00000000800,a00,read
1,01796324700,01796325300,00000000600,a00,read
1,01796475500,01796476200,00000000700,a00,read
1,01796513100,01796514300,00000001200,a0c,brk
1,01796629700,01796630400,00000000700,a00,read
1,01796779300,01796780100,00000000800,a00,read
1,01796936000,01796936700,00000000700,a00,read
1,01797097100,01797097800,00000000700,a00,read
1,01797228000,01797228800,00000000800,a00,read
1,01797259200,01797259900,00000000700,a0c,brk
1,01797367700,01797368500,00000000800,a00,read
1,01797611900,01797612500,00000000600,a00,read
1,01797624700,01797625000,00000000300,a00,read
1,01797668500,01797668900,00000000400,a00,read
1,01797688500,01797689200,00000000700,a00,read
1,01797895600,01797896100,00000000500,a00,read
1,01797925000,01797925900,00000000900,a00,read
1,01798023100,01798023700,00000000600,a00,read
1,01798047800,01798049000,00000001200,a0c,brk
1,01798094000,01798094300,00000000300,a00,read
1,01798172200,01798173000,00000000800,a00,read
1,01798326000,01798326500,00000000500,a00,read
1,01798437900,01798438600,00000000700,a00,read
1,01798532300,01798532800,00000000500,a00,read
1,01798544500,01798545000,00000000500,a00,read
1,01798628800,01798629300,00000000500,a00,read
1,01798653300,01798653700,00000000400,a00,read
1,01798675700,01798676200,00000000500,a00,read
1,01798778000,01798779000,00000001000,a0c,brk
1,01798780800,01798781900,00000001100,a00,read
1,01798983500,01798983900,00000000400,a00,read
1,01799067200,01799067900,00000000700,a00,read
1,01799132100,01799132700,00000000600,a00,read
1,01799261000,01799261500,00000000500,a00,read
1,01799294400,01799294900,00000000500,a00,read
1,01799311500,01799312900,00000001400,a02,open
1,01799424700,01799425200,00000000500,a00,read
1,01799497000,01799497400,00000000400,a00,read
1,01799549600,01799550700,00000001100,a0c,brk
1,01799557000,01799557700,00000000700,a00,read
1,01799667000,01799667600,00000000600,a00,read
1,01799817200,01799818000,00000000800,a00,read
1,01799947500,01799948200,00000000700,a00,read
1,01800005700,01800006400,00000000700,a00,read
1,01800062000,01800062600,00000000600,a00,read
1,01800132400,01800133000,00000000600,a00,read
1,01800185500,01800186100,00000000600,a00,read
1,01800274200,01800275000,00000000800,a0c,brk
1,01800307500,01800311300,00000003800,a0c,brk
1,01800325800,01800326500,00000000700,a00,read
1,01800441500,01800442400,00000000900,a00,read
1,01800600500,01800601300,00000000800,a00,read
1,01800717900,01800718700,00000000800,a00,read
1,01800864000,01800864600,00000000600,a00,read
1,01800980900,01800981600,00000000700,a00,read
1,01801142700,01801143400,00000000700,a00,read
1,01801148300,01801149000,00000000700,a0c,brk
1,01801272600,01801273200,00000000600,a00,read
1,01801392400,01801393000,00000000600,a00,read
1,01801533800,01801534600,00000000800,a00,read
1,01801665000,01801665700,00000000700,a00,read
1,01801758200,01801759000,00000000800,a00,read
1,01801870800,01801871400,00000000600,a00,read
1,01801995100,01801995800,00000000700,a00,read
1,01802107100,01802107700,00000000600,a0c,brk
1,01802130500,01802131200,00000000700,a00,read
1,01802300600,01802301200,00000000600,a00,read
1,01802450900,01802451500,00000000600,a00,read
1,01802561400,01802562100,00000000700,a00,read
1,01802729900,01802730700,00000000800,a00,read
1,01802807200,01802807900,00000000700,a00,read
1,01802889200,01802889800,00000000600,a00,read
1,01802970900,01802971500,00000000600,a00,read
1,01803044800,01803045500,00000000700,a00,read
1,01803146000,01803146600,00000000600,a00,read
1,01803248600,01803249200,00000000600,a00,read
1,01803338200,01803338800,00000000600,a00,read
1,01803418900,01803419700,00000000800,a00,read
1,01803520300,01803520900,00000000600,a00,read
1,01803603200,01803603700,00000000500,a0c,brk
1,01803606100,01803606800,00000000700,a00,read
1,01803713600,01803714200,00000000600,a00,read
1,01803806100,01803806800,00000000700,a00,read
1,01803926400,01803927000,00000000600,a00,read
1,01804039900,01804040600,00000000700,a00,read
1,01804142800,01804143500,00000000700,a00,read
1,01804243600,01804244000,00000000400,a0c,brk
1,01804602500,01804605900,00000003400,a57,unlink
1,01804630100,01804630700,00000000600,a48,fcntl
1,01804677700,01804694600,00000016900,a01,write
1,01804712500,01804715000,00000002500,a01,write
1,01804731200,01804734000,00000002800,a01,write
1,01794334400,01804981400,00010647000,a17,select
1,01805006800,01805007100,00000000300,a2f,recvmsg
1,01805010500,01805040900,00000030400,a17,select
1,01805045300,01805045500,00000000200,a2f,recvmsg
1,01805046100,01805064000,00000017900,a17,select
1,01805067600,01805067800,00000000200,a2f,recvmsg
1,01805068400,01805084200,00000015800,a17,select
1,01805088100,01805088300,00000000200,a2f,recvmsg
1,01805088800,01805105200,00000016400,a17,select
1,01805109200,01805109400,00000000200,a2f,recvmsg
1,01805109900,01805124600,00000014700,a17,select
1,01805128200,01805128400,00000000200,a2f,recvmsg
1,01805129000,01805148400,00000019400,a17,select
1,01805152200,01805152400,00000000200,a2f,recvmsg
1,01805152900,01805190900,00000038000,a17,select
1,01805194900,01805195000,00000000100,a2f,recvmsg
1,01805195700,01805203300,00000007600,a17,select
1,01805206800,01805207000,00000000200,a2f,recvmsg
1,01805207600,01805215700,00000008100,a17,select
1,01805219500,01805219700,00000000200,a2f,recvmsg
1,01805220200,01805228400,00000008200,a17,select
1,01805232100,01805232300,00000000200,a2f,recvmsg
1,01805232700,01805240400,00000007700,a17,select
1,01805244000,01805244100,00000000100,a2f,recvmsg
1,01805244700,01805252300,00000007600,a17,select
1,01805256100,01805256300,00000000200,a2f,recvmsg
1,01805256900,01805263900,00000007000,a17,select
1,01805267500,01805267600,00000000100,a2f,recvmsg
1,01805268200,01805276500,00000008300,a17,select
1,01805280300,01805280500,00000000200,a2f,recvmsg
1,01805281000,01805288500,00000007500,a17,select
1,01805292300,01805292400,00000000100,a2f,recvmsg
1,01805293000,01805301300,00000008300,a17,select
1,01805305000,01805305200,00000000200,a2f,recvmsg
1,01805305700,01805312900,00000007200,a17,select
1,01805316600,01805316800,00000000200,a2f,recvmsg
1,01805317300,01805324400,00000007100,a17,select
1,01805327800,01805328000,00000000200,a2f,recvmsg
1,01805328500,01805336000,00000007500,a17,select
1,01805339700,01805339800,00000000100,a2f,recvmsg
1,01805340500,01805347700,00000007200,a17,select
1,01805351300,01805351500,00000000200,a2f,recvmsg
1,01805352000,01805358700,00000006700,a17,select
1,01805362400,01805362600,00000000200,a2f,recvmsg
1,01805363200,01805372900,00000009700,a17,select
1,01805376400,01805376600,00000000200,a2f,recvmsg
1,01805377000,01805383900,00000006900,a17,select
1,01805387500,01805387700,00000000200,a2f,recvmsg
1,01805388200,01805395000,00000006800,a17,select
1,01805398700,01805398900,00000000200,a2f,recvmsg
1,01805399400,01805406300,00000006900,a17,select
1,01805409900,01805410000,00000000100,a2f,recvmsg
1,01805410600,01805417800,00000007200,a17,select
1,01805421300,01805421500,00000000200,a2f,recvmsg
1,01805422000,01805428900,00000006900,a17,select
1,01805432400,01805432500,00000000100,a2f,recvmsg
1,01805433100,01805440600,00000007500,a17,select
1,01805444200,01805444400,00000000200,a2f,recvmsg
1,01805444900,01805452300,00000007400,a17,select
1,01805455900,01805456000,00000000100,a2f,recvmsg
1,01805456500,01805464600,00000008100,a17,select
1,01805468400,01805468500,00000000100,a2f,recvmsg
1,01805469100,01805476800,00000007700,a17,select
1,01805480300,01805480500,00000000200,a2f,recvmsg
1,01805481000,01805488500,00000007500,a17,select
1,01805492300,01805492500,00000000200,a2f,recvmsg
1,01805492900,01805502300,00000009400,a17,select
1,01805505900,01805506100,00000000200,a2f,recvmsg
1,01805506600,01805514400,00000007800,a17,select
1,01805517900,01805518100,00000000200,a2f,recvmsg
1,01805518600,01805525700,00000007100,a17,select
1,01805529300,01805529500,00000000200,a2f,recvmsg
1,01805530000,01805539500,00000009500,a17,select
1,01805543100,01805543300,00000000200,a2f,recvmsg
1,01805543900,01805551300,00000007400,a17,select
1,01805555000,01805555100,00000000100,a2f,recvmsg
1,01805555600,01805563400,00000007800,a17,select
1,01805567000,01805567200,00000000200,a2f,recvmsg
1,01805567700,01805576000,00000008300,a17,select
1,01805579700,01805579900,00000000200,a2f,recvmsg
1,01805580300,01805587700,00000007400,a17,select
1,01805591400,01805591500,00000000100,a2f,recvmsg
1,01805592100,01805599100,00000007000,a17,select
1,01805602800,01805602900,00000000100,a2f,recvmsg
1,01805603400,01805610800,00000007400,a17,select
1,01805614500,01805614600,00000000100,a2f,recvmsg
1,01805615200,01805635400,00000020200,a17,select
1,01805638900,01805639000,00000000100,a2f,recvmsg
1,01805639600,01805669800,00000030200,a17,select
1,01805673400,01805673600,00000000200,a2f,recvmsg
1,01805674200,01805692100,00000017900,a17,select
1,01805695900,01805696000,00000000100,a2f,recvmsg
1,01805696600,01805703500,00000006900,a17,select
1,01805707100,01805707300,00000000200,a2f,recvmsg
1,01805707800,01805714600,00000006800,a17,select
1,01805718200,01805718300,00000000100,a2f,recvmsg
1,01805718800,01805725700,00000006900,a17,select
1,01805729300,01805729500,00000000200,a2f,recvmsg
1,01805730000,01805736800,00000006800,a17,select
1,01805740300,01805740500,00000000200,a2f,recvmsg
1,01805741000,01805747700,00000006700,a17,select
1,01805751200,01805751400,00000000200,a2f,recvmsg
1,01805751900,01805758700,00000006800,a17,select
1,01805762400,01805762500,00000000100,a2f,recvmsg
1,01805763000,01805770500,00000007500,a17,select
1,01805774200,01805774400,00000000200,a2f,recvmsg
1,01805775000,01805781900,00000006900,a17,select
1,01805785400,01805785600,00000000200,a2f,recvmsg
1,01805786200,01805795000,00000008800,a17,select
1,01805798600,01805798800,00000000200,a2f,recvmsg
1,01805799300,01805808400,00000009100,a17,select
1,01805812000,01805812200,00000000200,a2f,recvmsg
1,01805812800,01805820300,00000007500,a17,select
1,01805823800,01805824000,00000000200,a2f,recvmsg
1,01805824600,01805831700,00000007100,a17,select
1,01805835300,01805835400,00000000100,a2f,recvmsg
1,01805836000,01805843100,00000007100,a17,select
1,01805846400,01805846600,00000000200,a2f,recvmsg
1,01805847200,01805854400,00000007200,a17,select
1,01805858000,01805858100,00000000100,a2f,recvmsg
1,01805858700,01805866400,00000007700,a17,select
1,01805870000,01805870200,00000000200,a2f,recvmsg
1,01805870700,01805878000,00000007300,a17,select
1,01805881400,01805881600,00000000200,a2f,recvmsg
1,01805882100,01805889300,00000007200,a17,select
1,01805892800,01805893000,00000000200,a2f,recvmsg
1,01805893500,01805900500,00000007000,a17,select
1,01805904000,01805904200,00000000200,a2f,recvmsg
1,01805904700,01805912100,00000007400,a17,select
1,01805915500,01805915600,00000000100,a2f,recvmsg
1,01805916200,01805923200,00000007000,a17,select
1,01805926700,01805926800,00000000100,a2f,recvmsg
1,01805927400,01805935000,00000007600,a17,select
1,01805938900,01805939100,00000000200,a2f,recvmsg
1,01805939500,01805946800,00000007300,a17,select
1,01805950400,01805950500,00000000100,a2f,recvmsg
1,01805951100,01805958200,00000007100,a17,select
1,01805961800,01805961900,00000000100,a2f,recvmsg
1,01805962400,01805969500,00000007100,a17,select
1,01805973100,01805973300,00000000200,a2f,recvmsg
1,01805973700,01805987000,00000013300,a17,select
1,01805990600,01805990800,00000000200,a2f,recvmsg
1,01805991300,01805998700,00000007400,a17,select
1,01806002100,01806002300,00000000200,a2f,recvmsg
1,01806002900,01806010000,00000007100,a17,select
1,01806013500,01806013700,00000000200,a2f,recvmsg
1,01806014200,01806021500,00000007300,a17,select
1,01806024800,01806025000,00000000200,a2f,recvmsg
1,01806025500,01806032700,00000007200,a17,select
1,01806036100,01806036300,00000000200,a2f,recvmsg
1,01806036800,01806093700,00000056900,a17,select
1,01806094700,01806095900,00000001200,a2f,recvmsg
1,01806189500,01806193700,00000004200,a14,writev
1,01806271500,01806273100,00000001600,a14,writev
1,01806330500,01806332200,00000001700,a14,writev
1,01806390000,01806392200,00000002200,a14,writev
1,01806449000,01806450500,00000001500,a14,writev
1,01806505300,01806506700,00000001400,a14,writev
1,01806510100,01806510900,00000000800,a2f,recvmsg
1,01806559800,01806561400,00000001600,a14,writev
1,01806604600,01806606000,00000001400,a14,writev
1,01806648500,01806650100,00000001600,a14,writev
1,01806692900,01806694200,00000001300,a14,writev
1,01806736900,01806738300,00000001400,a14,writev
1,01806780000,01806781800,00000001800,a14,writev
1,01806781900,01806782300,00000000400,a14,writev
1,01806808900,01806810700,00000001800,a2f,recvmsg
1,01806836600,01806838500,00000001900,a14,writev
1,01806856500,01806857900,00000001400,a14,writev
1,01806873200,01806874800,00000001600,a14,writev
1,01806889700,01806891500,00000001800,a14,writev
1,01806905100,01806906700,00000001600,a14,writev
1,01806921200,01806923000,00000001800,a14,writev
1,01806927700,01806927900,00000000200,a2f,recvmsg
1,01806928500,01806928900,00000000400,a14,writev
1,01806929000,01806929200,00000000200,a14,writev
1,01806946600,01806948400,00000001800,a14,writev
1,01806948600,01806950200,00000001600,a14,writev
1,01806950700,01806950900,00000000200,a2f,recvmsg
1,01806962400,01806963900,00000001500,a14,writev
1,01806964200,01806965100,00000000900,a14,writev
1,01806965500,01806965700,00000000200,a2f,recvmsg
1,01794380800,01806973400,00012592600,a07,poll
1,01806979700,01806982200,00000002500,a2f,recvmsg
1,01806987200,01806987400,00000000200,a2f,recvmsg
1,01806990800,01806991000,00000000200,a2f,recvmsg
1,01806991300,01806991500,00000000200,a2f,recvmsg
1,01806995800,01806996000,00000000200,a2f,recvmsg
1,01806996200,01806996400,00000000200,a2f,recvmsg
1,01806997100,01807001800,00000004700,a07,poll
1,01807007700,01807013800,00000006100,a2f,recvmsg
1,01807028200,01807028400,00000000200,a2f,recvmsg
1,01807053900,01807058200,00000004300,a07,poll
1,01807063900,01807069700,00000005800,a2f,recvmsg
1,01807082400,01807082600,00000000200,a2f,recvmsg
1,01806966200,01807111400,00000145200,a17,select
1,01807127200,01807128500,00000001300,a14,writev
1,01807129000,01807129200,00000000200,a2f,recvmsg
1,01807146100,01807146300,00000000200,a2f,recvmsg
1,01807159200,01807160300,00000001100,a14,writev
1,01807160600,01807160800,00000000200,a2f,recvmsg
1,01807106000,01807165600,00000059600,a07,poll
1,01807168900,01807169000,00000000100,a2f,recvmsg
1,01807170400,01807170600,00000000200,a2f,recvmsg
1,01807170900,01807171000,00000000100,a2f,recvmsg
1,01807172200,01807172400,00000000200,a2f,recvmsg
1,01807172500,01807172700,00000000200,a2f,recvmsg
1,01807173100,01807174400,00000001300,a07,poll
1,01807175000,01807176000,00000001000,a2f,recvmsg
1,01807181500,01807182300,00000000800,a2d,recvfrom
1,01807183500,01807183600,00000000100,a2f,recvmsg
1,01807184300,01807184500,00000000200,a2f,recvmsg
1,01807213600,01807213900,00000000300,a2f,recvmsg
1,01807215700,01807215900,00000000200,a2f,recvmsg
1,01807219400,01807734500,00000515100,a07,poll
1,01807752600,01807757600,00000005000,a2e,sendmsg
1,01769153200,01807761000,00038607800,ae8,epoll_wait
1,01807775000,01807776300,00000001300,a2f,recvmsg
1,01807790200,01807790400,00000000200,a2f,recvmsg
1,01807848800,01807852600,00000003800,a2e,sendmsg
1,01807875600,01807877200,00000001600,a2e,sendmsg
1,01807858600,01807878600,00000020000,ae8,epoll_wait
1,01807881000,01807881900,00000000900,a2f,recvmsg
1,01807888700,01807888900,00000000200,a2f,recvmsg
1,01807919100,01807920000,00000000900,a2e,sendmsg
1,01807937600,01807938000,00000000400,a00,read
1,01807940600,01807945000,00000004400,a07,poll
1,01808130800,01808131300,00000000500,aca,futex
1,01807923400,01808223700,00000300300,ae8,epoll_wait
1,01808227400,01808229800,00000002400,a2f,recvmsg
1,01808262700,01808262800,00000000100,a2f,recvmsg
1,01808289000,01808292700,00000003700,a2e,sendmsg
1,01808312300,01808313400,00000001100,a2e,sendmsg
1,01808220800,01808834800,00000614000,a07,poll
1,01809208400,01809217600,00000009200,a02,open
1,01809231200,01809234400,00000003200,a00,read
1,01809291100,01809292000,00000000900,a00,read
1,01809344600,01809345400,00000000800,a00,read
1,01809397600,01809398300,00000000700,a00,read
1,01809450300,01809451100,00000000800,a00,read
1,01809502900,01809503600,00000000700,a00,read
1,01809553100,01809553900,00000000800,a00,read
1,01809604500,01809605200,00000000700,a00,read
1,01809658900,01809659600,00000000700,a00,read
1,01809711900,01809712700,00000000800,a00,read
1,01809762700,01809763400,00000000700,a00,read
1,01809791100,01809793000,00000001900,a02,open
1,01809796400,01809797300,00000000900,a00,read
1,01809852100,01809853000,00000000900,a00,read
1,01809937700,01809938600,00000000900,a00,read
1,01810011000,01810011800,00000000800,a00,read
1,01810090500,01810091100,00000000600,a00,read
1,01810171000,01810171700,00000000700,a00,read
1,01810248900,01810249600,00000000700,a00,read
1,01810335100,01810335700,00000000600,a00,read
1,01810402100,01810402800,00000000700,a00,read
1,01810461200,01810462000,00000000800,a00,read
1,01810544400,01810580600,00000036200,a07,poll
1,01810584600,01810584900,00000000300,a2f,recvmsg
1,01810585700,01810585800,00000000100,a2f,recvmsg
1,01810590200,01810598100,00000007900,a07,poll
1,01810599400,01810599600,00000000200,a2f,recvmsg
1,01810599800,01810600000,00000000200,a2f,recvmsg
1,01810604900,01810611600,00000006700,a06,lstat
1,01810612500,01810613300,00000000800,a06,lstat
1,01810636900,01810652300,00000015400,a01,write
1,01810657900,01810679000,00000021100,a07,poll
1,01810681000,01810681200,00000000200,a2f,recvmsg
1,01810681600,01810681800,00000000200,a2f,recvmsg
1,01810683200,01810995500,00000312300,a38,clone
1,01811471900,01811472000,00000000100,a0c,brk
1,01811482300,01811485000,00000002700,a15,access
1,01811485800,01811486700,00000000900,a09,mmap
1,01811491100,01811492900,00000001800,a15,access
1,01811500200,01811501200,00000001000,a09,mmap
1,01811505000,01811505600,00000000600,a15,access
1,01811513000,01811514200,00000001200,a00,read
1,01811515700,01811517200,00000001500,a09,mmap
1,01811521200,01811523400,00000002200,a09,mmap
1,01811535600,01811536300,00000000700,a15,access
1,01811539700,01811540300,00000000600,a00,read
1,01811541100,01811542000,00000000900,a09,mmap
1,01811543900,01811545100,00000001200,a09,mmap
1,01811554600,01811555200,00000000600,a15,access
1,01811558000,01811558900,00000000900,a00,read
1,01811559500,01811560400,00000000900,a09,mmap
1,01811562100,01811564200,00000002100,a09,mmap
1,01811568800,01811571900,00000003100,a09,mmap
1,01811574000,01811575100,00000001100,a09,mmap
1,01811583500,01811584100,00000000600,a15,access
1,01811587000,01811587700,00000000700,a00,read
1,01811588300,01811589800,00000001500,a09,mmap
1,01811592200,01811594000,00000001800,a09,mmap
1,01811602500,01811603000,00000000500,a15,access
1,01811606100,01811606800,00000000700,a00,read
1,01811607400,01811608800,00000001400,a09,mmap
1,01811611700,01811613900,00000002200,a09,mmap
1,01811622600,01811623300,00000000700,a15,access
1,01811626000,01811626500,00000000500,a00,read
1,01811627000,01811628000,00000001000,a09,mmap
1,01811629400,01811630700,00000001300,a09,mmap
1,01811633100,01811634400,00000001300,a09,mmap
1,01811640700,01811641200,00000000500,a15,access
1,01811643700,01811644200,00000000500,a00,read
1,01811644800,01811646200,00000001400,a09,mmap
1,01811647900,01811649500,00000001600,a09,mmap
1,01811663400,01811664000,00000000600,a09,mmap
1,01811667900,01811668200,00000000300,a09,mmap
1,01811669500,01811669700,00000000200,a09,mmap
1,01811846100,01811846300,00000000200,a0c,brk
1,01811846400,01811847200,00000000800,a0c,brk
1,01811884200,01811885100,00000000900,a00,read
1,01811896500,01811898000,00000001500,a00,read
1,01811932400,01811933300,00000000900,a00,read
1,01812054100,01812054900,00000000800,a00,read
1,01812127300,01812127800,00000000500,a00,read
1,01812212700,01812213200,00000000500,a00,read
1,01812342800,01812343600,00000000800,a00,read
1,01812472200,01812473000,00000000800,a00,read
1,01812629000,01812629800,00000000800,a00,read
1,01812779900,01812780600,00000000700,a00,read
1,01812817000,01812818300,00000001300,a0c,brk
1,01812934100,01812934800,00000000700,a00,read
1,01813082500,01813083200,00000000700,a00,read
1,01813258000,01813258800,00000000800,a00,read
1,01813418300,01813419000,00000000700,a00,read
1,01813527400,01813528000,00000000600,a00,read
1,01813558200,01813558900,00000000700,a0c,brk
1,01813667700,01813668300,00000000600,a00,read
1,01813911900,01813912500,00000000600,a00,read
1,01813925600,01813926000,00000000400,a00,read
1,01813970000,01813970400,00000000400,a00,read
1,01813990800,01813991500,00000000700,a00,read
1,01814198400,01814198800,00000000400,a00,read
1,01814227900,01814228700,00000000800,a00,read
1,01814325200,01814325900,00000000700,a00,read
1,01814396600,01814397000,00000000400,a00,read
1,01814475800,01814476600,00000000800,a00,read
1,01814628800,01814629300,00000000500,a00,read
1,01814740600,01814741300,00000000700,a00,read
1,01814835100,01814835600,00000000500,a00,read
1,01814847700,01814848200,00000000500,a00,read
1,01814927800,01814928400,00000000600,a00,read
1,01814952100,01814952400,00000000300,a00,read
1,01814974500,01814975300,00000000800,a00,read
1,01815077000,01815078100,00000001100,a0c,brk
1,01815079200,01815080200,00000001000,a00,read
1,01815283100,01815283400,00000000300,a00,read
1,01815366400,01815366900,00000000500,a00,read
1,01815463200,01815464000,00000000800,a00,read
1,01815605800,01815606300,00000000500,a00,read
1,01815640000,01815640500,00000000500,a00,read
1,01815657500,01815659000,00000001500,a02,open
1,01815770900,01815771400,00000000500,a00,read
1,01815842800,01815843300,00000000500,a00,read
1,01815896000,01815897400,00000001400,a0c,brk
1,01815906300,01815906900,00000000600,a00,read
1,01816014000,01816014700,00000000700,a00,read
1,01816167600,01816168500,00000000900,a00,read
1,01816303200,01816303800,00000000600,a00,read
1,01816364400,01816365200,00000000800,a00,read
1,01816424000,01816424800,00000000800,a00,read
1,01816497700,01816498400,00000000700,a00,read
1,01816553900,01816554600,00000000700,a00,read
1,01816645600,01816646500,00000000900,a0c,brk
1,01816678600,01816683000,00000004400,a0c,brk
1,01816697000,01816697800,00000000800,a00,read
1,01816817000,01816818000,00000001000,a00,read
1,01816976200,01816976800,00000000600,a00,read
1,01817093900,01817094600,00000000700,a00,read
1,01817248200,01817249000,00000000800,a00,read
1,01817365700,01817366300,00000000600,a00,read
1,01817527200,01817528000,00000000800,a00,read
1,01817532900,01817533700,00000000800,a0c,brk
1,01817650000,01817650700,00000000700,a00,read
1,01817768500,01817769100,00000000600,a00,read
1,01817910400,01817911100,00000000700,a00,read
1,01818042400,01818043200,00000000800,a00,read
1,01818135900,01818136700,00000000800,a00,read
1,01818248400,01818249100,00000000700,a00,read
1,01818373100,01818373800,00000000700,a00,read
1,01818486700,01818487300,00000000600,a0c,brk
1,01818510000,01818510600,00000000600,a00,read
1,01818679000,01818679800,00000000800,a00,read
1,01818829500,01818830200,00000000700,a00,read
1,01818940200,01818940900,00000000700,a00,read
1,01819110200,01819111300,00000001100,a00,read
1,01819188500,01819189200,00000000700,a00,read
1,01819270600,01819271300,00000000700,a00,read
1,01819338100,01819338800,00000000700,a0c,brk
1,01819352200,01819352900,00000000700,a00,read
1,01819425300,01819426000,00000000700,a00,read
1,01819526500,01819527200,00000000700,a00,read
1,01819629000,01819629700,00000000700,a00,read
1,01819718600,01819719400,00000000800,a00,read
1,01819799600,01819800200,00000000600,a00,read
1,01819902100,01819902700,00000000600,a00,read
1,01819983100,01819983500,00000000400,a0c,brk
1,01819985900,01819986600,00000000700,a00,read
1,01820093300,01820093900,00000000600,a00,read
1,01820185700,01820186400,00000000700,a00,read
1,01820304300,01820305000,00000000700,a00,read
1,01820417600,01820418300,00000000700,a00,read
1,01820522400,01820523100,00000000700,a00,read
1,01820623100,01820623500,00000000400,a0c,brk
1,01820983400,01820986600,00000003200,a57,unlink
1,01821010300,01821010900,00000000600,a48,fcntl
1,01821059400,01821075000,00000015600,a01,write
1,01821092900,01821095800,00000002900,a01,write
1,01821112100,01821114300,00000002200,a01,write
1,01807161300,01821368800,00014207500,a17,select
1,01821392800,01821393100,00000000300,a2f,recvmsg
1,01821396400,01821424200,00000027800,a17,select
1,01821428400,01821428600,00000000200,a2f,recvmsg
1,01821429200,01821447600,00000018400,a17,select
1,01821451200,01821451300,00000000100,a2f,recvmsg
1,01821451900,01821468600,00000016700,a17,select
1,01821472400,01821472500,00000000100,a2f,recvmsg
1,01821473100,01821489500,00000016400,a17,select
1,01821493400,01821493600,00000000200,a2f,recvmsg
1,01821494200,01821509600,00000015400,a17,select
1,01821513100,01821513400,00000000300,a2f,recvmsg
1,01821513900,01821540100,00000026200,a17,select
1,01821543900,01821544100,00000000200,a2f,recvmsg
1,01821544600,01821554900,00000010300,a17,select
1,01821558500,01821558600,00000000100,a2f,recvmsg
1,01821559100,01821566400,00000007300,a17,select
1,01821570000,01821570200,00000000200,a2f,recvmsg
1,01821570600,01821578900,00000008300,a17,select
1,01821582300,01821582500,00000000200,a2f,recvmsg
1,01821583100,01821590500,00000007400,a17,select
1,01821594300,01821594500,00000000200,a2f,recvmsg
1,01821595000,01821602600,00000007600,a17,select
1,01821606400,01821606500,00000000100,a2f,recvmsg
1,01821607000,01821614200,00000007200,a17,select
1,01821618000,01821618200,00000000200,a2f,recvmsg
1,01821618700,01821625700,00000007000,a17,select
1,01821629300,01821629400,00000000100,a2f,recvmsg
1,01821629900,01821639300,00000009400,a17,select
1,01821643300,01821643500,00000000200,a2f,recvmsg
1,01821644000,01821651500,00000007500,a17,select
1,01821655100,01821655200,00000000100,a2f,recvmsg
1,01821655800,01821663200,00000007400,a17,select
1,01821666800,01821667000,00000000200,a2f,recvmsg
1,01821667500,01821674800,00000007300,a17,select
1,01821678400,01821678600,00000000200,a2f,recvmsg
1,01821679100,01821686300,00000007200,a17,select
1,01821689700,01821689900,00000000200,a2f,recvmsg
1,01821690400,01821697700,00000007300,a17,select
1,01821701200,01821701400,00000000200,a2f,recvmsg
1,01821701800,01821710100,00000008300,a17,select
1,01821713700,01821713900,00000000200,a2f,recvmsg
1,01821714500,01821721300,00000006800,a17,select
1,01821724900,01821725100,00000000200,a2f,recvmsg
1,01821725700,01821734500,00000008800,a17,select
1,01821737900,01821738100,00000000200,a2f,recvmsg
1,01821738600,01821745400,00000006800,a17,select
1,01821749100,01821749200,00000000100,a2f,recvmsg
1,01821749800,01821756600,00000006800,a17,select
1,01821760200,01821760300,00000000100,a2f,recvmsg
1,01821760800,01821767600,00000006800,a17,select
1,01821771100,01821771300,00000000200,a2f,recvmsg
1,01821771800,01821779100,00000007300,a17,select
1,01821782700,01821782900,00000000200,a2f,recvmsg
1,01821783300,01821790200,00000006900,a17,select
1,01821793700,01821793900,00000000200,a2f,recvmsg
1,01821794400,01821801800,00000007400,a17,select
1,01821805400,01821805600,00000000200,a2f,recvmsg
1,01821806000,01821813600,00000007600,a17,select
1,01821817400,01821817500,00000000100,a2f,recvmsg
1,01821818000,01821825900,00000007900,a17,select
1,01821829800,01821830000,00000000200,a2f,recvmsg
1,01821830500,01821838100,00000007600,a17,select
1,01821841600,01821841800,00000000200,a2f,recvmsg
1,01821842300,01821849800,00000007500,a17,select
1,01821853500,01821853700,00000000200,a2f,recvmsg
1,01821854200,01821863600,00000009400,a17,select
1,01821867200,01821867400,00000000200,a2f,recvmsg
1,01821868000,01821875200,00000007200,a17,select
1,01821878800,01821878900,00000000100,a2f,recvmsg
1,01821879500,01821886700,00000007200,a17,select
1,01821890300,01821890500,00000000200,a2f,recvmsg
1,01821891000,01821898900,00000007900,a17,select
1,01821902500,01821902600,00000000100,a2f,recvmsg
1,01821903100,01821910700,00000007600,a17,select
1,01821914300,01821914500,00000000200,a2f,recvmsg
1,01821915000,01821922800,00000007800,a17,select
1,01821926500,01821926700,00000000200,a2f,recvmsg
1,01821927300,01821935200,00000007900,a17,select
1,01821938800,01821939000,00000000200,a2f,recvmsg
1,01821939500,01821946600,00000007100,a17,select
1,01821950400,01821950400,00000000000,a2f,recvmsg
1,01821951000,01821958000,00000007000,a17,select
1,01821961500,01821961700,00000000200,a2f,recvmsg
1,01821962200,01821969700,00000007500,a17,select
1,01821973400,01821973500,00000000100,a2f,recvmsg
1,01821974100,01821989900,00000015800,a17,select
1,01821993400,01821993600,00000000200,a2f,recvmsg
1,01821994100,01822024200,00000030100,a17,select
1,01822027900,01822028100,00000000200,a2f,recvmsg
1,01822028500,01822046300,00000017800,a17,select
1,01822049900,01822050100,00000000200,a2f,recvmsg
1,01822050600,01822057700,00000007100,a17,select
1,01822061200,01822061400,00000000200,a2f,recvmsg
1,01822061900,01822068700,00000006800,a17,select
1,01822072200,01822072300,00000000100,a2f,recvmsg
1,01822072900,01822079800,00000006900,a17,select
1,01822083200,01822083400,00000000200,a2f,recvmsg
1,01822083900,01822090700,00000006800,a17,select
1,01822094300,01822094500,00000000200,a2f,recvmsg
1,01822095000,01822102000,00000007000,a17,select
1,01822105700,01822105800,00000000100,a2f,recvmsg
1,01822106300,01822113200,00000006900,a17,select
1,01822116600,01822116800,00000000200,a2f,recvmsg
1,01822117300,01822124800,00000007500,a17,select
1,01822128400,01822128500,00000000100,a2f,recvmsg
1,01822129000,01822135900,00000006900,a17,select
1,01822139400,01822139600,00000000200,a2f,recvmsg
1,01822140100,01822149900,00000009800,a17,select
1,01822153600,01822153700,00000000100,a2f,recvmsg
1,01822154200,01822163300,00000009100,a17,select
1,01822167000,01822167100,00000000100,a2f,recvmsg
1,01822167700,01822175100,00000007400,a17,select
1,01822178700,01822178800,00000000100,a2f,recvmsg
1,01822179500,01822186300,00000006800,a17,select
1,01822189800,01822190000,00000000200,a2f,recvmsg
1,01822190600,01822197700,00000007100,a17,select
1,01822201200,01822201300,00000000100,a2f,recvmsg
1,01822201800,01822209000,00000007200,a17,select
1,01822212600,01822212700,00000000100,a2f,recvmsg
1,01822213200,01822220900,00000007700,a17,select
1,01822224500,01822224600,00000000100,a2f,recvmsg
1,01822225200,01822232400,00000007200,a17,select
1,01822236000,01822236200,00000000200,a2f,recvmsg
1,01822236700,01822244000,00000007300,a17,select
1,01822247600,01822247800,00000000200,a2f,recvmsg
1,01822248400,01822255500,00000007100,a17,select
1,01822258900,01822259100,00000000200,a2f,recvmsg
1,01822259600,01822266700,00000007100,a17,select
1,01822270100,01822270300,00000000200,a2f,recvmsg
1,01822270900,01822277900,00000007000,a17,select
1,01822281500,01822281700,00000000200,a2f,recvmsg
1,01822282200,01822290100,00000007900,a17,select
1,01822293700,01822293800,00000000100,a2f,recvmsg
1,01822294300,01822301900,00000007600,a17,select
1,01822305400,01822305600,00000000200,a2f,recvmsg
1,01822306000,01822313200,00000007200,a17,select
1,01822316700,01822316900,00000000200,a2f,recvmsg
1,01822317300,01822324300,00000007000,a17,select
1,01822327800,01822328000,00000000200,a2f,recvmsg
1,01822328500,01822343800,00000015300,a17,select
1,01822347500,01822347600,00000000100,a2f,recvmsg
1,01822348100,01822355600,00000007500,a17,select
1,01822359200,01822359300,00000000100,a2f,recvmsg
1,01822359900,01822367000,00000007100,a17,select
1,01822370400,01822370600,00000000200,a2f,recvmsg
1,01822371100,01822378300,00000007200,a17,select
1,01822381800,01822382000,00000000200,a2f,recvmsg
1,01822382500,01822389900,00000007400,a17,select
1,01822393500,01822393700,00000000200,a2f,recvmsg
1,01822394200,01822450500,00000056300,a17,select
1,01822451400,01822452500,00000001100,a2f,recvmsg
1,01822545000,01822549000,00000004000,a14,writev
1,01822622100,01822624100,00000002000,a14,writev
1,01822739600,01822741100,00000001500,a14,writev
1,01822797700,01822799200,00000001500,a14,writev
1,01822855700,01822857200,00000001500,a14,writev
1,01822860700,01822861600,00000000900,a2f,recvmsg
1,01822911500,01822913000,00000001500,a14,writev
1,01822956400,01822957800,00000001400,a14,writev
1,01823001800,01823003800,00000002000,a14,writev
1,01823047800,01823049200,00000001400,a14,writev
1,01823093000,01823094400,00000001400,a14,writev
1,01823137500,01823139000,00000001500,a14,writev
1,01823164300,01823166300,00000002000,a2f,recvmsg
1,01823193600,01823195200,00000001600,a14,writev
1,01823213100,01823214500,00000001400,a14,writev
1,01823230500,01823232000,00000001500,a14,writev
1,01823246600,01823248100,00000001500,a14,writev
1,01823263000,01823264400,00000001400,a14,writev
1,01823278500,01823280000,00000001500,a14,writev
1,01823284800,01823285000,00000000200,a2f,recvmsg
1,01823285700,01823286100,00000000400,a14,writev
1,01823286400,01823286800,00000000400,a14,writev
1,01823304800,01823306700,00000001900,a14,writev
1,01823306900,01823308300,00000001400,a14,writev
1,01823308800,01823308900,00000000100,a2f,recvmsg
1,01823322100,01823323000,00000000900,a14,writev
1,01823323400,01823323500,00000000100,a2f,recvmsg
1,01823334400,01823335800,00000001400,a14,writev
1,01823336000,01823337000,00000001000,a14,writev
1,01823337300,01823337400,00000000100,a2f,recvmsg
1,01810657900,01823345000,00012687100,a07,poll
1,01823350900,01823353400,00000002500,a2f,recvmsg
1,01823358700,01823358900,00000000200,a2f,recvmsg
1,01823362600,01823362800,00000000200,a2f,recvmsg
1,01823363100,01823363300,00000000200,a2f,recvmsg
1,01823367700,01823367800,00000000100,a2f,recvmsg
1,01823367900,01823368100,00000000200,a2f,recvmsg
1,01823368900,01823373500,00000004600,a07,poll
1,01823379500,01823384900,00000005400,a2f,recvmsg
1,01823397600,01823397800,00000000200,a2f,recvmsg
1,01823338000,01823428200,00000090200,a17,select
1,01823442400,01823443500,00000001100,a14,writev
1,01823443800,01823444000,00000000200,a2f,recvmsg
1,01823423500,01823451400,00000027900,a07,poll
1,01823451700,01823452800,00000001100,a2f,recvmsg
1,01823457500,01823460300,00000002800,a2d,recvfrom
1,01823461100,01823461300,00000000200,a2f,recvmsg
1,01823461800,01823462000,00000000200,a2f,recvmsg
1,01823490700,01823491000,00000000300,a2f,recvmsg
1,01823492700,01823492900,00000000200,a2f,recvmsg
1,01823445300,01823511600,00000066300,a17,select
1,01823526600,01823526800,00000000200,a2f,recvmsg
1,01823496700,01824171000,00000674300,a07,poll
1,01824193300,01824197500,00000004200,a2e,sendmsg
1,01808315300,01824201000,00015885700,ae8,epoll_wait
1,01824212300,01824213800,00000001500,a2f,recvmsg
1,01824229300,01824229500,00000000200,a2f,recvmsg
1,01824252400,01824255500,00000003100,a2e,sendmsg
1,01823496700,01824263400,00000766700,a07,poll
1,01824264700,01824265600,00000000900,a00,read
1,01824281000,01824282200,00000001200,a2f,recvmsg
1,01824363500,01824367800,00000004300,a07,poll
1,01824515500,01824516700,00000001200,a2f,recvmsg
1,01824522500,01824522700,00000000200,a2f,recvmsg
1,01824560700,01824561000,00000000300,a00,read
1,01824569900,01824573800,00000003900,a2e,sendmsg
1,01824258700,01824576100,00000317400,ae8,epoll_wait
1,01824580400,01824581800,00000001400,a2f,recvmsg
1,01824594800,01824595100,00000000300,a2f,recvmsg
1,01824608100,01824610300,00000002200,a2e,sendmsg
1,01824559800,01824615300,00000055500,a07,poll
1,01824615900,01824616300,00000000400,a00,read
1,01860073100,01860073700,00000000600,a2f,recvmsg
1,01824624200,01860081200,00035457000,a07,poll
1,01860087200,01860090000,00000002800,a2f,recvmsg
1,01860095500,01860095700,00000000200,a2f,recvmsg
1,01860099300,01860099500,00000000200,a2f,recvmsg
1,01860099800,01860100000,00000000200,a2f,recvmsg
1,01860104300,01860104500,00000000200,a2f,recvmsg
1,01860104700,01860104900,00000000200,a2f,recvmsg
1,01860105600,01860110500,00000004900,a07,poll
1,01860116200,01860122800,00000006600,a2f,recvmsg
1,01860136100,01860136300,00000000200,a2f,recvmsg
1,01860161700,01860166500,00000004800,a07,poll
1,01860171900,01860177300,00000005400,a2f,recvmsg
1,01860189900,01860190100,00000000200,a2f,recvmsg
1,01860074100,01860219400,00000145300,a17,select
1,01860235100,01860236300,00000001200,a14,writev
1,01860236800,01860237000,00000000200,a2f,recvmsg
1,01860253800,01860254000,00000000200,a2f,recvmsg
1,01860266600,01860267500,00000000900,a14,writev
1,01860267700,01860267900,00000000200,a2f,recvmsg
1,01860213800,01860272500,00000058700,a07,poll
1,01860275900,01860276100,00000000200,a2f,recvmsg
1,01860277400,01860277600,00000000200,a2f,recvmsg
1,01860277800,01860278000,00000000200,a2f,recvmsg
1,01860279200,01860279400,00000000200,a2f,recvmsg
1,01860279600,01860279800,00000000200,a2f,recvmsg
1,01860280200,01860281600,00000001400,a07,poll
1,01860282200,01860283200,00000001000,a2f,recvmsg
1,01860289200,01860290100,00000000900,a2d,recvfrom
1,01860291000,01860291100,00000000100,a2f,recvmsg
1,01860291900,01860292000,00000000100,a2f,recvmsg
1,01860321600,01860321800,00000000200,a2f,recvmsg
1,01860323700,01860323900,00000000200,a2f,recvmsg
1,01860327600,01860863500,00000535900,a07,poll
1,01860882300,01860887300,00000005000,a2e,sendmsg
1,01824612800,01860891100,00036278300,ae8,epoll_wait
1,01860905100,01860906600,00000001500,a2f,recvmsg
1,01860921100,01860921300,00000000200,a2f,recvmsg
1,01860979800,01860983500,00000003700,a2e,sendmsg
1,01861006000,01861008000,00000002000,a2e,sendmsg
1,01860989700,01861009300,00000019600,ae8,epoll_wait
1,01861011700,01861012500,00000000800,a2f,recvmsg
1,01861019200,01861019400,00000000200,a2f,recvmsg
1,01861048700,01861049500,00000000800,a2e,sendmsg
1,01861066200,01861066600,00000000400,a00,read
1,01861069000,01861074600,00000005600,a07,poll
1,01861113600,01861114000,00000000400,aca,futex
1,01861254500,01861254800,00000000300,aca,futex
1,01861052800,01861352600,00000299800,ae8,epoll_wait
1,01861356400,01861359300,00000002900,a2f,recvmsg
1,01861393000,01861393300,00000000300,a2f,recvmsg
1,01861419400,01861423000,00000003600,a2e,sendmsg
1,01861442700,01861443800,00000001100,a2e,sendmsg
1,01861349500,01861675900,00000326400,a07,poll
1,01862017500,01862026300,00000008800,a02,open
1,01862039400,01862042400,00000003000,a00,read
1,01862098500,01862099300,00000000800,a00,read
1,01862150800,01862151600,00000000800,a00,read
1,01862201600,01862202200,00000000600,a00,read
1,01862253200,01862254000,00000000800,a00,read
1,01862303700,01862304500,00000000800,a00,read
1,01862352500,01862353300,00000000800,a00,read
1,01862402400,01862403100,00000000700,a00,read
1,01862454300,01862454900,00000000600,a00,read
1,01862505700,01862506500,00000000800,a00,read
1,01862555500,01862556200,00000000700,a00,read
1,01862583300,01862585300,00000002000,a02,open
1,01862588700,01862589600,00000000900,a00,read
1,01862645500,01862646400,00000000900,a00,read
1,01862730100,01862730900,00000000800,a00,read
1,01862803500,01862804200,00000000700,a00,read
1,01862882300,01862883000,00000000700,a00,read
1,01862962700,01862963400,00000000700,a00,read
1,01863041200,01863041800,00000000600,a00,read
1,01863126600,01863127200,00000000600,a00,read
1,01863193700,01863194400,00000000700,a00,read
1,01863252400,01863253000,00000000600,a00,read
1,01863332400,01863366400,00000034000,a07,poll
1,01863370300,01863370400,00000000100,a2f,recvmsg
1,01863371200,01863371400,00000000200,a2f,recvmsg
1,01863373900,01863379900,00000006000,a07,poll
1,01863381000,01863381100,00000000100,a2f,recvmsg
1,01863381500,01863381700,00000000200,a2f,recvmsg
1,01863386300,01863392900,00000006600,a06,lstat
1,01863393600,01863395100,00000001500,a06,lstat
1,01863418000,01863432600,00000014600,a01,write
1,01863438800,01863460200,00000021400,a07,poll
1,01863462200,01863462400,00000000200,a2f,recvmsg
1,01863462900,01863463100,00000000200,a2f,recvmsg
1,01863464500,01863769800,00000305300,a38,clone
1,01864245500,01864245700,00000000200,a0c,brk
1,01864255900,01864258300,00000002400,a15,access
1,01864259100,01864259900,00000000800,a09,mmap
1,01864263700,01864264500,00000000800,a15,access
1,01864270500,01864271500,00000001000,a09,mmap
1,01864275400,01864275900,00000000500,a15,access
1,01864282600,01864283700,00000001100,a00,read
1,01864286200,01864287800,00000001600,a09,mmap
1,01864291900,01864294100,00000002200,a09,mmap
1,01864305000,01864305600,00000000600,a15,access
1,01864308900,01864309500,00000000600,a00,read
1,01864310300,01864311000,00000000700,a09,mmap
1,01864313400,01864314700,00000001300,a09,mmap
1,01864322800,01864323400,00000000600,a15,access
1,01864326200,01864326800,00000000600,a00,read
1,01864327500,01864328500,00000001000,a09,mmap
1,01864330100,01864332200,00000002100,a09,mmap
1,01864336500,01864339400,00000002900,a09,mmap
1,01864341600,01864342700,00000001100,a09,mmap
1,01864351600,01864352400,00000000800,a15,access
1,01864355100,01864355700,00000000600,a00,read
1,01864356500,01864357900,00000001400,a09,mmap
1,01864360800,01864362500,00000001700,a09,mmap
1,01864370900,01864371500,00000000600,a15,access
1,01864374600,01864375300,00000000700,a00,read
1,01864375800,01864377300,00000001500,a09,mmap
1,01864380800,01864383000,00000002200,a09,mmap
1,01864391600,01864392400,00000000800,a15,access
1,01864394800,01864395400,00000000600,a00,read
1,01864395900,01864396900,00000001000,a09,mmap
1,01864398300,01864399700,00000001400,a09,mmap
1,01864402700,01864404000,00000001300,a09,mmap
1,01864410400,01864411000,00000000600,a15,access
1,01864413800,01864414400,00000000600,a00,read
1,01864415100,01864416400,00000001300,a09,mmap
1,01864419100,01864420700,00000001600,a09,mmap
1,01864434300,01864434800,00000000500,a09,mmap
1,01864438700,01864439000,00000000300,a09,mmap
1,01864622900,01864623100,00000000200,a0c,brk
1,01864623200,01864624000,00000000800,a0c,brk
1,01864652800,01864653700,00000000900,a00,read
1,01864667500,01864668900,00000001400,a00,read
1,01864706300,01864707300,00000001000,a00,read
1,01864866500,01864867500,00000001000,a00,read
1,01864943000,01864943500,00000000500,a00,read
1,01865031300,01865032100,00000000800,a00,read
1,01865168500,01865169400,00000000900,a00,read
1,01865304400,01865305000,00000000600,a00,read
1,01865469600,01865470200,00000000600,a00,read
1,01865629000,01865629600,00000000600,a00,read
1,01865668500,01865669900,00000001400,a0c,brk
1,01865792500,01865793100,00000000600,a00,read
1,01865950300,01865950900,00000000600,a00,read
1,01866114600,01866115400,00000000800,a00,read
1,01866283200,01866283900,00000000700,a00,read
1,01866399200,01866400000,00000000800,a00,read
1,01866431800,01866432500,00000000700,a0c,brk
1,01866547300,01866548200,00000000900,a00,read
1,01866801400,01866802000,00000000600,a00,read
1,01866815000,01866815300,00000000300,a00,read
1,01866860700,01866861200,00000000500,a00,read
1,01866882000,01866882800,00000000800,a00,read
1,01867138500,01867139200,00000000700,a00,read
1,01867170400,01867171300,00000000900,a00,read
1,01867271100,01867271900,00000000800,a00,read
1,01867296100,01867297700,00000001600,a0c,brk
1,01867344300,01867344900,00000000600,a00,read
1,01867423500,01867424500,00000001000,a00,read
1,01867585800,01867586400,00000000600,a00,read
1,01867701400,01867702100,00000000700,a00,read
1,01867799600,01867800100,00000000500,a00,read
1,01867813400,01867813900,00000000500,a00,read
1,01867900100,01867900600,00000000500,a00,read
1,01867925300,01867925700,00000000400,a00,read
1,01867948900,01867949400,00000000500,a00,read
1,01868055400,01868056500,00000001100,a0c,brk
1,01868057700,01868058800,00000001100,a00,read
1,01868269400,01868269900,00000000500,a00,read
1,01868356300,01868357000,00000000700,a00,read
1,01868423500,01868424200,00000000700,a00,read
1,01868557400,01868557900,00000000500,a00,read
1,01868591300,01868591800,00000000500,a00,read
1,01868608400,01868610400,00000002000,a02,open
1,01868733100,01868733700,00000000600,a00,read
1,01868827100,01868827500,00000000400,a00,read
1,01868882600,01868883800,00000001200,a0c,brk
1,01868890600,01868891300,00000000700,a00,read
1,01869003600,01869004200,00000000600,a00,read
1,01869160800,01869161600,00000000800,a00,read
1,01869300600,01869301300,00000000700,a00,read
1,01869362600,01869363400,00000000800,a00,read
1,01869421400,01869422100,00000000700,a00,read
1,01869497200,01869497900,00000000700,a00,read
1,01869552700,01869553300,00000000600,a00,read
1,01869645300,01869646100,00000000800,a0c,brk
1,01869677300,01869681900,00000004600,a0c,brk
1,01869697200,01869698000,00000000800,a00,read
1,01869818200,01869819000,00000000800,a00,read
1,01869985900,01869986500,00000000600,a00,read
1,01870108400,01870109100,00000000700,a00,read
1,01870261700,01870262300,00000000600,a00,read
1,01870384800,01870385400,00000000600,a00,read
1,01870557100,01870557800,00000000700,a00,read
1,01870562900,01870563800,00000000900,a0c,brk
1,01870683700,01870684500,00000000800,a00,read
1,01870807600,01870808300,00000000700,a00,read
1,01870955000,01870955700,00000000700,a00,read
1,01871092200,01871093000,00000000800,a00,read
1,01871189600,01871190300,00000000700,a00,read
1,01871308800,01871309500,00000000700,a00,read
1,01871440200,01871440900,00000000700,a00,read
1,01871557900,01871558500,00000000600,a0c,brk
1,01871582200,01871582900,00000000700,a00,read
1,01871759700,01871760500,00000000800,a00,read
1,01871917300,01871918000,00000000700,a00,read
1,01872032800,01872033500,00000000700,a00,read
1,01872208200,01872209200,00000001000,a00,read
1,01872289400,01872290100,00000000700,a00,read
1,01872375200,01872375900,00000000700,a00,read
1,01872445500,01872446200,00000000700,a0c,brk
1,01872460300,01872461000,00000000700,a00,read
1,01872536900,01872537700,00000000800,a00,read
1,01872643700,01872644400,00000000700,a00,read
1,01872751900,01872752600,00000000700,a00,read
1,01872858300,01872859100,00000000800,a00,read
1,01872945100,01872945800,00000000700,a00,read
1,01873052200,01873052800,00000000600,a00,read
1,01873137700,01873138300,00000000600,a0c,brk
1,01873140700,01873141400,00000000700,a00,read
1,01873253600,01873254200,00000000600,a00,read
1,01873351100,01873351800,00000000700,a00,read
1,01873476500,01873477100,00000000600,a00,read
1,01873598100,01873598700,00000000600,a00,read
1,01873706600,01873707300,00000000700,a00,read
1,01873812500,01873812900,00000000400,a0c,brk
1,01874171900,01874175100,00000003200,a57,unlink
1,01874199200,01874199800,00000000600,a48,fcntl
1,01874246900,01874262600,00000015700,a01,write
1,01874280500,01874282800,00000002300,a01,write
1,01874299100,01874301600,00000002500,a01,write
1,01860268500,01874548700,00014280200,a17,select
1,01874573100,01874573400,00000000300,a2f,recvmsg
1,01874576800,01874606600,00000029800,a17,select
1,01874611200,01874611300,00000000100,a2f,recvmsg
1,01874612000,01874629800,00000017800,a17,select
1,01874633600,01874633700,00000000100,a2f,recvmsg
1,01874634200,01874651100,00000016900,a17,select
1,01874655000,01874655200,00000000200,a2f,recvmsg
1,01874655800,01874671200,00000015400,a17,select
1,01874675300,01874675400,00000000100,a2f,recvmsg
1,01874675900,01874691400,00000015500,a17,select
1,01874694800,01874695000,00000000200,a2f,recvmsg
1,01874695500,01874723300,00000027800,a17,select
1,01874727200,01874727400,00000000200,a2f,recvmsg
1,01874728000,01874738200,00000010200,a17,select
1,01874741900,01874742000,00000000100,a2f,recvmsg
1,01874742600,01874749900,00000007300,a17,select
1,01874753500,01874753700,00000000200,a2f,recvmsg
1,01874754200,01874762000,00000007800,a17,select
1,01874765400,01874765600,00000000200,a2f,recvmsg
1,01874766100,01874773600,00000007500,a17,select
1,01874777400,01874777600,00000000200,a2f,recvmsg
1,01874778000,01874785600,00000007600,a17,select
1,01874789400,01874789500,00000000100,a2f,recvmsg
1,01874790000,01874798300,00000008300,a17,select
1,01874802000,01874802200,00000000200,a2f,recvmsg
1,01874802700,01874810300,00000007600,a17,select
1,01874813900,01874814100,00000000200,a2f,recvmsg
1,01874814600,01874823100,00000008500,a17,select
1,01874827000,01874827200,00000000200,a2f,recvmsg
1,01874827700,01874835000,00000007300,a17,select
1,01874838800,01874838900,00000000100,a2f,recvmsg
1,01874839400,01874846800,00000007400,a17,select
1,01874850400,01874850600,00000000200,a2f,recvmsg
1,01874851100,01874858300,00000007200,a17,select
1,01874861900,01874862100,00000000200,a2f,recvmsg
1,01874862600,01874869800,00000007200,a17,select
1,01874873300,01874873400,00000000100,a2f,recvmsg
1,01874874000,01874881400,00000007400,a17,select
1,01874885100,01874885300,00000000200,a2f,recvmsg
1,01874885800,01874893800,00000008000,a17,select
1,01874897500,01874897600,00000000100,a2f,recvmsg
1,01874898100,01874904900,00000006800,a17,select
1,01874908600,01874908800,00000000200,a2f,recvmsg
1,01874909200,01874918200,00000009000,a17,select
1,01874921700,01874921900,00000000200,a2f,recvmsg
1,01874922400,01874929100,00000006700,a17,select
1,01874932800,01874933000,00000000200,a2f,recvmsg
1,01874933500,01874940300,00000006800,a17,select
1,01874944200,01874944400,00000000200,a2f,recvmsg
1,01874945000,01874951600,00000006600,a17,select
1,01874955400,01874955500,00000000100,a2f,recvmsg
1,01874956100,01874963200,00000007100,a17,select
1,01874966800,01874966900,00000000100,a2f,recvmsg
1,01874967500,01874974300,00000006800,a17,select
1,01874977900,01874978000,00000000100,a2f,recvmsg
1,01874978600,01874986000,00000007400,a17,select
1,01874989700,01874989900,00000000200,a2f,recvmsg
1,01874990400,01874998100,00000007700,a17,select
1,01875001700,01875001900,00000000200,a2f,recvmsg
1,01875002300,01875011000,00000008700,a17,select
1,01875015000,01875015100,00000000100,a2f,recvmsg
1,01875015600,01875023300,00000007700,a17,select
1,01875026900,01875027100,00000000200,a2f,recvmsg
1,01875027600,01875035300,00000007700,a17,select
1,01875039000,01875039200,00000000200,a2f,recvmsg
1,01875039700,01875049100,00000009400,a17,select
1,01875052800,01875053000,00000000200,a2f,recvmsg
1,01875053500,01875060700,00000007200,a17,select
1,01875064400,01875064600,00000000200,a2f,recvmsg
1,01875065000,01875072900,00000007900,a17,select
1,01875076600,01875076800,00000000200,a2f,recvmsg
1,01875077300,01875085400,00000008100,a17,select
1,01875089000,01875089200,00000000200,a2f,recvmsg
1,01875089700,01875097200,00000007500,a17,select
1,01875101000,01875101100,00000000100,a2f,recvmsg
1,01875101600,01875109800,00000008200,a17,select
1,01875113400,01875113600,00000000200,a2f,recvmsg
1,01875114100,01875121500,00000007400,a17,select
1,01875125200,01875125300,00000000100,a2f,recvmsg
1,01875125800,01875133000,00000007200,a17,select
1,01875136700,01875136900,00000000200,a2f,recvmsg
1,01875137300,01875144400,00000007100,a17,select
1,01875147900,01875148100,00000000200,a2f,recvmsg
1,01875148600,01875156400,00000007800,a17,select
1,01875160100,01875160300,00000000200,a2f,recvmsg
1,01875160900,01875176600,00000015700,a17,select
1,01875180200,01875180400,00000000200,a2f,recvmsg
1,01875180900,01875210800,00000029900,a17,select
1,01875214500,01875214600,00000000100,a2f,recvmsg
1,01875215100,01875232900,00000017800,a17,select
1,01875236600,01875236800,00000000200,a2f,recvmsg
1,01875237400,01875244400,00000007000,a17,select
1,01875247900,01875248100,00000000200,a2f,recvmsg
1,01875248700,01875255500,00000006800,a17,select
1,01875258900,01875259100,00000000200,a2f,recvmsg
1,01875259700,01875266600,00000006900,a17,select
1,01875270200,01875270300,00000000100,a2f,recvmsg
1,01875270900,01875277800,00000006900,a17,select
1,01875281500,01875281600,00000000100,a2f,recvmsg
1,01875282100,01875289000,00000006900,a17,select
1,01875292700,01875292900,00000000200,a2f,recvmsg
1,01875293300,01875300200,00000006900,a17,select
1,01875303700,01875303800,00000000100,a2f,recvmsg
1,01875304300,01875311900,00000007600,a17,select
1,01875315600,01875315700,00000000100,a2f,recvmsg
1,01875316200,01875323300,00000007100,a17,select
1,01875327000,01875327100,00000000100,a2f,recvmsg
1,01875327600,01875336400,00000008800,a17,select
1,01875340000,01875340200,00000000200,a2f,recvmsg
1,01875340600,01875349800,00000009200,a17,select
1,01875353600,01875353700,00000000100,a2f,recvmsg
1,01875354200,01875361900,00000007700,a17,select
1,01875365400,01875365600,00000000200,a2f,recvmsg
1,01875366100,01875373900,00000007800,a17,select
1,01875377400,01875377500,00000000100,a2f,recvmsg
1,01875378100,01875385300,00000007200,a17,select
1,01875388800,01875389000,00000000200,a2f,recvmsg
1,01875389500,01875396700,00000007200,a17,select
1,01875400200,01875400400,00000000200,a2f,recvmsg
1,01875401000,01875408600,00000007600,a17,select
1,01875412200,01875412400,00000000200,a2f,recvmsg
1,01875412800,01875420000,00000007200,a17,select
1,01875423500,01875423700,00000000200,a2f,recvmsg
1,01875424200,01875431300,00000007100,a17,select
1,01875434900,01875435100,00000000200,a2f,recvmsg
1,01875435500,01875442600,00000007100,a17,select
1,01875446200,01875446400,00000000200,a2f,recvmsg
1,01875446800,01875454100,00000007300,a17,select
1,01875457800,01875458000,00000000200,a2f,recvmsg
1,01875458400,01875465600,00000007200,a17,select
1,01875469200,01875469300,00000000100,a2f,recvmsg
1,01875469800,01875477600,00000007800,a17,select
1,01875481200,01875481300,00000000100,a2f,recvmsg
1,01875481900,01875488900,00000007000,a17,select
1,01875492500,01875492700,00000000200,a2f,recvmsg
1,01875493200,01875500400,00000007200,a17,select
1,01875503900,01875504100,00000000200,a2f,recvmsg
1,01875504600,01875511800,00000007200,a17,select
1,01875515400,01875515600,00000000200,a2f,recvmsg
1,01875516100,01875528400,00000012300,a17,select
1,01875532200,01875532300,00000000100,a2f,recvmsg
1,01875532800,01875540200,00000007400,a17,select
1,01875543700,01875543900,00000000200,a2f,recvmsg
1,01875544400,01875551600,00000007200,a17,select
1,01875555200,01875555400,00000000200,a2f,recvmsg
1,01875555900,01875563300,00000007400,a17,select
1,01875566700,01875566900,00000000200,a2f,recvmsg
1,01875567400,01875574900,00000007500,a17,select
1,01875578500,01875578700,00000000200,a2f,recvmsg
1,01875579200,01875637000,00000057800,a17,select
1,01875637900,01875639100,00000001200,a2f,recvmsg
1,01875730900,01875735300,00000004400,a14,writev
1,01875811800,01875813900,00000002100,a14,writev
1,01875873100,01875874600,00000001500,a14,writev
1,01875931300,01875933200,00000001900,a14,writev
1,01875988900,01875990600,00000001700,a14,writev
1,01876047400,01876049000,00000001600,a14,writev
1,01876053300,01876054200,00000000900,a2f,recvmsg
1,01876103800,01876105800,00000002000,a14,writev
1,01876149500,01876151300,00000001800,a14,writev
1,01876194200,01876195600,00000001400,a14,writev
1,01876239200,01876241000,00000001800,a14,writev
1,01876283900,01876285500,00000001600,a14,writev
1,01876328600,01876330200,00000001600,a14,writev
1,01876356000,01876358000,00000002000,a2f,recvmsg
1,01876385400,01876386900,00000001500,a14,writev
1,01876405500,01876406900,00000001400,a14,writev
1,01876424200,01876426100,00000001900,a14,writev
1,01876442300,01876443900,00000001600,a14,writev
1,01876460200,01876461600,00000001400,a14,writev
1,01876476800,01876478400,00000001600,a14,writev
1,01876485500,01876485800,00000000300,a2f,recvmsg
1,01876486400,01876486800,00000000400,a14,writev
1,01876504700,01876506500,00000001800,a14,writev
1,01876506700,01876508000,00000001300,a14,writev
1,01876508500,01876508700,00000000200,a2f,recvmsg
1,01876521500,01876522500,00000001000,a14,writev
1,01876522900,01876523100,00000000200,a2f,recvmsg
1,01876533800,01876535300,00000001500,a14,writev
1,01876535500,01876536400,00000000900,a14,writev
1,01876536700,01876536900,00000000200,a2f,recvmsg
1,01863438800,01876544400,00013105600,a07,poll
1,01876550400,01876552900,00000002500,a2f,recvmsg
1,01876557900,01876558100,00000000200,a2f,recvmsg
1,01876561600,01876561800,00000000200,a2f,recvmsg
1,01876562000,01876562100,00000000100,a2f,recvmsg
1,01876566500,01876566700,00000000200,a2f,recvmsg
1,01876566900,01876567100,00000000200,a2f,recvmsg
1,01876567800,01876572200,00000004400,a07,poll
1,01876578000,01876584400,00000006400,a2f,recvmsg
1,01876597300,01876597500,00000000200,a2f,recvmsg
1,01876537400,01876626800,00000089400,a17,select
1,01876640300,01876641600,00000001300,a14,writev
1,01876642000,01876642100,00000000100,a2f,recvmsg
1,01876621900,01876646900,00000025000,a07,poll
1,01876647300,01876648200,00000000900,a2f,recvmsg
1,01876652700,01876653600,00000000900,a2d,recvfrom
1,01876654600,01876654800,00000000200,a2f,recvmsg
1,01876655300,01876655500,00000000200,a2f,recvmsg
1,01876683300,01876683600,00000000300,a2f,recvmsg
1,01876685300,01876685500,00000000200,a2f,recvmsg
1,01876643300,01876707400,00000064100,a17,select
1,01876722100,01876722300,00000000200,a2f,recvmsg
1,01876689100,01877385900,00000696800,a07,poll
1,01877409400,01877414000,00000004600,a2e,sendmsg
1,01861445900,01877417900,00015972000,ae8,epoll_wait
1,01877428700,01877430600,00000001900,a2f,recvmsg
1,01877445200,01877445400,00000000200,a2f,recvmsg
1,01877468800,01877471800,00000003000,a2e,sendmsg
1,01876689100,01877479800,00000790700,a07,poll
1,01877481100,01877481900,00000000800,a00,read
1,01877498900,01877500000,00000001100,a2f,recvmsg
1,01877582200,01877586500,00000004300,a07,poll
1,01877735000,01877736000,00000001000,a2f,recvmsg
1,01877742000,01877742100,00000000100,a2f,recvmsg
1,01877758200,01877758500,00000000300,a00,read
1,01877766200,01877769700,00000003500,a2e,sendmsg
1,01877475100,01877771600,00000296500,ae8,epoll_wait
1,01877775900,01877777300,00000001400,a2f,recvmsg
1,01877789900,01877790200,00000000300,a2f,recvmsg
1,01877802900,01877804900,00000002000,a2e,sendmsg
1,01877757200,01877810200,00000053000,a07,poll
1,01877810700,01877811100,00000000400,a00,read
1,01877818400,01877819100,00000000700,a2f,recvmsg
1,01877882600,01877885200,00000002600,a07,poll
1,01878198000,01878199000,00000001000,a2f,recvmsg
1,01876723200,01878840500,00002117300,a17,select
1,01878860500,01878860700,00000000200,a2f,recvmsg
1,01878874200,01878874400,00000000200,a2f,recvmsg
1,01878875000,01878938800,00000063800,a17,select
1,01878943100,01878943300,00000000200,a2f,recvmsg
1,01768631900,01883134300,00114502400,a4a,fsync
1,01883196800,01883201700,00000004900,a09,mmap
1,01883274100,01883278800,00000004700,a01,write
1,01883473900,01883483200,00000009300,a01,write
1,01877807500,01883517400,00005709900,ae8,epoll_wait
1,01883529200,01883533200,00000004000,a2f,recvmsg
1,01883553300,01883553500,00000000200,a2f,recvmsg
1,01883597000,01883597800,00000000800,a2e,sendmsg
1,01883335600,01883608200,00000272600,a07,poll
1,01883721300,01883730000,00000008700,60e,page_fault
1,01883819500,01883820300,00000000800,a2f,recvmsg
1,01883823600,01883823800,00000000200,a00,read
1,01883877600,01883882100,00000004500,a07,poll
1,01883971900,01883975300,00000003400,a07,poll
1,01883979400,01883982700,00000003300,a2e,sendmsg
1,01883599800,01883984500,00000384700,ae8,epoll_wait
1,01883989700,01883990900,00000001200,a2f,recvmsg
1,01884000200,01884000400,00000000200,a2f,recvmsg
1,01884013500,01884016400,00000002900,a2e,sendmsg
1,01884027100,01884027300,00000000200,a00,read
1,01863789700,01889768600,00025978900,a3d,wait4
1,01889789400,01889791300,00000001900,a00,read
1,01889793400,01889793700,00000000300,a00,read
1,01889811400,01889858500,00000047100,a07,poll
1,01889863500,01889863800,00000000300,a2f,recvmsg
1,01889864700,01889864900,00000000200,a2f,recvmsg
1,01889870600,01889882500,00000011900,a07,poll
1,01889884700,01889884900,00000000200,a2f,recvmsg
1,01889885200,01889885400,00000000200,a2f,recvmsg
1,01889889700,01889901600,00000011900,a07,poll
1,01889903600,01889903800,00000000200,a2f,recvmsg
1,01889904100,01889904300,00000000200,a2f,recvmsg
1,01889909200,01889920900,00000011700,a07,poll
1,01889922900,01889923000,00000000100,a2f,recvmsg
1,01889923400,01889923600,00000000200,a2f,recvmsg
1,01889928500,01889940100,00000011600,a07,poll
1,01889942100,01889942300,00000000200,a2f,recvmsg
1,01889942600,01889942800,00000000200,a2f,recvmsg
1,01889946100,01889957900,00000011800,a07,poll
1,01889960000,01889960200,00000000200,a2f,recvmsg
1,01889960600,01889960700,00000000100,a2f,recvmsg
1,01889961500,01889961700,00000000200,a08,lseek
1,01889971700,01889971800,00000000100,a08,lseek
1,01889975000,01889981800,00000006800,a07,poll
1,01889983200,01889983400,00000000200,a2f,recvmsg
1,01889983700,01889983800,00000000100,a2f,recvmsg
1,01889988400,01889995100,00000006700,a07,poll
1,01889996500,01889996600,00000000100,a2f,recvmsg
1,01889996900,01889997000,00000000100,a2f,recvmsg
1,01890000300,01890006800,00000006500,a07,poll
1,01890008100,01890008300,00000000200,a2f,recvmsg
1,01890008500,01890008700,00000000200,a2f,recvmsg
1,01890012000,01890018600,00000006600,a07,poll
1,01890019800,01890020000,00000000200,a2f,recvmsg
1,01890020300,01890020500,00000000200,a2f,recvmsg
1,01890023800,01890030600,00000006800,a07,poll
1,01890031800,01890032000,00000000200,a2f,recvmsg
1,01890032300,01890032400,00000000100,a2f,recvmsg
1,01890035900,01890042500,00000006600,a07,poll
1,01890043600,01890043800,00000000200,a2f,recvmsg
1,01890044100,01890044300,00000000200,a2f,recvmsg
1,01890047400,01890054100,00000006700,a07,poll
1,01890055300,01890055500,00000000200,a2f,recvmsg
1,01890055800,01890055900,00000000100,a2f,recvmsg
1,01890059200,01890065600,00000006400,a07,poll
1,01890066800,01890067000,00000000200,a2f,recvmsg
1,01890067200,01890067300,00000000100,a2f,recvmsg
1,01890071600,01890078500,00000006900,a07,poll
1,01890079600,01890079800,00000000200,a2f,recvmsg
1,01890080100,01890080200,00000000100,a2f,recvmsg
1,01890083400,01890090200,00000006800,a07,poll
1,01890091300,01890091500,00000000200,a2f,recvmsg
1,01890091800,01890092000,00000000200,a2f,recvmsg
1,01890095800,01890102800,00000007000,a07,poll
1,01890103900,01890104000,00000000100,a2f,recvmsg
1,01890104300,01890104500,00000000200,a2f,recvmsg
1,01890107500,01890114200,00000006700,a07,poll
1,01890116100,01890116300,00000000200,a2f,recvmsg
1,01890116600,01890116700,00000000100,a2f,recvmsg
1,01890119700,01890126300,00000006600,a07,poll
1,01890127500,01890127700,00000000200,a2f,recvmsg
1,01890128000,01890128100,00000000100,a2f,recvmsg
1,01890131500,01890138200,00000006700,a07,poll
1,01890139400,01890139500,00000000100,a2f,recvmsg
1,01890139700,01890139900,00000000200,a2f,recvmsg
1,01890143100,01890149600,00000006500,a07,poll
1,01890150800,01890150900,00000000100,a2f,recvmsg
1,01890151100,01890151300,00000000200,a2f,recvmsg
1,01890154000,01890160700,00000006700,a07,poll
1,01890161800,01890162000,00000000200,a2f,recvmsg
1,01890162300,01890162400,00000000100,a2f,recvmsg
1,01890167200,01890173800,00000006600,a07,poll
1,01890175100,01890175200,00000000100,a2f,recvmsg
1,01890175500,01890175600,00000000100,a2f,recvmsg
1,01890178300,01890185100,00000006800,a07,poll
1,01890186200,01890186300,00000000100,a2f,recvmsg
1,01890186600,01890186800,00000000200,a2f,recvmsg
1,01890189500,01890196400,00000006900,a07,poll
1,01890197500,01890197600,00000000100,a2f,recvmsg
1,01890197900,01890198100,00000000200,a2f,recvmsg
1,01890200800,01890207500,00000006700,a07,poll
1,01890208600,01890208800,00000000200,a2f,recvmsg
1,01890209100,01890209300,00000000200,a2f,recvmsg
1,01890212200,01890219100,00000006900,a07,poll
1,01890220300,01890220500,00000000200,a2f,recvmsg
1,01890220800,01890221000,00000000200,a2f,recvmsg
1,01890223800,01890230600,00000006800,a07,poll
1,01890231700,01890231900,00000000200,a2f,recvmsg
1,01890232200,01890232400,00000000200,a2f,recvmsg
1,01890235600,01890242400,00000006800,a07,poll
1,01890243500,01890243700,00000000200,a2f,recvmsg
1,01890244000,01890244100,00000000100,a2f,recvmsg
1,01890247300,01890254100,00000006800,a07,poll
1,01890255200,01890255400,00000000200,a2f,recvmsg
1,01890255600,01890255800,00000000200,a2f,recvmsg
1,01890260200,01890267200,00000007000,a07,poll
1,01890268300,01890268500,00000000200,a2f,recvmsg
1,01890268700,01890268900,00000000200,a2f,recvmsg
1,01890272400,01890279100,00000006700,a07,poll
1,01890280200,01890280400,00000000200,a2f,recvmsg
1,01890280700,01890280900,00000000200,a2f,recvmsg
1,01890284100,01890290800,00000006700,a07,poll
1,01890291900,01890292100,00000000200,a2f,recvmsg
1,01890292400,01890292600,00000000200,a2f,recvmsg
1,01890298500,01890305100,00000006600,a07,poll
1,01890306300,01890306500,00000000200,a2f,recvmsg
1,01890306700,01890306900,00000000200,a2f,recvmsg
1,01890310000,01890316700,00000006700,a07,poll
1,01890317900,01890318100,00000000200,a2f,recvmsg
1,01890318300,01890318500,00000000200,a2f,recvmsg
1,01890322200,01890329000,00000006800,a07,poll
1,01890330100,01890330200,00000000100,a2f,recvmsg
1,01890330500,01890330700,00000000200,a2f,recvmsg
1,01890334400,01890341500,00000007100,a07,poll
1,01890342700,01890342800,00000000100,a2f,recvmsg
1,01890343100,01890343300,00000000200,a2f,recvmsg
1,01890346600,01890353400,00000006800,a07,poll
1,01890354500,01890354700,00000000200,a2f,recvmsg
1,01890355000,01890355200,00000000200,a2f,recvmsg
1,01890359000,01890365800,00000006800,a07,poll
1,01890367000,01890367100,00000000100,a2f,recvmsg
1,01890367400,01890367500,00000000100,a2f,recvmsg
1,01890371400,01890378300,00000006900,a07,poll
1,01890379500,01890379600,00000000100,a2f,recvmsg
1,01890379900,01890380100,00000000200,a2f,recvmsg
1,01890383100,01890390000,00000006900,a07,poll
1,01890391100,01890391300,00000000200,a2f,recvmsg
1,01890391600,01890391800,00000000200,a2f,recvmsg
1,01890394600,01890401400,00000006800,a07,poll
1,01890402600,01890402700,00000000100,a2f,recvmsg
1,01890403000,01890403200,00000000200,a2f,recvmsg
1,01890406500,01890413300,00000006800,a07,poll
1,01890414400,01890414500,00000000100,a2f,recvmsg
1,01890414800,01890415000,00000000200,a2f,recvmsg
1,01890416000,01890416100,00000000100,a08,lseek
1,01890419600,01890420700,00000001100,a00,read
1,01890424500,01890424500,00000000000,a08,lseek
1,01890427500,01890434200,00000006700,a07,poll
1,01890435600,01890435700,00000000100,a2f,recvmsg
1,01890435900,01890436100,00000000200,a2f,recvmsg
1,01890460800,01890467500,00000006700,a07,poll
1,01890468800,01890468900,00000000100,a2f,recvmsg
1,01890469300,01890469400,00000000100,a2f,recvmsg
1,01890473200,01890473900,00000000700,a00,read
1,01890479400,01890479500,00000000100,a08,lseek
1,01890482600,01890489500,00000006900,a07,poll
1,01890490700,01890490900,00000000200,a2f,recvmsg
1,01890491100,01890491300,00000000200,a2f,recvmsg
1,01890494200,01890500900,00000006700,a07,poll
1,01890502100,01890502300,00000000200,a2f,recvmsg
1,01890502500,01890502700,00000000200,a2f,recvmsg
1,01890505300,01890511900,00000006600,a07,poll
1,01890512900,01890513100,00000000200,a2f,recvmsg
1,01890513400,01890513600,00000000200,a2f,recvmsg
1,01890516200,01890522900,00000006700,a07,poll
1,01890524000,01890524100,00000000100,a2f,recvmsg
1,01890524400,01890524600,00000000200,a2f,recvmsg
1,01890527300,01890533900,00000006600,a07,poll
1,01890535000,01890535100,00000000100,a2f,recvmsg
1,01890535500,01890535700,00000000200,a2f,recvmsg
1,01890538300,01890545100,00000006800,a07,poll
1,01890546100,01890546300,00000000200,a2f,recvmsg
1,01890546600,01890546800,00000000200,a2f,recvmsg
1,01890549400,01890556000,00000006600,a07,poll
1,01890557200,01890557400,00000000200,a2f,recvmsg
1,01890557600,01890557800,00000000200,a2f,recvmsg
1,01890561300,01890568200,00000006900,a07,poll
1,01890569200,01890569400,00000000200,a2f,recvmsg
1,01890569700,01890569900,00000000200,a2f,recvmsg
1,01890572700,01890579400,00000006700,a07,poll
1,01890580500,01890580600,00000000100,a2f,recvmsg
1,01890580900,01890581100,00000000200,a2f,recvmsg
1,01890581600,01890581700,00000000100,a08,lseek
1,01890586800,01890593600,00000006800,a07,poll
1,01890594700,01890594800,00000000100,a2f,recvmsg
1,01890595200,01890595400,00000000200,a2f,recvmsg
1,01890600500,01890607300,00000006800,a07,poll
1,01890608500,01890608600,00000000100,a2f,recvmsg
1,01890608900,01890609100,00000000200,a2f,recvmsg
1,01890612600,01890619200,00000006600,a07,poll
1,01890620300,01890620500,00000000200,a2f,recvmsg
1,01890620800,01890621000,00000000200,a2f,recvmsg
1,01890624000,01890630700,00000006700,a07,poll
1,01890631800,01890631900,00000000100,a2f,recvmsg
1,01890632200,01890632400,00000000200,a2f,recvmsg
1,01890635400,01890642000,00000006600,a07,poll
1,01890643100,01890643300,00000000200,a2f,recvmsg
1,01890643600,01890643800,00000000200,a2f,recvmsg
1,01890646800,01890653600,00000006800,a07,poll
1,01890654600,01890654800,00000000200,a2f,recvmsg
1,01890655100,01890655300,00000000200,a2f,recvmsg
1,01890658700,01890665400,00000006700,a07,poll
1,01890666400,01890666600,00000000200,a2f,recvmsg
1,01890666900,01890667100,00000000200,a2f,recvmsg
1,01890670000,01890676900,00000006900,a07,poll
1,01890677900,01890678100,00000000200,a2f,recvmsg
1,01890678400,01890678600,00000000200,a2f,recvmsg
1,01890681600,01890688300,00000006700,a07,poll
1,01890689400,01890689600,00000000200,a2f,recvmsg
1,01890689900,01890690100,00000000200,a2f,recvmsg
1,01890693000,01890700000,00000007000,a07,poll
1,01890701100,01890701300,00000000200,a2f,recvmsg
1,01890701600,01890701800,00000000200,a2f,recvmsg
1,01890704800,01890711500,00000006700,a07,poll
1,01890712600,01890712800,00000000200,a2f,recvmsg
1,01890713100,01890713300,00000000200,a2f,recvmsg
1,01890716200,01890722800,00000006600,a07,poll
1,01890724200,01890724400,00000000200,a2f,recvmsg
1,01890724700,01890724800,00000000100,a2f,recvmsg
1,01890728400,01890735100,00000006700,a07,poll
1,01890736100,01890736300,00000000200,a2f,recvmsg
1,01890736600,01890736800,00000000200,a2f,recvmsg
1,01890739900,01890746800,00000006900,a07,poll
1,01890747900,01890748100,00000000200,a2f,recvmsg
1,01890748400,01890748600,00000000200,a2f,recvmsg
1,01890751300,01890758100,00000006800,a07,poll
1,01890759100,01890759300,00000000200,a2f,recvmsg
1,01890759600,01890759800,00000000200,a2f,recvmsg
1,01890762800,01890769600,00000006800,a07,poll
1,01890770700,01890770900,00000000200,a2f,recvmsg
1,01890771200,01890771400,00000000200,a2f,recvmsg
1,01890779700,01890786600,00000006900,a07,poll
1,01890787700,01890787900,00000000200,a2f,recvmsg
1,01890788200,01890788400,00000000200,a2f,recvmsg
1,01890791500,01890798300,00000006800,a07,poll
1,01890799400,01890799500,00000000100,a2f,recvmsg
1,01890799800,01890800000,00000000200,a2f,recvmsg
1,01890803000,01890809600,00000006600,a07,poll
1,01890810700,01890810900,00000000200,a2f,recvmsg
1,01890811200,01890811400,00000000200,a2f,recvmsg
1,01890814600,01890821300,00000006700,a07,poll
1,01890822300,01890822500,00000000200,a2f,recvmsg
1,01890822800,01890822900,00000000100,a2f,recvmsg
1,01890826000,01890832900,00000006900,a07,poll
1,01890833900,01890834100,00000000200,a2f,recvmsg
1,01890834400,01890834500,00000000100,a2f,recvmsg
1,01890854900,01890879800,00000024900,a57,unlink
1,01890881000,01890885300,00000004300,a14,writev
1,01890886000,01890982100,00000096100,a07,poll
1,01890984700,01890985500,00000000800,a00,read
1,01890997800,01890998000,00000000200,a2f,recvmsg
1,01891037900,01891061000,00000023100,a07,poll
1,01891062400,01891118100,00000055700,a07,poll
1,01891119200,01891176300,00000057100,a07,poll
1,01891177300,01891233000,00000055700,a07,poll
1,01891234000,01891289400,00000055400,a07,poll
1,01891290700,01891344700,00000054000,a07,poll
1,01891345900,01891388400,00000042500,a07,poll
1,01891389500,01891432400,00000042900,a07,poll
1,01891435100,01891476200,00000041100,a07,poll
1,01891477200,01891520100,00000042900,a07,poll
1,01891521000,01891562200,00000041200,a07,poll
1,01891563300,01891616100,00000052800,a07,poll
1,01891617100,01891635100,00000018000,a07,poll
1,01891636100,01891651500,00000015400,a07,poll
1,01891653100,01891666800,00000013700,a07,poll
1,01891668000,01891681400,00000013400,a07,poll
1,01891682500,01891696500,00000014000,a07,poll
1,01891697500,01891701700,00000004200,a07,poll
1,01891704100,01891704300,00000000200,a2f,recvmsg
1,01891704800,01891705000,00000000200,a2f,recvmsg
1,01891721900,01891723200,00000001300,a07,poll
1,01891721900,01891725100,00000003200,a07,poll
1,01891725600,01891727000,00000001400,a2f,recvmsg
1,01891730700,01891732000,00000001300,a2d,recvfrom
1,01891736600,01891736800,00000000200,a2f,recvmsg
1,01891737400,01891737500,00000000100,a2f,recvmsg
1,01891794600,01891794900,00000000300,a2f,recvmsg
1,01891797200,01891797400,00000000200,a2f,recvmsg
1,01891807900,01891936800,00000128900,a07,poll
1,01891937600,01891939100,00000001500,a2f,recvmsg
1,01891946000,01891946900,00000000900,a2d,recvfrom
1,01891947900,01891948100,00000000200,a2f,recvmsg
1,01891948800,01891949000,00000000200,a2f,recvmsg
1,01891981300,01891981500,00000000200,a2f,recvmsg
1,01891983700,01891983900,00000000200,a2f,recvmsg
1,01891987400,01891990100,00000002700,a07,poll
1,01891992700,01891992900,00000000200,a2f,recvmsg
1,01891993400,01891993600,00000000200,a2f,recvmsg
1,01892466600,01892470900,00000004300,a09,mmap
1,01892620900,01892626200,00000005300,a02,open
1,01892643700,01892645900,00000002200,a00,read
1,01892697400,01892698300,00000000900,a00,read
1,01892747300,01892748100,00000000800,a00,read
1,01892822100,01892822900,00000000800,a00,read
0,01864155500,01851525600,-0012629900,a14,writev
0,01851526000,01851532500,00000006500,a07,poll
0,01851533600,01851533800,00000000200,a2f,recvmsg
0,01851534100,01851534300,00000000200,a2f,recvmsg
0,01851537400,01851544000,00000006600,a07,poll
0,01851545100,01851545300,00000000200,a2f,recvmsg
0,01851545600,01851545800,00000000200,a2f,recvmsg
0,01851548700,01851555400,00000006700,a07,poll
0,01851556500,01851556700,00000000200,a2f,recvmsg
0,01851557000,01851557200,00000000200,a2f,recvmsg
0,01851560300,01851566700,00000006400,a07,poll
0,01851567800,01851568000,00000000200,a2f,recvmsg
0,01851568300,01851568400,00000000100,a2f,recvmsg
0,01851571400,01851578000,00000006600,a07,poll
0,01851579100,01851579300,00000000200,a2f,recvmsg
0,01851579600,01851579800,00000000200,a2f,recvmsg
0,01851599900,01851626400,00000026500,a57,unlink
0,01851627600,01851631700,00000004100,a14,writev
0,01851632100,01851731300,00000099200,a07,poll
0,01851632100,01851739100,00000107000,a07,poll
0,01851751700,01851751800,00000000100,a2f,recvmsg
0,01851794700,01851794900,00000000200,a2f,recvmsg
0,01851783800,01851815700,00000031900,a07,poll
0,01851824800,01851871500,00000046700,a07,poll
0,01851872700,01851874700,00000002000,a07,poll
0,01851876200,01851931000,00000054800,a07,poll
0,01851932400,01851934400,00000002000,a07,poll
0,01851936100,01851990000,00000053900,a07,poll
0,01851991300,01851992800,00000001500,a07,poll
0,01851995000,01852046400,00000051400,a07,poll
0,01851995000,01852048900,00000053900,a07,poll
0,01852052000,01852101700,00000049700,a07,poll
0,01852101800,01852102900,00000001100,a2f,recvmsg
0,01852052000,01852103800,00000051800,a07,poll
0,01852106500,01852146600,00000040100,a07,poll
0,01852146700,01852147700,00000001000,a2f,recvmsg
0,01852106500,01852148600,00000042100,a07,poll
0,01852151400,01852190400,00000039000,a07,poll
0,01852190500,01852191500,00000001000,a2f,recvmsg
0,01852151400,01852192500,00000041100,a07,poll
0,01852195100,01852234700,00000039600,a07,poll
0,01852234900,01852236000,00000001100,a2f,recvmsg
0,01852195100,01852236900,00000041800,a07,poll
0,01852239400,01852278800,00000039400,a07,poll
0,01852278900,01852280000,00000001100,a2f,recvmsg
0,01852239400,01852280800,00000041400,a07,poll
0,01852283300,01852321900,00000038600,a07,poll
0,01852322000,01852323100,00000001100,a2f,recvmsg
0,01852283300,01852323900,00000040600,a07,poll
0,01852326700,01852378400,00000051700,a07,poll
0,01852326700,01852380700,00000054000,a07,poll
0,01852383200,01852398300,00000015100,a07,poll
0,01852398400,01852399600,00000001200,a2f,recvmsg
0,01852383200,01852400500,00000017300,a07,poll
0,01852403100,01852415000,00000011900,a07,poll
0,01852415100,01852416200,00000001100,a2f,recvmsg
0,01852403100,01852417100,00000014000,a07,poll
0,01852419900,01852431600,00000011700,a07,poll
0,01852431800,01852433100,00000001300,a2f,recvmsg
0,01852419900,01852434000,00000014100,a07,poll
0,01852436600,01852447100,00000010500,a07,poll
0,01852447200,01852448200,00000001000,a2f,recvmsg
0,01852436600,01852449100,00000012500,a07,poll
0,01852451600,01852463000,00000011400,a07,poll
0,01852463200,01852464600,00000001400,a2f,recvmsg
0,01852451600,01852465600,00000014000,a07,poll
0,01852468300,01852470000,00000001700,a07,poll
0,01852472600,01852472800,00000000200,a2f,recvmsg
0,01852473500,01852473600,00000000100,a2f,recvmsg
0,01852468300,01852491400,00000023100,a07,poll
0,01852491700,01852493200,00000001500,a2f,recvmsg
0,01852494600,01852496200,00000001600,a2d,recvfrom
0,01852500400,01852500600,00000000200,a2f,recvmsg
0,01852501200,01852501400,00000000200,a2f,recvmsg
0,01852468300,01852506300,00000038000,a07,poll
0,01852506800,01852508200,00000001400,a2f,recvmsg
0,01852509700,01852510400,00000000700,a2d,recvfrom
0,01852514700,01852514900,00000000200,a2f,recvmsg
0,01852515400,01852515600,00000000200,a2f,recvmsg
0,01852556500,01852556800,00000000300,a2f,recvmsg
0,01852559200,01852559300,00000000100,a2f,recvmsg
0,01852615700,01852616000,00000000300,a2f,recvmsg
0,01852618300,01852618500,00000000200,a2f,recvmsg
0,01852632800,01852670100,00000037300,a07,poll
0,01852670900,01852672500,00000001600,a2f,recvmsg
0,01852679200,01852680100,00000000900,a2d,recvfrom
0,01852681000,01852681200,00000000200,a2f,recvmsg
0,01852682000,01852682200,00000000200,a2f,recvmsg
0,01852713900,01852714100,00000000200,a2f,recvmsg
0,01852716600,01852716800,00000000200,a2f,recvmsg
0,01852720100,01852722600,00000002500,a07,poll
0,01852725200,01852725400,00000000200,a2f,recvmsg
0,01852726000,01852726200,00000000200,a2f,recvmsg
0,01853336300,01853397400,00000061100,a07,poll
0,01853399500,01853400200,00000000700,a00,read
0,01853416900,01853418700,00000001800,a2f,recvmsg
0,01853478900,01853483000,00000004100,a01,write
0,01853491500,01853492200,00000000700,a2f,recvmsg
0,01853494700,01853494800,00000000100,a00,read
0,01853528300,01853529900,00000001600,aca,futex
0,01853533900,01853644200,00000110300,a07,poll
0,01853648100,01853651900,00000003800,a2e,sendmsg
0,01853654200,01853654400,00000000200,a00,read
0,01853678000,01853678300,00000000300,aca,futex
0,01853680700,01853758700,00000078000,a07,poll
0,01853760900,01853762100,00000001200,a2e,sendmsg
0,01853781000,01853835700,00000054700,a07,poll
0,01853845600,01853846900,00000001300,a2f,recvmsg
0,01853997800,01853998800,00000001000,a2f,recvmsg
0,01854000900,01854001100,00000000200,a00,read
0,01854381200,01854381600,00000000400,aca,futex
0,01854382300,01854382600,00000000300,aca,futex
0,01864157700,01856097700,-0008060000,a17,select
0,01856120300,01856120600,00000000300,a2f,recvmsg
0,01856124000,01856133500,00000009500,a17,select
0,01856138200,01856138400,00000000200,a2f,recvmsg
0,01856139000,01856212500,00000073500,a17,select
0,01856218900,01856219100,00000000200,a2f,recvmsg
0,01851460900,01866845600,00015384700,a3d,wait4
0,01866867200,01866871800,00000004600,a00,read
0,01866873900,01866874400,00000000500,a00,read
0,01866896900,01866947600,00000050700,a07,poll
0,01866953800,01866954000,00000000200,a2f,recvmsg
0,01866955000,01866955100,00000000100,a2f,recvmsg
0,01866962900,01866978200,00000015300,a07,poll
0,01866980300,01866980400,00000000100,a2f,recvmsg
0,01866980800,01866981000,00000000200,a2f,recvmsg
0,01866986300,01866999700,00000013400,a07,poll
0,01867001700,01867001900,00000000200,a2f,recvmsg
0,01867002300,01867002500,00000000200,a2f,recvmsg
0,01867007300,01867020500,00000013200,a07,poll
0,01867022500,01867022700,00000000200,a2f,recvmsg
0,01867023000,01867023300,00000000300,a2f,recvmsg
0,01867028200,01867041400,00000013200,a07,poll
0,01867043400,01867043600,00000000200,a2f,recvmsg
0,01867044000,01867044200,00000000200,a2f,recvmsg
0,01867048300,01867061500,00000013200,a07,poll
0,01867063700,01867063900,00000000200,a2f,recvmsg
0,01867064100,01867064300,00000000200,a2f,recvmsg
0,01867065300,01867065700,00000000400,a08,lseek
0,01867075700,01867075800,00000000100,a08,lseek
0,01867079000,01867085900,00000006900,a07,poll
0,01867087100,01867087200,00000000100,a2f,recvmsg
0,01867087600,01867087800,00000000200,a2f,recvmsg
0,01867093600,01867100300,00000006700,a07,poll
0,01867101500,01867101700,00000000200,a2f,recvmsg
0,01867101900,01867102100,00000000200,a2f,recvmsg
0,01867105100,01867111800,00000006700,a07,poll
0,01867113000,01867113200,00000000200,a2f,recvmsg
0,01867113400,01867113600,00000000200,a2f,recvmsg
0,01867117700,01867124200,00000006500,a07,poll
0,01867125400,01867125600,00000000200,a2f,recvmsg
0,01867125900,01867126100,00000000200,a2f,recvmsg
0,01867129200,01867136100,00000006900,a07,poll
0,01867137400,01867137500,00000000100,a2f,recvmsg
0,01867137900,01867138000,00000000100,a2f,recvmsg
0,01867141400,01867148200,00000006800,a07,poll
0,01867149400,01867149500,00000000100,a2f,recvmsg
0,01867149800,01867150000,00000000200,a2f,recvmsg
0,01867153100,01867159900,00000006800,a07,poll
0,01867161000,01867161200,00000000200,a2f,recvmsg
0,01867161500,01867161700,00000000200,a2f,recvmsg
0,01867164500,01867171000,00000006500,a07,poll
0,01867172200,01867172300,00000000100,a2f,recvmsg
0,01867172600,01867172800,00000000200,a2f,recvmsg
0,01867178100,01867185200,00000007100,a07,poll
0,01867186300,01867186500,00000000200,a2f,recvmsg
0,01867186800,01867187000,00000000200,a2f,recvmsg
0,01867190200,01867196900,00000006700,a07,poll
0,01867198000,01867198200,00000000200,a2f,recvmsg
0,01867198500,01867198700,00000000200,a2f,recvmsg
0,01867201900,01867208600,00000006700,a07,poll
0,01867209800,01867210000,00000000200,a2f,recvmsg
0,01867210200,01867210400,00000000200,a2f,recvmsg
0,01867213500,01867220200,00000006700,a07,poll
0,01867221400,01867221600,00000000200,a2f,recvmsg
0,01867221800,01867222000,00000000200,a2f,recvmsg
0,01867225200,01867231500,00000006300,a07,poll
0,01867232700,01867232900,00000000200,a2f,recvmsg
0,01867233100,01867233300,00000000200,a2f,recvmsg
0,01867236500,01867243000,00000006500,a07,poll
0,01867245000,01867245200,00000000200,a2f,recvmsg
0,01867245500,01867245700,00000000200,a2f,recvmsg
0,01867248700,01867255600,00000006900,a07,poll
0,01867256800,01867256900,00000000100,a2f,recvmsg
0,01867257300,01867257400,00000000100,a2f,recvmsg
0,01867260000,01867266800,00000006800,a07,poll
0,01867267900,01867268100,00000000200,a2f,recvmsg
0,01867268400,01867268600,00000000200,a2f,recvmsg
0,01867273200,01867279800,00000006600,a07,poll
0,01867281000,01867281100,00000000100,a2f,recvmsg
0,01867281500,01867281600,00000000100,a2f,recvmsg
0,01867284300,01867291000,00000006700,a07,poll
0,01867292000,01867292200,00000000200,a2f,recvmsg
0,01867292500,01867292700,00000000200,a2f,recvmsg
0,01867295400,01867301900,00000006500,a07,poll
0,01867303100,01867303300,00000000200,a2f,recvmsg
0,01867303500,01867303700,00000000200,a2f,recvmsg
0,01867306300,01867312900,00000006600,a07,poll
0,01867314100,01867314300,00000000200,a2f,recvmsg
0,01867314600,01867314700,00000000100,a2f,recvmsg
0,01867317800,01867324500,00000006700,a07,poll
0,01867325700,01867325800,00000000100,a2f,recvmsg
0,01867326100,01867326200,00000000100,a2f,recvmsg
0,01867329000,01867335600,00000006600,a07,poll
0,01867336700,01867336900,00000000200,a2f,recvmsg
0,01867337200,01867337400,00000000200,a2f,recvmsg
0,01867340500,01867347200,00000006700,a07,poll
0,01867348300,01867348500,00000000200,a2f,recvmsg
0,01867348800,01867348900,00000000100,a2f,recvmsg
0,01867352300,01867359200,00000006900,a07,poll
0,01867360300,01867360400,00000000100,a2f,recvmsg
0,01867360700,01867360900,00000000200,a2f,recvmsg
0,01867364500,01867371700,00000007200,a07,poll
0,01867372700,01867372900,00000000200,a2f,recvmsg
0,01867373200,01867373400,00000000200,a2f,recvmsg
0,01867376800,01867383400,00000006600,a07,poll
0,01867384700,01867384800,00000000100,a2f,recvmsg
0,01867385000,01867385200,00000000200,a2f,recvmsg
0,01867388600,01867395400,00000006800,a07,poll
0,01867396500,01867396700,00000000200,a2f,recvmsg
0,01867397000,01867397200,00000000200,a2f,recvmsg
0,01867402300,01867409100,00000006800,a07,poll
0,01867410100,01867410300,00000000200,a2f,recvmsg
0,01867410600,01867410800,00000000200,a2f,recvmsg
0,01867413800,01867420600,00000006800,a07,poll
0,01867421700,01867421900,00000000200,a2f,recvmsg
0,01867422200,01867422400,00000000200,a2f,recvmsg
0,01867425400,01867432200,00000006800,a07,poll
0,01867433300,01867433500,00000000200,a2f,recvmsg
0,01867433800,01867433900,00000000100,a2f,recvmsg
0,01867437500,01867444200,00000006700,a07,poll
0,01867445400,01867445600,00000000200,a2f,recvmsg
0,01867445800,01867446000,00000000200,a2f,recvmsg
0,01867449500,01867456100,00000006600,a07,poll
0,01867457200,01867457400,00000000200,a2f,recvmsg
0,01867457700,01867457900,00000000200,a2f,recvmsg
0,01867461500,01867468400,00000006900,a07,poll
0,01867469600,01867469700,00000000100,a2f,recvmsg
0,01867470000,01867470200,00000000200,a2f,recvmsg
0,01867473800,01867480600,00000006800,a07,poll
0,01867481800,01867481900,00000000100,a2f,recvmsg
0,01867482200,01867482400,00000000200,a2f,recvmsg
0,01867485400,01867492200,00000006800,a07,poll
0,01867493300,01867493400,00000000100,a2f,recvmsg
0,01867493700,01867493900,00000000200,a2f,recvmsg
0,01867496800,01867503300,00000006500,a07,poll
0,01867504500,01867504700,00000000200,a2f,recvmsg
0,01867504900,01867505100,00000000200,a2f,recvmsg
0,01867508400,01867515200,00000006800,a07,poll
0,01867516300,01867516400,00000000100,a2f,recvmsg
0,01867516800,01867517000,00000000200,a2f,recvmsg
0,01867518000,01867518000,00000000000,a08,lseek
0,01867520600,01867522000,00000001400,a00,read
0,01867525700,01867525800,00000000100,a08,lseek
0,01867528700,01867535200,00000006500,a07,poll
0,01867536600,01867536800,00000000200,a2f,recvmsg
0,01867537000,01867537200,00000000200,a2f,recvmsg
0,01867563000,01867569700,00000006700,a07,poll
0,01867571100,01867571200,00000000100,a2f,recvmsg
0,01867571500,01867571700,00000000200,a2f,recvmsg
0,01867575500,01867576300,00000000800,a00,read
0,01867581800,01867581900,00000000100,a08,lseek
0,01867585000,01867591800,00000006800,a07,poll
0,01867593000,01867593200,00000000200,a2f,recvmsg
0,01867593500,01867593700,00000000200,a2f,recvmsg
0,01867596500,01867603100,00000006600,a07,poll
0,01867604200,01867604300,00000000100,a2f,recvmsg
0,01867604600,01867604800,00000000200,a2f,recvmsg
0,01867607400,01867614000,00000006600,a07,poll
0,01867615100,01867615300,00000000200,a2f,recvmsg
0,01867615600,01867615800,00000000200,a2f,recvmsg
0,01867618600,01867625000,00000006400,a07,poll
0,01867626200,01867626300,00000000100,a2f,recvmsg
0,01867626600,01867626800,00000000200,a2f,recvmsg
0,01867629500,01867636100,00000006600,a07,poll
0,01867637300,01867637500,00000000200,a2f,recvmsg
0,01867637700,01867637900,00000000200,a2f,recvmsg
0,01867640600,01867647400,00000006800,a07,poll
0,01867648600,01867648800,00000000200,a2f,recvmsg
0,01867649100,01867649200,00000000100,a2f,recvmsg
0,01867651800,01867658400,00000006600,a07,poll
0,01867659500,01867659700,00000000200,a2f,recvmsg
0,01867660000,01867660200,00000000200,a2f,recvmsg
0,01867663500,01867670100,00000006600,a07,poll
0,01867671300,01867671400,00000000100,a2f,recvmsg
0,01867671700,01867671900,00000000200,a2f,recvmsg
0,01867674600,01867681300,00000006700,a07,poll
0,01867682400,01867682500,00000000100,a2f,recvmsg
0,01867682800,01867683000,00000000200,a2f,recvmsg
0,01867683400,01867683500,00000000100,a08,lseek
0,01867688700,01867695500,00000006800,a07,poll
0,01867696600,01867696700,00000000100,a2f,recvmsg
0,01867697100,01867697300,00000000200,a2f,recvmsg
0,01867702200,01867708900,00000006700,a07,poll
0,01867710000,01867710100,00000000100,a2f,recvmsg
0,01867710500,01867710700,00000000200,a2f,recvmsg
0,01867713900,01867720600,00000006700,a07,poll
0,01867721600,01867721800,00000000200,a2f,recvmsg
0,01867722100,01867722300,00000000200,a2f,recvmsg
0,01867725100,01867731700,00000006600,a07,poll
0,01867732800,01867732900,00000000100,a2f,recvmsg
0,01867733200,01867733400,00000000200,a2f,recvmsg
0,01867736500,01867743000,00000006500,a07,poll
0,01867744100,01867744200,00000000100,a2f,recvmsg
0,01867744600,01867744800,00000000200,a2f,recvmsg
0,01867747800,01867754400,00000006600,a07,poll
0,01867755500,01867755600,00000000100,a2f,recvmsg
0,01867755900,01867756100,00000000200,a2f,recvmsg
0,01867759600,01867766400,00000006800,a07,poll
0,01867767500,01867767700,00000000200,a2f,recvmsg
0,01867768000,01867768200,00000000200,a2f,recvmsg
0,01867771100,01867777800,00000006700,a07,poll
0,01867779000,01867779100,00000000100,a2f,recvmsg
0,01867779500,01867779700,00000000200,a2f,recvmsg
0,01867782700,01867789600,00000006900,a07,poll
0,01867790600,01867790800,00000000200,a2f,recvmsg
0,01867791100,01867791300,00000000200,a2f,recvmsg
0,01867794200,01867800800,00000006600,a07,poll
0,01867802000,01867802100,00000000100,a2f,recvmsg
0,01867802400,01867802600,00000000200,a2f,recvmsg
0,01867805400,01867812100,00000006700,a07,poll
0,01867813100,01867813300,00000000200,a2f,recvmsg
0,01867813600,01867813800,00000000200,a2f,recvmsg
0,01867816700,01867823400,00000006700,a07,poll
0,01867824600,01867824800,00000000200,a2f,recvmsg
0,01867825100,01867825300,00000000200,a2f,recvmsg
0,01867828700,01867835400,00000006700,a07,poll
0,01867836600,01867836800,00000000200,a2f,recvmsg
0,01867837100,01867837200,00000000100,a2f,recvmsg
0,01867840700,01867847200,00000006500,a07,poll
0,01867848400,01867848500,00000000100,a2f,recvmsg
0,01867848800,01867849000,00000000200,a2f,recvmsg
0,01867851800,01867858400,00000006600,a07,poll
0,01867859500,01867859700,00000000200,a2f,recvmsg
0,01867860000,01867860100,00000000100,a2f,recvmsg
0,01867863000,01867869600,00000006600,a07,poll
0,01867870700,01867870900,00000000200,a2f,recvmsg
0,01867871200,01867871400,00000000200,a2f,recvmsg
0,01867882600,01867889300,00000006700,a07,poll
0,01867890500,01867890700,00000000200,a2f,recvmsg
0,01867891000,01867891200,00000000200,a2f,recvmsg
0,01867894300,01867901100,00000006800,a07,poll
0,01867902100,01867902300,00000000200,a2f,recvmsg
0,01867902600,01867902800,00000000200,a2f,recvmsg
0,01867905700,01867912300,00000006600,a07,poll
0,01867913400,01867913500,00000000100,a2f,recvmsg
0,01867913900,01867914000,00000000100,a2f,recvmsg
0,01867917100,01867923700,00000006600,a07,poll
0,01867924700,01867924900,00000000200,a2f,recvmsg
0,01867925200,01867925400,00000000200,a2f,recvmsg
0,01867928600,01867935400,00000006800,a07,poll
0,01867936400,01867936600,00000000200,a2f,recvmsg
0,01867936900,01867937100,00000000200,a2f,recvmsg
0,01867957500,01867983500,00000026000,a57,unlink
0,01867984700,01867988800,00000004100,a14,writev
0,01867989300,01868087400,00000098100,a07,poll
0,01867989300,01868094900,00000105600,a07,poll
0,01868107000,01868107100,00000000100,a2f,recvmsg
0,01868155800,01868156100,00000000300,a2f,recvmsg
0,01868143800,01868166800,00000023000,a07,poll
0,01868191300,01868196000,00000004700,a07,poll
0,01868206900,01868207100,00000000200,a2f,recvmsg
0,01868224900,01868226800,00000001900,a07,poll
0,01868228600,01868230000,00000001400,a07,poll
0,01868231500,01868232600,00000001100,a07,poll
0,01868234300,01868281100,00000046800,a07,poll
0,01868234300,01868283500,00000049200,a07,poll
0,01868286400,01868287600,00000001200,a07,poll
0,01868288900,01868338700,00000049800,a07,poll
0,01868339900,01868341700,00000001800,a07,poll
0,01868342900,01868344300,00000001400,a07,poll
0,01868345600,01868396900,00000051300,a07,poll
0,01868397200,01868398600,00000001400,a2f,recvmsg
0,01868345600,01868399600,00000054000,a07,poll
0,01868402300,01868403400,00000001100,a07,poll
0,01868404900,01868453500,00000048600,a07,poll
0,01868453700,01868454700,00000001000,a2f,recvmsg
0,01868404900,01868455700,00000050800,a07,poll
0,01868458300,01868459400,00000001100,a07,poll
0,01868460800,01868498400,00000037600,a07,poll
0,01868498500,01868499700,00000001200,a2f,recvmsg
0,01868460800,01868500700,00000039900,a07,poll
0,01868503200,01868504300,00000001100,a07,poll
0,01868505800,01868543800,00000038000,a07,poll
0,01868505800,01868545900,00000040100,a07,poll
0,01868550200,01868551400,00000001200,a07,poll
0,01868553100,01868589700,00000036600,a07,poll
0,01868553100,01868591500,00000038400,a07,poll
0,01868591700,01868594400,00000002700,a2f,recvmsg
0,01868595000,01868596100,00000001100,a07,poll
0,01868597600,01868635100,00000037500,a07,poll
0,01868597600,01868636700,00000039100,a07,poll
0,01868637000,01868639300,00000002300,a2f,recvmsg
0,01868639900,01868640900,00000001000,a07,poll
0,01868642300,01868679500,00000037200,a07,poll
0,01868642300,01868681100,00000038800,a07,poll
0,01868681400,01868685900,00000004500,a2f,recvmsg
0,01868686500,01868687600,00000001100,a07,poll
0,01868688900,01868735600,00000046700,a07,poll
0,01868735900,01868736800,00000000900,a2f,recvmsg
0,01868688900,01868737800,00000048900,a07,poll
0,01868740600,01868741700,00000001100,a07,poll
0,01868743100,01868755000,00000011900,a07,poll
0,01868743100,01868756800,00000013700,a07,poll
0,01868757000,01868759400,00000002400,a2f,recvmsg
0,01868759900,01868761000,00000001100,a07,poll
0,01868762300,01868772400,00000010100,a07,poll
0,01868772600,01868773700,00000001100,a2f,recvmsg
0,01868762300,01868774600,00000012300,a07,poll
0,01868777600,01868778700,00000001100,a07,poll
0,01868780000,01868788600,00000008600,a07,poll
0,01868788900,01868790300,00000001400,a2f,recvmsg
0,01868780000,01868791200,00000011200,a07,poll
0,01868793800,01868794900,00000001100,a07,poll
0,01868796200,01868805000,00000008800,a07,poll
0,01868796200,01868806800,00000010600,a07,poll
0,01868807000,01868809400,00000002400,a2f,recvmsg
0,01868810000,01868811100,00000001100,a07,poll
0,01868812400,01868820500,00000008100,a07,poll
0,01868812400,01868822200,00000009800,a07,poll
0,01868822500,01868825000,00000002500,a2f,recvmsg
0,01868825500,01868826900,00000001400,a07,poll
0,01868828100,01868829300,00000001200,a07,poll
0,01868831900,01868832100,00000000200,a2f,recvmsg
0,01868832800,01868832800,00000000000,a2f,recvmsg
0,01868833500,01868848000,00000014500,a57,unlink
0,01868828100,01868849600,00000021500,a07,poll
0,01868849900,01868851500,00000001600,a2f,recvmsg
0,01868853400,01868854500,00000001100,a2d,recvfrom
0,01868858900,01868859100,00000000200,a2f,recvmsg
0,01868859600,01868859800,00000000200,a2f,recvmsg
0,01868828100,01868878300,00000050200,a07,poll
0,01868878700,01868880300,00000001600,a2f,recvmsg
0,01868882200,01868883300,00000001100,a2d,recvfrom
0,01868887700,01868887900,00000000200,a2f,recvmsg
0,01868888400,01868888500,00000000100,a2f,recvmsg
0,01868931300,01868931600,00000000300,a2f,recvmsg
0,01868934000,01868934100,00000000100,a2f,recvmsg
0,01868982000,01868982400,00000000400,a2f,recvmsg
0,01868984600,01868984800,00000000200,a2f,recvmsg
0,01868987500,01868991200,00000003700,a07,poll
0,01868991800,01868993300,00000001500,a2f,recvmsg
0,01868995200,01868995900,00000000700,a2d,recvfrom
0,01869000600,01869000800,00000000200,a2f,recvmsg
0,01869001500,01869001700,00000000200,a2f,recvmsg
0,01869031000,01869031300,00000000300,a2f,recvmsg
0,01869033600,01869033800,00000000200,a2f,recvmsg
0,01869049400,01869067100,00000017700,a07,poll
0,01869072100,01869072200,00000000100,a2f,recvmsg
0,01869074000,01869074100,00000000100,a2f,recvmsg
0,01869074600,01869074700,00000000100,a2f,recvmsg
0,01869076600,01869076700,00000000100,a2f,recvmsg
0,01869076900,01869077100,00000000200,a2f,recvmsg
0,01869077600,01869079200,00000001600,a07,poll
0,01869081200,01869081400,00000000200,a2f,recvmsg
0,01869081900,01869082100,00000000200,a2f,recvmsg
0,01869830700,01869840400,00000009700,a02,open
0,01869853100,01869856400,00000003300,a00,read
0,01869908700,01869909800,00000001100,a00,read
0,01869959600,01869960500,00000000900,a00,read
0,01870008000,01870008800,00000000800,a00,read
0,01870057500,01870058300,00000000800,a00,read
0,01870107000,01870107700,00000000700,a00,read
0,01870154700,01870155500,00000000800,a00,read
0,01870203200,01870204000,00000000800,a00,read
0,01870253800,01870254400,00000000600,a00,read
0,01870305200,01870305900,00000000700,a00,read
0,01870354400,01870355000,00000000600,a00,read
0,01870384800,01870387200,00000002400,a02,open
0,01870391800,01870392700,00000000900,a00,read
0,01870447600,01870448500,00000000900,a00,read
0,01870533100,01870533900,00000000800,a00,read
0,01870610600,01870611500,00000000900,a00,read
0,01870715400,01870716400,00000001000,a00,read
0,01870796200,01870797000,00000000800,a00,read
0,01870874400,01870875300,00000000900,a00,read
0,01870960600,01870961500,00000000900,a00,read
0,01871027000,01871027600,00000000600,a00,read
0,01871085400,01871086200,00000000800,a00,read
0,01871164700,01871196600,00000031900,a07,poll
0,01871200200,01871200300,00000000100,a2f,recvmsg
0,01871201200,01871201400,00000000200,a2f,recvmsg
0,01871203600,01871209700,00000006100,a07,poll
0,01871210800,01871210900,00000000100,a2f,recvmsg
0,01871211200,01871211400,00000000200,a2f,recvmsg
0,01871217300,01871224200,00000006900,a06,lstat
0,01871225000,01871225900,00000000900,a06,lstat
0,01871249100,01871265100,00000016000,a01,write
0,01871271100,01871278700,00000007600,a07,poll
0,01871280700,01871280900,00000000200,a2f,recvmsg
0,01871281400,01871281600,00000000200,a2f,recvmsg
0,01871282900,01871592600,00000309700,a38,clone
0,01872072300,01872072500,00000000200,a0c,brk
0,01872082200,01872084800,00000002600,a15,access
0,01872085400,01872086200,00000000800,a09,mmap
0,01872091500,01872092400,00000000900,a15,access
0,01872098400,01872099600,00000001200,a09,mmap
0,01872103200,01872104100,00000000900,a15,access
0,01872111100,01872112200,00000001100,a00,read
0,01872113600,01872115000,00000001400,a09,mmap
0,01872119000,01872121200,00000002200,a09,mmap
0,01872131500,01872132100,00000000600,a15,access
0,01872135700,01872136400,00000000700,a00,read
0,01872137000,01872137900,00000000900,a09,mmap
0,01872139700,01872140900,00000001200,a09,mmap
0,01872149000,01872149500,00000000500,a15,access
0,01872152400,01872153100,00000000700,a00,read
0,01872153700,01872154400,00000000700,a09,mmap
0,01872156000,01872157900,00000001900,a09,mmap
0,01872162500,01872165600,00000003100,a09,mmap
0,01872167600,01872168800,00000001200,a09,mmap
0,01872177700,01872178300,00000000600,a15,access
0,01872180800,01872181400,00000000600,a00,read
0,01872182100,01872183700,00000001600,a09,mmap
0,01872186100,01872187700,00000001600,a09,mmap
0,01872197300,01872197800,00000000500,a15,access
0,01872201100,01872201700,00000000600,a00,read
0,01872202400,01872203700,00000001300,a09,mmap
0,01872208000,01872210100,00000002100,a09,mmap
0,01872218800,01872219400,00000000600,a15,access
0,01872222300,01872222800,00000000500,a00,read
0,01872223200,01872224300,00000001100,a09,mmap
0,01872225500,01872226800,00000001300,a09,mmap
0,01872230600,01872231900,00000001300,a09,mmap
0,01872238300,01872238900,00000000600,a15,access
0,01872240900,01872241400,00000000500,a00,read
0,01872242000,01872243400,00000001400,a09,mmap
0,01872246300,01872247900,00000001600,a09,mmap
0,01872261800,01872262400,00000000600,a09,mmap
0,01872266200,01872266500,00000000300,a09,mmap
0,01872267700,01872268000,00000000300,a09,mmap
0,01872448600,01872448700,00000000100,a0c,brk
0,01872478900,01872479900,00000001000,a00,read
0,01872491800,01872493400,00000001600,a00,read
0,01872531100,01872532100,00000001000,a00,read
0,01872654800,01872655500,00000000700,a00,read
0,01872726600,01872727100,00000000500,a00,read
0,01872812600,01872813300,00000000700,a00,read
0,01872944000,01872944900,00000000900,a00,read
0,01873073800,01873074500,00000000700,a00,read
0,01873230200,01873231000,00000000800,a00,read
0,01873381300,01873381900,00000000600,a00,read
0,01873418800,01873420100,00000001300,a0c,brk
0,01873535000,01873535600,00000000600,a00,read
0,01873684200,01873684900,00000000700,a00,read
0,01873840200,01873841000,00000000800,a00,read
0,01874000000,01874000700,00000000700,a00,read
0,01874109300,01874110000,00000000700,a00,read
0,01874140500,01874141100,00000000600,a0c,brk
0,01874249600,01874250300,00000000700,a00,read
0,01874494300,01874495000,00000000700,a00,read
0,01874507100,01874507500,00000000400,a00,read
0,01874550800,01874551200,00000000400,a00,read
0,01874570900,01874571600,00000000700,a00,read
0,01874804600,01874805300,00000000700,a00,read
0,01874835000,01874835900,00000000900,a00,read
0,01874932700,01874933500,00000000800,a00,read
0,01874957500,01874958800,00000001300,a0c,brk
0,01875004100,01875004500,00000000400,a00,read
0,01875083200,01875084000,00000000800,a00,read
0,01875237000,01875237500,00000000500,a00,read
0,01875350900,01875351600,00000000700,a00,read
0,01875445600,01875446100,00000000500,a00,read
0,01875458100,01875458500,00000000400,a00,read
0,01875541300,01875541700,00000000400,a00,read
0,01875566300,01875566600,00000000300,a00,read
0,01875588900,01875589400,00000000500,a00,read
0,01875691800,01875692900,00000001100,a0c,brk
0,01875694900,01875695900,00000001000,a00,read
0,01875898900,01875899300,00000000400,a00,read
0,01875982400,01875982900,00000000500,a00,read
0,01876047100,01876047700,00000000600,a00,read
0,01876176600,01876177200,00000000600,a00,read
0,01876209700,01876210400,00000000700,a00,read
0,01876227100,01876228300,00000001200,a02,open
0,01876343900,01876344400,00000000500,a00,read
0,01876416000,01876416500,00000000500,a00,read
0,01876469000,01876470100,00000001100,a0c,brk
0,01876477100,01876477800,00000000700,a00,read
0,01876588100,01876588700,00000000600,a00,read
0,01876738700,01876739700,00000001000,a00,read
0,01876870300,01876870900,00000000600,a00,read
0,01876928500,01876929200,00000000700,a00,read
0,01876985400,01876986000,00000000600,a00,read
0,01877056000,01877056700,00000000700,a00,read
0,01877109200,01877110000,00000000800,a00,read
0,01877198200,01877198900,00000000700,a0c,brk
0,01877231800,01877235700,00000003900,a0c,brk
0,01877250500,01877251400,00000000900,a00,read
0,01877367100,01877367900,00000000800,a00,read
0,01877526300,01877527100,00000000800,a00,read
0,01877643800,01877644600,00000000800,a00,read
0,01877790300,01877791000,00000000700,a00,read
0,01877908200,01877908800,00000000600,a00,read
0,01878070200,01878070900,00000000700,a00,read
0,01878075800,01878076600,00000000800,a0c,brk
0,01878192800,01878193600,00000000800,a00,read
0,01878311900,01878312800,00000000900,a00,read
0,01871271100,01878443700,00007172600,a07,poll
0,01878476700,01878476900,00000000200,a00,read
0,01878489500,01878491000,00000001500,a2e,sendmsg
0,01878528500,01878529700,00000001200,a00,read
0,01878661800,01878662500,00000000700,a00,read
0,01878766000,01878766700,00000000700,a00,read
0,01878880800,01878881600,00000000800,a00,read
0,01879007300,01879008300,00000001000,a00,read
0,01879122600,01879124900,00000002300,a0c,brk
0,01879148600,01879149400,00000000800,a00,read
0,01878497800,01879183600,00000685800,a07,poll
0,01879184200,01879184600,00000000400,a00,read
0,01879193300,01879194400,00000001100,a2f,recvmsg
0,01879405900,01879407000,00000001100,a00,read
0,01879558800,01879559400,00000000600,a00,read
0,01879671400,01879672200,00000000800,a00,read
0,01879860300,01879861200,00000000900,a00,read
0,01879938800,01879939600,00000000800,a00,read
0,01880020900,01880021700,00000000800,a00,read
0,01880090000,01880092000,00000002000,a0c,brk
0,01880105400,01880106100,00000000700,a00,read
0,01880178500,01880179200,00000000700,a00,read
0,01880280100,01880280800,00000000700,a00,read
0,01880383100,01880383800,00000000700,a00,read
0,01880473000,01880473700,00000000700,a00,read
0,01880553900,01880554600,00000000700,a00,read
0,01880656000,01880656500,00000000500,a00,read
0,01880738500,01880739100,00000000600,a0c,brk
0,01880741700,01880742200,00000000500,a00,read
0,01880848900,01880849600,00000000700,a00,read
0,01880941900,01880942600,00000000700,a00,read
0,01881061100,01881061700,00000000600,a00,read
0,01881174900,01881175400,00000000500,a00,read
0,01881279500,01881280000,00000000500,a00,read
0,01881381500,01881382000,00000000500,a0c,brk
0,01881748400,01881751400,00000003000,a57,unlink
0,01881772700,01881773300,00000000600,a48,fcntl
0,01881825000,01881836100,00000011100,a01,write
0,01881855100,01881857600,00000002500,a01,write
0,01881873900,01881876300,00000002400,a01,write
0,01856219900,01882115900,00025896000,a17,select
0,01882139200,01882139500,00000000300,a2f,recvmsg
0,01882143100,01882163800,00000020700,a17,select
0,01882167800,01882168000,00000000200,a2f,recvmsg
0,01882168600,01882182000,00000013400,a17,select
0,01882185300,01882185500,00000000200,a2f,recvmsg
0,01882186000,01882201300,00000015300,a17,select
0,01882205200,01882205400,00000000200,a2f,recvmsg
0,01882205900,01882219800,00000013900,a17,select
0,01882223600,01882223800,00000000200,a2f,recvmsg
0,01882224400,01882238800,00000014400,a17,select
0,01882242400,01882242600,00000000200,a2f,recvmsg
0,01882243100,01882260800,00000017700,a17,select
0,01882264700,01882264900,00000000200,a2f,recvmsg
0,01882265400,01882275000,00000009600,a17,select
0,01882278700,01882278900,00000000200,a2f,recvmsg
0,01882279300,01882286800,00000007500,a17,select
0,01882290400,01882290500,00000000100,a2f,recvmsg
0,01882291000,01882298800,00000007800,a17,select
0,01882302300,01882302400,00000000100,a2f,recvmsg
0,01882303000,01882310700,00000007700,a17,select
0,01882314500,01882314700,00000000200,a2f,recvmsg
0,01882315200,01882323700,00000008500,a17,select
0,01882327200,01882327400,00000000200,a2f,recvmsg
0,01882328000,01882335500,00000007500,a17,select
0,01882339200,01882339400,00000000200,a2f,recvmsg
0,01882339900,01882347100,00000007200,a17,select
0,01882350500,01882350700,00000000200,a2f,recvmsg
0,01882351300,01882359700,00000008400,a17,select
0,01882363400,01882363600,00000000200,a2f,recvmsg
0,01882364100,01882371600,00000007500,a17,select
0,01882375400,01882375600,00000000200,a2f,recvmsg
0,01882376000,01882383400,00000007400,a17,select
0,01882387000,01882387200,00000000200,a2f,recvmsg
0,01882387600,01882395800,00000008200,a17,select
0,01882399500,01882399600,00000000100,a2f,recvmsg
0,01882400200,01882407400,00000007200,a17,select
0,01882410900,01882411100,00000000200,a2f,recvmsg
0,01882411600,01882419100,00000007500,a17,select
0,01882422800,01882422900,00000000100,a2f,recvmsg
0,01882423500,01882431000,00000007500,a17,select
0,01882434500,01882434600,00000000100,a2f,recvmsg
0,01882435100,01882442100,00000007000,a17,select
0,01882445900,01882446100,00000000200,a2f,recvmsg
0,01882446500,01882455600,00000009100,a17,select
0,01882459100,01882459300,00000000200,a2f,recvmsg
0,01882459700,01882466800,00000007100,a17,select
0,01882470400,01882470600,00000000200,a2f,recvmsg
0,01882471000,01882478100,00000007100,a17,select
0,01882481500,01882481700,00000000200,a2f,recvmsg
0,01882482200,01882489200,00000007000,a17,select
0,01882492900,01882493100,00000000200,a2f,recvmsg
0,01882493600,01882501100,00000007500,a17,select
0,01882504600,01882504700,00000000100,a2f,recvmsg
0,01882505200,01882512300,00000007100,a17,select
0,01882515900,01882516100,00000000200,a2f,recvmsg
0,01882516600,01882524100,00000007500,a17,select
0,01882527700,01882527900,00000000200,a2f,recvmsg
0,01882528300,01882535800,00000007500,a17,select
0,01882539500,01882539700,00000000200,a2f,recvmsg
0,01882540200,01882548100,00000007900,a17,select
0,01882551900,01882552100,00000000200,a2f,recvmsg
0,01882552600,01882560300,00000007700,a17,select
0,01882564000,01882564100,00000000100,a2f,recvmsg
0,01882564600,01882572200,00000007600,a17,select
0,01882575800,01882576000,00000000200,a2f,recvmsg
0,01882576500,01882586400,00000009900,a17,select
0,01882590000,01882590200,00000000200,a2f,recvmsg
0,01882590700,01882598000,00000007300,a17,select
0,01882601600,01882601700,00000000100,a2f,recvmsg
0,01882602200,01882609500,00000007300,a17,select
0,01882613300,01882613500,00000000200,a2f,recvmsg
0,01882613900,01882622000,00000008100,a17,select
0,01882625700,01882625900,00000000200,a2f,recvmsg
0,01882626400,01882634200,00000007800,a17,select
0,01882637900,01882638000,00000000100,a2f,recvmsg
0,01882638500,01882646400,00000007900,a17,select
0,01882650100,01882650300,00000000200,a2f,recvmsg
0,01882650800,01882658400,00000007600,a17,select
0,01882662200,01882662400,00000000200,a2f,recvmsg
0,01882662900,01882670200,00000007300,a17,select
0,01882674000,01882674200,00000000200,a2f,recvmsg
0,01882674600,01882681800,00000007200,a17,select
0,01882683800,01882702100,00000018300,a14,writev
0,01882702500,01882702700,00000000200,a2f,recvmsg
0,01882703400,01882721600,00000018200,a17,select
0,01882725500,01882725600,00000000100,a2f,recvmsg
0,01882726200,01882745300,00000019100,a17,select
0,01882748900,01882749000,00000000100,a2f,recvmsg
0,01882749600,01882780100,00000030500,a17,select
0,01882783600,01882783800,00000000200,a2f,recvmsg
0,01882784300,01882802400,00000018100,a17,select
0,01882806100,01882806300,00000000200,a2f,recvmsg
0,01882806900,01882814000,00000007100,a17,select
0,01882817500,01882817600,00000000100,a2f,recvmsg
0,01882818200,01882825100,00000006900,a17,select
0,01882828700,01882828900,00000000200,a2f,recvmsg
0,01882829400,01882836300,00000006900,a17,select
0,01882839700,01882839900,00000000200,a2f,recvmsg
0,01882840400,01882847400,00000007000,a17,select
0,01882850900,01882851000,00000000100,a2f,recvmsg
0,01882851500,01882858600,00000007100,a17,select
0,01882862000,01882862200,00000000200,a2f,recvmsg
0,01882862600,01882869700,00000007100,a17,select
0,01882873300,01882873500,00000000200,a2f,recvmsg
0,01882873900,01882881400,00000007500,a17,select
0,01882885200,01882885200,00000000000,a2f,recvmsg
0,01882885800,01882892800,00000007000,a17,select
0,01882896400,01882896600,00000000200,a2f,recvmsg
0,01882897000,01882906800,00000009800,a17,select
0,01882910300,01882910500,00000000200,a2f,recvmsg
0,01882911000,01882920400,00000009400,a17,select
0,01882924300,01882924500,00000000200,a2f,recvmsg
0,01882925000,01882932600,00000007600,a17,select
0,01882936000,01882936200,00000000200,a2f,recvmsg
0,01882936600,01882944200,00000007600,a17,select
0,01882947800,01882947900,00000000100,a2f,recvmsg
0,01882948400,01882955700,00000007300,a17,select
0,01882959200,01882959300,00000000100,a2f,recvmsg
0,01882959800,01882967100,00000007300,a17,select
0,01882970700,01882970800,00000000100,a2f,recvmsg
0,01882971300,01882979000,00000007700,a17,select
0,01882982600,01882982800,00000000200,a2f,recvmsg
0,01882983300,01882990500,00000007200,a17,select
0,01882993900,01882994100,00000000200,a2f,recvmsg
0,01882994600,01883001800,00000007200,a17,select
0,01883005300,01883005500,00000000200,a2f,recvmsg
0,01883006000,01883013200,00000007200,a17,select
0,01883016800,01883017000,00000000200,a2f,recvmsg
0,01883017500,01883024800,00000007300,a17,select
0,01883028200,01883028400,00000000200,a2f,recvmsg
0,01883028900,01883036100,00000007200,a17,select
0,01883039600,01883039800,00000000200,a2f,recvmsg
0,01883040300,01883048200,00000007900,a17,select
0,01883051900,01883052100,00000000200,a2f,recvmsg
0,01883052500,01883059700,00000007200,a17,select
0,01883063400,01883063600,00000000200,a2f,recvmsg
0,01883064000,01883071200,00000007200,a17,select
0,01883074600,01883074800,00000000200,a2f,recvmsg
0,01883075200,01883082400,00000007200,a17,select
0,01883086100,01883086300,00000000200,a2f,recvmsg
0,01883086700,01883099500,00000012800,a17,select
0,01883103100,01883103300,00000000200,a2f,recvmsg
0,01883103700,01883111300,00000007600,a17,select
0,01883114700,01883114900,00000000200,a2f,recvmsg
0,01883115300,01883122500,00000007200,a17,select
0,01883126200,01883126300,00000000100,a2f,recvmsg
0,01883126800,01883134300,00000007500,a17,select
0,01883137700,01883137900,00000000200,a2f,recvmsg
0,01883138300,01883145500,00000007200,a17,select
0,01883149100,01883149300,00000000200,a2f,recvmsg
0,01883149700,01883202500,00000052800,a17,select
0,01883203400,01883204600,00000001200,a2f,recvmsg
0,01883601600,01883602400,00000000800,a2f,recvmsg
0,01883893800,01883895700,00000001900,a2f,recvmsg
0,01884005500,01884005600,00000000100,a2f,recvmsg
0,01884006300,01884006700,00000000400,a14,writev
0,01884007000,01884007300,00000000300,a14,writev
0,01884024700,01884027100,00000002400,a14,writev
0,01884027200,01884028800,00000001600,a14,writev
0,01884029200,01884029400,00000000200,a2f,recvmsg
0,01879256000,01884037800,00004781800,a07,poll
0,01884043500,01884046100,00000002600,a2f,recvmsg
0,01884051300,01884051500,00000000200,a2f,recvmsg
0,01884055000,01884055200,00000000200,a2f,recvmsg
0,01884055400,01884055600,00000000200,a2f,recvmsg
0,01884059600,01884059800,00000000200,a2f,recvmsg
0,01884060000,01884060100,00000000100,a2f,recvmsg
0,01884060800,01884064600,00000003800,a07,poll
0,01884068700,01884075200,00000006500,a2f,recvmsg
0,01884086100,01884086300,00000000200,a2f,recvmsg
0,01884112200,01884116900,00000004700,a07,poll
0,01884122900,01884129000,00000006100,a2f,recvmsg
0,01884141600,01884141900,00000000300,a2f,recvmsg
0,01884164500,01884169000,00000004500,a07,poll
0,01884174400,01884180500,00000006100,a2f,recvmsg
0,01884193100,01884193300,00000000200,a2f,recvmsg
0,01884030100,01884221600,00000191500,a17,select
0,01884238800,01884240300,00000001500,a14,writev
0,01884240900,01884241100,00000000200,a2f,recvmsg
0,01884255400,01884256400,00000001000,a14,writev
0,01884256700,01884256900,00000000200,a2f,recvmsg
0,01884268700,01884269700,00000001000,a14,writev
0,01884270000,01884270200,00000000200,a2f,recvmsg
0,01884284500,01884284700,00000000200,a2f,recvmsg
0,01884215900,01884289200,00000073300,a07,poll
0,01884292900,01884293100,00000000200,a2f,recvmsg
0,01884294600,01884294700,00000000100,a2f,recvmsg
0,01884295000,01884295000,00000000000,a2f,recvmsg
0,01884296500,01884296700,00000000200,a2f,recvmsg
0,01884296800,01884296900,00000000100,a2f,recvmsg
0,01884297400,01884298900,00000001500,a07,poll
0,01884299500,01884300600,00000001100,a2f,recvmsg
0,01884306200,01884307200,00000001000,a2d,recvfrom
0,01884308200,01884308300,00000000100,a2f,recvmsg
0,01884309000,01884309100,00000000100,a2f,recvmsg
0,01884350800,01884351100,00000000300,a2f,recvmsg
0,01884353500,01884353700,00000000200,a2f,recvmsg
0,01884355800,01884357700,00000001900,a07,poll
0,01884358300,01884359500,00000001200,a2f,recvmsg
0,01884365100,01884365800,00000000700,a2d,recvfrom
0,01884366700,01884366900,00000000200,a2f,recvmsg
0,01884367500,01884367700,00000000200,a2f,recvmsg
0,01884397800,01884398100,00000000300,a2f,recvmsg
0,01884399800,01884400000,00000000200,a2f,recvmsg
0,01884285300,01886187700,00001902400,a17,select
0,01886201800,01886202000,00000000200,a2f,recvmsg
0,01886203700,01886213300,00000009600,a17,select
0,01886217300,01886217500,00000000200,a2f,recvmsg
0,01886218000,01886266200,00000048200,a17,select
0,01886269800,01886269900,00000000100,a2f,recvmsg
0,01886682500,01886705000,00000022500,60e,page_fault
0,01871612900,01896867800,00025254900,a3d,wait4
0,01896892300,01896894100,00000001800,a00,read
0,01896896400,01896896700,00000000300,a00,read
0,01896918400,01896969600,00000051200,a07,poll
0,01896975600,01896975800,00000000200,a2f,recvmsg
0,01896976700,01896976900,00000000200,a2f,recvmsg
0,01896986600,01897002100,00000015500,a07,poll
0,01897004100,01897004300,00000000200,a2f,recvmsg
0,01897004700,01897004900,00000000200,a2f,recvmsg
0,01897009600,01897023100,00000013500,a07,poll
0,01897025100,01897025300,00000000200,a2f,recvmsg
0,01897025600,01897025800,00000000200,a2f,recvmsg
0,01897030900,01897044100,00000013200,a07,poll
0,01897046100,01897046300,00000000200,a2f,recvmsg
0,01897046600,01897046800,00000000200,a2f,recvmsg
0,01897051700,01897065000,00000013300,a07,poll
0,01897067100,01897067200,00000000100,a2f,recvmsg
0,01897067600,01897067800,00000000200,a2f,recvmsg
0,01897071200,01897084400,00000013200,a07,poll
0,01897086600,01897086800,00000000200,a2f,recvmsg
0,01897087200,01897087400,00000000200,a2f,recvmsg
0,01897088200,01897088500,00000000300,a08,lseek
0,01897099100,01897099100,00000000000,a08,lseek
0,01897102500,01897109600,00000007100,a07,poll
0,01897110900,01897111100,00000000200,a2f,recvmsg
0,01897111500,01897111600,00000000100,a2f,recvmsg
0,01897117300,01897124000,00000006700,a07,poll
0,01897125300,01897125500,00000000200,a2f,recvmsg
0,01897125700,01897125900,00000000200,a2f,recvmsg
0,01897129100,01897135900,00000006800,a07,poll
0,01897137100,01897137200,00000000100,a2f,recvmsg
0,01897137600,01897137800,00000000200,a2f,recvmsg
0,01897141300,01897148100,00000006800,a07,poll
0,01897149300,01897149500,00000000200,a2f,recvmsg
0,01897149900,01897150000,00000000100,a2f,recvmsg
0,01897153300,01897160300,00000007000,a07,poll
0,01897161600,01897161800,00000000200,a2f,recvmsg
0,01897162000,01897162200,00000000200,a2f,recvmsg
0,01897165600,01897172200,00000006600,a07,poll
0,01897173500,01897173600,00000000100,a2f,recvmsg
0,01897174000,01897174200,00000000200,a2f,recvmsg
0,01897177400,01897184400,00000007000,a07,poll
0,01897185500,01897185700,00000000200,a2f,recvmsg
0,01897186000,01897186200,00000000200,a2f,recvmsg
0,01897189000,01897195800,00000006800,a07,poll
0,01897196900,01897197000,00000000100,a2f,recvmsg
0,01897197400,01897197600,00000000200,a2f,recvmsg
0,01897201700,01897209000,00000007300,a07,poll
0,01897210100,01897210300,00000000200,a2f,recvmsg
0,01897210600,01897210800,00000000200,a2f,recvmsg
0,01897214000,01897220800,00000006800,a07,poll
0,01897222000,01897222200,00000000200,a2f,recvmsg
0,01897222500,01897222600,00000000100,a2f,recvmsg
0,01897227300,01897233400,00000006100,a07,poll
0,01897234500,01897234700,00000000200,a2f,recvmsg
0,01897235000,01897235200,00000000200,a2f,recvmsg
0,01897238300,01897245100,00000006800,a07,poll
0,01897246200,01897246300,00000000100,a2f,recvmsg
0,01897246700,01897246900,00000000200,a2f,recvmsg
0,01897249900,01897256800,00000006900,a07,poll
0,01897257900,01897258100,00000000200,a2f,recvmsg
0,01897258400,01897258600,00000000200,a2f,recvmsg
0,01897261800,01897268600,00000006800,a07,poll
0,01897269800,01897269900,00000000100,a2f,recvmsg
0,01897270200,01897270400,00000000200,a2f,recvmsg
0,01897273600,01897280200,00000006600,a07,poll
0,01897281500,01897281600,00000000100,a2f,recvmsg
0,01897281900,01897282100,00000000200,a2f,recvmsg
0,01897284800,01897291600,00000006800,a07,poll
0,01897292800,01897292900,00000000100,a2f,recvmsg
0,01897293200,01897293400,00000000200,a2f,recvmsg
0,01897298200,01897304800,00000006600,a07,poll
0,01897306000,01897306200,00000000200,a2f,recvmsg
0,01897306400,01897306600,00000000200,a2f,recvmsg
0,01897309200,01897316000,00000006800,a07,poll
0,01897317200,01897317300,00000000100,a2f,recvmsg
0,01897317600,01897317700,00000000100,a2f,recvmsg
0,01897320500,01897327200,00000006700,a07,poll
0,01897328500,01897328600,00000000100,a2f,recvmsg
0,01897329000,01897329000,00000000000,a2f,recvmsg
0,01897331800,01897338500,00000006700,a07,poll
0,01897339700,01897339800,00000000100,a2f,recvmsg
0,01897340200,01897340400,00000000200,a2f,recvmsg
0,01897343400,01897350100,00000006700,a07,poll
0,01897351400,01897351600,00000000200,a2f,recvmsg
0,01897351800,01897352000,00000000200,a2f,recvmsg
0,01897354900,01897361700,00000006800,a07,poll
0,01897362800,01897363000,00000000200,a2f,recvmsg
0,01897363200,01897363400,00000000200,a2f,recvmsg
0,01897366800,01897373600,00000006800,a07,poll
0,01897374700,01897374900,00000000200,a2f,recvmsg
0,01897375200,01897375400,00000000200,a2f,recvmsg
0,01897378600,01897385500,00000006900,a07,poll
0,01897386500,01897386700,00000000200,a2f,recvmsg
0,01897387000,01897387200,00000000200,a2f,recvmsg
0,01897391800,01897398800,00000007000,a07,poll
0,01897400000,01897400200,00000000200,a2f,recvmsg
0,01897400500,01897400700,00000000200,a2f,recvmsg
0,01897404200,01897410800,00000006600,a07,poll
0,01897412000,01897412200,00000000200,a2f,recvmsg
0,01897412500,01897412600,00000000100,a2f,recvmsg
0,01897416200,01897423000,00000006800,a07,poll
0,01897424200,01897424300,00000000100,a2f,recvmsg
0,01897424700,01897424800,00000000100,a2f,recvmsg
0,01897430900,01897437700,00000006800,a07,poll
0,01897439000,01897439100,00000000100,a2f,recvmsg
0,01897439400,01897439600,00000000200,a2f,recvmsg
0,01897443300,01897450100,00000006800,a07,poll
0,01897451200,01897451400,00000000200,a2f,recvmsg
0,01897451700,01897451900,00000000200,a2f,recvmsg
0,01897455100,01897461900,00000006800,a07,poll
0,01897463000,01897463100,00000000100,a2f,recvmsg
0,01897463500,01897463700,00000000200,a2f,recvmsg
0,01897467500,01897474700,00000007200,a07,poll
0,01897475800,01897476000,00000000200,a2f,recvmsg
0,01897476300,01897476500,00000000200,a2f,recvmsg
0,01897479800,01897486600,00000006800,a07,poll
0,01897487700,01897487900,00000000200,a2f,recvmsg
0,01897488200,01897488400,00000000200,a2f,recvmsg
0,01897492100,01897498900,00000006800,a07,poll
0,01897500100,01897500300,00000000200,a2f,recvmsg
0,01897500600,01897500800,00000000200,a2f,recvmsg
0,01897504100,01897511000,00000006900,a07,poll
0,01897512100,01897512300,00000000200,a2f,recvmsg
0,01897512600,01897512800,00000000200,a2f,recvmsg
0,01897515800,01897522700,00000006900,a07,poll
0,01897523800,01897523900,00000000100,a2f,recvmsg
0,01897524300,01897524500,00000000200,a2f,recvmsg
0,01897527200,01897534000,00000006800,a07,poll
0,01897535000,01897535200,00000000200,a2f,recvmsg
0,01897535500,01897535700,00000000200,a2f,recvmsg
0,01897539100,01897545800,00000006700,a07,poll
0,01897547000,01897547200,00000000200,a2f,recvmsg
0,01897547500,01897547600,00000000100,a2f,recvmsg
0,01897548600,01897548700,00000000100,a08,lseek
0,01897551300,01897552800,00000001500,a00,read
0,01897556400,01897556500,00000000100,a08,lseek
0,01897559300,01897566000,00000006700,a07,poll
0,01897567200,01897567400,00000000200,a2f,recvmsg
0,01897567700,01897567900,00000000200,a2f,recvmsg
0,01897594300,01897601000,00000006700,a07,poll
0,01897602400,01897602600,00000000200,a2f,recvmsg
0,01897602800,01897603000,00000000200,a2f,recvmsg
0,01897606900,01897607800,00000000900,a00,read
0,01897613300,01897613400,00000000100,a08,lseek
0,01897616700,01897623500,00000006800,a07,poll
0,01897624800,01897625000,00000000200,a2f,recvmsg
0,01897625300,01897625400,00000000100,a2f,recvmsg
0,01897628300,01897634900,00000006600,a07,poll
0,01897636100,01897636300,00000000200,a2f,recvmsg
0,01897636600,01897636800,00000000200,a2f,recvmsg
0,01897639400,01897646100,00000006700,a07,poll
0,01897647100,01897647300,00000000200,a2f,recvmsg
0,01897647600,01897647800,00000000200,a2f,recvmsg
0,01897650600,01897657300,00000006700,a07,poll
0,01897658500,01897658600,00000000100,a2f,recvmsg
0,01897659000,01897659200,00000000200,a2f,recvmsg
0,01897661800,01897668600,00000006800,a07,poll
0,01897669700,01897669800,00000000100,a2f,recvmsg
0,01897670100,01897670300,00000000200,a2f,recvmsg
0,01897673000,01897679900,00000006900,a07,poll
0,01897681000,01897681200,00000000200,a2f,recvmsg
0,01897681500,01897681700,00000000200,a2f,recvmsg
0,01897684300,01897691300,00000007000,a07,poll
0,01897692400,01897692600,00000000200,a2f,recvmsg
0,01897692900,01897693100,00000000200,a2f,recvmsg
0,01897696500,01897703500,00000007000,a07,poll
0,01897704700,01897704800,00000000100,a2f,recvmsg
0,01897705200,01897705300,00000000100,a2f,recvmsg
0,01897708000,01897714700,00000006700,a07,poll
0,01897715800,01897716000,00000000200,a2f,recvmsg
0,01897716300,01897716500,00000000200,a2f,recvmsg
0,01897716800,01897716900,00000000100,a08,lseek
0,01897721300,01897728100,00000006800,a07,poll
0,01897729400,01897729500,00000000100,a2f,recvmsg
0,01897729800,01897729900,00000000100,a2f,recvmsg
0,01897734900,01897741700,00000006800,a07,poll
0,01897742900,01897743100,00000000200,a2f,recvmsg
0,01897743300,01897743500,00000000200,a2f,recvmsg
0,01897747000,01897753600,00000006600,a07,poll
0,01897754800,01897754900,00000000100,a2f,recvmsg
0,01897755300,01897755400,00000000100,a2f,recvmsg
0,01897758600,01897765200,00000006600,a07,poll
0,01897766300,01897766500,00000000200,a2f,recvmsg
0,01897766800,01897767000,00000000200,a2f,recvmsg
0,01897770100,01897776700,00000006600,a07,poll
0,01897777900,01897778100,00000000200,a2f,recvmsg
0,01897778400,01897778600,00000000200,a2f,recvmsg
0,01897781600,01897788300,00000006700,a07,poll
0,01897789400,01897789700,00000000300,a2f,recvmsg
0,01897790000,01897790200,00000000200,a2f,recvmsg
0,01897793600,01897800200,00000006600,a07,poll
0,01897801400,01897801600,00000000200,a2f,recvmsg
0,01897801900,01897802100,00000000200,a2f,recvmsg
0,01897805000,01897811600,00000006600,a07,poll
0,01897812800,01897813000,00000000200,a2f,recvmsg
0,01897813300,01897813500,00000000200,a2f,recvmsg
0,01897816500,01897823100,00000006600,a07,poll
0,01897824300,01897824500,00000000200,a2f,recvmsg
0,01897824800,01897824900,00000000100,a2f,recvmsg
0,01897827900,01897834700,00000006800,a07,poll
0,01897835900,01897836100,00000000200,a2f,recvmsg
0,01897836300,01897836500,00000000200,a2f,recvmsg
0,01897840500,01897846300,00000005800,a07,poll
0,01897847500,01897847700,00000000200,a2f,recvmsg
0,01897847900,01897848100,00000000200,a2f,recvmsg
0,01897851100,01897857800,00000006700,a07,poll
0,01897858900,01897859100,00000000200,a2f,recvmsg
0,01897859300,01897859500,00000000200,a2f,recvmsg
0,01897863100,01897869900,00000006800,a07,poll
0,01897871000,01897871200,00000000200,a2f,recvmsg
0,01897871500,01897871700,00000000200,a2f,recvmsg
0,01897874600,01897881200,00000006600,a07,poll
0,01897882300,01897882500,00000000200,a2f,recvmsg
0,01897882800,01897883000,00000000200,a2f,recvmsg
0,01897886000,01897892700,00000006700,a07,poll
0,01897893800,01897894000,00000000200,a2f,recvmsg
0,01897894300,01897894500,00000000200,a2f,recvmsg
0,01897897400,01897904100,00000006700,a07,poll
0,01897905100,01897905300,00000000200,a2f,recvmsg
0,01897905600,01897905800,00000000200,a2f,recvmsg
0,01897914400,01897921200,00000006800,a07,poll
0,01897922300,01897922500,00000000200,a2f,recvmsg
0,01897922800,01897923000,00000000200,a2f,recvmsg
0,01897926200,01897932800,00000006600,a07,poll
0,01897933900,01897934100,00000000200,a2f,recvmsg
0,01897934400,01897934600,00000000200,a2f,recvmsg
0,01897937700,01897944400,00000006700,a07,poll
0,01897945600,01897945800,00000000200,a2f,recvmsg
0,01897946100,01897946300,00000000200,a2f,recvmsg
0,01897949400,01897956000,00000006600,a07,poll
0,01897957000,01897957200,00000000200,a2f,recvmsg
0,01897957500,01897957700,00000000200,a2f,recvmsg
0,01897960800,01897967400,00000006600,a07,poll
0,01897968600,01897968800,00000000200,a2f,recvmsg
0,01897969100,01897969200,00000000100,a2f,recvmsg
0,01897989700,01898016000,00000026300,a57,unlink
0,01898017200,01898021300,00000004100,a14,writev
0,01898021900,01898121300,00000099400,a07,poll
0,01898021900,01898130400,00000108500,a07,poll
0,01898142100,01898142200,00000000100,a2f,recvmsg
0,01898185100,01898185400,00000000300,a2f,recvmsg
0,01898174000,01898203000,00000029000,a07,poll
0,01898221600,01898258700,00000037100,a07,poll
0,01898259900,01898261900,00000002000,a07,poll
0,01898263700,01898316600,00000052900,a07,poll
0,01898316900,01898318800,00000001900,a2f,recvmsg
0,01898263700,01898319800,00000056100,a07,poll
0,01898322500,01898373900,00000051400,a07,poll
0,01898375000,01898376700,00000001700,a07,poll
0,01898378000,01898429500,00000051500,a07,poll
0,01898430600,01898432300,00000001700,a07,poll
0,01898433500,01898486400,00000052900,a07,poll
0,01898486600,01898487800,00000001200,a2f,recvmsg
0,01898433500,01898488700,00000055200,a07,poll
0,01898491200,01898531100,00000039900,a07,poll
0,01898531200,01898532100,00000000900,a2f,recvmsg
0,01898491200,01898533100,00000041900,a07,poll
0,01898535600,01898575400,00000039800,a07,poll
0,01898575400,01898576400,00000001000,a2f,recvmsg
0,01898535600,01898577300,00000041700,a07,poll
0,01898581100,01898620000,00000038900,a07,poll
0,01898620100,01898621200,00000001100,a2f,recvmsg
0,01898581100,01898622200,00000041100,a07,poll
0,01898624600,01898664500,00000039900,a07,poll
0,01898664600,01898665600,00000001000,a2f,recvmsg
0,01898624600,01898666500,00000041900,a07,poll
0,01898669100,01898735600,00000066500,a07,poll
0,01898669100,01898737500,00000068400,a07,poll
0,01898737800,01898740800,00000003000,a2f,recvmsg
0,01898741500,01898791000,00000049500,a07,poll
0,01898791100,01898792700,00000001600,a2f,recvmsg
0,01898741500,01898793800,00000052300,a07,poll
0,01898796200,01898811200,00000015000,a07,poll
0,01898811300,01898812400,00000001100,a2f,recvmsg
0,01898796200,01898813300,00000017100,a07,poll
0,01898815800,01898828400,00000012600,a07,poll
0,01898828500,01898830000,00000001500,a2f,recvmsg
0,01898815800,01898830900,00000015100,a07,poll
0,01898833400,01898843800,00000010400,a07,poll
0,01898844000,01898845100,00000001100,a2f,recvmsg
0,01898833400,01898846000,00000012600,a07,poll
0,01898848500,01898859100,00000010600,a07,poll
0,01898859200,01898860400,00000001200,a2f,recvmsg
0,01898848500,01898861200,00000012700,a07,poll
0,01898863800,01898874000,00000010200,a07,poll
0,01898874100,01898875200,00000001100,a2f,recvmsg
0,01898863800,01898876000,00000012200,a07,poll
0,01898878700,01898880200,00000001500,a07,poll
0,01898883100,01898883200,00000000100,a2f,recvmsg
0,01898883800,01898884000,00000000200,a2f,recvmsg
0,01898878700,01898904100,00000025400,a07,poll
0,01898904400,01898905900,00000001500,a2f,recvmsg
0,01898907800,01898909200,00000001400,a2d,recvfrom
0,01898913600,01898913700,00000000100,a2f,recvmsg
0,01898914300,01898914500,00000000200,a2f,recvmsg
0,01898878700,01898919500,00000040800,a07,poll
0,01898920000,01898921500,00000001500,a2f,recvmsg
0,01898923100,01898923900,00000000800,a2d,recvfrom
0,01898928100,01898928200,00000000100,a2f,recvmsg
0,01898928800,01898928900,00000000100,a2f,recvmsg
0,01898970000,01898970300,00000000300,a2f,recvmsg
0,01898972700,01898972900,00000000200,a2f,recvmsg
0,01899033700,01899034100,00000000400,a2f,recvmsg
0,01899036700,01899037000,00000000300,a2f,recvmsg
0,01899050000,01899083400,00000033400,a07,poll
0,01899084200,01899085900,00000001700,a2f,recvmsg
0,01899092700,01899093600,00000000900,a2d,recvfrom
0,01899094500,01899094700,00000000200,a2f,recvmsg
0,01899095400,01899095600,00000000200,a2f,recvmsg
0,01899128300,01899128400,00000000100,a2f,recvmsg
0,01899130800,01899131000,00000000200,a2f,recvmsg
0,01899134600,01899137200,00000002600,a07,poll
0,01899139800,01899139900,00000000100,a2f,recvmsg
0,01899140500,01899140700,00000000200,a2f,recvmsg
0,01899759200,01899818000,00000058800,a07,poll
0,01899820000,01899820800,00000000800,a00,read
0,01899837700,01899839600,00000001900,a2f,recvmsg
0,01899911100,01899912000,00000000900,a2f,recvmsg
0,01899914400,01899914500,00000000100,a00,read
0,01899925500,01899926800,00000001300,aca,futex
0,01899952400,01900055500,00000103100,a07,poll
0,01900059200,01900063300,00000004100,a2e,sendmsg
0,01900065500,01900065800,00000000300,a00,read
0,01900077800,01900078100,00000000300,aca,futex
0,01900092400,01900172700,00000080300,a07,poll
0,01900175100,01900176300,00000001200,a2e,sendmsg
0,01900194500,01900249500,00000055000,a07,poll
0,01900260700,01900261900,00000001200,a2f,recvmsg
0,01900413500,01900414400,00000000900,a2f,recvmsg
0,01900416500,01900416600,00000000100,a00,read
0,01886270400,01902190700,00015920300,a17,select
0,01902211900,01902212100,00000000200,a2f,recvmsg
0,01902215600,01902226800,00000011200,a17,select
0,01902232400,01902232500,00000000100,a2f,recvmsg
0,01902233200,01902305100,00000071900,a17,select
0,01902311400,01902311600,00000000200,a2f,recvmsg
0,01902675400,01902704000,00000028600,60e,page_fault
0,01871612900,01912914700,00041301800,a3d,wait4
0,01912937700,01912939800,00000002100,a00,read
0,01912941800,01912942200,00000000400,a00,read
0,01912964000,01913015800,00000051800,a07,poll
0,01913022100,01913022400,00000000300,a2f,recvmsg
0,01913023200,01913023400,00000000200,a2f,recvmsg
0,01913033300,01913048700,00000015400,a07,poll
0,01913051000,01913051200,00000000200,a2f,recvmsg
0,01913051500,01913051600,00000000100,a2f,recvmsg
0,01913056300,01913069800,00000013500,a07,poll
0,01913072000,01913072100,00000000100,a2f,recvmsg
0,01913072400,01913072600,00000000200,a2f,recvmsg
0,01913077400,01913090600,00000013200,a07,poll
0,01913092700,01913092800,00000000100,a2f,recvmsg
0,01913093200,01913093300,00000000100,a2f,recvmsg
0,01913098200,01913111400,00000013200,a07,poll
0,01913113500,01913113600,00000000100,a2f,recvmsg
0,01913114000,01913114200,00000000200,a2f,recvmsg
0,01913117500,01913130700,00000013200,a07,poll
0,01913132700,01913132900,00000000200,a2f,recvmsg
0,01913133200,01913133400,00000000200,a2f,recvmsg
0,01913134400,01913134700,00000000300,a08,lseek
0,01913147500,01913147500,00000000000,a08,lseek
0,01913150700,01913158000,00000007300,a07,poll
0,01913159300,01913159500,00000000200,a2f,recvmsg
0,01913159800,01913159900,00000000100,a2f,recvmsg
0,01913164600,01913171300,00000006700,a07,poll
0,01913172500,01913172700,00000000200,a2f,recvmsg
0,01913173000,01913173100,00000000100,a2f,recvmsg
0,01913176300,01913183100,00000006800,a07,poll
0,01913184400,01913184500,00000000100,a2f,recvmsg
0,01913184800,01913185000,00000000200,a2f,recvmsg
0,01913189100,01913195600,00000006500,a07,poll
0,01913196900,01913197100,00000000200,a2f,recvmsg
0,01913197400,01913197600,00000000200,a2f,recvmsg
0,01913201500,01913208400,00000006900,a07,poll
0,01913209500,01913209700,00000000200,a2f,recvmsg
0,01913210000,01913210200,00000000200,a2f,recvmsg
0,01913213700,01913220400,00000006700,a07,poll
0,01913221500,01913221600,00000000100,a2f,recvmsg
0,01913222000,01913222200,00000000200,a2f,recvmsg
0,01913225300,01913232200,00000006900,a07,poll
0,01913233400,01913233600,00000000200,a2f,recvmsg
0,01913233900,01913234000,00000000100,a2f,recvmsg
0,01913236800,01913243500,00000006700,a07,poll
0,01913244600,01913244800,00000000200,a2f,recvmsg
0,01913245100,01913245300,00000000200,a2f,recvmsg
0,01913249500,01913256500,00000007000,a07,poll
0,01913257600,01913257800,00000000200,a2f,recvmsg
0,01913258100,01913258300,00000000200,a2f,recvmsg
0,01913261600,01913268200,00000006600,a07,poll
0,01913269400,01913269600,00000000200,a2f,recvmsg
0,01913269900,01913270000,00000000100,a2f,recvmsg
0,01913273200,01913280000,00000006800,a07,poll
0,01913281200,01913281400,00000000200,a2f,recvmsg
0,01913281600,01913281800,00000000200,a2f,recvmsg
0,01913284900,01913291700,00000006800,a07,poll
0,01913292800,01913293000,00000000200,a2f,recvmsg
0,01913293300,01913293500,00000000200,a2f,recvmsg
0,01913296600,01913303300,00000006700,a07,poll
0,01913304300,01913304500,00000000200,a2f,recvmsg
0,01913304800,01913305000,00000000200,a2f,recvmsg
0,01913308200,01913314900,00000006700,a07,poll
0,01913316000,01913316200,00000000200,a2f,recvmsg
0,01913316500,01913316700,00000000200,a2f,recvmsg
0,01913319700,01913326700,00000007000,a07,poll
0,01913327800,01913328000,00000000200,a2f,recvmsg
0,01913328300,01913328500,00000000200,a2f,recvmsg
0,01913331100,01913337900,00000006800,a07,poll
0,01913339000,01913339100,00000000100,a2f,recvmsg
0,01913339500,01913339600,00000000100,a2f,recvmsg
0,01913344200,01913351100,00000006900,a07,poll
0,01913352300,01913352500,00000000200,a2f,recvmsg
0,01913352800,01913353000,00000000200,a2f,recvmsg
0,01913355500,01913362400,00000006900,a07,poll
0,01913363400,01913363600,00000000200,a2f,recvmsg
0,01913363900,01913364100,00000000200,a2f,recvmsg
0,01913366900,01913373600,00000006700,a07,poll
0,01913374700,01913374900,00000000200,a2f,recvmsg
0,01913375200,01913375400,00000000200,a2f,recvmsg
0,01913378000,01913384700,00000006700,a07,poll
0,01913385900,01913386000,00000000100,a2f,recvmsg
0,01913386300,01913386500,00000000200,a2f,recvmsg
0,01913389500,01913396300,00000006800,a07,poll
0,01913397400,01913397600,00000000200,a2f,recvmsg
0,01913397900,01913398100,00000000200,a2f,recvmsg
0,01913400900,01913407400,00000006500,a07,poll
0,01913408500,01913408700,00000000200,a2f,recvmsg
0,01913408900,01913409100,00000000200,a2f,recvmsg
0,01913412400,01913419200,00000006800,a07,poll
0,01913420300,01913420500,00000000200,a2f,recvmsg
0,01913420800,01913421000,00000000200,a2f,recvmsg
0,01913424300,01913431500,00000007200,a07,poll
0,01913432500,01913432700,00000000200,a2f,recvmsg
0,01913433000,01913433200,00000000200,a2f,recvmsg
0,01913436900,01913444000,00000007100,a07,poll
0,01913445000,01913445200,00000000200,a2f,recvmsg
0,01913445500,01913445700,00000000200,a2f,recvmsg
0,01913449200,01913455900,00000006700,a07,poll
0,01913457000,01913457200,00000000200,a2f,recvmsg
0,01913457500,01913457700,00000000200,a2f,recvmsg
0,01913461100,01913468000,00000006900,a07,poll
0,01913469200,01913469400,00000000200,a2f,recvmsg
0,01913469600,01913469800,00000000200,a2f,recvmsg
0,01913475100,01913481900,00000006800,a07,poll
0,01913483000,01913483100,00000000100,a2f,recvmsg
0,01913483500,01913483700,00000000200,a2f,recvmsg
0,01913486600,01913493400,00000006800,a07,poll
0,01913494600,01913494800,00000000200,a2f,recvmsg
0,01913495100,01913495300,00000000200,a2f,recvmsg
0,01913499200,01913506000,00000006800,a07,poll
0,01913507200,01913507400,00000000200,a2f,recvmsg
0,01913507600,01913507800,00000000200,a2f,recvmsg
0,01913511700,01913518600,00000006900,a07,poll
0,01913519700,01913519900,00000000200,a2f,recvmsg
0,01913520200,01913520400,00000000200,a2f,recvmsg
0,01913524600,01913531400,00000006800,a07,poll
0,01913532500,01913532700,00000000200,a2f,recvmsg
0,01913533000,01913533200,00000000200,a2f,recvmsg
0,01913536900,01913543800,00000006900,a07,poll
0,01913545100,01913545300,00000000200,a2f,recvmsg
0,01913545500,01913545700,00000000200,a2f,recvmsg
0,01913549100,01913555900,00000006800,a07,poll
0,01913557000,01913557200,00000000200,a2f,recvmsg
0,01913557500,01913557700,00000000200,a2f,recvmsg
0,01913560700,01913567500,00000006800,a07,poll
0,01913568500,01913568700,00000000200,a2f,recvmsg
0,01913569000,01913569200,00000000200,a2f,recvmsg
0,01913572000,01913578700,00000006700,a07,poll
0,01913579800,01913579900,00000000100,a2f,recvmsg
0,01913580300,01913580400,00000000100,a2f,recvmsg
0,01913583700,01913590500,00000006800,a07,poll
0,01913591600,01913591800,00000000200,a2f,recvmsg
0,01913592100,01913592200,00000000100,a2f,recvmsg
0,01913593200,01913593300,00000000100,a08,lseek
0,01913595900,01913597200,00000001300,a00,read
0,01913600900,01913601000,00000000100,a08,lseek
0,01913603900,01913610500,00000006600,a07,poll
0,01913611800,01913612000,00000000200,a2f,recvmsg
0,01913612200,01913612400,00000000200,a2f,recvmsg
0,01913637800,01913644700,00000006900,a07,poll
0,01913646200,01913646200,00000000000,a2f,recvmsg
0,01913646600,01913646800,00000000200,a2f,recvmsg
0,01913650900,01913651900,00000001000,a00,read
0,01913657600,01913657600,00000000000,a08,lseek
0,01913660800,01913667400,00000006600,a07,poll
0,01913668600,01913668800,00000000200,a2f,recvmsg
0,01913669000,01913669200,00000000200,a2f,recvmsg
0,01913672100,01913679000,00000006900,a07,poll
0,01913680200,01913680300,00000000100,a2f,recvmsg
0,01913680600,01913680700,00000000100,a2f,recvmsg
0,01913683400,01913689900,00000006500,a07,poll
0,01913691100,01913691300,00000000200,a2f,recvmsg
0,01913691600,01913691800,00000000200,a2f,recvmsg
0,01913694400,01913701200,00000006800,a07,poll
0,01913702300,01913702500,00000000200,a2f,recvmsg
0,01913702800,01913703000,00000000200,a2f,recvmsg
0,01913705600,01913712600,00000007000,a07,poll
0,01913713600,01913713700,00000000100,a2f,recvmsg
0,01913714100,01913714200,00000000100,a2f,recvmsg
0,01913717000,01913724000,00000007000,a07,poll
0,01913725100,01913725200,00000000100,a2f,recvmsg
0,01913725500,01913725700,00000000200,a2f,recvmsg
0,01913728200,01913735000,00000006800,a07,poll
0,01913736100,01913736300,00000000200,a2f,recvmsg
0,01913736600,01913736800,00000000200,a2f,recvmsg
0,01913740000,01913747000,00000007000,a07,poll
0,01913748100,01913748300,00000000200,a2f,recvmsg
0,01913748600,01913748800,00000000200,a2f,recvmsg
0,01913751600,01913758300,00000006700,a07,poll
0,01913759500,01913759600,00000000100,a2f,recvmsg
0,01913760000,01913760200,00000000200,a2f,recvmsg
0,01913760500,01913760600,00000000100,a08,lseek
0,01913764600,01913771600,00000007000,a07,poll
0,01913772700,01913772800,00000000100,a2f,recvmsg
0,01913773200,01913773400,00000000200,a2f,recvmsg
0,01913778200,01913785000,00000006800,a07,poll
0,01913786200,01913786300,00000000100,a2f,recvmsg
0,01913786700,01913786800,00000000100,a2f,recvmsg
0,01913790200,01913796900,00000006700,a07,poll
0,01913798100,01913798200,00000000100,a2f,recvmsg
0,01913798500,01913798700,00000000200,a2f,recvmsg
0,01913801800,01913808300,00000006500,a07,poll
0,01913809500,01913809600,00000000100,a2f,recvmsg
0,01913809800,01913810000,00000000200,a2f,recvmsg
0,01913813200,01913819700,00000006500,a07,poll
0,01913820900,01913821000,00000000100,a2f,recvmsg
0,01913821300,01913821500,00000000200,a2f,recvmsg
0,01913824400,01913831100,00000006700,a07,poll
0,01913832300,01913832400,00000000100,a2f,recvmsg
0,01913832600,01913832800,00000000200,a2f,recvmsg
0,01913836200,01913843000,00000006800,a07,poll
0,01913844100,01913844300,00000000200,a2f,recvmsg
0,01913844600,01913844800,00000000200,a2f,recvmsg
0,01913847600,01913854300,00000006700,a07,poll
0,01913855400,01913855500,00000000100,a2f,recvmsg
0,01913855900,01913856000,00000000100,a2f,recvmsg
0,01913859000,01913865900,00000006900,a07,poll
0,01913866900,01913867100,00000000200,a2f,recvmsg
0,01913867400,01913867600,00000000200,a2f,recvmsg
0,01913870500,01913877200,00000006700,a07,poll
0,01913878200,01913878400,00000000200,a2f,recvmsg
0,01913878700,01913878900,00000000200,a2f,recvmsg
0,01913881900,01913888800,00000006900,a07,poll
0,01913889900,01913890100,00000000200,a2f,recvmsg
0,01913890400,01913890600,00000000200,a2f,recvmsg
0,01913893600,01913900300,00000006700,a07,poll
0,01913901400,01913901600,00000000200,a2f,recvmsg
0,01913901900,01913902100,00000000200,a2f,recvmsg
0,01913905800,01913912700,00000006900,a07,poll
0,01913913900,01913914000,00000000100,a2f,recvmsg
0,01913914300,01913914500,00000000200,a2f,recvmsg
0,01913917400,01913924000,00000006600,a07,poll
0,01913925200,01913925400,00000000200,a2f,recvmsg
0,01913925600,01913925800,00000000200,a2f,recvmsg
0,01913929100,01913935400,00000006300,a07,poll
0,01913936700,01913936900,00000000200,a2f,recvmsg
0,01913937100,01913937300,00000000200,a2f,recvmsg
0,01913940200,01913946900,00000006700,a07,poll
0,01913948000,01913948200,00000000200,a2f,recvmsg
0,01913948400,01913948600,00000000200,a2f,recvmsg
0,01913956900,01913963600,00000006700,a07,poll
0,01913964800,01913965000,00000000200,a2f,recvmsg
0,01913965300,01913965400,00000000100,a2f,recvmsg
0,01913968700,01913975300,00000006600,a07,poll
0,01913976400,01913976600,00000000200,a2f,recvmsg
0,01913976800,01913977000,00000000200,a2f,recvmsg
0,01913980100,01913986800,00000006700,a07,poll
0,01913988000,01913988200,00000000200,a2f,recvmsg
0,01913988400,01913988600,00000000200,a2f,recvmsg
0,01913991800,01913998300,00000006500,a07,poll
0,01913999400,01913999600,00000000200,a2f,recvmsg
0,01913999800,01914000000,00000000200,a2f,recvmsg
0,01914003300,01914010100,00000006800,a07,poll
0,01914011200,01914011400,00000000200,a2f,recvmsg
0,01914011700,01914011900,00000000200,a2f,recvmsg
0,01914032000,01914059400,00000027400,a57,unlink
0,01914060700,01914064800,00000004100,a14,writev
0,01914065400,01914161800,00000096400,a07,poll
0,01914065400,01914169200,00000103800,a07,poll
0,01914181200,01914181400,00000000200,a2f,recvmsg
0,01914231700,01914231900,00000000200,a2f,recvmsg
0,01914219400,01914245700,00000026300,a07,poll
0,01914262300,01914266800,00000004500,a07,poll
0,01914277800,01914278000,00000000200,a2f,recvmsg
0,01914295800,01914301700,00000005900,a07,poll
0,01914295800,01914304400,00000008600,a07,poll
0,01914307800,01914309100,00000001300,a07,poll
0,01914310500,01914358900,00000048400,a07,poll
0,01914360200,01914362400,00000002200,a07,poll
0,01914363800,01914365100,00000001300,a07,poll
0,01914366300,01914416400,00000050100,a07,poll
0,01914416700,01914419100,00000002400,a2f,recvmsg
0,01914366300,01914420100,00000053800,a07,poll
0,01914422900,01914424000,00000001100,a07,poll
0,01914425300,01914472700,00000047400,a07,poll
0,01914425300,01914475200,00000049900,a07,poll
0,01914478000,01914479100,00000001100,a07,poll
0,01914480700,01914529600,00000048900,a07,poll
0,01914529800,01914530800,00000001000,a2f,recvmsg
0,01914480700,01914531800,00000051100,a07,poll
0,01914534400,01914535400,00000001000,a07,poll
0,01914536800,01914575300,00000038500,a07,poll
0,01914575500,01914576600,00000001100,a2f,recvmsg
0,01914536800,01914577500,00000040700,a07,poll
0,01914580300,01914581300,00000001000,a07,poll
0,01914582700,01914620200,00000037500,a07,poll
0,01914582700,01914621900,00000039200,a07,poll
0,01914622200,01914624600,00000002400,a2f,recvmsg
0,01914625000,01914626200,00000001200,a07,poll
0,01914627500,01914665100,00000037600,a07,poll
0,01914665300,01914666300,00000001000,a2f,recvmsg
0,01914627500,01914667200,00000039700,a07,poll
0,01914669900,01914671000,00000001100,a07,poll
0,01914672300,01914729400,00000057100,a07,poll
0,01914672300,01914731000,00000058700,a07,poll
0,01914735000,01914736100,00000001100,a07,poll
0,01914737900,01914774800,00000036900,a07,poll
0,01914737900,01914776500,00000038600,a07,poll
0,01914776700,01914781300,00000004600,a2f,recvmsg
0,01914782000,01914783100,00000001100,a07,poll
0,01914784400,01914830100,00000045700,a07,poll
0,01914830300,01914831600,00000001300,a2f,recvmsg
0,01914784400,01914832500,00000048100,a07,poll
0,01914835200,01914836300,00000001100,a07,poll
0,01914837700,01914849900,00000012200,a07,poll
0,01914850100,01914851100,00000001000,a2f,recvmsg
0,01914837700,01914852100,00000014400,a07,poll
0,01914854900,01914856100,00000001200,a07,poll
0,01914857500,01914867900,00000010400,a07,poll
0,01914868200,01914869300,00000001100,a2f,recvmsg
0,01914857500,01914870100,00000012600,a07,poll
0,01914872900,01914873900,00000001000,a07,poll
0,01914875400,01914884400,00000009000,a07,poll
0,01914884600,01914885500,00000000900,a2f,recvmsg
0,01914875400,01914886400,00000011000,a07,poll
0,01914889500,01914890600,00000001100,a07,poll
0,01914891900,01914900300,00000008400,a07,poll
0,01914891900,01914902100,00000010200,a07,poll
0,01914902300,01914904800,00000002500,a2f,recvmsg
0,01914905400,01914906900,00000001500,a07,poll
0,01914908200,01914915600,00000007400,a07,poll
0,01914915900,01914917000,00000001100,a2f,recvmsg
0,01914908200,01914917800,00000009600,a07,poll
0,01914920700,01914921900,00000001200,a07,poll
0,01914923200,01914924400,00000001200,a07,poll
0,01914927000,01914927200,00000000200,a2f,recvmsg
0,01914927800,01914928000,00000000200,a2f,recvmsg
0,01914928700,01914944200,00000015500,a57,unlink
0,01914923200,01914945900,00000022700,a07,poll
0,01914946300,01914947700,00000001400,a2f,recvmsg
0,01914949300,01914950400,00000001100,a2d,recvfrom
0,01914954500,01914954700,00000000200,a2f,recvmsg
0,01914955500,01914955700,00000000200,a2f,recvmsg
0,01914923200,01914973600,00000050400,a07,poll
0,01914974100,01914975500,00000001400,a2f,recvmsg
0,01914977700,01914978700,00000001000,a2d,recvfrom
0,01914983000,01914983200,00000000200,a2f,recvmsg
0,01914983800,01914983900,00000000100,a2f,recvmsg
0,01915027800,01915028100,00000000300,a2f,recvmsg
0,01915030600,01915030700,00000000100,a2f,recvmsg
0,01915078200,01915078600,00000000400,a2f,recvmsg
0,01915081100,01915081300,00000000200,a2f,recvmsg
0,01915084200,01915087700,00000003500,a07,poll
0,01915088300,01915089800,00000001500,a2f,recvmsg
0,01915091700,01915092600,00000000900,a2d,recvfrom
0,01915097800,01915097900,00000000100,a2f,recvmsg
0,01915098600,01915098800,00000000200,a2f,recvmsg
0,01915127900,01915128200,00000000300,a2f,recvmsg
0,01915130900,01915131100,00000000200,a2f,recvmsg
0,01915146000,01915163800,00000017800,a07,poll
0,01915168500,01915168700,00000000200,a2f,recvmsg
0,01915170300,01915170500,00000000200,a2f,recvmsg
0,01915170800,01915170900,00000000100,a2f,recvmsg
0,01915172700,01915172900,00000000200,a2f,recvmsg
0,01915173100,01915173300,00000000200,a2f,recvmsg
0,01915173700,01915175400,00000001700,a07,poll
0,01915177500,01915177600,00000000100,a2f,recvmsg
0,01915178200,01915178400,00000000200,a2f,recvmsg
0,01915931800,01915941200,00000009400,a02,open
0,01915952900,01915956400,00000003500,a00,read
0,01916009700,01916010500,00000000800,a00,read
0,01916060000,01916060800,00000000800,a00,read
0,01916107800,01916108600,00000000800,a00,read
0,01916158000,01916158600,00000000600,a00,read
0,01916206200,01916206900,00000000700,a00,read
0,01916253300,01916254100,00000000800,a00,read
0,01916301800,01916302500,00000000700,a00,read
0,01916352300,01916353100,00000000800,a00,read
0,01916403000,01916403800,00000000800,a00,read
0,01916452100,01916452700,00000000600,a00,read
0,01916482500,01916484900,00000002400,a02,open
0,01916489400,01916490500,00000001100,a00,read
0,01916547000,01916547700,00000000700,a00,read
0,01916632400,01916633200,00000000800,a00,read
0,01916710200,01916711100,00000000900,a00,read
0,01916788900,01916789600,00000000700,a00,read
0,01916867800,01916868600,00000000800,a00,read
0,01916946200,01916946900,00000000700,a00,read
0,01917032800,01917033600,00000000800,a00,read
0,01917100200,01917100800,00000000600,a00,read
0,01917159100,01917159800,00000000700,a00,read
0,01917239100,01917271300,00000032200,a07,poll
0,01917274600,01917274800,00000000200,a2f,recvmsg
0,01917275300,01917275500,00000000200,a2f,recvmsg
0,01917277800,01917284100,00000006300,a07,poll
0,01917285400,01917285600,00000000200,a2f,recvmsg
0,01917285900,01917286100,00000000200,a2f,recvmsg
0,01917291800,01917298900,00000007100,a06,lstat
0,01917299700,01917300700,00000001000,a06,lstat
0,01917323800,01917339900,00000016100,a01,write
0,01917345800,01917353200,00000007400,a07,poll
0,01917355200,01917355400,00000000200,a2f,recvmsg
0,01917355900,01917356100,00000000200,a2f,recvmsg
0,01917357300,01917674200,00000316900,a38,clone
0,01918160200,01918160400,00000000200,a0c,brk
0,01918170700,01918173700,00000003000,a15,access
0,01918180200,01918181100,00000000900,a15,access
0,01918187200,01918188100,00000000900,a09,mmap
0,01918191700,01918192300,00000000600,a15,access
0,01918199500,01918200700,00000001200,a00,read
0,01918202400,01918203900,00000001500,a09,mmap
0,01918207800,01918210000,00000002200,a09,mmap
0,01918222000,01918222800,00000000800,a15,access
0,01918226000,01918226700,00000000700,a00,read
0,01918227500,01918228400,00000000900,a09,mmap
0,01918230900,01918232200,00000001300,a09,mmap
0,01918240300,01918240800,00000000500,a15,access
0,01918244000,01918244500,00000000500,a00,read
0,01918245200,01918246100,00000000900,a09,mmap
0,01918247700,01918249700,00000002000,a09,mmap
0,01918253700,01918256600,00000002900,a09,mmap
0,01918258600,01918259600,00000001000,a09,mmap
0,01918268600,01918269100,00000000500,a15,access
0,01918271600,01918272200,00000000600,a00,read
0,01918274000,01918275600,00000001600,a09,mmap
0,01918278400,01918280200,00000001800,a09,mmap
0,01918288400,01918289000,00000000600,a15,access
0,01918291900,01918292500,00000000600,a00,read
0,01918293200,01918294600,00000001400,a09,mmap
0,01918308700,01918309100,00000000400,a15,access
0,01918311900,01918312500,00000000600,a00,read
0,01918312900,01918314100,00000001200,a09,mmap
0,01918315600,01918316900,00000001300,a09,mmap
0,01918319800,01918321100,00000001300,a09,mmap
0,01918327800,01918328300,00000000500,a15,access
0,01918330700,01918331200,00000000500,a00,read
0,01918331800,01918333200,00000001400,a09,mmap
0,01918335400,01918337100,00000001700,a09,mmap
0,01918351200,01918351800,00000000600,a09,mmap
0,01918355900,01918356200,00000000300,a09,mmap
0,01918357300,01918357600,00000000300,a09,mmap
0,01918534100,01918534200,00000000100,a0c,brk
0,01918534300,01918535100,00000000800,a0c,brk
0,01918569500,01918570500,00000001000,a00,read
0,01918581900,01918583400,00000001500,a00,read
0,01918617500,01918618400,00000000900,a00,read
0,01918770900,01918771900,00000001000,a00,read
0,01918844100,01918844600,00000000500,a00,read
0,01918930900,01918931600,00000000700,a00,read
0,01919061500,01919062400,00000000900,a00,read
0,01919191500,01919192300,00000000800,a00,read
0,01919348000,01919348700,00000000700,a00,read
0,01919498800,01919499400,00000000600,a00,read
0,01919652800,01919653600,00000000800,a00,read
0,01919801900,01919802400,00000000500,a00,read
0,01919960500,01919961300,00000000800,a00,read
0,01920121000,01920121600,00000000600,a00,read
0,01920230200,01920230900,00000000700,a00,read
0,01920261300,01920261900,00000000600,a0c,brk
0,01920369700,01920370500,00000000800,a00,read
0,01920615200,01920615700,00000000500,a00,read
0,01920627600,01920628000,00000000400,a00,read
0,01920671600,01920672000,00000000400,a00,read
0,01920691600,01920692400,00000000800,a00,read
0,01920898000,01920898500,00000000500,a00,read
0,01920927700,01920928600,00000000900,a00,read
0,01921025600,01921026200,00000000600,a00,read
0,01921050100,01921051300,00000001200,a0c,brk
0,01921096100,01921096400,00000000300,a00,read
0,01921174500,01921175300,00000000800,a00,read
0,01921328300,01921328800,00000000500,a00,read
0,01921440000,01921440600,00000000600,a00,read
0,01921534100,01921534600,00000000500,a00,read
0,01921546800,01921547300,00000000500,a00,read
0,01921627500,01921627900,00000000400,a00,read
0,01921652400,01921652800,00000000400,a00,read
0,01921675000,01921675600,00000000600,a00,read
0,01921778200,01921779300,00000001100,a0c,brk
0,01921780400,01921781500,00000001100,a00,read
0,01921984600,01921985000,00000000400,a00,read
0,01922067300,01922067900,00000000600,a00,read
0,01922130900,01922131500,00000000600,a00,read
0,01922259400,01922259800,00000000400,a00,read
0,01922292200,01922292800,00000000600,a00,read
0,01922309100,01922311000,00000001900,a02,open
0,01922422300,01922422700,00000000400,a00,read
0,01922493300,01922493700,00000000400,a00,read
0,01922546300,01922547400,00000001100,a0c,brk
0,01922553500,01922554200,00000000700,a00,read
0,01922662600,01922663300,00000000700,a00,read
0,01922823200,01922824100,00000000900,a00,read
0,01922953800,01922954500,00000000700,a00,read
0,01923011800,01923012600,00000000800,a00,read
0,01923067900,01923068600,00000000700,a00,read
0,01923138000,01923138600,00000000600,a00,read
0,01923191400,01923192100,00000000700,a00,read
0,01923279600,01923280600,00000001000,a0c,brk
1,01863789700,01862158600,-0001631100,a3d,wait4
1,01862180600,01862182500,00000001900,a00,read
1,01862184500,01862184900,00000000400,a00,read
1,01862206500,01862259200,00000052700,a07,poll
1,01862265400,01862265600,00000000200,a2f,recvmsg
1,01862266400,01862266600,00000000200,a2f,recvmsg
1,01862276000,01862291500,00000015500,a07,poll
1,01862293700,01862293900,00000000200,a2f,recvmsg
1,01862294300,01862294400,00000000100,a2f,recvmsg
1,01862299200,01862312800,00000013600,a07,poll
1,01862314900,01862315100,00000000200,a2f,recvmsg
1,01862315400,01862315500,00000000100,a2f,recvmsg
1,01862320600,01862334000,00000013400,a07,poll
1,01862336100,01862336100,00000000000,a2f,recvmsg
1,01862336500,01862336700,00000000200,a2f,recvmsg
1,01862341700,01862355000,00000013300,a07,poll
1,01862357000,01862357200,00000000200,a2f,recvmsg
1,01862357500,01862357700,00000000200,a2f,recvmsg
1,01862361900,01862375300,00000013400,a07,poll
1,01862378700,01862378900,00000000200,a2f,recvmsg
1,01862379300,01862379500,00000000200,a2f,recvmsg
1,01862380300,01862380700,00000000400,a08,lseek
1,01862391700,01862391800,00000000100,a08,lseek
1,01862395100,01862402100,00000007000,a07,poll
1,01862403400,01862403600,00000000200,a2f,recvmsg
1,01862404000,01862404200,00000000200,a2f,recvmsg
1,01862408800,01862415600,00000006800,a07,poll
1,01862416900,01862417100,00000000200,a2f,recvmsg
1,01862417400,01862417600,00000000200,a2f,recvmsg
1,01862420700,01862427500,00000006800,a07,poll
1,01862428800,01862429000,00000000200,a2f,recvmsg
1,01862429200,01862429400,00000000200,a2f,recvmsg
1,01862432900,01862439400,00000006500,a07,poll
1,01862440600,01862440800,00000000200,a2f,recvmsg
1,01862441100,01862441300,00000000200,a2f,recvmsg
1,01862445300,01862452400,00000007100,a07,poll
1,01862453800,01862453900,00000000100,a2f,recvmsg
1,01862454200,01862454400,00000000200,a2f,recvmsg
1,01862457700,01862464500,00000006800,a07,poll
1,01862465800,01862465900,00000000100,a2f,recvmsg
1,01862466200,01862466400,00000000200,a2f,recvmsg
1,01862469700,01862476700,00000007000,a07,poll
1,01862477900,01862478100,00000000200,a2f,recvmsg
1,01862478400,01862478600,00000000200,a2f,recvmsg
1,01862481300,01862488100,00000006800,a07,poll
1,01862489200,01862489400,00000000200,a2f,recvmsg
1,01862489700,01862489900,00000000200,a2f,recvmsg
1,01862494900,01862501200,00000006300,a07,poll
1,01862502400,01862502600,00000000200,a2f,recvmsg
1,01862502900,01862503100,00000000200,a2f,recvmsg
1,01862506400,01862513200,00000006800,a07,poll
1,01862514500,01862514700,00000000200,a2f,recvmsg
1,01862514900,01862515100,00000000200,a2f,recvmsg
1,01862518200,01862524900,00000006700,a07,poll
1,01862526100,01862526300,00000000200,a2f,recvmsg
1,01862526600,01862526800,00000000200,a2f,recvmsg
1,01862529900,01862536800,00000006900,a07,poll
1,01862537900,01862538100,00000000200,a2f,recvmsg
1,01862538400,01862538600,00000000200,a2f,recvmsg
1,01862541600,01862548400,00000006800,a07,poll
1,01862549700,01862549800,00000000100,a2f,recvmsg
1,01862550100,01862550300,00000000200,a2f,recvmsg
1,01862553700,01862560300,00000006600,a07,poll
1,01862561600,01862561800,00000000200,a2f,recvmsg
1,01862562100,01862562200,00000000100,a2f,recvmsg
1,01862566000,01862572800,00000006800,a07,poll
1,01862574000,01862574200,00000000200,a2f,recvmsg
1,01862574500,01862574700,00000000200,a2f,recvmsg
1,01862577400,01862584300,00000006900,a07,poll
1,01862585400,01862585600,00000000200,a2f,recvmsg
1,01862585900,01862586100,00000000200,a2f,recvmsg
1,01862591000,01862597600,00000006600,a07,poll
1,01862598800,01862599000,00000000200,a2f,recvmsg
1,01862599300,01862599500,00000000200,a2f,recvmsg
1,01862602200,01862609400,00000007200,a07,poll
1,01862610500,01862610700,00000000200,a2f,recvmsg
1,01862611000,01862611200,00000000200,a2f,recvmsg
1,01862613900,01862620600,00000006700,a07,poll
1,01862621800,01862622000,00000000200,a2f,recvmsg
1,01862622300,01862622500,00000000200,a2f,recvmsg
1,01862625800,01862632600,00000006800,a07,poll
1,01862633900,01862634100,00000000200,a2f,recvmsg
1,01862634400,01862634500,00000000100,a2f,recvmsg
1,01862637400,01862644200,00000006800,a07,poll
1,01862645600,01862645800,00000000200,a2f,recvmsg
1,01862646000,01862646100,00000000100,a2f,recvmsg
1,01862649000,01862655700,00000006700,a07,poll
1,01862657000,01862657200,00000000200,a2f,recvmsg
1,01862657400,01862657600,00000000200,a2f,recvmsg
1,01862660800,01862667500,00000006700,a07,poll
1,01862668600,01862668800,00000000200,a2f,recvmsg
1,01862669100,01862669300,00000000200,a2f,recvmsg
1,01862672500,01862679400,00000006900,a07,poll
1,01862680500,01862680700,00000000200,a2f,recvmsg
1,01862681000,01862681200,00000000200,a2f,recvmsg
1,01862685800,01862693000,00000007200,a07,poll
1,01862694100,01862694300,00000000200,a2f,recvmsg
1,01862694600,01862694800,00000000200,a2f,recvmsg
1,01862698200,01862704800,00000006600,a07,poll
1,01862706000,01862706200,00000000200,a2f,recvmsg
1,01862706500,01862706600,00000000100,a2f,recvmsg
1,01862710200,01862717100,00000006900,a07,poll
1,01862718300,01862718400,00000000100,a2f,recvmsg
1,01862718700,01862718900,00000000200,a2f,recvmsg
1,01862724200,01862731200,00000007000,a07,poll
1,01862732400,01862732600,00000000200,a2f,recvmsg
1,01862732900,01862733000,00000000100,a2f,recvmsg
1,01862736000,01862742700,00000006700,a07,poll
1,01862744000,01862744200,00000000200,a2f,recvmsg
1,01862744500,01862744600,00000000100,a2f,recvmsg
1,01862747700,01862754600,00000006900,a07,poll
1,01862755900,01862756000,00000000100,a2f,recvmsg
1,01862756200,01862756400,00000000200,a2f,recvmsg
1,01862760500,01862767400,00000006900,a07,poll
1,01862768600,01862768800,00000000200,a2f,recvmsg
1,01862769100,01862769300,00000000200,a2f,recvmsg
1,01862772700,01862779500,00000006800,a07,poll
1,01862780700,01862780900,00000000200,a2f,recvmsg
1,01862781200,01862781400,00000000200,a2f,recvmsg
1,01862785000,01862792100,00000007100,a07,poll
1,01862793300,01862793500,00000000200,a2f,recvmsg
1,01862793800,01862794000,00000000200,a2f,recvmsg
1,01862797300,01862804200,00000006900,a07,poll
1,01862805400,01862805600,00000000200,a2f,recvmsg
1,01862805900,01862806100,00000000200,a2f,recvmsg
1,01862809100,01862816100,00000007000,a07,poll
1,01862817200,01862817400,00000000200,a2f,recvmsg
1,01862817700,01862817900,00000000200,a2f,recvmsg
1,01862820700,01862827500,00000006800,a07,poll
1,01862828700,01862828800,00000000100,a2f,recvmsg
1,01862829100,01862829300,00000000200,a2f,recvmsg
1,01862832900,01862839700,00000006800,a07,poll
1,01862841000,01862841200,00000000200,a2f,recvmsg
1,01862841500,01862841600,00000000100,a2f,recvmsg
1,01862842600,01862842700,00000000100,a08,lseek
1,01862845300,01862846800,00000001500,a00,read
1,01862850500,01862850600,00000000100,a08,lseek
1,01862853400,01862859900,00000006500,a07,poll
1,01862861200,01862861400,00000000200,a2f,recvmsg
1,01862861700,01862861900,00000000200,a2f,recvmsg
1,01862886700,01862893600,00000006900,a07,poll
1,01862894900,01862895100,00000000200,a2f,recvmsg
1,01862895400,01862895600,00000000200,a2f,recvmsg
1,01862899300,01862900200,00000000900,a00,read
1,01862905800,01862905900,00000000100,a08,lseek
1,01862909200,01862915900,00000006700,a07,poll
1,01862917200,01862917400,00000000200,a2f,recvmsg
1,01862917600,01862917800,00000000200,a2f,recvmsg
1,01862920600,01862927200,00000006600,a07,poll
1,01862928500,01862928600,00000000100,a2f,recvmsg
1,01862928900,01862929000,00000000100,a2f,recvmsg
1,01862931800,01862938500,00000006700,a07,poll
1,01862939800,01862940000,00000000200,a2f,recvmsg
1,01862940200,01862940300,00000000100,a2f,recvmsg
1,01862943100,01862949800,00000006700,a07,poll
1,01862951000,01862951200,00000000200,a2f,recvmsg
1,01862951500,01862951700,00000000200,a2f,recvmsg
1,01862954300,01862961100,00000006800,a07,poll
1,01862962200,01862962400,00000000200,a2f,recvmsg
1,01862962700,01862962900,00000000200,a2f,recvmsg
1,01862965500,01862972600,00000007100,a07,poll
1,01862973800,01862974000,00000000200,a2f,recvmsg
1,01862974300,01862974500,00000000200,a2f,recvmsg
1,01862977100,01862983900,00000006800,a07,poll
1,01862985000,01862985200,00000000200,a2f,recvmsg
1,01862985500,01862985700,00000000200,a2f,recvmsg
1,01862989100,01862995900,00000006800,a07,poll
1,01862997100,01862997300,00000000200,a2f,recvmsg
1,01862997500,01862997700,00000000200,a2f,recvmsg
1,01863000600,01863007400,00000006800,a07,poll
1,01863008600,01863008700,00000000100,a2f,recvmsg
1,01863009000,01863009200,00000000200,a2f,recvmsg
1,01863009600,01863009700,00000000100,a08,lseek
1,01863013600,01863020400,00000006800,a07,poll
1,01863021700,01863021900,00000000200,a2f,recvmsg
1,01863022100,01863022300,00000000200,a2f,recvmsg
1,01863027300,01863034100,00000006800,a07,poll
1,01863035400,01863035600,00000000200,a2f,recvmsg
1,01863035900,01863036100,00000000200,a2f,recvmsg
1,01863039500,01863046200,00000006700,a07,poll
1,01863047400,01863047600,00000000200,a2f,recvmsg
1,01863047900,01863048100,00000000200,a2f,recvmsg
1,01863051100,01863057900,00000006800,a07,poll
1,01863059000,01863059200,00000000200,a2f,recvmsg
1,01863059500,01863059700,00000000200,a2f,recvmsg
1,01863062700,01863069400,00000006700,a07,poll
1,01863070700,01863070900,00000000200,a2f,recvmsg
1,01863071200,01863071400,00000000200,a2f,recvmsg
1,01863074300,01863081100,00000006800,a07,poll
1,01863082500,01863082600,00000000100,a2f,recvmsg
1,01863082800,01863083000,00000000200,a2f,recvmsg
1,01863087500,01863094300,00000006800,a07,poll
1,01863095600,01863095700,00000000100,a2f,recvmsg
1,01863096000,01863096100,00000000100,a2f,recvmsg
1,01863099100,01863105800,00000006700,a07,poll
1,01863107100,01863107300,00000000200,a2f,recvmsg
1,01863107500,01863107700,00000000200,a2f,recvmsg
1,01863110800,01863117500,00000006700,a07,poll
1,01863118700,01863118900,00000000200,a2f,recvmsg
1,01863119100,01863119300,00000000200,a2f,recvmsg
1,01863122300,01863129100,00000006800,a07,poll
1,01863130300,01863130400,00000000100,a2f,recvmsg
1,01863130700,01863130900,00000000200,a2f,recvmsg
1,01863122300,01888811500,00025689200,a07,poll
1,01888812500,01888813200,00000000700,a2f,recvmsg
1,01888878200,01888881000,00000002800,a07,poll
1,01889193700,01889194800,00000001100,a2f,recvmsg
1,01878943900,01889821000,00010877100,a17,select
1,01889841800,01889842100,00000000300,a2f,recvmsg
1,01889854700,01889854900,00000000200,a2f,recvmsg
1,01889855600,01889919800,00000064200,a17,select
1,01889923700,01889923900,00000000200,a2f,recvmsg
1,01883487100,01896937500,00013450400,a4a,fsync
1,01897000500,01897005500,00000005000,a09,mmap
1,01897077600,01897081800,00000004200,a01,write
1,01897130200,01897131600,00000001400,aca,futex
1,01897280600,01897289700,00000009100,a01,write
1,01884020800,01897321500,00013300700,ae8,epoll_wait
1,01897348600,01897352800,00000004200,a2f,recvmsg
1,01897373100,01897373300,00000000200,a2f,recvmsg
1,01897417500,01897418400,00000000900,a2e,sendmsg
1,01897141400,01897429700,00000288300,a07,poll
1,01897633900,01897634900,00000001000,a2f,recvmsg
1,01897637300,01897637500,00000000200,a00,read
1,01897691200,01897695200,00000004000,a07,poll
1,01897749200,01897749400,00000000200,a00,read
1,01897785300,01897788300,00000003000,a07,poll
1,01897792300,01897795500,00000003200,a2e,sendmsg
1,01897420500,01897797400,00000376900,ae8,epoll_wait
1,01897802100,01897803200,00000001100,a2f,recvmsg
1,01897812000,01897812300,00000000300,a2f,recvmsg
1,01897824300,01897826900,00000002600,a2e,sendmsg
1,01897837400,01897837800,00000000400,a00,read
1,01863789700,01900705000,00036915300,a3d,wait4
1,01900728700,01900730400,00000001700,a00,read
1,01900732600,01900733000,00000000400,a00,read
1,01900748700,01900795300,00000046600,a07,poll
1,01900799900,01900800200,00000000300,a2f,recvmsg
1,01900801100,01900801300,00000000200,a2f,recvmsg
1,01900807200,01900819000,00000011800,a07,poll
1,01900821300,01900821500,00000000200,a2f,recvmsg
1,01900821900,01900822100,00000000200,a2f,recvmsg
1,01900825600,01900837400,00000011800,a07,poll
1,01900839400,01900839600,00000000200,a2f,recvmsg
1,01900839900,01900840100,00000000200,a2f,recvmsg
1,01900845200,01900856800,00000011600,a07,poll
1,01900858800,01900859000,00000000200,a2f,recvmsg
1,01900859300,01900859500,00000000200,a2f,recvmsg
1,01900863500,01900875400,00000011900,a07,poll
1,01900877400,01900877500,00000000100,a2f,recvmsg
1,01900877800,01900878000,00000000200,a2f,recvmsg
1,01900882500,01900889300,00000006800,a07,poll
1,01900890600,01900890800,00000000200,a2f,recvmsg
1,01900891000,01900891200,00000000200,a2f,recvmsg
1,01900891900,01900892200,00000000300,a08,lseek
1,01900901700,01900901800,00000000100,a08,lseek
1,01900904600,01900911700,00000007100,a07,poll
1,01900912900,01900913100,00000000200,a2f,recvmsg
1,01900913400,01900913600,00000000200,a2f,recvmsg
1,01900918800,01900925600,00000006800,a07,poll
1,01900927000,01900927000,00000000000,a2f,recvmsg
1,01900927300,01900927500,00000000200,a2f,recvmsg
1,01900930700,01900937200,00000006500,a07,poll
1,01900938400,01900938600,00000000200,a2f,recvmsg
1,01900938900,01900939100,00000000200,a2f,recvmsg
1,01900942600,01900949200,00000006600,a07,poll
1,01900950400,01900950600,00000000200,a2f,recvmsg
1,01900950900,01900951100,00000000200,a2f,recvmsg
1,01900954400,01900961300,00000006900,a07,poll
1,01900962600,01900962700,00000000100,a2f,recvmsg
1,01900963100,01900963100,00000000000,a2f,recvmsg
1,01900967500,01900974200,00000006700,a07,poll
1,01900975300,01900975500,00000000200,a2f,recvmsg
1,01900975800,01900976000,00000000200,a2f,recvmsg
1,01900979400,01900986100,00000006700,a07,poll
1,01900987200,01900987400,00000000200,a2f,recvmsg
1,01900987700,01900987800,00000000100,a2f,recvmsg
1,01900990800,01900997400,00000006600,a07,poll
1,01900998600,01900998800,00000000200,a2f,recvmsg
1,01900999100,01900999200,00000000100,a2f,recvmsg
1,01901003400,01901010400,00000007000,a07,poll
1,01901011400,01901011600,00000000200,a2f,recvmsg
1,01901011900,01901012100,00000000200,a2f,recvmsg
1,01901015400,01901022200,00000006800,a07,poll
1,01901023400,01901023600,00000000200,a2f,recvmsg
1,01901023900,01901023900,00000000000,a2f,recvmsg
1,01901027300,01901033800,00000006500,a07,poll
1,01901035000,01901035200,00000000200,a2f,recvmsg
1,01901035400,01901035600,00000000200,a2f,recvmsg
1,01901039600,01901046400,00000006800,a07,poll
1,01901047500,01901047600,00000000100,a2f,recvmsg
1,01901047900,01901048100,00000000200,a2f,recvmsg
1,01901051200,01901057900,00000006700,a07,poll
1,01901058900,01901059100,00000000200,a2f,recvmsg
1,01901059400,01901059600,00000000200,a2f,recvmsg
1,01901062800,01901069600,00000006800,a07,poll
1,01901070800,01901070900,00000000100,a2f,recvmsg
1,01901071300,01901071400,00000000100,a2f,recvmsg
1,01901074600,01901081300,00000006700,a07,poll
1,01901082500,01901082700,00000000200,a2f,recvmsg
1,01901082900,01901083000,00000000100,a2f,recvmsg
1,01901085900,01901092700,00000006800,a07,poll
1,01901093800,01901094000,00000000200,a2f,recvmsg
1,01901094200,01901094400,00000000200,a2f,recvmsg
1,01901099400,01901105900,00000006500,a07,poll
1,01901107100,01901107300,00000000200,a2f,recvmsg
1,01901107500,01901107700,00000000200,a2f,recvmsg
1,01901110500,01901117300,00000006800,a07,poll
1,01901118400,01901118600,00000000200,a2f,recvmsg
1,01901118900,01901119000,00000000100,a2f,recvmsg
1,01901121800,01901128400,00000006600,a07,poll
1,01901129600,01901129800,00000000200,a2f,recvmsg
1,01901130100,01901130200,00000000100,a2f,recvmsg
1,01901132900,01901139800,00000006900,a07,poll
1,01901141000,01901141200,00000000200,a2f,recvmsg
1,01901141500,01901141700,00000000200,a2f,recvmsg
1,01901144800,01901151400,00000006600,a07,poll
1,01901152500,01901152700,00000000200,a2f,recvmsg
1,01901153000,01901153100,00000000100,a2f,recvmsg
1,01901156000,01901162700,00000006700,a07,poll
1,01901163900,01901164100,00000000200,a2f,recvmsg
1,01901164400,01901164500,00000000100,a2f,recvmsg
1,01901167900,01901174500,00000006600,a07,poll
1,01901175600,01901175800,00000000200,a2f,recvmsg
1,01901176000,01901176200,00000000200,a2f,recvmsg
1,01901179600,01901186400,00000006800,a07,poll
1,01901187400,01901187600,00000000200,a2f,recvmsg
1,01901187900,01901188100,00000000200,a2f,recvmsg
1,01901191800,01901198700,00000006900,a07,poll
1,01901199800,01901200000,00000000200,a2f,recvmsg
1,01901200300,01901200500,00000000200,a2f,recvmsg
1,01901204100,01901210800,00000006700,a07,poll
1,01901212000,01901212100,00000000100,a2f,recvmsg
1,01901212400,01901212500,00000000100,a2f,recvmsg
1,01901215900,01901222800,00000006900,a07,poll
1,01901223800,01901224000,00000000200,a2f,recvmsg
1,01901224300,01901224500,00000000200,a2f,recvmsg
1,01901230000,01901236900,00000006900,a07,poll
1,01901238100,01901238200,00000000100,a2f,recvmsg
1,01901238600,01901238600,00000000000,a2f,recvmsg
1,01901241700,01901248400,00000006700,a07,poll
1,01901249500,01901249700,00000000200,a2f,recvmsg
1,01901250000,01901250100,00000000100,a2f,recvmsg
1,01901253200,01901260100,00000006900,a07,poll
1,01901261300,01901261400,00000000100,a2f,recvmsg
1,01901261600,01901261800,00000000200,a2f,recvmsg
1,01901265700,01901272600,00000006900,a07,poll
1,01901273800,01901274000,00000000200,a2f,recvmsg
1,01901274300,01901274500,00000000200,a2f,recvmsg
1,01901278000,01901284700,00000006700,a07,poll
1,01901285900,01901286000,00000000100,a2f,recvmsg
1,01901286200,01901286400,00000000200,a2f,recvmsg
1,01901290100,01901297000,00000006900,a07,poll
1,01901298100,01901298300,00000000200,a2f,recvmsg
1,01901298600,01901298800,00000000200,a2f,recvmsg
1,01901302200,01901309000,00000006800,a07,poll
1,01901310200,01901310400,00000000200,a2f,recvmsg
1,01901310700,01901310800,00000000100,a2f,recvmsg
1,01901314000,01901320800,00000006800,a07,poll
1,01901322000,01901322200,00000000200,a2f,recvmsg
1,01901322400,01901322600,00000000200,a2f,recvmsg
1,01901325500,01901359100,00000033600,a07,poll
1,01901360700,01901360900,00000000200,a2f,recvmsg
1,01901361400,01901361600,00000000200,a2f,recvmsg
1,01901365300,01901372400,00000007100,a07,poll
1,01901373500,01901373600,00000000100,a2f,recvmsg
1,01901373900,01901374100,00000000200,a2f,recvmsg
1,01901375200,01901375300,00000000100,a08,lseek
1,01901377900,01901381900,00000004000,a00,read
1,01901385800,01901385900,00000000100,a08,lseek
1,01901389200,01901395900,00000006700,a07,poll
1,01901397200,01901397400,00000000200,a2f,recvmsg
1,01901397700,01901397900,00000000200,a2f,recvmsg
1,01901423900,01901430500,00000006600,a07,poll
1,01901431900,01901432000,00000000100,a2f,recvmsg
1,01901432400,01901432500,00000000100,a2f,recvmsg
1,01901436300,01901437300,00000001000,a00,read
1,01901442700,01901442800,00000000100,a08,lseek
1,01901446300,01901453100,00000006800,a07,poll
1,01901454300,01901454500,00000000200,a2f,recvmsg
1,01901454800,01901455000,00000000200,a2f,recvmsg
1,01901457700,01901464400,00000006700,a07,poll
1,01901465500,01901465600,00000000100,a2f,recvmsg
1,01901465900,01901466100,00000000200,a2f,recvmsg
1,01901468800,01901475600,00000006800,a07,poll
1,01901476600,01901476800,00000000200,a2f,recvmsg
1,01901477100,01901477300,00000000200,a2f,recvmsg
1,01901480000,01901486600,00000006600,a07,poll
1,01901487700,01901487900,00000000200,a2f,recvmsg
1,01901488200,01901488400,00000000200,a2f,recvmsg
1,01901491200,01901497800,00000006600,a07,poll
1,01901498900,01901499100,00000000200,a2f,recvmsg
1,01901499400,01901499600,00000000200,a2f,recvmsg
1,01901502300,01901508900,00000006600,a07,poll
1,01901510000,01901510200,00000000200,a2f,recvmsg
1,01901510400,01901510600,00000000200,a2f,recvmsg
1,01901513500,01901520100,00000006600,a07,poll
1,01901521300,01901521500,00000000200,a2f,recvmsg
1,01901521700,01901521900,00000000200,a2f,recvmsg
1,01901525300,01901532000,00000006700,a07,poll
1,01901533100,01901533200,00000000100,a2f,recvmsg
1,01901533500,01901533700,00000000200,a2f,recvmsg
1,01901536600,01901543300,00000006700,a07,poll
1,01901544500,01901544500,00000000000,a2f,recvmsg
1,01901544800,01901545000,00000000200,a2f,recvmsg
1,01901545500,01901545600,00000000100,a08,lseek
1,01901550600,01901557300,00000006700,a07,poll
1,01901558400,01901558500,00000000100,a2f,recvmsg
1,01901558800,01901559000,00000000200,a2f,recvmsg
1,01901564200,01901571200,00000007000,a07,poll
1,01901572300,01901572500,00000000200,a2f,recvmsg
1,01901572800,01901573000,00000000200,a2f,recvmsg
1,01901576500,01901582900,00000006400,a07,poll
1,01901584100,01901584300,00000000200,a2f,recvmsg
1,01901584500,01901584700,00000000200,a2f,recvmsg
1,01901588100,01901594600,00000006500,a07,poll
1,01901595800,01901595900,00000000100,a2f,recvmsg
1,01901596200,01901596400,00000000200,a2f,recvmsg
1,01901600700,01901606000,00000005300,a07,poll
1,01901607100,01901607200,00000000100,a2f,recvmsg
1,01901607500,01901607700,00000000200,a2f,recvmsg
1,01901610900,01901617600,00000006700,a07,poll
1,01901618600,01901618800,00000000200,a2f,recvmsg
1,01901619100,01901619300,00000000200,a2f,recvmsg
1,01901622700,01901629500,00000006800,a07,poll
1,01901630600,01901630800,00000000200,a2f,recvmsg
1,01901631000,01901631200,00000000200,a2f,recvmsg
1,01901634200,01901640900,00000006700,a07,poll
1,01901642000,01901642100,00000000100,a2f,recvmsg
1,01901642400,01901642600,00000000200,a2f,recvmsg
1,01901645500,01901652200,00000006700,a07,poll
1,01901653300,01901653500,00000000200,a2f,recvmsg
1,01901653800,01901654000,00000000200,a2f,recvmsg
1,01901657000,01901663800,00000006800,a07,poll
1,01901664900,01901665000,00000000100,a2f,recvmsg
1,01901665400,01901665500,00000000100,a2f,recvmsg
1,01901668500,01901675100,00000006600,a07,poll
1,01901676200,01901676300,00000000100,a2f,recvmsg
1,01901676600,01901676800,00000000200,a2f,recvmsg
1,01901679900,01901686500,00000006600,a07,poll
1,01901687600,01901687700,00000000100,a2f,recvmsg
1,01901688100,01901688300,00000000200,a2f,recvmsg
1,01901691900,01901698600,00000006700,a07,poll
1,01901699800,01901700000,00000000200,a2f,recvmsg
1,01901700300,01901700400,00000000100,a2f,recvmsg
1,01901703400,01901710200,00000006800,a07,poll
1,01901711400,01901711500,00000000100,a2f,recvmsg
1,01901711800,01901712000,00000000200,a2f,recvmsg
1,01901714900,01901721400,00000006500,a07,poll
1,01901722600,01901722700,00000000100,a2f,recvmsg
1,01901723100,01901723100,00000000000,a2f,recvmsg
1,01901726200,01901732900,00000006700,a07,poll
1,01901734100,01901734300,00000000200,a2f,recvmsg
1,01901734500,01901734700,00000000200,a2f,recvmsg
1,01901743200,01901749900,00000006700,a07,poll
1,01901751100,01901751200,00000000100,a2f,recvmsg
1,01901751500,01901751600,00000000100,a2f,recvmsg
1,01901755000,01901761600,00000006600,a07,poll
1,01901762700,01901762900,00000000200,a2f,recvmsg
1,01901763100,01901763300,00000000200,a2f,recvmsg
1,01901766300,01901773000,00000006700,a07,poll
1,01901774200,01901774400,00000000200,a2f,recvmsg
1,01901774600,01901774700,00000000100,a2f,recvmsg
1,01901778100,01901784500,00000006400,a07,poll
1,01901785600,01901785800,00000000200,a2f,recvmsg
1,01901786000,01901786200,00000000200,a2f,recvmsg
1,01901789300,01901795900,00000006600,a07,poll
1,01901797100,01901797200,00000000100,a2f,recvmsg
1,01901797400,01901797600,00000000200,a2f,recvmsg
1,01901841600,01901845900,00000004300,a14,writev
1,01901846600,01901943300,00000096700,a07,poll
1,01901945700,01901946500,00000000800,a00,read
1,01901959300,01901959500,00000000200,a2f,recvmsg
1,01901991700,01902018800,00000027100,a07,poll
1,01902020500,01902075700,00000055200,a07,poll
1,01902076800,01902131400,00000054600,a07,poll
1,01902132500,01902188600,00000056100,a07,poll
1,01902190400,01902243700,00000053300,a07,poll
1,01902245800,01902299800,00000054000,a07,poll
1,01902300900,01902344100,00000043200,a07,poll
1,01902345100,01902388000,00000042900,a07,poll
1,01902389000,01902430900,00000041900,a07,poll
1,01902432000,01902472600,00000040600,a07,poll
1,01902473600,01902515800,00000042200,a07,poll
1,01902517000,01902569100,00000052100,a07,poll
1,01902570200,01902586900,00000016700,a07,poll
1,01902587900,01902602400,00000014500,a07,poll
1,01902604100,01902618000,00000013900,a07,poll
1,01902619100,01902633000,00000013900,a07,poll
1,01902634000,01902647300,00000013300,a07,poll
1,01902648300,01902652500,00000004200,a07,poll
1,01902654700,01902654900,00000000200,a2f,recvmsg
1,01902655500,01902655700,00000000200,a2f,recvmsg
1,01902672200,01902675800,00000003600,a07,poll
1,01902676400,01902677800,00000001400,a2f,recvmsg
1,01902681000,01902682500,00000001500,a2d,recvfrom
1,01902686800,01902687000,00000000200,a2f,recvmsg
1,01902687500,01902687700,00000000200,a2f,recvmsg
1,01902743100,01902743400,00000000300,a2f,recvmsg
1,01902745500,01902745700,00000000200,a2f,recvmsg
1,01902756400,01902886500,00000130100,a07,poll
1,01902887300,01902888900,00000001600,a2f,recvmsg
1,01902895700,01902896500,00000000800,a2d,recvfrom
1,01902897400,01902897600,00000000200,a2f,recvmsg
1,01902898400,01902898500,00000000100,a2f,recvmsg
1,01902930800,01902931000,00000000200,a2f,recvmsg
1,01902933400,01902933600,00000000200,a2f,recvmsg
1,01902936900,01902939200,00000002300,a07,poll
1,01902941900,01902942100,00000000200,a2f,recvmsg
1,01902942700,01902942900,00000000200,a2f,recvmsg
1,01903412300,01903416200,00000003900,a09,mmap
1,01903559300,01903564400,00000005100,a02,open
1,01903585800,01903587800,00000002000,a00,read
1,01903638600,01903639500,00000000900,a00,read
1,01903688600,01903689500,00000000900,a00,read
1,01903735200,01903735900,00000000700,a00,read
1,01903783100,01903784000,00000000900,a00,read
1,01903829900,01903830600,00000000700,a00,read
1,01903874600,01903875400,00000000800,a00,read
1,01903920500,01903921200,00000000700,a00,read
1,01903968900,01903969600,00000000700,a00,read
1,01904017600,01904018300,00000000700,a00,read
1,01904065800,01904066300,00000000500,a00,read
1,01904093000,01904094400,00000001400,a02,open
1,01904097800,01904098700,00000000900,a00,read
1,01904153300,01904154100,00000000800,a00,read
1,01904236900,01904237800,00000000900,a00,read
1,01904308400,01904309100,00000000700,a00,read
1,01904385700,01904386400,00000000700,a00,read
1,01904463200,01904464000,00000000800,a00,read
1,01904539700,01904540500,00000000800,a00,read
1,01904623000,01904623800,00000000800,a00,read
1,01904689900,01904690600,00000000700,a00,read
1,01904747700,01904748400,00000000700,a00,read
1,01904825300,01904849000,00000023700,a07,poll
1,01904852600,01904853000,00000000400,a2f,recvmsg
1,01904853800,01904854000,00000000200,a2f,recvmsg
1,01904856900,01904864200,00000007300,a07,poll
1,01904865500,01904865600,00000000100,a2f,recvmsg
1,01904865900,01904866000,00000000100,a2f,recvmsg
1,01904870500,01904875400,00000004900,a06,lstat
1,01904876200,01904877100,00000000900,a06,lstat
1,01904893900,01904904900,00000011000,a01,write
1,01904910300,01904916900,00000006600,a07,poll
1,01904918900,01904919000,00000000100,a2f,recvmsg
1,01904919400,01904919600,00000000200,a2f,recvmsg
1,01904920800,01905234600,00000313800,a38,clone
1,01905736300,01905736500,00000000200,a0c,brk
1,01905746100,01905748700,00000002600,a15,access
1,01905749300,01905750200,00000000900,a09,mmap
1,01905753900,01905756000,00000002100,a15,access
1,01905763000,01905764000,00000001000,a09,mmap
1,01905768100,01905768600,00000000500,a15,access
1,01905776100,01905777200,00000001100,a00,read
1,01905778600,01905780100,00000001500,a09,mmap
1,01905784700,01905786800,00000002100,a09,mmap
1,01905798400,01905799000,00000000600,a15,access
1,01905802400,01905803200,00000000800,a00,read
1,01905807000,01905808300,00000001300,a09,mmap
1,01905816300,01905816900,00000000600,a15,access
1,01905819600,01905820200,00000000600,a00,read
1,01905820900,01905821600,00000000700,a09,mmap
1,01905823300,01905825200,00000001900,a09,mmap
1,01905829200,01905832200,00000003000,a09,mmap
1,01905834300,01905835300,00000001000,a09,mmap
1,01905843500,01905844200,00000000700,a15,access
1,01905847100,01905847800,00000000700,a00,read
1,01905848500,01905849900,00000001400,a09,mmap
1,01905852500,01905854100,00000001600,a09,mmap
1,01905862300,01905862800,00000000500,a15,access
1,01905866100,01905866800,00000000700,a00,read
1,01905867400,01905868900,00000001500,a09,mmap
1,01905872100,01905874300,00000002200,a09,mmap
1,01905882900,01905883500,00000000600,a15,access
1,01905886300,01905886900,00000000600,a00,read
1,01905887300,01905888400,00000001100,a09,mmap
1,01905889800,01905891200,00000001400,a09,mmap
1,01905894000,01905895500,00000001500,a09,mmap
1,01905901600,01905902200,00000000600,a15,access
1,01905904500,01905905000,00000000500,a00,read
1,01905905600,01905906900,00000001300,a09,mmap
1,01905908900,01905910600,00000001700,a09,mmap
1,01905924600,01905925300,00000000700,a09,mmap
1,01905929000,01905929400,00000000400,a09,mmap
1,01905930400,01905930700,00000000300,a09,mmap
1,01906109100,01906109200,00000000100,a0c,brk
1,01906109300,01906110200,00000000900,a0c,brk
1,01906144800,01906151000,00000006200,a00,read
1,01906164000,01906165600,00000001600,a00,read
1,01906203700,01906204700,00000001000,a00,read
1,01906325000,01906325800,00000000800,a00,read
1,01906397900,01906398400,00000000500,a00,read
1,01906483700,01906484300,00000000600,a00,read
1,01906614900,01906615900,00000001000,a00,read
1,01906744100,01906744800,00000000700,a00,read
1,01906900600,01906901300,00000000700,a00,read
1,01907051500,01907052200,00000000700,a00,read
1,01907088800,01907090200,00000001400,a0c,brk
1,01907205400,01907206100,00000000700,a00,read
1,01907355200,01907355800,00000000600,a00,read
1,01907511800,01907512500,00000000700,a00,read
1,01907672200,01907673000,00000000800,a00,read
1,01907783600,01907784200,00000000600,a00,read
1,01907815200,01907815800,00000000600,a0c,brk
1,01907924100,01907924800,00000000700,a00,read
1,01908169600,01908170300,00000000700,a00,read
1,01908182900,01908183300,00000000400,a00,read
1,01908227700,01908228100,00000000400,a00,read
1,01908248100,01908248900,00000000800,a00,read
1,01908458300,01908458700,00000000400,a00,read
1,01908488400,01908489100,00000000700,a00,read
1,01908586000,01908586800,00000000800,a00,read
1,01908610700,01908612000,00000001300,a0c,brk
1,01908657100,01908657500,00000000400,a00,read
1,01908734100,01908734900,00000000800,a00,read
1,01908888000,01908888400,00000000400,a00,read
1,01909000900,01909001600,00000000700,a00,read
1,01909098900,01909099400,00000000500,a00,read
1,01909111900,01909112300,00000000400,a00,read
1,01909193300,01909193800,00000000500,a00,read
1,01909218300,01909218600,00000000300,a00,read
1,01909241300,01909241700,00000000400,a00,read
1,01909356000,01909357100,00000001100,a0c,brk
1,01909358200,01909359400,00000001200,a00,read
1,01909560400,01909560800,00000000400,a00,read
1,01909644400,01909645000,00000000600,a00,read
1,01909708700,01909709300,00000000600,a00,read
1,01909839400,01909839800,00000000400,a00,read
1,01909874800,01909875500,00000000700,a00,read
1,01909892000,01909893300,00000001300,a02,open
1,01910005200,01910005700,00000000500,a00,read
1,01910076800,01910077200,00000000400,a00,read
1,01910129700,01910130800,00000001100,a0c,brk
1,01910136800,01910137700,00000000900,a00,read
1,01910244800,01910245500,00000000700,a00,read
1,01910395800,01910396700,00000000900,a00,read
1,01910526700,01910527400,00000000700,a00,read
1,01910586300,01910586900,00000000600,a00,read
1,01910642100,01910643000,00000000900,a00,read
1,01910712300,01910712900,00000000600,a00,read
1,01910765200,01910765800,00000000600,a00,read
1,01910853800,01910854500,00000000700,a0c,brk
1,01910884900,01910889200,00000004300,a0c,brk
1,01910903800,01910904500,00000000700,a00,read
1,01911019700,01911020400,00000000700,a00,read
1,01911178400,01911179100,00000000700,a00,read
1,01911295800,01911296500,00000000700,a00,read
1,01911442000,01911442700,00000000700,a00,read
1,01911561100,01911561600,00000000500,a00,read
1,01911723300,01911724100,00000000800,a00,read
1,01911728900,01911729700,00000000800,a0c,brk
1,01911844400,01911845100,00000000700,a00,read
1,01911962400,01911963100,00000000700,a00,read
1,01912103800,01912104600,00000000800,a00,read
1,01912235100,01912235800,00000000700,a00,read
1,01912329600,01912330300,00000000700,a00,read
1,01912441900,01912442600,00000000700,a00,read
1,01912565500,01912566200,00000000700,a00,read
1,01912677100,01912677600,00000000500,a0c,brk
1,01912700500,01912701100,00000000600,a00,read
1,01912869600,01912870200,00000000600,a00,read
1,01913019700,01913020400,00000000700,a00,read
1,01913130500,01913131300,00000000800,a00,read
1,01913300100,01913301000,00000000900,a00,read
1,01913394500,01913395100,00000000600,a00,read
1,01913476100,01913476800,00000000700,a00,read
1,01913543700,01913544400,00000000700,a0c,brk
1,01913558000,01913558600,00000000600,a00,read
1,01913631300,01913632000,00000000700,a00,read
1,01913733000,01913733700,00000000700,a00,read
1,01913836000,01913836600,00000000600,a00,read
1,01913926200,01913926800,00000000600,a00,read
1,01914007300,01914007900,00000000600,a00,read
1,01914108600,01914109200,00000000600,a00,read
1,01914189300,01914189700,00000000400,a0c,brk
1,01914192200,01914192800,00000000600,a00,read
1,01914299500,01914300200,00000000700,a00,read
1,01914392400,01914393100,00000000700,a00,read
1,01914511700,01914512300,00000000600,a00,read
1,01914625500,01914626100,00000000600,a00,read
1,01914729000,01914729600,00000000600,a00,read
1,01914830000,01914830400,00000000400,a0c,brk
1,01915195100,01915198500,00000003400,a57,unlink
1,01915222900,01915223400,00000000500,a48,fcntl
1,01915273200,01915288800,00000015600,a01,write
1,01915306700,01915309100,00000002400,a01,write
1,01915325500,01915328000,00000002500,a01,write
1,01889924400,01915577200,00025652800,a17,select
1,01915601700,01915601900,00000000200,a2f,recvmsg
1,01915605500,01915634800,00000029300,a17,select
1,01915639100,01915639200,00000000100,a2f,recvmsg
1,01915640000,01915657800,00000017800,a17,select
1,01915661600,01915661700,00000000100,a2f,recvmsg
1,01915662300,01915679200,00000016900,a17,select
1,01915683000,01915683200,00000000200,a2f,recvmsg
1,01915683700,01915700000,00000016300,a17,select
1,01915704000,01915704200,00000000200,a2f,recvmsg
1,01915704700,01915719500,00000014800,a17,select
1,01915723000,01915723100,00000000100,a2f,recvmsg
1,01915723700,01915750700,00000027000,a17,select
1,01915754600,01915754800,00000000200,a2f,recvmsg
1,01915755400,01915765500,00000010100,a17,select
1,01915769200,01915769300,00000000100,a2f,recvmsg
1,01915769800,01915777400,00000007600,a17,select
1,01915781100,01915781200,00000000100,a2f,recvmsg
1,01915781700,01915789500,00000007800,a17,select
1,01915793200,01915793300,00000000100,a2f,recvmsg
1,01915793900,01915801600,00000007700,a17,select
1,01915805500,01915805700,00000000200,a2f,recvmsg
1,01915806100,01915813700,00000007600,a17,select
1,01915817300,01915817500,00000000200,a2f,recvmsg
1,01915818000,01915825600,00000007600,a17,select
1,01915829500,01915829700,00000000200,a2f,recvmsg
1,01915830200,01915837400,00000007200,a17,select
1,01915840900,01915841000,00000000100,a2f,recvmsg
1,01915841600,01915849900,00000008300,a17,select
1,01915854100,01915854300,00000000200,a2f,recvmsg
1,01915854800,01915862400,00000007600,a17,select
1,01915866000,01915866200,00000000200,a2f,recvmsg
1,01915866700,01915874800,00000008100,a17,select
1,01915878500,01915878700,00000000200,a2f,recvmsg
1,01915879300,01915886500,00000007200,a17,select
1,01915890200,01915890300,00000000100,a2f,recvmsg
1,01915890900,01915898200,00000007300,a17,select
1,01915901900,01915902100,00000000200,a2f,recvmsg
1,01915902600,01915910100,00000007500,a17,select
1,01915913800,01915914000,00000000200,a2f,recvmsg
1,01915914400,01915921800,00000007400,a17,select
1,01915925500,01915925600,00000000100,a2f,recvmsg
1,01915926100,01915933100,00000007000,a17,select
1,01915936800,01915937000,00000000200,a2f,recvmsg
1,01915937500,01915946400,00000008900,a17,select
1,01915950000,01915950200,00000000200,a2f,recvmsg
1,01915950700,01915957600,00000006900,a17,select
1,01915961300,01915961500,00000000200,a2f,recvmsg
1,01915961900,01915968800,00000006900,a17,select
1,01915972500,01915972600,00000000100,a2f,recvmsg
1,01915973100,01915980100,00000007000,a17,select
1,01915983700,01915983900,00000000200,a2f,recvmsg
1,01915984400,01915991700,00000007300,a17,select
1,01915995300,01915995500,00000000200,a2f,recvmsg
1,01915995900,01916003200,00000007300,a17,select
1,01916006900,01916007100,00000000200,a2f,recvmsg
1,01916007500,01916015100,00000007600,a17,select
1,01916018700,01916018900,00000000200,a2f,recvmsg
1,01916019500,01916026900,00000007400,a17,select
1,01916030600,01916030800,00000000200,a2f,recvmsg
1,01916031300,01916040200,00000008900,a17,select
1,01916044000,01916044100,00000000100,a2f,recvmsg
1,01916044700,01916052500,00000007800,a17,select
1,01916056000,01916056200,00000000200,a2f,recvmsg
1,01916056700,01916064400,00000007700,a17,select
1,01916068100,01916068300,00000000200,a2f,recvmsg
1,01916068900,01916079200,00000010300,a17,select
1,01916082900,01916083000,00000000100,a2f,recvmsg
1,01916083500,01916091600,00000008100,a17,select
1,01916095200,01916095400,00000000200,a2f,recvmsg
1,01916096000,01916103400,00000007400,a17,select
1,01916107000,01916107100,00000000100,a2f,recvmsg
1,01916107700,01916115700,00000008000,a17,select
1,01916119700,01916119900,00000000200,a2f,recvmsg
1,01916120500,01916128100,00000007600,a17,select
1,01916131700,01916131900,00000000200,a2f,recvmsg
1,01916132400,01916140300,00000007900,a17,select
1,01916144100,01916144200,00000000100,a2f,recvmsg
1,01916144700,01916152400,00000007700,a17,select
1,01916156100,01916156300,00000000200,a2f,recvmsg
1,01916156800,01916164100,00000007300,a17,select
1,01916167800,01916168000,00000000200,a2f,recvmsg
1,01916168500,01916175500,00000007000,a17,select
1,01916179100,01916179200,00000000100,a2f,recvmsg
1,01916179800,01916187300,00000007500,a17,select
1,01916191000,01916191200,00000000200,a2f,recvmsg
1,01916191700,01916207500,00000015800,a17,select
1,01916211100,01916211200,00000000100,a2f,recvmsg
1,01916211800,01916242500,00000030700,a17,select
1,01916246200,01916246300,00000000100,a2f,recvmsg
1,01916246800,01916264900,00000018100,a17,select
1,01916268700,01916268900,00000000200,a2f,recvmsg
1,01916269400,01916276500,00000007100,a17,select
1,01916280100,01916280300,00000000200,a2f,recvmsg
1,01916280800,01916287700,00000006900,a17,select
1,01916291100,01916291300,00000000200,a2f,recvmsg
1,01916291900,01916298800,00000006900,a17,select
1,01916302400,01916302600,00000000200,a2f,recvmsg
1,01916303300,01916310100,00000006800,a17,select
1,01916313700,01916313900,00000000200,a2f,recvmsg
1,01916314500,01916321400,00000006900,a17,select
1,01916325100,01916325300,00000000200,a2f,recvmsg
1,01916325800,01916332900,00000007100,a17,select
1,01916336500,01916336600,00000000100,a2f,recvmsg
1,01916337200,01916344900,00000007700,a17,select
1,01916348700,01916348900,00000000200,a2f,recvmsg
1,01916349300,01916356300,00000007000,a17,select
1,01916359800,01916360000,00000000200,a2f,recvmsg
1,01916360600,01916369600,00000009000,a17,select
1,01916373300,01916373400,00000000100,a2f,recvmsg
1,01916374000,01916383200,00000009200,a17,select
1,01916386900,01916387100,00000000200,a2f,recvmsg
1,01916387500,01916395200,00000007700,a17,select
1,01916398700,01916398900,00000000200,a2f,recvmsg
1,01916399400,01916406700,00000007300,a17,select
1,01916410300,01916410500,00000000200,a2f,recvmsg
1,01916411000,01916418400,00000007400,a17,select
1,01916421800,01916422000,00000000200,a2f,recvmsg
1,01916422500,01916429900,00000007400,a17,select
1,01916433400,01916433600,00000000200,a2f,recvmsg
1,01916434100,01916441800,00000007700,a17,select
1,01916445400,01916445600,00000000200,a2f,recvmsg
1,01916446100,01916453300,00000007200,a17,select
1,01916456800,01916457000,00000000200,a2f,recvmsg
1,01916457500,01916464700,00000007200,a17,select
1,01916468300,01916468500,00000000200,a2f,recvmsg
1,01916469000,01916476200,00000007200,a17,select
1,01916479900,01916480100,00000000200,a2f,recvmsg
1,01916480600,01916487900,00000007300,a17,select
1,01916491600,01916491700,00000000100,a2f,recvmsg
1,01916492200,01916499400,00000007200,a17,select
1,01916503000,01916503200,00000000200,a2f,recvmsg
1,01916503600,01916511300,00000007700,a17,select
1,01916514900,01916515100,00000000200,a2f,recvmsg
1,01916515700,01916522800,00000007100,a17,select
1,01916526400,01916526500,00000000100,a2f,recvmsg
1,01916527100,01916534300,00000007200,a17,select
1,01916537800,01916538000,00000000200,a2f,recvmsg
1,01916538500,01916545600,00000007100,a17,select
1,01916549200,01916549400,00000000200,a2f,recvmsg
1,01916549900,01916562600,00000012700,a17,select
1,01916566300,01916566500,00000000200,a2f,recvmsg
1,01916567100,01916574400,00000007300,a17,select
1,01916577900,01916578100,00000000200,a2f,recvmsg
1,01916578700,01916585900,00000007200,a17,select
1,01916589500,01916589700,00000000200,a2f,recvmsg
1,01916590300,01916597600,00000007300,a17,select
1,01916601100,01916601300,00000000200,a2f,recvmsg
1,01916601800,01916609000,00000007200,a17,select
1,01916612600,01916612800,00000000200,a2f,recvmsg
1,01916613300,01916670200,00000056900,a17,select
1,01916671100,01916672300,00000001200,a2f,recvmsg
1,01916766800,01916771400,00000004600,a14,writev
1,01916845600,01916847300,00000001700,a14,writev
1,01916905000,01916906500,00000001500,a14,writev
1,01916962700,01916964100,00000001400,a14,writev
1,01917020000,01917021500,00000001500,a14,writev
1,01917075300,01917077100,00000001800,a14,writev
1,01917079700,01917080500,00000000800,a2f,recvmsg
1,01917131400,01917133000,00000001600,a14,writev
1,01917176000,01917177800,00000001800,a14,writev
1,01917220500,01917222100,00000001600,a14,writev
1,01917265100,01917266500,00000001400,a14,writev
1,01917309500,01917311200,00000001700,a14,writev
1,01917380600,01917382100,00000001500,a14,writev
1,01917407200,01917409100,00000001900,a2f,recvmsg
1,01917436100,01917437800,00000001700,a14,writev
1,01917456300,01917457800,00000001500,a14,writev
1,01917473500,01917474900,00000001400,a14,writev
1,01917489000,01917490500,00000001500,a14,writev
1,01917504300,01917505600,00000001300,a14,writev
1,01917519100,01917520600,00000001500,a14,writev
1,01917525400,01917525500,00000000100,a2f,recvmsg
1,01917526500,01917526900,00000000400,a14,writev
1,01917527200,01917527500,00000000300,a14,writev
1,01917546500,01917548300,00000001800,a14,writev
1,01917548500,01917550100,00000001600,a14,writev
1,01917550700,01917550900,00000000200,a2f,recvmsg
1,01917562600,01917564100,00000001500,a14,writev
1,01917564400,01917565400,00000001000,a14,writev
1,01917565800,01917565900,00000000100,a2f,recvmsg
1,01904910300,01917573200,00012662900,a07,poll
1,01917579300,01917581900,00000002600,a2f,recvmsg
1,01917587200,01917587400,00000000200,a2f,recvmsg
1,01917591200,01917591400,00000000200,a2f,recvmsg
1,01917591700,01917591800,00000000100,a2f,recvmsg
1,01917596200,01917596400,00000000200,a2f,recvmsg
1,01917596500,01917596700,00000000200,a2f,recvmsg
1,01917597600,01917602100,00000004500,a07,poll
1,01917607900,01917613800,00000005900,a2f,recvmsg
1,01917626600,01917626800,00000000200,a2f,recvmsg
1,01917652200,01917656500,00000004300,a07,poll
1,01917662100,01917668900,00000006800,a2f,recvmsg
1,01917681700,01917681900,00000000200,a2f,recvmsg
1,01917566500,01917712100,00000145600,a17,select
1,01917727600,01917728800,00000001200,a14,writev
1,01917729300,01917729500,00000000200,a2f,recvmsg
1,01917745700,01917745800,00000000100,a2f,recvmsg
1,01917758400,01917759400,00000001000,a14,writev
1,01917759800,01917759900,00000000100,a2f,recvmsg
1,01917705900,01917764500,00000058600,a07,poll
1,01917768000,01917768100,00000000100,a2f,recvmsg
1,01917769500,01917769700,00000000200,a2f,recvmsg
1,01917770000,01917770100,00000000100,a2f,recvmsg
1,01917771300,01917771500,00000000200,a2f,recvmsg
1,01917771700,01917771800,00000000100,a2f,recvmsg
1,01917772200,01917773800,00000001600,a07,poll
1,01917774300,01917775200,00000000900,a2f,recvmsg
1,01917780900,01917781700,00000000800,a2d,recvfrom
1,01917782600,01917782800,00000000200,a2f,recvmsg
1,01917783500,01917783700,00000000200,a2f,recvmsg
1,01917812600,01917812900,00000000300,a2f,recvmsg
1,01917814600,01917814700,00000000100,a2f,recvmsg
1,01917818100,01918340800,00000522700,a07,poll
1,01918359000,01918364000,00000005000,a2e,sendmsg
1,01897830900,01918367300,00020536400,ae8,epoll_wait
1,01918381100,01918382300,00000001200,a2f,recvmsg
1,01918397500,01918397600,00000000100,a2f,recvmsg
1,01918456100,01918460000,00000003900,a2e,sendmsg
1,01918480800,01918482600,00000001800,a2e,sendmsg
1,01918466500,01918483800,00000017300,ae8,epoll_wait
1,01918486100,01918486900,00000000800,a2f,recvmsg
1,01918493700,01918493900,00000000200,a2f,recvmsg
1,01918523200,01918524000,00000000800,a2e,sendmsg
1,01918539800,01918540200,00000000400,a00,read
1,01918542600,01918551600,00000009000,a07,poll
1,01918527100,01918824700,00000297600,ae8,epoll_wait
1,01918828400,01918830800,00000002400,a2f,recvmsg
1,01918863400,01918863600,00000000200,a2f,recvmsg
1,01918890200,01918893400,00000003200,a2e,sendmsg
1,01918913400,01918914200,00000000800,a2e,sendmsg
1,01918821600,01919157500,00000335900,a07,poll
1,01919489300,01919498000,00000008700,a02,open
1,01919510900,01919514300,00000003400,a00,read
1,01919570600,01919571400,00000000800,a00,read
1,01919623100,01919623900,00000000800,a00,read
1,01919674100,01919674800,00000000700,a00,read
1,01919725500,01919726300,00000000800,a00,read
1,01919776000,01919776700,00000000700,a00,read
1,01919824000,01919824600,00000000600,a00,read
1,01919873900,01919874700,00000000800,a00,read
1,01919927000,01919927700,00000000700,a00,read
1,01919979600,01919980200,00000000600,a00,read
1,01920029800,01920030500,00000000700,a00,read
1,01920057900,01920059500,00000001600,a02,open
1,01920062900,01920063800,00000000900,a00,read
1,01920121100,01920121900,00000000800,a00,read
1,01920208800,01920209700,00000000900,a00,read
1,01920284100,01920284700,00000000600,a00,read
1,01920364600,01920365400,00000000800,a00,read
1,01920447500,01920448200,00000000700,a00,read
1,01920527700,01920528400,00000000700,a00,read
1,01920614700,01920615300,00000000600,a00,read
1,01920683800,01920684600,00000000800,a00,read
1,01920743400,01920744100,00000000700,a00,read
1,01920824900,01920859000,00000034100,a07,poll
1,01920862900,01920863100,00000000200,a2f,recvmsg
1,01920864000,01920864200,00000000200,a2f,recvmsg
1,01920865500,01920868900,00000003400,a14,writev
1,01920869300,01920879200,00000009900,a07,poll
1,01920880400,01920880600,00000000200,a2f,recvmsg
1,01920880900,01920881100,00000000200,a2f,recvmsg
1,01920886100,01920892500,00000006400,a06,lstat
1,01920893400,01920894500,00000001100,a06,lstat
1,01920917100,01920931700,00000014600,a01,write
1,01920937100,01920958500,00000021400,a07,poll
1,01920960500,01920960600,00000000100,a2f,recvmsg
1,01920961100,01920961300,00000000200,a2f,recvmsg
1,01920962600,01921268200,00000305600,a38,clone
1,01921770300,01921770500,00000000200,a0c,brk
1,01921781600,01921784300,00000002700,a15,access
1,01921785000,01921785800,00000000800,a09,mmap
1,01921790900,01921791700,00000000800,a15,access
1,01921797900,01921798900,00000001000,a09,mmap
1,01921802900,01921803400,00000000500,a15,access
1,01921811000,01921811900,00000000900,a00,read
1,01921813600,01921815100,00000001500,a09,mmap
1,01921818600,01921820900,00000002300,a09,mmap
1,01921831300,01921832000,00000000700,a15,access
1,01921835200,01921835900,00000000700,a00,read
1,01921836500,01921837500,00000001000,a09,mmap
1,01921839700,01921841000,00000001300,a09,mmap
1,01921849500,01921850200,00000000700,a15,access
1,01921852900,01921853500,00000000600,a00,read
1,01921854100,01921855000,00000000900,a09,mmap
1,01921862700,01921865600,00000002900,a09,mmap
1,01921867900,01921868900,00000001000,a09,mmap
1,01921877400,01921878100,00000000700,a15,access
1,01921880600,01921881400,00000000800,a00,read
1,01921882100,01921883600,00000001500,a09,mmap
1,01921886000,01921887700,00000001700,a09,mmap
1,01921895800,01921896400,00000000600,a15,access
1,01921899700,01921900300,00000000600,a00,read
1,01921901000,01921902300,00000001300,a09,mmap
1,01921905600,01921907800,00000002200,a09,mmap
1,01921916200,01921916700,00000000500,a15,access
1,01921919100,01921919800,00000000700,a00,read
1,01921920200,01921921300,00000001100,a09,mmap
1,01921922600,01921923900,00000001300,a09,mmap
1,01921926700,01921928000,00000001300,a09,mmap
1,01921934200,01921934800,00000000600,a15,access
1,01921937300,01921937800,00000000500,a00,read
1,01921942000,01921943800,00000001800,a09,mmap
1,01921960300,01921960900,00000000600,a09,mmap
1,01921964600,01921964900,00000000300,a09,mmap
1,01921966000,01921966200,00000000200,a09,mmap
1,01922144100,01922144300,00000000200,a0c,brk
1,01922144300,01922145100,00000000800,a0c,brk
1,01922174900,01922181300,00000006400,a00,read
1,01922193000,01922194400,00000001400,a00,read
1,01922231400,01922232200,00000000800,a00,read
1,01922353900,01922354800,00000000900,a00,read
1,01922426000,01922426400,00000000400,a00,read
1,01922511100,01922511800,00000000700,a00,read
1,01922641500,01922642200,00000000700,a00,read
1,01922769800,01922770500,00000000700,a00,read
1,01922925300,01922926100,00000000800,a00,read
1,01923075100,01923075800,00000000700,a00,read
1,01923227700,01923228500,00000000800,a00,read
1,01923376300,01923377000,00000000700,a00,read
1,01923534000,01923534700,00000000700,a00,read
1,01923693900,01923694600,00000000700,a00,read
1,01923802700,01923803400,00000000700,a00,read
1,01923834200,01923834900,00000000700,a0c,brk
1,01923942300,01923943000,00000000700,a00,read
1,01924182200,01924182800,00000000600,a00,read
1,01924194500,01924195000,00000000500,a00,read
1,01924238100,01924238500,00000000400,a00,read
1,01924258600,01924259300,00000000700,a00,read
1,01924464900,01924465300,00000000400,a00,read
1,01924494000,01924494800,00000000800,a00,read
1,01924591400,01924592200,00000000800,a00,read
1,01924616000,01924617000,00000001000,a0c,brk
1,01924661900,01924662400,00000000500,a00,read
1,01924737900,01924738700,00000000800,a00,read
1,01924891500,01924891900,00000000400,a00,read
1,01925003300,01925003900,00000000600,a00,read
1,01925097400,01925097900,00000000500,a00,read
1,01925109400,01925109900,00000000500,a00,read
1,01925191900,01925192300,00000000400,a00,read
1,01925216000,01925216300,00000000300,a00,read
1,01925238200,01925238600,00000000400,a00,read
1,01925367600,01925368600,00000001000,a0c,brk
1,01925370500,01925371600,00000001100,a00,read
1,01925573000,01925573400,00000000400,a00,read
1,01925656600,01925657100,00000000500,a00,read
1,01925720800,01925721500,00000000700,a00,read
1,01925848900,01925849300,00000000400,a00,read
1,01925881600,01925882200,00000000600,a00,read
1,01925898600,01925900100,00000001500,a02,open
1,01926014200,01926014600,00000000400,a00,read
1,01926085100,01926085500,00000000400,a00,read
1,01926137400,01926138500,00000001100,a0c,brk
1,01926145100,01926145800,00000000700,a00,read
1,01926252700,01926253400,00000000700,a00,read
1,01926402400,01926403300,00000000900,a00,read
1,01926533100,01926533700,00000000600,a00,read
1,01926591300,01926592100,00000000800,a00,read
1,01926647300,01926648000,00000000700,a00,read
1,01926717400,01926718000,00000000600,a00,read
1,01926770300,01926770900,00000000600,a00,read
1,01926858300,01926859100,00000000800,a0c,brk
1,01926889500,01926893000,00000003500,a0c,brk
1,01926907200,01926908000,00000000800,a00,read
1,01927021700,01927022600,00000000900,a00,read
1,01927179800,01927180600,00000000800,a00,read
1,01927298300,01927298900,00000000600,a00,read
1,01927444100,01927444800,00000000700,a00,read
1,01927561900,01927562600,00000000700,a00,read
1,01927754700,01927755600,00000000900,a00,read
1,01927760700,01927761800,00000001100,a0c,brk
1,01927885900,01927886800,00000000900,a00,read
1,01928005100,01928005800,00000000700,a00,read
1,01928146300,01928147000,00000000700,a00,read
1,01928280900,01928281500,00000000600,a00,read
1,01928374300,01928374900,00000000600,a00,read
1,01928486500,01928487200,00000000700,a00,read
1,01928610300,01928611000,00000000700,a00,read
1,01928722200,01928723100,00000000900,a0c,brk
1,01928745900,01928746600,00000000700,a00,read
1,01928915200,01928915900,00000000700,a00,read
1,01929065400,01929066000,00000000600,a00,read
1,01929178400,01929179100,00000000700,a00,read
1,01929365000,01929366200,00000001200,a00,read
1,01929442900,01929443600,00000000700,a00,read
1,01929524700,01929525500,00000000800,a00,read
1,01929591700,01929592600,00000000900,a0c,brk
1,01929606300,01929607000,00000000700,a00,read
1,01929679400,01929680000,00000000600,a00,read
1,01929780900,01929781600,00000000700,a00,read
1,01929885400,01929886100,00000000700,a00,read
1,01929974900,01929975700,00000000800,a00,read
1,01930055800,01930056400,00000000600,a00,read
1,01930157300,01930158000,00000000700,a00,read
1,01930238600,01930239200,00000000600,a0c,brk
1,01930241700,01930242300,00000000600,a00,read
1,01930348800,01930349500,00000000700,a00,read
1,01930442700,01930443500,00000000800,a00,read
1,01930561600,01930562300,00000000700,a00,read
1,01930675200,01930675700,00000000500,a00,read
1,01930778300,01930778900,00000000600,a00,read
1,01930879000,01930879500,00000000500,a0c,brk
1,01931242600,01931246200,00000003600,a57,unlink
1,01931270100,01931270700,00000000600,a48,fcntl
1,01931317900,01931333300,00000015400,a01,write
1,01931351400,01931353800,00000002400,a01,write
1,01931370100,01931372300,00000002200,a01,write
1,01917760500,01931623100,00013862600,a17,select
1,01931647800,01931648000,00000000200,a2f,recvmsg
1,01931651200,01931681600,00000030400,a17,select
1,01931686100,01931686200,00000000100,a2f,recvmsg
1,01931686800,01931704700,00000017900,a17,select
1,01931708500,01931708700,00000000200,a2f,recvmsg
1,01931709100,01931725700,00000016600,a17,select
1,01931729400,01931729600,00000000200,a2f,recvmsg
1,01931730100,01931746500,00000016400,a17,select
1,01931750500,01931750700,00000000200,a2f,recvmsg
1,01931751200,01931765800,00000014600,a17,select
1,01931769100,01931769300,00000000200,a2f,recvmsg
1,01931769700,01931799000,00000029300,a17,select
1,01931803100,01931803300,00000000200,a2f,recvmsg
1,01931803800,01931812900,00000009100,a17,select
1,01931816400,01931816600,00000000200,a2f,recvmsg
1,01931817200,01931824600,00000007400,a17,select
1,01931828300,01931828500,00000000200,a2f,recvmsg
1,01931828900,01931837300,00000008400,a17,select
1,01931840700,01931840900,00000000200,a2f,recvmsg
1,01931841500,01931849600,00000008100,a17,select
1,01931853500,01931853700,00000000200,a2f,recvmsg
1,01931854200,01931861900,00000007700,a17,select
1,01931865400,01931865600,00000000200,a2f,recvmsg
1,01931866200,01931873500,00000007300,a17,select
1,01931877400,01931877600,00000000200,a2f,recvmsg
1,01931878000,01931885100,00000007100,a17,select
1,01931888700,01931888800,00000000100,a2f,recvmsg
1,01931889400,01931897600,00000008200,a17,select
1,01931901600,01931901800,00000000200,a2f,recvmsg
1,01931902400,01931909800,00000007400,a17,select
1,01931913400,01931913600,00000000200,a2f,recvmsg
1,01931914100,01931921500,00000007400,a17,select
1,01931925200,01931925400,00000000200,a2f,recvmsg
1,01931925800,01931933100,00000007300,a17,select
1,01931936900,01931937000,00000000100,a2f,recvmsg
1,01931937500,01931944800,00000007300,a17,select
1,01931948400,01931948500,00000000100,a2f,recvmsg
1,01931949100,01931956500,00000007400,a17,select
1,01931960000,01931960200,00000000200,a2f,recvmsg
1,01931960700,01931968100,00000007400,a17,select
1,01931971800,01931972000,00000000200,a2f,recvmsg
1,01931972500,01931979300,00000006800,a17,select
1,01931983000,01931983200,00000000200,a2f,recvmsg
1,01931983700,01931992500,00000008800,a17,select
1,01931996200,01931996400,00000000200,a2f,recvmsg
1,01931996900,01932003800,00000006900,a17,select
1,01932007500,01932007700,00000000200,a2f,recvmsg
1,01932008200,01932015100,00000006900,a17,select
1,01932018700,01932018900,00000000200,a2f,recvmsg
1,01932019400,01932026200,00000006800,a17,select
1,01932029900,01932030000,00000000100,a2f,recvmsg
1,01932030600,01932037700,00000007100,a17,select
1,01932041400,01932041600,00000000200,a2f,recvmsg
1,01932042100,01932049000,00000006900,a17,select
1,01932052600,01932052800,00000000200,a2f,recvmsg
1,01932053200,01932060700,00000007500,a17,select
1,01932064300,01932064500,00000000200,a2f,recvmsg
1,01932065100,01932072600,00000007500,a17,select
1,01932076600,01932076700,00000000100,a2f,recvmsg
1,01932077300,01932085100,00000007800,a17,select
1,01932089100,01932089300,00000000200,a2f,recvmsg
1,01932089800,01932097500,00000007700,a17,select
1,01932101000,01932101200,00000000200,a2f,recvmsg
1,01932101700,01932109400,00000007700,a17,select
1,01932113300,01932113500,00000000200,a2f,recvmsg
1,01932113900,01932123300,00000009400,a17,select
1,01932127000,01932127200,00000000200,a2f,recvmsg
1,01932127700,01932134900,00000007200,a17,select
1,01932138600,01932138700,00000000100,a2f,recvmsg
1,01932139300,01932147500,00000008200,a17,select
1,01932151300,01932151400,00000000100,a2f,recvmsg
1,01932151900,01932159900,00000008000,a17,select
1,01932163700,01932163800,00000000100,a2f,recvmsg
1,01932164400,01932172800,00000008400,a17,select
1,01932176500,01932176700,00000000200,a2f,recvmsg
1,01932177400,01932185200,00000007800,a17,select
1,01932189000,01932189200,00000000200,a2f,recvmsg
1,01932189700,01932197300,00000007600,a17,select
1,01932201100,01932201300,00000000200,a2f,recvmsg
1,01932201800,01932209000,00000007200,a17,select
1,01932212600,01932212800,00000000200,a2f,recvmsg
1,01932213300,01932220200,00000006900,a17,select
1,01932223900,01932224000,00000000100,a2f,recvmsg
1,01932224600,01932232000,00000007400,a17,select
1,01932235700,01932235900,00000000200,a2f,recvmsg
1,01932236400,01932252100,00000015700,a17,select
1,01932255700,01932255800,00000000100,a2f,recvmsg
1,01932256300,01932286100,00000029800,a17,select
1,01932289900,01932290000,00000000100,a2f,recvmsg
1,01932290500,01932309000,00000018500,a17,select
1,01932312600,01932312700,00000000100,a2f,recvmsg
1,01932313200,01932320400,00000007200,a17,select
1,01932324200,01932324400,00000000200,a2f,recvmsg
1,01932324800,01932331600,00000006800,a17,select
1,01932335200,01932335300,00000000100,a2f,recvmsg
1,01932335900,01932342700,00000006800,a17,select
1,01932346300,01932346500,00000000200,a2f,recvmsg
1,01932347000,01932353900,00000006900,a17,select
1,01932357700,01932357800,00000000100,a2f,recvmsg
1,01932358400,01932365300,00000006900,a17,select
1,01932369100,01932369300,00000000200,a2f,recvmsg
1,01932369800,01932376600,00000006800,a17,select
1,01932380200,01932380300,00000000100,a2f,recvmsg
1,01932380900,01932388300,00000007400,a17,select
1,01932392100,01932392300,00000000200,a2f,recvmsg
1,01932392900,01932399900,00000007000,a17,select
1,01932403500,01932403700,00000000200,a2f,recvmsg
1,01932404300,01932413000,00000008700,a17,select
1,01932416700,01932416800,00000000100,a2f,recvmsg
1,01932417400,01932426400,00000009000,a17,select
1,01932430200,01932430300,00000000100,a2f,recvmsg
1,01932430900,01932438500,00000007600,a17,select
1,01932442100,01932442300,00000000200,a2f,recvmsg
1,01932442700,01932449900,00000007200,a17,select
1,01932453500,01932453700,00000000200,a2f,recvmsg
1,01932454100,01932461300,00000007200,a17,select
1,01932465000,01932465100,00000000100,a2f,recvmsg
1,01932465600,01932472700,00000007100,a17,select
1,01932476300,01932476500,00000000200,a2f,recvmsg
1,01932476900,01932484500,00000007600,a17,select
1,01932488100,01932488300,00000000200,a2f,recvmsg
1,01932488800,01932495900,00000007100,a17,select
1,01932499400,01932499600,00000000200,a2f,recvmsg
1,01932500100,01932507300,00000007200,a17,select
1,01932511000,01932511200,00000000200,a2f,recvmsg
1,01932511700,01932518800,00000007100,a17,select
1,01932522300,01932522500,00000000200,a2f,recvmsg
1,01932523000,01932530200,00000007200,a17,select
1,01932533900,01932534100,00000000200,a2f,recvmsg
1,01932534700,01932541900,00000007200,a17,select
1,01932545500,01932545700,00000000200,a2f,recvmsg
1,01932546200,01932554200,00000008000,a17,select
1,01932557900,01932558100,00000000200,a2f,recvmsg
1,01932558500,01932565700,00000007200,a17,select
1,01932569200,01932569400,00000000200,a2f,recvmsg
1,01932569900,01932577000,00000007100,a17,select
1,01932580600,01932580800,00000000200,a2f,recvmsg
1,01932581200,01932588500,00000007300,a17,select
1,01932592100,01932592300,00000000200,a2f,recvmsg
1,01932592700,01932605100,00000012400,a17,select
1,01932608900,01932609000,00000000100,a2f,recvmsg
1,01932609500,01932616900,00000007400,a17,select
1,01932620500,01932620700,00000000200,a2f,recvmsg
1,01932621100,01932628400,00000007300,a17,select
1,01932632000,01932632200,00000000200,a2f,recvmsg
1,01932632700,01932640000,00000007300,a17,select
1,01932643600,01932643700,00000000100,a2f,recvmsg
1,01932644200,01932651400,00000007200,a17,select
1,01932655200,01932655300,00000000100,a2f,recvmsg
1,01932655900,01932713600,00000057700,a17,select
1,01932714400,01932715700,00000001300,a2f,recvmsg
1,01932806200,01932810500,00000004300,a14,writev
1,01932887700,01932890200,00000002500,a14,writev
1,01932947300,01932949100,00000001800,a14,writev
1,01933004800,01933006900,00000002100,a14,writev
1,01933062600,01933064100,00000001500,a14,writev
1,01933118600,01933120100,00000001500,a14,writev
1,01933123600,01933124400,00000000800,a2f,recvmsg
1,01933174600,01933176100,00000001500,a14,writev
1,01933220300,01933221800,00000001500,a14,writev
1,01933265100,01933266700,00000001600,a14,writev
1,01933310100,01933311600,00000001500,a14,writev
1,01933374200,01933375700,00000001500,a14,writev
1,01933419700,01933421200,00000001500,a14,writev
1,01933446600,01933448300,00000001700,a2f,recvmsg
1,01933475200,01933476700,00000001500,a14,writev
1,01933494900,01933496600,00000001700,a14,writev
1,01933513000,01933514500,00000001500,a14,writev
1,01933529300,01933530900,00000001600,a14,writev
1,01933545300,01933546700,00000001400,a14,writev
1,01933560700,01933562200,00000001500,a14,writev
1,01933567000,01933567100,00000000100,a2f,recvmsg
1,01933567800,01933568200,00000000400,a14,writev
1,01933568500,01933568900,00000000400,a14,writev
1,01933587500,01933589100,00000001600,a14,writev
1,01933589300,01933590700,00000001400,a14,writev
1,01933591200,01933591400,00000000200,a2f,recvmsg
1,01933604300,01933605300,00000001000,a14,writev
1,01933605700,01933605800,00000000100,a2f,recvmsg
1,01933616800,01933618200,00000001400,a14,writev
1,01933618400,01933619400,00000001000,a14,writev
1,01933619700,01933619800,00000000100,a2f,recvmsg
1,01920937100,01933627400,00012690300,a07,poll
1,01933633100,01933635700,00000002600,a2f,recvmsg
1,01933641200,01933641300,00000000100,a2f,recvmsg
1,01933645000,01933645200,00000000200,a2f,recvmsg
1,01933645500,01933645700,00000000200,a2f,recvmsg
1,01933650100,01933650300,00000000200,a2f,recvmsg
1,01933650500,01933650600,00000000100,a2f,recvmsg
1,01933651400,01933656200,00000004800,a07,poll
1,01933661700,01933667500,00000005800,a2f,recvmsg
1,01933680400,01933680600,00000000200,a2f,recvmsg
1,01933620300,01933710500,00000090200,a17,select
1,01933723400,01933724700,00000001300,a14,writev
1,01933725000,01933725200,00000000200,a2f,recvmsg
1,01933705200,01933732200,00000027000,a07,poll
1,01933732500,01933733700,00000001200,a2f,recvmsg
1,01933738700,01933741500,00000002800,a2d,recvfrom
1,01933742400,01933742600,00000000200,a2f,recvmsg
1,01933743100,01933743300,00000000200,a2f,recvmsg
1,01933771500,01933771700,00000000200,a2f,recvmsg
1,01933773400,01933773500,00000000100,a2f,recvmsg
1,01933726400,01933795200,00000068800,a17,select
1,01933810000,01933810200,00000000200,a2f,recvmsg
1,01933777200,01934461000,00000683800,a07,poll
1,01934483600,01934487700,00000004100,a2e,sendmsg
1,01918916200,01934491300,00015575100,ae8,epoll_wait
1,01934502100,01934503800,00000001700,a2f,recvmsg
1,01934518700,01934519000,00000000300,a2f,recvmsg
1,01934542100,01934545400,00000003300,a2e,sendmsg
1,01933777200,01934553900,00000776700,a07,poll
1,01934555100,01934556100,00000001000,a00,read
1,01934572600,01934573800,00000001200,a2f,recvmsg
1,01934657700,01934662200,00000004500,a07,poll
1,01934811300,01934812300,00000001000,a2f,recvmsg
1,01934818200,01934818400,00000000200,a2f,recvmsg
1,01934862800,01934863100,00000000300,a00,read
1,01934869800,01934873700,00000003900,a2e,sendmsg
1,01934548600,01934875900,00000327300,ae8,epoll_wait
1,01934880400,01934881700,00000001300,a2f,recvmsg
1,01934894500,01934894800,00000000300,a2f,recvmsg
1,01934907700,01934909800,00000002100,a2e,sendmsg
1,01934861700,01934914800,00000053100,a07,poll
1,01934915500,01934916000,00000000500,a00,read
1,01934923700,01934924700,00000001000,a2f,recvmsg
1,01934989700,01934992200,00000002500,a07,poll
1,01935305000,01935306000,00000001000,a2f,recvmsg
1,01933811100,01935896500,00002085400,a17,select
1,01935916400,01935916600,00000000200,a2f,recvmsg
1,01935929300,01935929400,00000000100,a2f,recvmsg
1,01935930100,01935994100,00000064000,a17,select
1,01935998200,01935998400,00000000200,a2f,recvmsg
1,01897293800,01946147200,00048853400,a4a,fsync
1,01946155900,01946180300,00000024400,a52,rename
1,01946213200,01946218900,00000005700,a09,mmap
1,01946297700,01946302600,00000004900,a01,write
1,01946497700,01946503400,00000005700,a01,write
1,01934912300,01946545400,00011633100,ae8,epoll_wait
1,01946559900,01946565300,00000005400,a2f,recvmsg
1,01946584900,01946585100,00000000200,a2f,recvmsg
1,01946631000,01946631900,00000000900,a2e,sendmsg
1,01946362500,01946642400,00000279900,a07,poll
1,01946695400,01946697000,00000001600,60e,page_fault
1,01935999000,01946713900,00010714900,a17,select
1,01946734800,01946735000,00000000200,a2f,recvmsg
1,01946738500,01946749200,00000010700,a17,select
1,01946754200,01946754400,00000000200,a2f,recvmsg
1,01946755000,01946763800,00000008800,a17,select
1,01946768100,01946768300,00000000200,a2f,recvmsg
1,01946760600,01946772500,00000011900,60e,page_fault
1,01946768800,01946777500,00000008700,a17,select
1,01946782300,01946782400,00000000100,a2f,recvmsg
1,01946783000,01946797700,00000014700,a17,select
1,01946803600,01946803800,00000000200,a2f,recvmsg
1,01946804400,01946840500,00000036100,a17,select
1,01946845900,01946846100,00000000200,a2f,recvmsg
1,01946846800,01946867900,00000021100,a17,select
1,01946872800,01946872900,00000000100,a2f,recvmsg
1,01946873500,01946882800,00000009300,a17,select
1,01946887300,01946887400,00000000100,a2f,recvmsg
1,01946888000,01946896000,00000008000,a17,select
1,01946899900,01946900100,00000000200,a2f,recvmsg
1,01946900700,01946909200,00000008500,a17,select
1,01946913200,01946913400,00000000200,a2f,recvmsg
1,01946918800,01946919700,00000000900,60e,page_fault
1,01946914000,01946922300,00000008300,a17,select
1,01946926700,01946926900,00000000200,a2f,recvmsg
1,01946927500,01946935900,00000008400,a17,select
1,01946940300,01946940500,00000000200,a2f,recvmsg
1,01946932700,01946944400,00000011700,60e,page_fault
1,01946941200,01946949400,00000008200,a17,select
1,01946953800,01946954000,00000000200,a2f,recvmsg
1,01946954500,01946962100,00000007600,a17,select
1,01946966000,01946966100,00000000100,a2f,recvmsg
1,01946966700,01946975600,00000008900,a17,select
1,01946979800,01946980000,00000000200,a2f,recvmsg
1,01946980600,01946988500,00000007900,a17,select
1,01946992900,01946993100,00000000200,a2f,recvmsg
1,01946993600,01947001400,00000007800,a17,select
1,01947005500,01947005600,00000000100,a2f,recvmsg
1,01947006100,01947014900,00000008800,a17,select
1,01947019000,01947019100,00000000100,a2f,recvmsg
1,01947019700,01947027500,00000007800,a17,select
1,01947031400,01947031600,00000000200,a2f,recvmsg
1,01947024500,01947035400,00000010900,60e,page_fault
1,01947032200,01947040000,00000007800,a17,select
1,01947044300,01947044400,00000000100,a2f,recvmsg
1,01947049900,01947050600,00000000700,60e,page_fault
1,01947045000,01947053300,00000008300,a17,select
1,01947057400,01947057600,00000000200,a2f,recvmsg
1,01947058200,01947065800,00000007600,a17,select
1,01947070100,01947070300,00000000200,a2f,recvmsg
1,01947070700,01947080500,00000009800,a17,select
1,01947084800,01947084900,00000000100,a2f,recvmsg
1,01947077400,01947089000,00000011600,60e,page_fault
1,01947085600,01947092900,00000007300,a17,select
1,01947097000,01947097100,00000000100,a2f,recvmsg
1,01947101800,01947102600,00000000800,60e,page_fault
1,01947097700,01947105200,00000007500,a17,select
1,01947109200,01947109300,00000000100,a2f,recvmsg
1,01947109900,01947117200,00000007300,a17,select
1,01947121300,01947121400,00000000100,a2f,recvmsg
1,01947121900,01947129900,00000008000,a17,select
1,01947134100,01947134300,00000000200,a2f,recvmsg
1,01947126900,01947138000,00000011100,60e,page_fault
1,01947134800,01947143200,00000008400,a17,select
1,01947147600,01947147800,00000000200,a2f,recvmsg
1,01947148300,01947166500,00000018200,a17,select
1,01947171300,01947171500,00000000200,a2f,recvmsg
1,01947172100,01947181300,00000009200,a17,select
1,01947185600,01947185700,00000000100,a2f,recvmsg
1,01947178200,01947189600,00000011400,60e,page_fault
1,01947191700,01947192300,00000000600,60e,page_fault
1,01947186300,01947195100,00000008800,a17,select
1,01947199600,01947199600,00000000000,a2f,recvmsg
1,01947200200,01947208800,00000008600,a17,select
1,01947212900,01947213100,00000000200,a2f,recvmsg
1,01947213700,01947221800,00000008100,a17,select
1,01947226200,01947226400,00000000200,a2f,recvmsg
1,01947227000,01947237100,00000010100,a17,select
1,01947241400,01947241600,00000000200,a2f,recvmsg
1,01947242200,01947250000,00000007800,a17,select
1,01947254100,01947254300,00000000200,a2f,recvmsg
1,01947254800,01947262500,00000007700,a17,select
1,01947267100,01947267300,00000000200,a2f,recvmsg
1,01947267900,01947276400,00000008500,a17,select
1,01947280700,01947280900,00000000200,a2f,recvmsg
1,01947281500,01947290600,00000009100,a17,select
1,01947294900,01947295100,00000000200,a2f,recvmsg
1,01947295700,01947304100,00000008400,a17,select
1,01947308400,01947308600,00000000200,a2f,recvmsg
1,01947309200,01947317300,00000008100,a17,select
1,01947321400,01947321600,00000000200,a2f,recvmsg
1,01947322100,01947330000,00000007900,a17,select
1,01947334200,01947334300,00000000100,a2f,recvmsg
1,01947334800,01947342500,00000007700,a17,select
1,01947346600,01947346700,00000000100,a2f,recvmsg
1,01947347300,01947355400,00000008100,a17,select
1,01947359500,01947359600,00000000100,a2f,recvmsg
1,01947360200,01947378000,00000017800,a17,select
1,01947383000,01947383200,00000000200,a2f,recvmsg
1,01947404800,01947405400,00000000600,a2f,recvmsg
1,01947407900,01947408100,00000000200,a00,read
1,01947383900,01947414600,00000030700,a17,select
1,01947420000,01947420100,00000000100,a2f,recvmsg
1,01947407700,01947425400,00000017700,a07,poll
1,01947421000,01947439900,00000018900,a17,select
1,01947444800,01947445000,00000000200,a2f,recvmsg
1,01947445700,01947453100,00000007400,a17,select
1,01947457300,01947457500,00000000200,a2f,recvmsg
1,01947450100,01947461300,00000011200,60e,page_fault
1,01947458000,01947465600,00000007600,a17,select
1,01947469600,01947469800,00000000200,a2f,recvmsg
1,01947470400,01947477700,00000007300,a17,select
1,01947481900,01947482100,00000000200,a2f,recvmsg
1,01947482600,01947490100,00000007500,a17,select
1,01947494100,01947494200,00000000100,a2f,recvmsg
1,01947494800,01947502200,00000007400,a17,select
1,01947506400,01947506500,00000000100,a2f,recvmsg
1,01947507100,01947514400,00000007300,a17,select
1,01947518500,01947518600,00000000100,a2f,recvmsg
1,01947519100,01947527100,00000008000,a17,select
1,01947531400,01947531600,00000000200,a2f,recvmsg
1,01947532100,01947539800,00000007700,a17,select
1,01947544100,01947544300,00000000200,a2f,recvmsg
1,01947544800,01947553800,00000009000,a17,select
1,01947558100,01947558200,00000000100,a2f,recvmsg
1,01947558700,01947568500,00000009800,a17,select
1,01947573200,01947573400,00000000200,a2f,recvmsg
1,01947574000,01947581800,00000007800,a17,select
1,01947585700,01947585900,00000000200,a2f,recvmsg
1,01947586400,01947594000,00000007600,a17,select
1,01947598100,01947598300,00000000200,a2f,recvmsg
1,01947598800,01947606700,00000007900,a17,select
1,01947610700,01947610900,00000000200,a2f,recvmsg
1,01947603700,01947614700,00000011000,60e,page_fault
1,01947611500,01947619200,00000007700,a17,select
1,01947623400,01947623600,00000000200,a2f,recvmsg
1,01947624200,01947632300,00000008100,a17,select
1,01947636500,01947636600,00000000100,a2f,recvmsg
1,01947637100,01947644700,00000007600,a17,select
1,01947648600,01947648800,00000000200,a2f,recvmsg
1,01947649300,01947657200,00000007900,a17,select
1,01947661300,01947661500,00000000200,a2f,recvmsg
1,01947654200,01947665300,00000011100,60e,page_fault
1,01947662000,01947669600,00000007600,a17,select
1,01947673700,01947673900,00000000200,a2f,recvmsg
1,01947674400,01947682200,00000007800,a17,select
1,01947686200,01947686400,00000000200,a2f,recvmsg
1,01947686900,01947694800,00000007900,a17,select
1,01947698800,01947698900,00000000100,a2f,recvmsg
1,01947699400,01947707700,00000008300,a17,select
1,01947711900,01947712100,00000000200,a2f,recvmsg
1,01947712600,01947720300,00000007700,a17,select
1,01947724500,01947724700,00000000200,a2f,recvmsg
1,01947725200,01947732900,00000007700,a17,select
1,01947736900,01947737100,00000000200,a2f,recvmsg
1,01947737500,01947745300,00000007800,a17,select
1,01947749300,01947749500,00000000200,a2f,recvmsg
1,01947750100,01947763300,00000013200,a17,select
1,01947767700,01947767800,00000000100,a2f,recvmsg
1,01947768400,01947776300,00000007900,a17,select
1,01947780400,01947780600,00000000200,a2f,recvmsg
1,01947781000,01947788700,00000007700,a17,select
1,01947792800,01947793000,00000000200,a2f,recvmsg
1,01947793600,01947801500,00000007900,a17,select
1,01947805500,01947805700,00000000200,a2f,recvmsg
1,01947806200,01947814100,00000007900,a17,select
1,01947818300,01947818500,00000000200,a2f,recvmsg
1,01947850200,01947862500,00000012300,60e,page_fault
1,01947819000,01947875300,00000056300,a17,select
1,01947877800,01947879500,00000001700,a2f,recvmsg
1,01947968200,01947971800,00000003600,a14,writev
1,01947859600,01947983100,00000123500,a07,poll
1,01947995900,01947996100,00000000200,a2f,recvmsg
1,01948013600,01948013900,00000000300,a2f,recvmsg
1,01948014800,01948015000,00000000200,a2f,recvmsg
1,01948018300,01948036300,00000018000,a07,poll
1,01948039400,01948039500,00000000100,a2f,recvmsg
1,01948045800,01948112900,00000067100,a07,poll
1,01948170600,01948172600,00000002000,a14,writev
1,01948114400,01948176900,00000062500,a07,poll
1,01948233600,01948235200,00000001600,a14,writev
1,01948178100,01948239800,00000061700,a07,poll
1,01948295700,01948297300,00000001600,a14,writev
1,01948240900,01948301500,00000060600,a07,poll
1,01948302600,01948360500,00000057900,a07,poll
1,01948365200,01948365400,00000000200,a2f,recvmsg
1,01948367200,01948367400,00000000200,a2f,recvmsg
1,01948367700,01948367900,00000000200,a2f,recvmsg
1,01948369700,01948369900,00000000200,a2f,recvmsg
1,01948370000,01948370100,00000000100,a2f,recvmsg
1,01948370600,01948376100,00000005500,a07,poll
1,01948381700,01948382500,00000000800,a2f,recvmsg
1,01948431700,01948433300,00000001600,a14,writev
1,01948377600,01948435500,00000057900,a07,poll
1,01948480500,01948482100,00000001600,a14,writev
1,01948436700,01948484000,00000047300,a07,poll
1,01948528900,01948530400,00000001500,a14,writev
1,01948485300,01948532200,00000046900,a07,poll
1,01948576800,01948578300,00000001500,a14,writev
1,01948533300,01948580100,00000046800,a07,poll
1,01948625100,01948626500,00000001400,a14,writev
1,01948581300,01948628500,00000047200,a07,poll
1,01948673400,01948674900,00000001500,a14,writev
1,01948629700,01948676900,00000047200,a07,poll
1,01948703300,01948705600,00000002300,a2f,recvmsg
1,01948730700,01948732100,00000001400,a14,writev
1,01948678100,01948734400,00000056300,a07,poll
1,01948753700,01948755100,00000001400,a14,writev
1,01948735800,01948757300,00000021500,a07,poll
1,01948774600,01948776100,00000001500,a14,writev
1,01948758500,01948777900,00000019400,a07,poll
1,01948794700,01948796100,00000001400,a14,writev
1,01948779000,01948797900,00000018900,a07,poll
1,01948813700,01948815000,00000001300,a14,writev
1,01948799000,01948817000,00000018000,a07,poll
1,01948832400,01948833800,00000001400,a14,writev
1,01948818200,01948835700,00000017500,a07,poll
1,01948842100,01948842300,00000000200,a2f,recvmsg
1,01948843000,01948843300,00000000300,a14,writev
1,01948843800,01948844200,00000000400,a14,writev
1,01948864200,01948865800,00000001600,a14,writev
1,01948865900,01948867300,00000001400,a14,writev
1,01948867800,01948867900,00000000100,a2f,recvmsg
1,01948882100,01948883000,00000000900,a14,writev
1,01948883300,01948883400,00000000100,a2f,recvmsg
1,01948836900,01948896100,00000059200,a07,poll
1,01948898000,01948898200,00000000200,a2d,recvfrom
1,01948899900,01948901500,00000001600,a14,writev
1,01948898400,01948902100,00000003700,a07,poll
1,01948902300,01948903400,00000001100,a2d,recvfrom
1,01948908700,01948908900,00000000200,a2f,recvmsg
1,01948909600,01948909800,00000000200,a2f,recvmsg
1,01948938700,01948939000,00000000300,a2f,recvmsg
1,01948940700,01948940800,00000000100,a2f,recvmsg
1,01948947300,01948947600,00000000300,a2f,recvmsg
1,01948962400,01948963300,00000000900,a14,writev
1,01948963700,01948963800,00000000100,a2f,recvmsg
1,01949031100,01949034200,00000003100,a2e,sendmsg
1,01946634200,01949037300,00002403100,ae8,epoll_wait
1,01949045800,01949047000,00000001200,a2f,recvmsg
1,01949058800,01949059100,00000000300,a2f,recvmsg
1,01949077400,01949079700,00000002300,a2e,sendmsg
1,01948964400,01949089700,00000125300,a17,select
1,01949026000,01949105800,00000079800,a07,poll
1,01949110400,01949110600,00000000200,a2f,recvmsg
1,01949112400,01949112600,00000000200,a2f,recvmsg
1,01949112800,01949112900,00000000100,a2f,recvmsg
1,01949114500,01949114700,00000000200,a2f,recvmsg
1,01949114800,01949115000,00000000200,a2f,recvmsg
1,01949120600,01949120800,00000000200,a2f,recvmsg
1,01949115400,01949127600,00000012200,a07,poll
1,01949122400,01951102700,00001980300,a17,select
1,01951117800,01951118100,00000000300,a2f,recvmsg
1,01951120100,01951130900,00000010800,a17,select
1,01951135700,01951135800,00000000100,a2f,recvmsg
1,01951136400,01951197200,00000060800,a17,select
1,01951202600,01951202800,00000000200,a2f,recvmsg
0,01910619300,01910620200,00000000900,a0c,brk
0,01910651300,01910655200,00000003900,a0c,brk
0,01910669800,01910670700,00000000900,a00,read
0,01910785600,01910786300,00000000700,a00,read
0,01910964800,01910965700,00000000900,a00,read
0,01911082600,01911083300,00000000700,a00,read
0,01911228100,01911228900,00000000800,a00,read
0,01911345500,01911346200,00000000700,a00,read
0,01911507100,01911507700,00000000600,a00,read
0,01911512700,01911513500,00000000800,a0c,brk
0,01911628500,01911629200,00000000700,a00,read
0,01911748900,01911749500,00000000600,a00,read
0,01911890400,01911891200,00000000800,a00,read
0,01912021200,01912021800,00000000600,a00,read
0,01912114300,01912115000,00000000700,a00,read
0,01912226500,01912227200,00000000700,a00,read
0,01912350400,01912351100,00000000700,a00,read
0,01912462100,01912462800,00000000700,a0c,brk
0,01912485400,01912486100,00000000700,a00,read
0,01912655600,01912656300,00000000700,a00,read
0,01912805500,01912806300,00000000800,a00,read
0,01912915900,01912916700,00000000800,a00,read
0,01913085300,01913086200,00000000900,a00,read
0,01913162500,01913163200,00000000700,a00,read
0,01913244200,01913245000,00000000800,a00,read
0,01913311700,01913312400,00000000700,a0c,brk
0,01913325900,01913326500,00000000600,a00,read
0,01913400100,01913400900,00000000800,a00,read
0,01913501100,01913502000,00000000900,a00,read
0,01913603900,01913604600,00000000700,a00,read
0,01913693500,01913694200,00000000700,a00,read
0,01913774300,01913775000,00000000700,a00,read
0,01913875700,01913876400,00000000700,a00,read
0,01913956900,01913957400,00000000500,a0c,brk
0,01913959900,01913960500,00000000600,a00,read
0,01914068300,01914068900,00000000600,a00,read
0,01914161300,01914161900,00000000600,a00,read
0,01914280200,01914280900,00000000700,a00,read
0,01914393700,01914394300,00000000600,a00,read
0,01914496900,01914497500,00000000600,a00,read
0,01914597300,01914597800,00000000500,a0c,brk
0,01914978000,01914981000,00000003000,a57,unlink
0,01915005000,01915005500,00000000500,a48,fcntl
0,01915052600,01915067800,00000015200,a01,write
0,01915085800,01915088300,00000002500,a01,write
0,01915104500,01915107200,00000002700,a01,write
0,01902312400,01915353000,00013040600,a17,select
0,01915378200,01915378500,00000000300,a2f,recvmsg
0,01915382100,01915411400,00000029300,a17,select
0,01915415900,01915415900,00000000000,a2f,recvmsg
0,01915416600,01915434600,00000018000,a17,select
0,01915438500,01915438700,00000000200,a2f,recvmsg
0,01915439200,01915455800,00000016600,a17,select
0,01915459600,01915459800,00000000200,a2f,recvmsg
0,01915460400,01915476800,00000016400,a17,select
0,01915481000,01915481200,00000000200,a2f,recvmsg
0,01915481800,01915497200,00000015400,a17,select
0,01915500600,01915500700,00000000100,a2f,recvmsg
0,01915501300,01915530200,00000028900,a17,select
0,01915534100,01915534300,00000000200,a2f,recvmsg
0,01915534900,01915544000,00000009100,a17,select
0,01915547700,01915547900,00000000200,a2f,recvmsg
0,01915548400,01915556000,00000007600,a17,select
0,01915559600,01915559800,00000000200,a2f,recvmsg
0,01915560300,01915568000,00000007700,a17,select
0,01915571600,01915571700,00000000100,a2f,recvmsg
0,01915572200,01915580700,00000008500,a17,select
0,01915584600,01915584800,00000000200,a2f,recvmsg
0,01915585200,01915592900,00000007700,a17,select
0,01915596600,01915596800,00000000200,a2f,recvmsg
0,01915597300,01915604900,00000007600,a17,select
0,01915608800,01915609000,00000000200,a2f,recvmsg
0,01915609500,01915616600,00000007100,a17,select
0,01915620200,01915620300,00000000100,a2f,recvmsg
0,01915620900,01915629300,00000008400,a17,select
0,01915633300,01915633500,00000000200,a2f,recvmsg
0,01915634000,01915641600,00000007600,a17,select
0,01915645400,01915645600,00000000200,a2f,recvmsg
0,01915646000,01915653400,00000007400,a17,select
0,01915657100,01915657200,00000000100,a2f,recvmsg
0,01915657700,01915665000,00000007300,a17,select
0,01915668800,01915669000,00000000200,a2f,recvmsg
0,01915669600,01915676900,00000007300,a17,select
0,01915680500,01915680700,00000000200,a2f,recvmsg
0,01915681200,01915688900,00000007700,a17,select
0,01915692500,01915692700,00000000200,a2f,recvmsg
0,01915693300,01915701200,00000007900,a17,select
0,01915704900,01915705100,00000000200,a2f,recvmsg
0,01915705600,01915712500,00000006900,a17,select
0,01915716400,01915716600,00000000200,a2f,recvmsg
0,01915717200,01915726200,00000009000,a17,select
0,01915729700,01915729900,00000000200,a2f,recvmsg
0,01915730400,01915737400,00000007000,a17,select
0,01915741400,01915741600,00000000200,a2f,recvmsg
0,01915742100,01915749100,00000007000,a17,select
0,01915752700,01915752900,00000000200,a2f,recvmsg
0,01915753400,01915761100,00000007700,a17,select
0,01915764800,01915764900,00000000100,a2f,recvmsg
0,01915765500,01915772700,00000007200,a17,select
0,01915776400,01915776600,00000000200,a2f,recvmsg
0,01915777000,01915784300,00000007300,a17,select
0,01915787900,01915788100,00000000200,a2f,recvmsg
0,01915788500,01915796100,00000007600,a17,select
0,01915799700,01915799800,00000000100,a2f,recvmsg
0,01915800300,01915807800,00000007500,a17,select
0,01915811500,01915811700,00000000200,a2f,recvmsg
0,01915812200,01915821100,00000008900,a17,select
0,01915825000,01915825200,00000000200,a2f,recvmsg
0,01915825700,01915833500,00000007800,a17,select
0,01915836900,01915837100,00000000200,a2f,recvmsg
0,01915837600,01915845300,00000007700,a17,select
0,01915849200,01915849300,00000000100,a2f,recvmsg
0,01915849900,01915859500,00000009600,a17,select
0,01915863200,01915863400,00000000200,a2f,recvmsg
0,01915864000,01915871300,00000007300,a17,select
0,01915874900,01915875100,00000000200,a2f,recvmsg
0,01915875600,01915883000,00000007400,a17,select
0,01915886700,01915886900,00000000200,a2f,recvmsg
0,01915887300,01915895800,00000008500,a17,select
0,01915899500,01915899700,00000000200,a2f,recvmsg
0,01915900200,01915907900,00000007700,a17,select
0,01915911700,01915911800,00000000100,a2f,recvmsg
0,01915912300,01915920300,00000008000,a17,select
0,01915924100,01915924300,00000000200,a2f,recvmsg
0,01915924900,01915932500,00000007600,a17,select
0,01915936400,01915936500,00000000100,a2f,recvmsg
0,01915937000,01915944500,00000007500,a17,select
0,01915948200,01915948300,00000000100,a2f,recvmsg
0,01915948900,01915955900,00000007000,a17,select
0,01915959600,01915959800,00000000200,a2f,recvmsg
0,01915960300,01915968100,00000007800,a17,select
0,01915971900,01915972100,00000000200,a2f,recvmsg
0,01915972600,01915988500,00000015900,a17,select
0,01915992000,01915992200,00000000200,a2f,recvmsg
0,01915992800,01916022000,00000029200,a17,select
0,01916025800,01916025800,00000000000,a2f,recvmsg
0,01916026400,01916044300,00000017900,a17,select
0,01916048100,01916048200,00000000100,a2f,recvmsg
0,01916048700,01916055900,00000007200,a17,select
0,01916059400,01916059600,00000000200,a2f,recvmsg
0,01916060000,01916067000,00000007000,a17,select
0,01916070700,01916070900,00000000200,a2f,recvmsg
0,01916071400,01916078400,00000007000,a17,select
0,01916081900,01916082100,00000000200,a2f,recvmsg
0,01916082700,01916089600,00000006900,a17,select
0,01916093200,01916093300,00000000100,a2f,recvmsg
0,01916093900,01916101000,00000007100,a17,select
0,01916104700,01916104800,00000000100,a2f,recvmsg
0,01916105400,01916112400,00000007000,a17,select
0,01916116000,01916116100,00000000100,a2f,recvmsg
0,01916116700,01916124400,00000007700,a17,select
0,01916128100,01916128200,00000000100,a2f,recvmsg
0,01916128700,01916135900,00000007200,a17,select
0,01916139600,01916139800,00000000200,a2f,recvmsg
0,01916140200,01916148900,00000008700,a17,select
0,01916152600,01916152800,00000000200,a2f,recvmsg
0,01916153200,01916162500,00000009300,a17,select
0,01916166300,01916166400,00000000100,a2f,recvmsg
0,01916166900,01916174700,00000007800,a17,select
0,01916178300,01916178500,00000000200,a2f,recvmsg
0,01916179000,01916186300,00000007300,a17,select
0,01916190000,01916190200,00000000200,a2f,recvmsg
0,01916190700,01916197900,00000007200,a17,select
0,01916201500,01916201700,00000000200,a2f,recvmsg
0,01916202200,01916209500,00000007300,a17,select
0,01916213300,01916213400,00000000100,a2f,recvmsg
0,01916213900,01916222800,00000008900,a17,select
0,01916226500,01916226700,00000000200,a2f,recvmsg
0,01916227200,01916234400,00000007200,a17,select
0,01916238000,01916238200,00000000200,a2f,recvmsg
0,01916238600,01916246000,00000007400,a17,select
0,01916249700,01916249800,00000000100,a2f,recvmsg
0,01916250300,01916257600,00000007300,a17,select
0,01916261300,01916261400,00000000100,a2f,recvmsg
0,01916261900,01916269300,00000007400,a17,select
0,01916272900,01916273100,00000000200,a2f,recvmsg
0,01916273600,01916280800,00000007200,a17,select
0,01916284400,01916284600,00000000200,a2f,recvmsg
0,01916285100,01916293200,00000008100,a17,select
0,01916296900,01916297000,00000000100,a2f,recvmsg
0,01916297500,01916304700,00000007200,a17,select
0,01916308400,01916308500,00000000100,a2f,recvmsg
0,01916309000,01916316200,00000007200,a17,select
0,01916319900,01916320000,00000000100,a2f,recvmsg
0,01916320500,01916327800,00000007300,a17,select
0,01916331400,01916331600,00000000200,a2f,recvmsg
0,01916332000,01916344700,00000012700,a17,select
0,01916348400,01916348600,00000000200,a2f,recvmsg
0,01916349000,01916356400,00000007400,a17,select
0,01916360100,01916360200,00000000100,a2f,recvmsg
0,01916360700,01916368200,00000007500,a17,select
0,01916371700,01916371900,00000000200,a2f,recvmsg
0,01916372400,01916379900,00000007500,a17,select
0,01916383500,01916383700,00000000200,a2f,recvmsg
0,01916384200,01916391600,00000007400,a17,select
0,01916395300,01916395400,00000000100,a2f,recvmsg
0,01916396000,01916454600,00000058600,a17,select
0,01916455600,01916456800,00000001200,a2f,recvmsg
0,01916884800,01916885600,00000000800,a2f,recvmsg
0,01917179500,01917181400,00000001900,a2f,recvmsg
0,01917291100,01917291200,00000000100,a2f,recvmsg
0,01917291900,01917292400,00000000500,a14,writev
0,01917292800,01917293100,00000000300,a14,writev
0,01917310900,01917313600,00000002700,a14,writev
0,01917313800,01917315800,00000002000,a14,writev
0,01917316300,01917316500,00000000200,a2f,recvmsg
0,01917345800,01917324900,-0000020900,a07,poll
0,01917331100,01917333900,00000002800,a2f,recvmsg
0,01917339000,01917339200,00000000200,a2f,recvmsg
0,01917342700,01917342900,00000000200,a2f,recvmsg
0,01917343100,01917343300,00000000200,a2f,recvmsg
0,01917348000,01917348200,00000000200,a2f,recvmsg
0,01917348300,01917348500,00000000200,a2f,recvmsg
0,01917349400,01917353100,00000003700,a07,poll
0,01917357200,01917363700,00000006500,a2f,recvmsg
0,01917374600,01917374800,00000000200,a2f,recvmsg
0,01917400600,01917405500,00000004900,a07,poll
0,01917411200,01917417900,00000006700,a2f,recvmsg
0,01917431500,01917431700,00000000200,a2f,recvmsg
0,01917455000,01917459300,00000004300,a07,poll
0,01917464800,01917471900,00000007100,a2f,recvmsg
0,01917483600,01917483800,00000000200,a2f,recvmsg
0,01917317200,01917511000,00000193800,a17,select
0,01917528100,01917529300,00000001200,a14,writev
0,01917529900,01917530100,00000000200,a2f,recvmsg
0,01917544200,01917545200,00000001000,a14,writev
0,01917545600,01917545700,00000000100,a2f,recvmsg
0,01917557500,01917558500,00000001000,a14,writev
0,01917558800,01917559000,00000000200,a2f,recvmsg
0,01917578100,01917578100,00000000000,a2f,recvmsg
0,01917505700,01917582900,00000077200,a07,poll
0,01917586700,01917586900,00000000200,a2f,recvmsg
0,01917588300,01917588500,00000000200,a2f,recvmsg
0,01917588700,01917588900,00000000200,a2f,recvmsg
0,01917590300,01917590400,00000000100,a2f,recvmsg
0,01917590600,01917590800,00000000200,a2f,recvmsg
0,01917591200,01917592800,00000001600,a07,poll
0,01917593400,01917594500,00000001100,a2f,recvmsg
0,01917599700,01917600600,00000000900,a2d,recvfrom
0,01917601500,01917601700,00000000200,a2f,recvmsg
0,01917602400,01917602600,00000000200,a2f,recvmsg
0,01917644100,01917644400,00000000300,a2f,recvmsg
0,01917646500,01917646700,00000000200,a2f,recvmsg
0,01917648900,01917650800,00000001900,a07,poll
0,01917651300,01917652300,00000001000,a2f,recvmsg
0,01917658700,01917659400,00000000700,a2d,recvfrom
0,01917660300,01917660500,00000000200,a2f,recvmsg
0,01917661300,01917661500,00000000200,a2f,recvmsg
0,01917691600,01917691800,00000000200,a2f,recvmsg
0,01917694000,01917694100,00000000100,a2f,recvmsg
0,01917697600,01918141100,00000443500,a07,poll
0,01918160800,01918167000,00000006200,a2e,sendmsg
0,01918173100,01918173300,00000000200,a00,read
0,01918181900,01918269100,00000087200,a07,poll
0,01918271000,01918271600,00000000600,a00,read
0,01918289100,01918290800,00000001700,a2f,recvmsg
0,01918365300,01918368200,00000002900,a07,poll
0,01918375000,01918378200,00000003200,a2e,sendmsg
0,01570007500,01918380300,00348372800,ae8,epoll_wait
0,01918385600,01918387000,00000001400,a2f,recvmsg
0,01918396900,01918397100,00000000200,a2f,recvmsg
0,01918436000,01918438400,00000002400,a2e,sendmsg
0,01918365300,01918445300,00000080000,a07,poll
0,01918445800,01918446300,00000000500,a00,read
0,01918453000,01918454100,00000001100,a2f,recvmsg
0,01918456600,01918458200,00000001600,aca,futex
0,01918490100,01918516000,00000025900,aca,futex
0,01918537600,01918540700,00000003100,a2e,sendmsg
0,01918542800,01918543000,00000000200,a00,read
0,01918443200,01918570700,00000127500,ae8,epoll_wait
0,01918574300,01918575600,00000001300,a2f,recvmsg
0,01918594600,01918594800,00000000200,a2f,recvmsg
0,01918620500,01918622800,00000002300,a2e,sendmsg
0,01918568700,01918628000,00000059300,a07,poll
0,01918628500,01918628800,00000000300,a00,read
0,01918633000,01918634500,00000001500,a2f,recvmsg
0,01918641100,01918641900,00000000800,a2f,recvmsg
0,01918639700,01918645300,00000005600,a07,poll
0,01918650200,01918652300,00000002100,a2e,sendmsg
0,01918900400,01918901300,00000000900,a2f,recvmsg
0,01918903500,01918903600,00000000100,a00,read
0,01919085600,01919086100,00000000500,aca,futex
0,01919086700,01919086900,00000000200,aca,futex
0,01917578700,01920749900,00003171200,a17,select
0,01920770800,01920771000,00000000200,a2f,recvmsg
0,01920773900,01920783200,00000009300,a17,select
0,01920787700,01920787900,00000000200,a2f,recvmsg
0,01920788600,01920851000,00000062400,a17,select
0,01920854800,01920854900,00000000100,a2f,recvmsg
0,01917695100,01931485000,00013789900,a3d,wait4
0,01931505200,01931507000,00000001800,a00,read
0,01931509200,01931509600,00000000400,a00,read
0,01931528000,01931577900,00000049900,a07,poll
0,01931582900,01931583000,00000000100,a2f,recvmsg
0,01931583900,01931584100,00000000200,a2f,recvmsg
0,01931589800,01931601700,00000011900,a07,poll
0,01931603800,01931603900,00000000100,a2f,recvmsg
0,01931604300,01931604500,00000000200,a2f,recvmsg
0,01931609000,01931620700,00000011700,a07,poll
0,01931622700,01931622900,00000000200,a2f,recvmsg
0,01931623200,01931623400,00000000200,a2f,recvmsg
0,01931628400,01931640000,00000011600,a07,poll
0,01931641900,01931642100,00000000200,a2f,recvmsg
0,01931642500,01931642700,00000000200,a2f,recvmsg
0,01931647800,01931659400,00000011600,a07,poll
0,01931661500,01931661600,00000000100,a2f,recvmsg
0,01931662100,01931662300,00000000200,a2f,recvmsg
0,01931665600,01931677300,00000011700,a07,poll
0,01931679700,01931679900,00000000200,a2f,recvmsg
0,01931680200,01931680400,00000000200,a2f,recvmsg
0,01931681200,01931681500,00000000300,a08,lseek
0,01931691300,01931691400,00000000100,a08,lseek
0,01931694600,01931701700,00000007100,a07,poll
0,01931703000,01931703200,00000000200,a2f,recvmsg
0,01931703600,01931703700,00000000100,a2f,recvmsg
0,01931709800,01931716400,00000006600,a07,poll
0,01931717700,01931717900,00000000200,a2f,recvmsg
0,01931718100,01931718300,00000000200,a2f,recvmsg
0,01931721400,01931728200,00000006800,a07,poll
0,01931729300,01931729500,00000000200,a2f,recvmsg
0,01931729800,01931730000,00000000200,a2f,recvmsg
0,01931734200,01931740700,00000006500,a07,poll
0,01931742000,01931742200,00000000200,a2f,recvmsg
0,01931742500,01931742600,00000000100,a2f,recvmsg
0,01931745900,01931752600,00000006700,a07,poll
0,01931753800,01931754000,00000000200,a2f,recvmsg
0,01931754200,01931754400,00000000200,a2f,recvmsg
0,01931757900,01931764500,00000006600,a07,poll
0,01931765600,01931765800,00000000200,a2f,recvmsg
0,01931766100,01931766300,00000000200,a2f,recvmsg
0,01931769500,01931776600,00000007100,a07,poll
0,01931777700,01931777900,00000000200,a2f,recvmsg
0,01931778200,01931778400,00000000200,a2f,recvmsg
0,01931781900,01931788600,00000006700,a07,poll
0,01931789800,01931789900,00000000100,a2f,recvmsg
0,01931790200,01931790300,00000000100,a2f,recvmsg
0,01931794800,01931801600,00000006800,a07,poll
0,01931802700,01931802900,00000000200,a2f,recvmsg
0,01931803200,01931803400,00000000200,a2f,recvmsg
0,01931806600,01931813600,00000007000,a07,poll
0,01931814700,01931814800,00000000100,a2f,recvmsg
0,01931815200,01931815400,00000000200,a2f,recvmsg
0,01931818500,01931825300,00000006800,a07,poll
0,01931826400,01931826600,00000000200,a2f,recvmsg
0,01931826900,01931827100,00000000200,a2f,recvmsg
0,01931830100,01931836800,00000006700,a07,poll
0,01931837900,01931838000,00000000100,a2f,recvmsg
0,01931838400,01931838600,00000000200,a2f,recvmsg
0,01931841700,01931848500,00000006800,a07,poll
0,01931849600,01931849800,00000000200,a2f,recvmsg
0,01931850100,01931850300,00000000200,a2f,recvmsg
0,01931853400,01931860200,00000006800,a07,poll
0,01931862800,01931863000,00000000200,a2f,recvmsg
0,01931863300,01931863500,00000000200,a2f,recvmsg
0,01931866600,01931873500,00000006900,a07,poll
0,01931874600,01931874800,00000000200,a2f,recvmsg
0,01931875100,01931875300,00000000200,a2f,recvmsg
0,01931877900,01931884900,00000007000,a07,poll
0,01931885900,01931886100,00000000200,a2f,recvmsg
0,01931886400,01931886600,00000000200,a2f,recvmsg
0,01931891800,01931898500,00000006700,a07,poll
0,01931899700,01931899900,00000000200,a2f,recvmsg
0,01931900200,01931900300,00000000100,a2f,recvmsg
0,01931903000,01931909700,00000006700,a07,poll
0,01931910700,01931910900,00000000200,a2f,recvmsg
0,01931911200,01931911400,00000000200,a2f,recvmsg
0,01931914000,01931921000,00000007000,a07,poll
0,01931922100,01931922200,00000000100,a2f,recvmsg
0,01931922500,01931922700,00000000200,a2f,recvmsg
0,01931925300,01931932000,00000006700,a07,poll
0,01931933000,01931933200,00000000200,a2f,recvmsg
0,01931933500,01931933700,00000000200,a2f,recvmsg
0,01931936600,01931943400,00000006800,a07,poll
0,01931944500,01931944600,00000000100,a2f,recvmsg
0,01931945000,01931945100,00000000100,a2f,recvmsg
0,01931947900,01931954700,00000006800,a07,poll
0,01931955800,01931955900,00000000100,a2f,recvmsg
0,01931956300,01931956500,00000000200,a2f,recvmsg
0,01931959700,01931966700,00000007000,a07,poll
0,01931967700,01931967900,00000000200,a2f,recvmsg
0,01931968200,01931968400,00000000200,a2f,recvmsg
0,01931971600,01931978200,00000006600,a07,poll
0,01931979300,01931979500,00000000200,a2f,recvmsg
0,01931979800,01931980000,00000000200,a2f,recvmsg
0,01931983600,01931990600,00000007000,a07,poll
0,01931991700,01931991900,00000000200,a2f,recvmsg
0,01931992200,01931992400,00000000200,a2f,recvmsg
0,01931996800,01932003600,00000006800,a07,poll
0,01932004800,01932004900,00000000100,a2f,recvmsg
0,01932005200,01932005400,00000000200,a2f,recvmsg
0,01932008700,01932015800,00000007100,a07,poll
0,01932016900,01932017100,00000000200,a2f,recvmsg
0,01932017400,01932017500,00000000100,a2f,recvmsg
0,01932022700,01932029500,00000006800,a07,poll
0,01932030700,01932030900,00000000200,a2f,recvmsg
0,01932031200,01932031400,00000000200,a2f,recvmsg
0,01932034400,01932041200,00000006800,a07,poll
0,01932042400,01932042600,00000000200,a2f,recvmsg
0,01932042800,01932043000,00000000200,a2f,recvmsg
0,01932046000,01932052500,00000006500,a07,poll
0,01932053800,01932053900,00000000100,a2f,recvmsg
0,01932054200,01932054300,00000000100,a2f,recvmsg
0,01932058100,01932064900,00000006800,a07,poll
0,01932066100,01932066300,00000000200,a2f,recvmsg
0,01932066600,01932066800,00000000200,a2f,recvmsg
0,01932070100,01932077000,00000006900,a07,poll
0,01932078100,01932078300,00000000200,a2f,recvmsg
0,01932078600,01932078800,00000000200,a2f,recvmsg
0,01932082500,01932089500,00000007000,a07,poll
0,01932090500,01932090700,00000000200,a2f,recvmsg
0,01932091000,01932091200,00000000200,a2f,recvmsg
0,01932094500,01932101500,00000007000,a07,poll
0,01932102600,01932102800,00000000200,a2f,recvmsg
0,01932103100,01932103300,00000000200,a2f,recvmsg
0,01932106200,01932113300,00000007100,a07,poll
0,01932114400,01932114600,00000000200,a2f,recvmsg
0,01932114900,01932115000,00000000100,a2f,recvmsg
0,01932117900,01932124700,00000006800,a07,poll
0,01932126000,01932126200,00000000200,a2f,recvmsg
0,01932126400,01932126600,00000000200,a2f,recvmsg
0,01932129900,01932136800,00000006900,a07,poll
0,01932137900,01932138000,00000000100,a2f,recvmsg
0,01932138400,01932138500,00000000100,a2f,recvmsg
0,01932139600,01932139700,00000000100,a08,lseek
0,01932142500,01932143500,00000001000,a00,read
0,01932147200,01932147300,00000000100,a08,lseek
0,01932150000,01932156700,00000006700,a07,poll
0,01932157900,01932158100,00000000200,a2f,recvmsg
0,01932158400,01932158600,00000000200,a2f,recvmsg
0,01932183400,01932190300,00000006900,a07,poll
0,01932191700,01932191800,00000000100,a2f,recvmsg
0,01932192200,01932192400,00000000200,a2f,recvmsg
0,01932196100,01932196800,00000000700,a00,read
0,01932202400,01932202500,00000000100,a08,lseek
0,01932205900,01932212500,00000006600,a07,poll
0,01932213800,01932213900,00000000100,a2f,recvmsg
0,01932214200,01932214400,00000000200,a2f,recvmsg
0,01932217300,01932224000,00000006700,a07,poll
0,01932225100,01932225200,00000000100,a2f,recvmsg
0,01932225500,01932225700,00000000200,a2f,recvmsg
0,01932228400,01932234900,00000006500,a07,poll
0,01932236100,01932236200,00000000100,a2f,recvmsg
0,01932236600,01932236700,00000000100,a2f,recvmsg
0,01932239400,01932246100,00000006700,a07,poll
0,01932247300,01932247400,00000000100,a2f,recvmsg
0,01932247800,01932248000,00000000200,a2f,recvmsg
0,01932250500,01932257200,00000006700,a07,poll
0,01932258200,01932258300,00000000100,a2f,recvmsg
0,01932258700,01932258900,00000000200,a2f,recvmsg
0,01932261500,01932268400,00000006900,a07,poll
0,01932269400,01932269600,00000000200,a2f,recvmsg
0,01932269900,01932270100,00000000200,a2f,recvmsg
0,01932272700,01932279400,00000006700,a07,poll
0,01932280500,01932280700,00000000200,a2f,recvmsg
0,01932281000,01932281200,00000000200,a2f,recvmsg
0,01932284500,01932291400,00000006900,a07,poll
0,01932292400,01932292600,00000000200,a2f,recvmsg
0,01932292900,01932293100,00000000200,a2f,recvmsg
0,01932295900,01932302500,00000006600,a07,poll
0,01932303600,01932303800,00000000200,a2f,recvmsg
0,01932304100,01932304300,00000000200,a2f,recvmsg
0,01932304700,01932304800,00000000100,a08,lseek
0,01932308500,01932315300,00000006800,a07,poll
0,01932316400,01932316600,00000000200,a2f,recvmsg
0,01932316900,01932317100,00000000200,a2f,recvmsg
0,01932322200,01932328900,00000006700,a07,poll
0,01932330000,01932330200,00000000200,a2f,recvmsg
0,01932330500,01932330700,00000000200,a2f,recvmsg
0,01932334300,01932340800,00000006500,a07,poll
0,01932341900,01932342000,00000000100,a2f,recvmsg
0,01932342300,01932342500,00000000200,a2f,recvmsg
0,01932345600,01932352300,00000006700,a07,poll
0,01932353400,01932353500,00000000100,a2f,recvmsg
0,01932353800,01932354000,00000000200,a2f,recvmsg
0,01932357000,01932363800,00000006800,a07,poll
0,01932365000,01932365200,00000000200,a2f,recvmsg
0,01932365500,01932365700,00000000200,a2f,recvmsg
0,01932368700,01932375500,00000006800,a07,poll
0,01932376600,01932376800,00000000200,a2f,recvmsg
0,01932377100,01932377200,00000000100,a2f,recvmsg
0,01932380800,01932387600,00000006800,a07,poll
0,01932388700,01932388900,00000000200,a2f,recvmsg
0,01932389300,01932389500,00000000200,a2f,recvmsg
0,01932392400,01932399300,00000006900,a07,poll
0,01932400300,01932400500,00000000200,a2f,recvmsg
0,01932400800,01932401000,00000000200,a2f,recvmsg
0,01932404000,01932410700,00000006700,a07,poll
0,01932411700,01932411900,00000000200,a2f,recvmsg
0,01932412200,01932412400,00000000200,a2f,recvmsg
0,01932415400,01932422200,00000006800,a07,poll
0,01932423300,01932423500,00000000200,a2f,recvmsg
0,01932423800,01932424000,00000000200,a2f,recvmsg
0,01932426900,01932433700,00000006800,a07,poll
0,01932434800,01932434900,00000000100,a2f,recvmsg
0,01932435300,01932435500,00000000200,a2f,recvmsg
0,01932438400,01932445100,00000006700,a07,poll
0,01932446100,01932446300,00000000200,a2f,recvmsg
0,01932446600,01932446800,00000000200,a2f,recvmsg
0,01932450400,01932457300,00000006900,a07,poll
0,01932458500,01932458700,00000000200,a2f,recvmsg
0,01932458900,01932459100,00000000200,a2f,recvmsg
0,01932462100,01932468900,00000006800,a07,poll
0,01932470000,01932470200,00000000200,a2f,recvmsg
0,01932470400,01932470600,00000000200,a2f,recvmsg
0,01932474000,01932480600,00000006600,a07,poll
0,01932481700,01932481900,00000000200,a2f,recvmsg
0,01932482200,01932482400,00000000200,a2f,recvmsg
0,01932485500,01932492200,00000006700,a07,poll
0,01932493300,01932493400,00000000100,a2f,recvmsg
0,01932493800,01932494000,00000000200,a2f,recvmsg
0,01932504500,01932511300,00000006800,a07,poll
0,01932512400,01932512600,00000000200,a2f,recvmsg
0,01932512900,01932513100,00000000200,a2f,recvmsg
0,01932516400,01932523000,00000006600,a07,poll
0,01932524100,01932524200,00000000100,a2f,recvmsg
0,01932524600,01932524800,00000000200,a2f,recvmsg
0,01932527700,01932534500,00000006800,a07,poll
0,01932535700,01932535800,00000000100,a2f,recvmsg
0,01932536200,01932536400,00000000200,a2f,recvmsg
0,01932539600,01932546300,00000006700,a07,poll
0,01932547300,01932547500,00000000200,a2f,recvmsg
0,01932547800,01932548000,00000000200,a2f,recvmsg
0,01932551200,01932558000,00000006800,a07,poll
0,01932559200,01932559400,00000000200,a2f,recvmsg
0,01932559600,01932559800,00000000200,a2f,recvmsg
0,01932580100,01932607100,00000027000,a57,unlink
0,01932608300,01932612400,00000004100,a14,writev
0,01932612900,01932710100,00000097200,a07,poll
0,01932612900,01932718500,00000105600,a07,poll
0,01932730000,01932730200,00000000200,a2f,recvmsg
0,01932771800,01932772100,00000000300,a2f,recvmsg
0,01932760700,01932793100,00000032400,a07,poll
0,01932809800,01932849000,00000039200,a07,poll
0,01932850300,01932852000,00000001700,a07,poll
0,01932853600,01932905100,00000051500,a07,poll
0,01932906300,01932908200,00000001900,a07,poll
0,01932909700,01932961000,00000051300,a07,poll
0,01932962500,01932963700,00000001200,a07,poll
0,01932965100,01933016400,00000051300,a07,poll
0,01933017500,01933019300,00000001800,a07,poll
0,01933020500,01933071500,00000051000,a07,poll
0,01933071800,01933072900,00000001100,a2f,recvmsg
0,01933020500,01933073900,00000053400,a07,poll
0,01933076800,01933118600,00000041800,a07,poll
0,01933118800,01933120300,00000001500,a2f,recvmsg
0,01933076800,01933121200,00000044400,a07,poll
0,01933123800,01933162800,00000039000,a07,poll
0,01933162900,01933163900,00000001000,a2f,recvmsg
0,01933123800,01933164800,00000041000,a07,poll
0,01933168400,01933205600,00000037200,a07,poll
0,01933207200,01933208200,00000001000,a07,poll
0,01933209500,01933250200,00000040700,a07,poll
0,01933250500,01933251500,00000001000,a2f,recvmsg
0,01933209500,01933252500,00000043000,a07,poll
0,01933255100,01933293500,00000038400,a07,poll
0,01933255100,01933295700,00000040600,a07,poll
0,01933298400,01933348100,00000049700,a07,poll
0,01933348100,01933349300,00000001200,a2f,recvmsg
0,01933298400,01933350100,00000051700,a07,poll
0,01933352700,01933367100,00000014400,a07,poll
0,01933367200,01933368800,00000001600,a2f,recvmsg
0,01933352700,01933369600,00000016900,a07,poll
0,01933372100,01933384200,00000012100,a07,poll
0,01933384400,01933385400,00000001000,a2f,recvmsg
0,01933372100,01933386300,00000014200,a07,poll
0,01933389100,01933400500,00000011400,a07,poll
0,01933400700,01933401700,00000001000,a2f,recvmsg
0,01933389100,01933402600,00000013500,a07,poll
0,01933405000,01933415900,00000010900,a07,poll
0,01933416000,01933417200,00000001200,a2f,recvmsg
0,01933405000,01933418100,00000013100,a07,poll
0,01933420800,01933431800,00000011000,a07,poll
0,01933432000,01933433000,00000001000,a2f,recvmsg
0,01933420800,01933433900,00000013100,a07,poll
0,01933436600,01933438100,00000001500,a07,poll
0,01933440700,01933440900,00000000200,a2f,recvmsg
0,01933441400,01933441500,00000000100,a2f,recvmsg
0,01933436600,01933461200,00000024600,a07,poll
0,01933461600,01933463100,00000001500,a2f,recvmsg
0,01933465000,01933466300,00000001300,a2d,recvfrom
0,01933470600,01933470800,00000000200,a2f,recvmsg
0,01933471400,01933471500,00000000100,a2f,recvmsg
0,01933436600,01933476800,00000040200,a07,poll
0,01933477300,01933478900,00000001600,a2f,recvmsg
0,01933480200,01933481100,00000000900,a2d,recvfrom
0,01933485300,01933485500,00000000200,a2f,recvmsg
0,01933486000,01933486200,00000000200,a2f,recvmsg
0,01933526100,01933526400,00000000300,a2f,recvmsg
0,01933528700,01933528900,00000000200,a2f,recvmsg
0,01933587700,01933588000,00000000300,a2f,recvmsg
0,01933590500,01933590700,00000000200,a2f,recvmsg
0,01933601600,01933642100,00000040500,a07,poll
0,01933642700,01933644500,00000001800,a2f,recvmsg
0,01933651700,01933652500,00000000800,a2d,recvfrom
0,01933653400,01933653600,00000000200,a2f,recvmsg
0,01933654300,01933654500,00000000200,a2f,recvmsg
0,01933686100,01933686300,00000000200,a2f,recvmsg
0,01933688700,01933688900,00000000200,a2f,recvmsg
0,01933692100,01933694700,00000002600,a07,poll
0,01933697300,01933697500,00000000200,a2f,recvmsg
0,01933698000,01933698200,00000000200,a2f,recvmsg
0,01934451100,01934460300,00000009200,a02,open
0,01934472200,01934476000,00000003800,a00,read
0,01934529300,01934530200,00000000900,a00,read
0,01934579900,01934580900,00000001000,a00,read
0,01934629200,01934630100,00000000900,a00,read
0,01934679100,01934679800,00000000700,a00,read
0,01934728600,01934729500,00000000900,a00,read
0,01934775900,01934776600,00000000700,a00,read
0,01934858700,01934859800,00000001100,a00,read
0,01934910100,01934910900,00000000800,a00,read
0,01934962200,01934963100,00000000900,a00,read
0,01935013200,01935013800,00000000600,a00,read
0,01935043700,01935046600,00000002900,a02,open
0,01935051200,01935052400,00000001200,a00,read
0,01935107100,01935108000,00000000900,a00,read
0,01935191800,01935192800,00000001000,a00,read
0,01935206300,01935207500,00000001200,aca,futex
0,01935270400,01935271100,00000000700,a00,read
0,01935348500,01935349300,00000000800,a00,read
0,01935428400,01935429000,00000000600,a00,read
0,01935506400,01935507000,00000000600,a00,read
0,01935591700,01935592400,00000000700,a00,read
0,01935657900,01935658500,00000000600,a00,read
0,01935716300,01935717000,00000000700,a00,read
0,01935795100,01935828600,00000033500,a07,poll
0,01935832000,01935832200,00000000200,a2f,recvmsg
0,01935832900,01935833100,00000000200,a2f,recvmsg
0,01935835300,01935841600,00000006300,a07,poll
0,01935842800,01935843000,00000000200,a2f,recvmsg
0,01935843300,01935843400,00000000100,a2f,recvmsg
0,01935849200,01935856300,00000007100,a06,lstat
0,01935857100,01935858100,00000001000,a06,lstat
0,01935880600,01935896000,00000015400,a01,write
0,01935902100,01935909500,00000007400,a07,poll
0,01935911300,01935911500,00000000200,a2f,recvmsg
0,01935912000,01935912200,00000000200,a2f,recvmsg
0,01935913600,01936228800,00000315200,a38,clone
0,01936709700,01936709900,00000000200,a0c,brk
0,01936719800,01936722600,00000002800,a15,access
0,01936723300,01936724200,00000000900,a09,mmap
0,01936728000,01936728700,00000000700,a15,access
0,01936734700,01936735800,00000001100,a09,mmap
0,01936739500,01936739900,00000000400,a15,access
0,01936746400,01936747400,00000001000,a00,read
0,01936749800,01936751200,00000001400,a09,mmap
0,01936755400,01936757700,00000002300,a09,mmap
0,01936769000,01936769800,00000000800,a15,access
0,01936772900,01936773600,00000000700,a00,read
0,01936774300,01936775200,00000000900,a09,mmap
0,01936777100,01936778300,00000001200,a09,mmap
0,01936786100,01936786700,00000000600,a15,access
0,01936789600,01936790200,00000000600,a00,read
0,01936790800,01936791700,00000000900,a09,mmap
0,01936793200,01936795200,00000002000,a09,mmap
0,01936798700,01936801700,00000003000,a09,mmap
0,01936804000,01936805000,00000001000,a09,mmap
0,01936814100,01936814700,00000000600,a15,access
0,01936817400,01936817900,00000000500,a00,read
0,01936818600,01936820100,00000001500,a09,mmap
0,01936822500,01936824200,00000001700,a09,mmap
0,01936832700,01936833300,00000000600,a15,access
0,01936836300,01936836900,00000000600,a00,read
0,01936837600,01936838900,00000001300,a09,mmap
0,01936841900,01936844000,00000002100,a09,mmap
0,01936852400,01936853000,00000000600,a15,access
0,01936855300,01936855800,00000000500,a00,read
0,01936862300,01936863500,00000001200,a09,mmap
0,01936869900,01936870500,00000000600,a15,access
0,01936872600,01936873300,00000000700,a00,read
0,01936874000,01936875300,00000001300,a09,mmap
0,01936877100,01936878700,00000001600,a09,mmap
0,01936892800,01936893400,00000000600,a09,mmap
0,01936897400,01936897700,00000000300,a09,mmap
0,01936898900,01936899200,00000000300,a09,mmap
0,01937077500,01937077600,00000000100,a0c,brk
0,01937112700,01937113500,00000000800,a00,read
0,01937125200,01937126400,00000001200,a00,read
0,01937163800,01937164800,00000001000,a00,read
0,01937285700,01937286700,00000001000,a00,read
0,01937358100,01937358500,00000000400,a00,read
0,01937447300,01937448100,00000000800,a00,read
0,01937577800,01937578600,00000000800,a00,read
0,01937708900,01937709700,00000000800,a00,read
0,01937866300,01937867100,00000000800,a00,read
0,01938018100,01938018700,00000000600,a00,read
0,01938055600,01938056900,00000001300,a0c,brk
0,01938172700,01938173400,00000000700,a00,read
0,01938322700,01938323400,00000000700,a00,read
0,01938480100,01938480900,00000000800,a00,read
0,01938642000,01938642700,00000000700,a00,read
0,01938751700,01938752400,00000000700,a00,read
0,01938783300,01938783900,00000000600,a0c,brk
0,01938922700,01938923600,00000000900,a00,read
0,01939166400,01939167100,00000000700,a00,read
0,01939179600,01939179900,00000000300,a00,read
0,01939224400,01939224700,00000000300,a00,read
0,01939244800,01939245500,00000000700,a00,read
0,01939451800,01939452400,00000000600,a00,read
0,01939482000,01939483000,00000001000,a00,read
0,01939580100,01939580800,00000000700,a00,read
0,01939604700,01939606000,00000001300,a0c,brk
0,01939651100,01939651500,00000000400,a00,read
0,01939730500,01939731300,00000000800,a00,read
0,01939884100,01939884600,00000000500,a00,read
0,01939996600,01939997200,00000000600,a00,read
0,01940090800,01940091200,00000000400,a00,read
0,01940103100,01940103600,00000000500,a00,read
0,01940185000,01940185400,00000000400,a00,read
0,01940209200,01940209500,00000000300,a00,read
0,01940231800,01940232200,00000000400,a00,read
0,01940334400,01940335400,00000001000,a0c,brk
0,01940339000,01940340000,00000001000,a00,read
0,01940540700,01940541100,00000000400,a00,read
0,01940623700,01940624400,00000000700,a00,read
0,01940688500,01940689200,00000000700,a00,read
0,01940817800,01940818200,00000000400,a00,read
0,01940850200,01940850700,00000000500,a00,read
0,01940867300,01940868800,00000001500,a02,open
0,01940978800,01940979300,00000000500,a00,read
0,01941050800,01941051200,00000000400,a00,read
0,01941104900,01941106000,00000001100,a0c,brk
0,01941112300,01941113000,00000000700,a00,read
0,01941220600,01941221200,00000000600,a00,read
0,01941371300,01941372100,00000000800,a00,read
0,01941501900,01941502600,00000000700,a00,read
0,01941559600,01941560200,00000000600,a00,read
0,01941615700,01941616500,00000000800,a00,read
0,01941686200,01941686900,00000000700,a00,read
0,01941739500,01941740200,00000000700,a00,read
0,01941827900,01941828800,00000000900,a0c,brk
0,01941861400,01941865500,00000004100,a0c,brk
0,01941880000,01941880900,00000000900,a00,read
0,01941996700,01941997600,00000000900,a00,read
0,01942155200,01942155900,00000000700,a00,read
0,01942272500,01942273100,00000000600,a00,read
0,01942418300,01942418800,00000000500,a00,read
0,01942535400,01942536100,00000000700,a00,read
0,01942698800,01942699500,00000000700,a00,read
0,01942704400,01942705300,00000000900,a0c,brk
0,01942826300,01942827100,00000000800,a00,read
0,01942945000,01942945600,00000000600,a00,read
0,01943087500,01943088200,00000000700,a00,read
0,01943218600,01943219300,00000000700,a00,read
0,01943311800,01943312700,00000000900,a00,read
0,01943424400,01943425100,00000000700,a00,read
0,01943547900,01943548600,00000000700,a00,read
0,01943661400,01943662000,00000000600,a0c,brk
0,01943684600,01943685300,00000000700,a00,read
0,01943853800,01943854500,00000000700,a00,read
0,01944004600,01944005200,00000000600,a00,read
0,01944115500,01944116200,00000000700,a00,read
0,01944286800,01944287800,00000001000,a00,read
0,01944364300,01944364900,00000000600,a00,read
0,01944446600,01944447300,00000000700,a00,read
0,01944514100,01944514700,00000000600,a0c,brk
0,01944528200,01944528900,00000000700,a00,read
0,01944601200,01944602000,00000000800,a00,read
0,01944702600,01944703400,00000000800,a00,read
0,01944805200,01944805800,00000000600,a00,read
0,01944894900,01944895600,00000000700,a00,read
0,01944975800,01944976500,00000000700,a00,read
0,01945078200,01945078800,00000000600,a00,read
0,01945159100,01945159500,00000000400,a0c,brk
0,01945161900,01945162500,00000000600,a00,read
0,01945268600,01945269200,00000000600,a00,read
0,01945361200,01945361800,00000000600,a00,read
0,01945480200,01945480800,00000000600,a00,read
0,01945593700,01945594300,00000000600,a00,read
0,01945698100,01945698900,00000000800,a00,read
0,01945798000,01945798300,00000000300,a0c,brk
0,01946156500,01946160200,00000003700,a57,unlink
0,01946184200,01946184800,00000000600,a48,fcntl
0,01946231900,01946246300,00000014400,a01,write
0,01946264300,01946266600,00000002300,a01,write
0,01946282700,01946285200,00000002500,a01,write
0,01920855500,01946532600,00025677100,a17,select
0,01946556900,01946557100,00000000200,a2f,recvmsg
0,01946560700,01946590000,00000029300,a17,select
0,01946594300,01946594500,00000000200,a2f,recvmsg
0,01946595000,01946612800,00000017800,a17,select
0,01946616500,01946616700,00000000200,a2f,recvmsg
0,01946617200,01946634300,00000017100,a17,select
0,01946638200,01946638300,00000000100,a2f,recvmsg
0,01946638800,01946654400,00000015600,a17,select
0,01946658400,01946658500,00000000100,a2f,recvmsg
0,01946659100,01946674700,00000015600,a17,select
0,01946678200,01946678300,00000000100,a2f,recvmsg
0,01946678800,01946707000,00000028200,a17,select
0,01946710900,01946711100,00000000200,a2f,recvmsg
0,01946711600,01946721600,00000010000,a17,select
0,01946725200,01946725400,00000000200,a2f,recvmsg
0,01946726000,01946733500,00000007500,a17,select
0,01946737100,01946737300,00000000200,a2f,recvmsg
0,01946737700,01946745400,00000007700,a17,select
0,01946748800,01946748900,00000000100,a2f,recvmsg
0,01946749500,01946757100,00000007600,a17,select
0,01946760900,01946761100,00000000200,a2f,recvmsg
0,01946761600,01946769400,00000007800,a17,select
0,01946773100,01946773200,00000000100,a2f,recvmsg
0,01946773700,01946781800,00000008100,a17,select
0,01946785700,01946785900,00000000200,a2f,recvmsg
0,01946786400,01946793700,00000007300,a17,select
0,01946797100,01946797300,00000000200,a2f,recvmsg
0,01946797900,01946806400,00000008500,a17,select
0,01946810400,01946810600,00000000200,a2f,recvmsg
0,01946811200,01946833400,00000022200,a17,select
0,01946838100,01946838200,00000000100,a2f,recvmsg
0,01946838800,01946847100,00000008300,a17,select
0,01946850900,01946851100,00000000200,a2f,recvmsg
0,01946851500,01946859700,00000008200,a17,select
0,01946863300,01946863500,00000000200,a2f,recvmsg
0,01946864000,01946871300,00000007300,a17,select
0,01946874800,01946875000,00000000200,a2f,recvmsg
0,01946875600,01946884000,00000008400,a17,select
0,01946887600,01946887800,00000000200,a2f,recvmsg
0,01946888300,01946895600,00000007300,a17,select
0,01946899300,01946899500,00000000200,a2f,recvmsg
0,01946900000,01946906900,00000006900,a17,select
0,01946910500,01946910700,00000000200,a2f,recvmsg
0,01946911300,01946920100,00000008800,a17,select
0,01946923700,01946923900,00000000200,a2f,recvmsg
0,01946924400,01946931400,00000007000,a17,select
0,01946935100,01946935300,00000000200,a2f,recvmsg
0,01946935800,01946942700,00000006900,a17,select
0,01946946400,01946946400,00000000000,a2f,recvmsg
0,01946947000,01946954100,00000007100,a17,select
0,01946957800,01946957900,00000000100,a2f,recvmsg
0,01946958500,01946965600,00000007100,a17,select
0,01946969300,01946969400,00000000100,a2f,recvmsg
0,01946970000,01946977000,00000007000,a17,select
0,01946980600,01946980700,00000000100,a2f,recvmsg
0,01946981300,01946988700,00000007400,a17,select
0,01946992500,01946992700,00000000200,a2f,recvmsg
0,01946993200,01947000700,00000007500,a17,select
0,01947004400,01947004600,00000000200,a2f,recvmsg
0,01947005100,01947012900,00000007800,a17,select
0,01947016800,01947017000,00000000200,a2f,recvmsg
0,01947017500,01947025200,00000007700,a17,select
0,01947028700,01947028900,00000000200,a2f,recvmsg
0,01947029400,01947037000,00000007600,a17,select
0,01947040800,01947041000,00000000200,a2f,recvmsg
0,01947041400,01947051100,00000009700,a17,select
0,01947054800,01947055000,00000000200,a2f,recvmsg
0,01947055500,01947062600,00000007100,a17,select
0,01947066300,01947066500,00000000200,a2f,recvmsg
0,01947067100,01947074300,00000007200,a17,select
0,01947077900,01947078100,00000000200,a2f,recvmsg
0,01947078600,01947086600,00000008000,a17,select
0,01947090300,01947090500,00000000200,a2f,recvmsg
0,01947090900,01947099500,00000008600,a17,select
0,01947103400,01947103500,00000000100,a2f,recvmsg
0,01947104100,01947112000,00000007900,a17,select
0,01947115800,01947115900,00000000100,a2f,recvmsg
0,01947116500,01947124000,00000007500,a17,select
0,01947127800,01947127900,00000000100,a2f,recvmsg
0,01947128500,01947135700,00000007200,a17,select
0,01947139300,01947139500,00000000200,a2f,recvmsg
0,01947140000,01947147200,00000007200,a17,select
0,01947150700,01947150800,00000000100,a2f,recvmsg
0,01947151400,01947158900,00000007500,a17,select
0,01947162600,01947162800,00000000200,a2f,recvmsg
0,01947163200,01947183000,00000019800,a17,select
0,01947186500,01947186700,00000000200,a2f,recvmsg
0,01947187200,01947216800,00000029600,a17,select
0,01947220600,01947220700,00000000100,a2f,recvmsg
0,01947221300,01947239100,00000017800,a17,select
0,01947242800,01947242800,00000000000,a2f,recvmsg
0,01947243400,01947250400,00000007000,a17,select
0,01947254200,01947254200,00000000000,a2f,recvmsg
0,01947254800,01947261800,00000007000,a17,select
0,01947265300,01947265500,00000000200,a2f,recvmsg
0,01947266000,01947272900,00000006900,a17,select
0,01947276500,01947276700,00000000200,a2f,recvmsg
0,01947277100,01947284200,00000007100,a17,select
0,01947287700,01947287800,00000000100,a2f,recvmsg
0,01947288400,01947295200,00000006800,a17,select
0,01947298800,01947298900,00000000100,a2f,recvmsg
0,01947299500,01947306500,00000007000,a17,select
0,01947310000,01947310100,00000000100,a2f,recvmsg
0,01947310700,01947318200,00000007500,a17,select
0,01947321900,01947322100,00000000200,a2f,recvmsg
0,01947322600,01947329700,00000007100,a17,select
0,01947333200,01947333400,00000000200,a2f,recvmsg
0,01947333900,01947342300,00000008400,a17,select
0,01947345900,01947346100,00000000200,a2f,recvmsg
0,01947346600,01947356100,00000009500,a17,select
0,01947359800,01947359900,00000000100,a2f,recvmsg
0,01947360500,01947367900,00000007400,a17,select
0,01947371400,01947371500,00000000100,a2f,recvmsg
0,01947372000,01947379500,00000007500,a17,select
0,01947382900,01947383100,00000000200,a2f,recvmsg
0,01947383500,01947390700,00000007200,a17,select
0,01947394300,01947394400,00000000100,a2f,recvmsg
0,01947394900,01947402400,00000007500,a17,select
0,01947405900,01947406100,00000000200,a2f,recvmsg
0,01947406500,01947414500,00000008000,a17,select
0,01947418000,01947418200,00000000200,a2f,recvmsg
0,01947418700,01947425900,00000007200,a17,select
0,01947429400,01947429600,00000000200,a2f,recvmsg
0,01947430200,01947437200,00000007000,a17,select
0,01947440800,01947441000,00000000200,a2f,recvmsg
0,01947441500,01947448800,00000007300,a17,select
0,01947452300,01947452400,00000000100,a2f,recvmsg
0,01947453000,01947460100,00000007100,a17,select
0,01947463700,01947463900,00000000200,a2f,recvmsg
0,01947464400,01947471700,00000007300,a17,select
0,01947475200,01947475400,00000000200,a2f,recvmsg
0,01947476000,01947483600,00000007600,a17,select
0,01947487300,01947487500,00000000200,a2f,recvmsg
0,01947487900,01947495300,00000007400,a17,select
0,01947498800,01947499000,00000000200,a2f,recvmsg
0,01947499500,01947506600,00000007100,a17,select
0,01947510200,01947510400,00000000200,a2f,recvmsg
0,01947510800,01947518200,00000007400,a17,select
0,01947521700,01947521900,00000000200,a2f,recvmsg
0,01947522400,01947534700,00000012300,a17,select
0,01947538400,01947538600,00000000200,a2f,recvmsg
0,01947539200,01947546600,00000007400,a17,select
0,01947550100,01947550300,00000000200,a2f,recvmsg
0,01947550700,01947557900,00000007200,a17,select
0,01947561400,01947561600,00000000200,a2f,recvmsg
0,01947562100,01947569600,00000007500,a17,select
0,01947573100,01947573200,00000000100,a2f,recvmsg
0,01947573700,01947581000,00000007300,a17,select
0,01947584600,01947584800,00000000200,a2f,recvmsg
0,01947585200,01947642500,00000057300,a17,select
0,01947643500,01947644700,00000001200,a2f,recvmsg
0,01947735000,01947739400,00000004400,a14,writev
0,01948050800,01948051800,00000001000,a2f,recvmsg
0,01948342900,01948344800,00000001900,a2f,recvmsg
0,01948456500,01948456700,00000000200,a2f,recvmsg
0,01948457500,01948458000,00000000500,a14,writev
0,01948458300,01948458700,00000000400,a14,writev
0,01948475900,01948477800,00000001900,a14,writev
0,01948478100,01948479500,00000001400,a14,writev
0,01948479900,01948480100,00000000200,a2f,recvmsg
0,01948492600,01948493500,00000000900,a14,writev
0,01948493900,01948494100,00000000200,a2f,recvmsg
0,01935902100,01948500500,00012598400,a07,poll
0,01948503300,01948505300,00000002000,a2f,recvmsg
0,01948508700,01948508900,00000000200,a2f,recvmsg
0,01948511100,01948511300,00000000200,a2f,recvmsg
0,01948511600,01948511700,00000000100,a2f,recvmsg
0,01948513600,01948513800,00000000200,a2f,recvmsg
0,01948513900,01948514100,00000000200,a2f,recvmsg
0,01948514800,01948518600,00000003800,a07,poll
0,01948522500,01948528400,00000005900,a2f,recvmsg
0,01948539900,01948540100,00000000200,a2f,recvmsg
0,01948566800,01948569000,00000002200,a07,poll
0,01948570000,01948576600,00000006600,a2f,recvmsg
0,01948584900,01948585900,00000001000,a2d,recvfrom
0,01948590800,01948591000,00000000200,a2f,recvmsg
0,01948591900,01948592000,00000000100,a2f,recvmsg
0,01948622300,01948622600,00000000300,a2f,recvmsg
0,01948625000,01948625200,00000000200,a2f,recvmsg
0,01948629100,01948635500,00000006400,a07,poll
0,01948640700,01948646600,00000005900,a2f,recvmsg
0,01948658500,01948658700,00000000200,a2f,recvmsg
0,01948494700,01948686800,00000192100,a17,select
0,01948703000,01948704200,00000001200,a14,writev
0,01948704700,01948704900,00000000200,a2f,recvmsg
0,01948718600,01948719500,00000000900,a14,writev
0,01948719900,01948720000,00000000100,a2f,recvmsg
0,01948734600,01948734800,00000000200,a2f,recvmsg
0,01948681000,01948739200,00000058200,a07,poll
0,01948742600,01948742800,00000000200,a2f,recvmsg
0,01948744100,01948744300,00000000200,a2f,recvmsg
0,01948744600,01948744700,00000000100,a2f,recvmsg
0,01948746200,01948746300,00000000100,a2f,recvmsg
0,01948746500,01948746700,00000000200,a2f,recvmsg
0,01948747100,01948748700,00000001600,a07,poll
0,01948749300,01948750300,00000001000,a2f,recvmsg
0,01948755300,01948756200,00000000900,a2d,recvfrom
0,01948757300,01948757400,00000000100,a2f,recvmsg
0,01948758100,01948758200,00000000100,a2f,recvmsg
0,01948800900,01948801200,00000000300,a2f,recvmsg
0,01948803400,01948803500,00000000100,a2f,recvmsg
0,01784326800,01948820900,00164494100,a4a,fsync
0,01948880900,01948888400,00000007500,a09,mmap
0,01948805700,01948965300,00000159600,a07,poll
0,01948969300,01948970800,00000001500,aca,futex
0,01948974500,01948975400,00000000900,aca,futex
0,01948977700,01948978700,00000001000,aca,futex
0,01948986800,01948992400,00000005600,a2e,sendmsg
0,01948996500,01948996700,00000000200,a00,read
0,01949002100,01949049700,00000047600,a07,poll
0,01949051100,01949051900,00000000800,aca,futex
0,01949053500,01949054400,00000000900,aca,futex
0,01949055500,01949056400,00000000900,aca,futex
0,01949058300,01949060700,00000002400,a2e,sendmsg
0,01949221900,01949231200,00000009300,a01,write
0,01918625700,01949407600,00030781900,ae8,epoll_wait
0,01949413100,01949415600,00000002500,a2f,recvmsg
0,01949426200,01949426500,00000000300,a2f,recvmsg
0,01949441000,01949444600,00000003600,a2e,sendmsg
0,01949080400,01949446700,00000366300,a07,poll
0,01949447500,01949448000,00000000500,a00,read
0,01949457700,01949458300,00000000600,a2f,recvmsg
0,01948735300,01951430400,00002695100,a17,select
0,01951451300,01951451400,00000000100,a2f,recvmsg
0,01951454500,01951462700,00000008200,a17,select
0,01951467100,01951467300,00000000200,a2f,recvmsg
0,01951467900,01951517900,00000050000,a17,select
0,01951521900,01951522000,00000000100,a2f,recvmsg
0,01936249400,01962136900,00025887500,a3d,wait4
0,01962154900,01962156500,00000001600,a00,read
0,01962158600,01962158900,00000000300,a00,read
0,01962178200,01962226400,00000048200,a07,poll
0,01962231100,01962231300,00000000200,a2f,recvmsg
0,01962232300,01962232500,00000000200,a2f,recvmsg
0,01962238200,01962250000,00000011800,a07,poll
0,01962252100,01962252200,00000000100,a2f,recvmsg
0,01962252600,01962252800,00000000200,a2f,recvmsg
0,01962257300,01962269000,00000011700,a07,poll
0,01962270900,01962271100,00000000200,a2f,recvmsg
0,01962271500,01962271700,00000000200,a2f,recvmsg
0,01962276700,01962288400,00000011700,a07,poll
0,01962290400,01962290500,00000000100,a2f,recvmsg
0,01962290800,01962291000,00000000200,a2f,recvmsg
0,01962296000,01962307700,00000011700,a07,poll
0,01962309700,01962309800,00000000100,a2f,recvmsg
0,01962310200,01962310400,00000000200,a2f,recvmsg
0,01962314600,01962326300,00000011700,a07,poll
0,01962328400,01962328500,00000000100,a2f,recvmsg
0,01962328800,01962329000,00000000200,a2f,recvmsg
0,01962329800,01962330100,00000000300,a08,lseek
0,01962340800,01962340900,00000000100,a08,lseek
0,01962344000,01962351300,00000007300,a07,poll
0,01962352700,01962352800,00000000100,a2f,recvmsg
0,01962353200,01962353400,00000000200,a2f,recvmsg
0,01962357900,01962364600,00000006700,a07,poll
0,01962365800,01962366000,00000000200,a2f,recvmsg
0,01962366300,01962366500,00000000200,a2f,recvmsg
0,01962369700,01962376300,00000006600,a07,poll
0,01962377500,01962377700,00000000200,a2f,recvmsg
0,01962378000,01962378200,00000000200,a2f,recvmsg
0,01962382000,01962388400,00000006400,a07,poll
0,01962389600,01962389700,00000000100,a2f,recvmsg
0,01962390100,01962390300,00000000200,a2f,recvmsg
0,01962393500,01962400200,00000006700,a07,poll
0,01962401300,01962401500,00000000200,a2f,recvmsg
0,01962401800,01962402000,00000000200,a2f,recvmsg
0,01962406400,01962412900,00000006500,a07,poll
0,01962414200,01962414300,00000000100,a2f,recvmsg
0,01962414600,01962414800,00000000200,a2f,recvmsg
0,01962418600,01962425700,00000007100,a07,poll
0,01962426800,01962427000,00000000200,a2f,recvmsg
0,01962427300,01962427500,00000000200,a2f,recvmsg
0,01962430500,01962437000,00000006500,a07,poll
0,01962438200,01962438300,00000000100,a2f,recvmsg
0,01962438600,01962438800,00000000200,a2f,recvmsg
0,01962443100,01962450100,00000007000,a07,poll
0,01962451200,01962451400,00000000200,a2f,recvmsg
0,01962451700,01962451900,00000000200,a2f,recvmsg
0,01962455100,01962462100,00000007000,a07,poll
0,01962463300,01962463400,00000000100,a2f,recvmsg
0,01962463700,01962463800,00000000100,a2f,recvmsg
0,01995091500,01995095700,00000004200,a0c,brk
0,01995110600,01995111400,00000000800,a00,read
0,01995226100,01995226900,00000000800,a00,read
0,01995385000,01995385700,00000000700,a00,read
0,01995502200,01995502900,00000000700,a00,read
0,01995647800,01995648500,00000000700,a00,read
0,01995765300,01995765900,00000000600,a00,read
0,01995926700,01995927400,00000000700,a00,read
0,01995932200,01995933100,00000000900,a0c,brk
0,01996047300,01996048000,00000000700,a00,read
0,01996167600,01996168300,00000000700,a00,read
0,01996308900,01996309900,00000001000,a00,read
0,01996440300,01996441000,00000000700,a00,read
0,01996533800,01996534500,00000000700,a00,read
0,01996646100,01996646700,00000000600,a00,read
0,01996770100,01996770600,00000000500,a00,read
0,01996881700,01996882200,00000000500,a0c,brk
0,01996905000,01996905500,00000000500,a00,read
0,01997075300,01997076100,00000000800,a00,read
0,01997226100,01997226700,00000000600,a00,read
0,01997337100,01997337900,00000000800,a00,read
0,01997504600,01997505400,00000000800,a00,read
0,01997581800,01997582500,00000000700,a00,read
0,01997663500,01997664200,00000000700,a00,read
0,01997730800,01997731500,00000000700,a0c,brk
0,01997745000,01997745600,00000000600,a00,read
0,01997818900,01997819600,00000000700,a00,read
0,01997920200,01997920900,00000000700,a00,read
0,01998022600,01998023400,00000000800,a00,read
0,01998112200,01998112900,00000000700,a00,read
0,01998193200,01998194000,00000000800,a00,read
0,01998294200,01998294900,00000000700,a00,read
0,01998376500,01998376900,00000000400,a0c,brk
0,01998379400,01998380000,00000000600,a00,read
0,01998493800,01998494500,00000000700,a00,read
0,01998586500,01998587100,00000000600,a00,read
0,01998705500,01998706100,00000000600,a00,read
0,01998818700,01998819400,00000000700,a00,read
0,01998921900,01998922600,00000000700,a00,read
0,01999023700,01999024200,00000000500,a0c,brk
0,01999385100,01999387900,00000002800,a57,unlink
0,01999409600,01999410200,00000000600,a48,fcntl
0,01962467100,01999444500,00036977400,a07,poll
0,01999477700,01999477900,00000000200,a00,read
0,01999489100,01999490800,00000001700,a2e,sendmsg
0,01999530300,01999546600,00000016300,a01,write
0,01999565000,01999567600,00000002600,a01,write
0,01999584700,01999587100,00000002400,a01,write
0,01936249400,01999787300,00063537900,a3d,wait4
0,01999809000,01999810600,00000001600,a00,read
0,01999813100,01999813600,00000000500,a00,read
0,01999823700,01999828900,00000005200,a14,writev
0,01999830700,01999869200,00000038500,a07,poll
0,01999873100,01999873400,00000000300,a2f,recvmsg
0,01999874100,01999874200,00000000100,a2f,recvmsg
0,01999877200,01999879100,00000001900,a14,writev
0,01999879500,01999888100,00000008600,a07,poll
0,01999889400,01999889600,00000000200,a2f,recvmsg
0,01999889900,01999890000,00000000100,a2f,recvmsg
0,01999891800,01999893600,00000001800,a14,writev
0,01999893900,01999901900,00000008000,a07,poll
0,01999903100,01999903200,00000000100,a2f,recvmsg
0,01999903500,01999903700,00000000200,a2f,recvmsg
0,01999905900,01999907500,00000001600,a14,writev
0,01999907800,01999916200,00000008400,a07,poll
0,01999917300,01999917500,00000000200,a2f,recvmsg
0,01999917800,01999918000,00000000200,a2f,recvmsg
0,01999920200,01999921700,00000001500,a14,writev
0,01999922000,01999963600,00000041600,a07,poll
0,01999965800,01999965900,00000000100,a2f,recvmsg
0,01999966500,01999966600,00000000100,a2f,recvmsg
0,01999968300,01999970100,00000001800,a14,writev
0,01999970500,01999979800,00000009300,a07,poll
0,01999981100,01999981200,00000000100,a2f,recvmsg
0,01999981600,01999981800,00000000200,a2f,recvmsg
0,01999982600,01999982800,00000000200,a08,lseek
0,01999995100,01999995100,00000000000,a08,lseek
0,01999996100,01999997800,00000001700,a14,writev
0,01999998200,02000006600,00000008400,a07,poll
0,02000007800,02000008000,00000000200,a2f,recvmsg
0,02000008300,02000008500,00000000200,a2f,recvmsg
0,02000011200,02000012900,00000001700,a14,writev
0,02000013300,02000021100,00000007800,a07,poll
0,02000022400,02000022600,00000000200,a2f,recvmsg
0,02000022900,02000023000,00000000100,a2f,recvmsg
0,02000024400,02000026100,00000001700,a14,writev
0,02000026400,02000033800,00000007400,a07,poll
0,02000035000,02000035200,00000000200,a2f,recvmsg
0,02000035500,02000035700,00000000200,a2f,recvmsg
0,02000037300,02000039100,00000001800,a14,writev
0,02000039500,02000047100,00000007600,a07,poll
0,02000048300,02000048500,00000000200,a2f,recvmsg
0,02000048800,02000049000,00000000200,a2f,recvmsg
0,02000050600,02000052300,00000001700,a14,writev
0,02000052600,02000060600,00000008000,a07,poll
0,02000061800,02000062000,00000000200,a2f,recvmsg
0,02000062300,02000062500,00000000200,a2f,recvmsg
0,02000064100,02000065800,00000001700,a14,writev
0,02000066200,02000074200,00000008000,a07,poll
0,02000075400,02000075600,00000000200,a2f,recvmsg
0,02000075900,02000076100,00000000200,a2f,recvmsg
0,02000077700,02000079600,00000001900,a14,writev
0,02000079900,02000087600,00000007700,a07,poll
0,02000088800,02000089000,00000000200,a2f,recvmsg
0,02000089300,02000089400,00000000100,a2f,recvmsg
0,02000090500,02000092200,00000001700,a14,writev
0,02000092600,02000099900,00000007300,a07,poll
0,02000100900,02000101100,00000000200,a2f,recvmsg
0,02000101400,02000101600,00000000200,a2f,recvmsg
0,02000104100,02000105700,00000001600,a14,writev
0,02000106100,02000113700,00000007600,a07,poll
0,02000114800,02000115000,00000000200,a2f,recvmsg
0,02000115300,02000115500,00000000200,a2f,recvmsg
0,02000117100,02000118700,00000001600,a14,writev
0,02000119100,02000126800,00000007700,a07,poll
0,02000127900,02000128000,00000000100,a2f,recvmsg
0,02000128300,02000128500,00000000200,a2f,recvmsg
0,02000130000,02000131600,00000001600,a14,writev
0,02000132000,02000139300,00000007300,a07,poll
0,02000140500,02000140600,00000000100,a2f,recvmsg
0,02000140900,02000141000,00000000100,a2f,recvmsg
0,02000143300,02000145000,00000001700,a14,writev
0,02000145500,02000152800,00000007300,a07,poll
0,02000154000,02000154100,00000000100,a2f,recvmsg
0,02000154400,02000154600,00000000200,a2f,recvmsg
0,02000155900,02000157600,00000001700,a14,writev
0,02000157900,02000165300,00000007400,a07,poll
0,02000166400,02000166600,00000000200,a2f,recvmsg
0,02000166900,02000167100,00000000200,a2f,recvmsg
0,02000168600,02000170300,00000001700,a14,writev
0,02000170600,02000178200,00000007600,a07,poll
0,02000179300,02000179500,00000000200,a2f,recvmsg
0,02000179800,02000180000,00000000200,a2f,recvmsg
0,02000181400,02000183000,00000001600,a14,writev
0,02000183400,02000191300,00000007900,a07,poll
0,02000192400,02000192600,00000000200,a2f,recvmsg
0,02000192900,02000193100,00000000200,a2f,recvmsg
0,02000194000,02000195700,00000001700,a14,writev
0,02000196000,02000203900,00000007900,a07,poll
0,02000205000,02000205200,00000000200,a2f,recvmsg
0,02000205400,02000205600,00000000200,a2f,recvmsg
0,02000208800,02000210400,00000001600,a14,writev
0,02000210700,02000218600,00000007900,a07,poll
0,02000219700,02000219900,00000000200,a2f,recvmsg
0,02000220200,02000220400,00000000200,a2f,recvmsg
0,02000221300,02000223000,00000001700,a14,writev
0,02000223300,02000230900,00000007600,a07,poll
0,02000231900,02000232100,00000000200,a2f,recvmsg
0,02000232400,02000232600,00000000200,a2f,recvmsg
0,02000233700,02000235200,00000001500,a14,writev
0,02000235600,02000243000,00000007400,a07,poll
0,02000244100,02000244300,00000000200,a2f,recvmsg
0,02000244600,02000244800,00000000200,a2f,recvmsg
0,02000245800,02000247400,00000001600,a14,writev
0,02000247800,02000255100,00000007300,a07,poll
0,02000256300,02000256500,00000000200,a2f,recvmsg
0,02000256700,02000256900,00000000200,a2f,recvmsg
0,02000258300,02000259800,00000001500,a14,writev
0,02000260200,02000268000,00000007800,a07,poll
0,02000269900,02000270100,00000000200,a2f,recvmsg
0,02000270400,02000270600,00000000200,a2f,recvmsg
0,02000271800,02000273400,00000001600,a14,writev
0,02000273700,02000281400,00000007700,a07,poll
0,02000282500,02000282700,00000000200,a2f,recvmsg
0,02000283000,02000283200,00000000200,a2f,recvmsg
0,02000284800,02000286300,00000001500,a14,writev
0,02000286700,02000305500,00000018800,a07,poll
0,02000306800,02000307000,00000000200,a2f,recvmsg
0,02000307400,02000307600,00000000200,a2f,recvmsg
0,02000309400,02000311300,00000001900,a14,writev
0,02000311700,02000319400,00000007700,a07,poll
0,02000320600,02000320800,00000000200,a2f,recvmsg
0,02000321100,02000321200,00000000100,a2f,recvmsg
0,02000323300,02000325000,00000001700,a14,writev
0,02000325400,02000333400,00000008000,a07,poll
0,02000334500,02000334600,00000000100,a2f,recvmsg
0,02000334900,02000335100,00000000200,a2f,recvmsg
0,02000337100,02000338800,00000001700,a14,writev
0,02000339100,02000346800,00000007700,a07,poll
0,02000347900,02000348100,00000000200,a2f,recvmsg
0,02000348400,02000348600,00000000200,a2f,recvmsg
0,02000350200,02000351900,00000001700,a14,writev
0,02000352300,02000360100,00000007800,a07,poll
0,02000361100,02000361300,00000000200,a2f,recvmsg
0,02000361600,02000361800,00000000200,a2f,recvmsg
0,02000365500,02000367200,00000001700,a14,writev
0,02000367500,02000375300,00000007800,a07,poll
0,02000376400,02000376600,00000000200,a2f,recvmsg
0,02000376900,02000377100,00000000200,a2f,recvmsg
0,02000378500,02000380100,00000001600,a14,writev
0,02000380400,02000387900,00000007500,a07,poll
0,02000389100,02000389300,00000000200,a2f,recvmsg
0,02000389600,02000389700,00000000100,a2f,recvmsg
0,02000391000,02000392700,00000001700,a14,writev
0,02000393100,02000401000,00000007900,a07,poll
0,02000402000,02000402200,00000000200,a2f,recvmsg
0,02000402500,02000402700,00000000200,a2f,recvmsg
0,02000404800,02000406500,00000001700,a14,writev
0,02000406800,02000414500,00000007700,a07,poll
0,02000415700,02000415900,00000000200,a2f,recvmsg
0,02000416200,02000416300,00000000100,a2f,recvmsg
0,02000419000,02000420600,00000001600,a14,writev
0,02000420900,02000428800,00000007900,a07,poll
0,02000429800,02000430000,00000000200,a2f,recvmsg
0,02000430300,02000430500,00000000200,a2f,recvmsg
0,02000432600,02000434300,00000001700,a14,writev
0,02000434600,02000442300,00000007700,a07,poll
0,02000443400,02000443500,00000000100,a2f,recvmsg
0,02000443800,02000444000,00000000200,a2f,recvmsg
0,02000445700,02000447300,00000001600,a14,writev
0,02000447600,02000455300,00000007700,a07,poll
0,02000456400,02000456600,00000000200,a2f,recvmsg
0,02000456900,02000457100,00000000200,a2f,recvmsg
0,02000458500,02000460100,00000001600,a14,writev
0,02000460500,02000468000,00000007500,a07,poll
0,02000469100,02000469300,00000000200,a2f,recvmsg
0,02000469500,02000469700,00000000200,a2f,recvmsg
0,02000471000,02000472700,00000001700,a14,writev
0,02000473000,02000480500,00000007500,a07,poll
0,02000481500,02000481700,00000000200,a2f,recvmsg
0,02000482000,02000482200,00000000200,a2f,recvmsg
0,02000483800,02000485400,00000001600,a14,writev
0,02000485800,02000493400,00000007600,a07,poll
0,02000494500,02000494600,00000000100,a2f,recvmsg
0,02000494900,02000495100,00000000200,a2f,recvmsg
0,02000496200,02000496400,00000000200,a08,lseek
0,02000499900,02000501400,00000001500,a00,read
0,02000505100,02000505200,00000000100,a08,lseek
0,02000506200,02000507900,00000001700,a14,writev
0,02000508300,02000516900,00000008600,a07,poll
0,02000518200,02000518300,00000000100,a2f,recvmsg
0,02000518700,02000518800,00000000100,a2f,recvmsg
0,02000542400,02000544100,00000001700,a14,writev
0,02000544500,02000553700,00000009200,a07,poll
0,02000555000,02000555200,00000000200,a2f,recvmsg
0,02000555500,02000555700,00000000200,a2f,recvmsg
0,02000559400,02000560500,00000001100,a00,read
0,02000566000,02000566100,00000000100,a08,lseek
0,02000567700,02000569400,00000001700,a14,writev
0,02000569800,02000578600,00000008800,a07,poll
0,02000579800,02000579900,00000000100,a2f,recvmsg
0,02000580300,02000580500,00000000200,a2f,recvmsg
0,02000581500,02000583200,00000001700,a14,writev
0,02000583500,02000591100,00000007600,a07,poll
0,02000592300,02000592500,00000000200,a2f,recvmsg
0,02000592800,02000592900,00000000100,a2f,recvmsg
0,02000594000,02000595600,00000001600,a14,writev
0,02000596000,02000603500,00000007500,a07,poll
0,02000604600,02000604700,00000000100,a2f,recvmsg
0,02000605000,02000605200,00000000200,a2f,recvmsg
0,02000606200,02000607900,00000001700,a14,writev
0,02000608200,02000615700,00000007500,a07,poll
0,02000616900,02000617000,00000000100,a2f,recvmsg
0,02000617300,02000617500,00000000200,a2f,recvmsg
0,02000618500,02000620100,00000001600,a14,writev
0,02000620500,02000627900,00000007400,a07,poll
0,02000629000,02000629200,00000000200,a2f,recvmsg
0,02000629500,02000629700,00000000200,a2f,recvmsg
0,02000630800,02000632500,00000001700,a14,writev
0,02000632800,02000640300,00000007500,a07,poll
0,02000641400,02000641500,00000000100,a2f,recvmsg
0,02000641800,02000642000,00000000200,a2f,recvmsg
0,02000643000,02000644600,00000001600,a14,writev
0,02000645000,02000652300,00000007300,a07,poll
0,02000653500,02000653600,00000000100,a2f,recvmsg
0,02000653800,02000654000,00000000200,a2f,recvmsg
0,02000655700,02000657400,00000001700,a14,writev
0,02000657600,02000665200,00000007600,a07,poll
0,02000666400,02000666600,00000000200,a2f,recvmsg
0,02000666900,02000667000,00000000100,a2f,recvmsg
0,02000668200,02000669900,00000001700,a14,writev
0,02000670200,02000678000,00000007800,a07,poll
0,02000679000,02000679200,00000000200,a2f,recvmsg
0,02000679500,02000679700,00000000200,a2f,recvmsg
0,02000680100,02000680200,00000000100,a08,lseek
0,02000682200,02000684000,00000001800,a14,writev
0,02000684200,02000691800,00000007600,a07,poll
0,02000693100,02000693300,00000000200,a2f,recvmsg
0,02000693600,02000693700,00000000100,a2f,recvmsg
0,02000697000,02000698600,00000001600,a14,writev
0,02000699000,02000706900,00000007900,a07,poll
0,02000708100,02000708300,00000000200,a2f,recvmsg
0,02000708600,02000708800,00000000200,a2f,recvmsg
0,02000710400,02000712100,00000001700,a14,writev
0,02000712500,02000719600,00000007100,a07,poll
0,02000720600,02000720800,00000000200,a2f,recvmsg
0,02000721100,02000721300,00000000200,a2f,recvmsg
0,02000722600,02000724200,00000001600,a14,writev
0,02000724600,02000732000,00000007400,a07,poll
0,02000733100,02000733300,00000000200,a2f,recvmsg
0,02000733500,02000733700,00000000200,a2f,recvmsg
0,02000735100,02000736700,00000001600,a14,writev
0,02000737100,02000744600,00000007500,a07,poll
0,02000745700,02000745900,00000000200,a2f,recvmsg
0,02000746200,02000746400,00000000200,a2f,recvmsg
0,02000747700,02000749300,00000001600,a14,writev
0,02000749700,02000757300,00000007600,a07,poll
0,02000758300,02000758500,00000000200,a2f,recvmsg
0,02000758800,02000759000,00000000200,a2f,recvmsg
0,02000760700,02000762300,00000001600,a14,writev
0,02000762700,02000770200,00000007500,a07,poll
0,02000771400,02000771500,00000000100,a2f,recvmsg
0,02000771700,02000771900,00000000200,a2f,recvmsg
0,02000773300,02000774900,00000001600,a14,writev
0,02000775300,02000782500,00000007200,a07,poll
0,02000783600,02000783700,00000000100,a2f,recvmsg
0,02000784100,02000784200,00000000100,a2f,recvmsg
0,02000785500,02000787200,00000001700,a14,writev
0,02000787600,02000795200,00000007600,a07,poll
0,02000796200,02000796400,00000000200,a2f,recvmsg
0,02000796700,02000796900,00000000200,a2f,recvmsg
0,02000798200,02000799900,00000001700,a14,writev
0,02000800300,02000807600,00000007300,a07,poll
0,02000808700,02000808900,00000000200,a2f,recvmsg
0,02000809200,02000809400,00000000200,a2f,recvmsg
0,02000810700,02000812400,00000001700,a14,writev
0,02000812800,02000820100,00000007300,a07,poll
0,02000821200,02000821400,00000000200,a2f,recvmsg
0,02000821700,02000821900,00000000200,a2f,recvmsg
0,02000823200,02000824900,00000001700,a14,writev
0,02000825300,02000832600,00000007300,a07,poll
0,02000833700,02000833900,00000000200,a2f,recvmsg
0,02000834200,02000834300,00000000100,a2f,recvmsg
0,02000836200,02000837900,00000001700,a14,writev
0,02000838200,02000845700,00000007500,a07,poll
0,02000846900,02000847000,00000000100,a2f,recvmsg
0,02000847300,02000847500,00000000200,a2f,recvmsg
0,02000848800,02000850400,00000001600,a14,writev
0,02000850800,02000858400,00000007600,a07,poll
0,02000859500,02000859700,00000000200,a2f,recvmsg
0,02000860000,02000860200,00000000200,a2f,recvmsg
0,02000861400,02000863100,00000001700,a14,writev
0,02000863400,02000870700,00000007300,a07,poll
0,02000871900,02000872100,00000000200,a2f,recvmsg
0,02000872300,02000872500,00000000200,a2f,recvmsg
0,02000873900,02000875500,00000001600,a14,writev
0,02000875800,02000883300,00000007500,a07,poll
0,02000884300,02000884500,00000000200,a2f,recvmsg
0,02000884800,02000885000,00000000200,a2f,recvmsg
0,02000891600,02000893200,00000001600,a14,writev
0,02000893600,02000901500,00000007900,a07,poll
0,02000902600,02000902700,00000000100,a2f,recvmsg
0,02000903000,02000903200,00000000200,a2f,recvmsg
0,02000904800,02000906500,00000001700,a14,writev
0,02000906800,02000914200,00000007400,a07,poll
0,02000915400,02000915500,00000000100,a2f,recvmsg
0,02000915800,02000915900,00000000100,a2f,recvmsg
0,02000917400,02000919000,00000001600,a14,writev
0,02000919300,02000926700,00000007400,a07,poll
0,02000927800,02000928000,00000000200,a2f,recvmsg
0,02000928300,02000928400,00000000100,a2f,recvmsg
0,02000930000,02000931600,00000001600,a14,writev
0,02000931900,02000939300,00000007400,a07,poll
0,02000940500,02000940600,00000000100,a2f,recvmsg
0,02000940900,02000941100,00000000200,a2f,recvmsg
0,02000942500,02000944300,00000001800,a14,writev
0,02000944600,02000952100,00000007500,a07,poll
0,02000953300,02000953400,00000000100,a2f,recvmsg
0,02000953700,02000953900,00000000200,a2f,recvmsg
0,02000974400,02000998700,00000024300,a57,unlink
0,02000999900,02001004600,00000004700,a14,writev
0,02001005200,02001105700,00000100500,a07,poll
0,02001005200,02001109200,00000104000,a07,poll
0,02001119900,02001120100,00000000200,a2f,recvmsg
0,02001123700,02001123900,00000000200,a2f,recvmsg
0,02001124200,02001124300,00000000100,a2f,recvmsg
0,02001127700,02001127900,00000000200,a2f,recvmsg
0,02001128100,02001128300,00000000200,a2f,recvmsg
0,02001128800,02001132800,00000004000,a07,poll
0,02001141100,02001141300,00000000200,a2f,recvmsg
0,02001159600,02001159800,00000000200,a2f,recvmsg
0,02001161500,02001161700,00000000200,a2f,recvmsg
0,02001163500,02001165900,00000002400,a07,poll
0,02001168500,02001168600,00000000100,a2f,recvmsg
0,02001169400,02001169500,00000000100,a2f,recvmsg
0,02001169700,02001169900,00000000200,a2f,recvmsg
0,02001170700,02001170900,00000000200,a2f,recvmsg
0,02001171100,02001171200,00000000100,a2f,recvmsg
0,02001171500,02001173100,00000001600,a07,poll
0,02001175300,02001175500,00000000200,a2f,recvmsg
0,02001184800,02001185700,00000000900,a00,read
0,02001195200,02001195400,00000000200,a2f,recvmsg
0,02001223200,02001227500,00000004300,a07,poll
0,02001237200,02001237400,00000000200,a2f,recvmsg
0,02001261500,02001263500,00000002000,a07,poll
0,02001266900,02001267000,00000000100,a2f,recvmsg
0,02001268100,02001268300,00000000200,a2f,recvmsg
0,02001268400,02001268600,00000000200,a2f,recvmsg
0,02001269800,02001270000,00000000200,a2f,recvmsg
0,02001270100,02001270300,00000000200,a2f,recvmsg
0,02001270700,02001272100,00000001400,a07,poll
0,02001274400,02001275400,00000001000,a07,poll
0,02001277000,02001305000,00000028000,a07,poll
0,02001305100,02001306300,00000001200,a2f,recvmsg
0,02001277000,02001307700,00000030700,a07,poll
0,02001309500,02001309700,00000000200,a2f,recvmsg
0,02001310300,02001310500,00000000200,a2f,recvmsg
0,02001310700,02001310900,00000000200,a2f,recvmsg
0,02001311300,02001311500,00000000200,a2f,recvmsg
0,02001311700,02001311900,00000000200,a2f,recvmsg
0,02001312100,02001313500,00000001400,a07,poll
0,02001316500,02001317700,00000001200,a07,poll
0,02001319100,02001367600,00000048500,a07,poll
0,02001367800,02001368900,00000001100,a2f,recvmsg
0,02001319100,02001370000,00000050900,a07,poll
0,02001371800,02001371900,00000000100,a2f,recvmsg
0,02001372400,02001372600,00000000200,a2f,recvmsg
0,02001372800,02001372900,00000000100,a2f,recvmsg
0,02001373500,02001373700,00000000200,a2f,recvmsg
0,02001373800,02001373900,00000000100,a2f,recvmsg
0,02001374100,02001375600,00000001500,a07,poll
0,02001378600,02001379700,00000001100,a07,poll
0,02001381000,02001429600,00000048600,a07,poll
0,02001429900,02001430900,00000001000,a2f,recvmsg
0,02001381000,02001432200,00000051200,a07,poll
0,02001433900,02001434100,00000000200,a2f,recvmsg
0,02001434600,02001434700,00000000100,a2f,recvmsg
0,02001434900,02001435100,00000000200,a2f,recvmsg
0,02001435700,02001435800,00000000100,a2f,recvmsg
0,02001436000,02001436200,00000000200,a2f,recvmsg
0,02001436400,02001437800,00000001400,a07,poll
0,02001440700,02001441900,00000001200,a07,poll
0,02001443000,02001491000,00000048000,a07,poll
0,02001492200,02001508200,00000016000,a07,poll
0,02001509500,02001514300,00000004800,a07,poll
0,02001515300,02001565700,00000050400,a07,poll
0,02001565900,02001566900,00000001000,a2f,recvmsg
0,02001515300,02001567800,00000052500,a07,poll
0,02001570300,02001573400,00000003100,a07,poll
0,02001574700,02001614600,00000039900,a07,poll
0,02001614800,02001615800,00000001000,a2f,recvmsg
0,02001574700,02001616800,00000042100,a07,poll
0,02001619300,02001622000,00000002700,a07,poll
0,02001623100,02001662900,00000039800,a07,poll
0,02001663100,02001664200,00000001100,a2f,recvmsg
0,02001623100,02001665100,00000042000,a07,poll
0,02001669100,02001670500,00000001400,a07,poll
0,02001671700,02001710800,00000039100,a07,poll
0,02001711000,02001712000,00000001000,a2f,recvmsg
0,02001671700,02001712900,00000041200,a07,poll
0,02001715400,02001717900,00000002500,a07,poll
0,02001719100,02001759100,00000040000,a07,poll
0,02001719100,02001760800,00000041700,a07,poll
0,02001761100,02001763400,00000002300,a2f,recvmsg
0,02001763900,02001766500,00000002600,a07,poll
0,02001767700,02001807400,00000039700,a07,poll
0,02001807600,02001808700,00000001100,a2f,recvmsg
0,02001767700,02001809600,00000041900,a07,poll
0,02001812100,02001814800,00000002700,a07,poll
0,02001816000,02001864500,00000048500,a07,poll
0,02001864800,02001865900,00000001100,a2f,recvmsg
0,02001816000,02001866700,00000050700,a07,poll
0,02001869300,02001872800,00000003500,a07,poll
0,02001873900,02001887600,00000013700,a07,poll
0,02001887900,02001888900,00000001000,a2f,recvmsg
0,02001873900,02001889800,00000015900,a07,poll
0,02001892400,02001895200,00000002800,a07,poll
0,02001896300,02001908600,00000012300,a07,poll
0,02001896300,02001910200,00000013900,a07,poll
0,02001910500,02001912900,00000002400,a2f,recvmsg
0,02001913400,02001915800,00000002400,a07,poll
0,02001917000,02001928600,00000011600,a07,poll
0,02001917000,02001930400,00000013400,a07,poll
0,02001930500,02001932800,00000002300,a2f,recvmsg
0,02001933300,02001935700,00000002400,a07,poll
0,02001936900,02001947600,00000010700,a07,poll
0,02001936900,02001949400,00000012500,a07,poll
0,02001949600,02001951900,00000002300,a2f,recvmsg
0,02001952400,02001955000,00000002600,a07,poll
0,02001956200,02001966400,00000010200,a07,poll
0,02001956200,02001968100,00000011900,a07,poll
0,02001968300,02001970600,00000002300,a2f,recvmsg
0,02001971200,02001973600,00000002400,a07,poll
0,02001974800,02001976300,00000001500,a07,poll
0,02001979300,02001979500,00000000200,a2f,recvmsg
0,02001980000,02001980100,00000000100,a2f,recvmsg
0,02001974800,02002000800,00000026000,a07,poll
0,02002001100,02002002500,00000001400,a2f,recvmsg
0,02002005800,02002006900,00000001100,a2d,recvfrom
0,02002011300,02002011600,00000000300,a2f,recvmsg
0,02002012200,02002012300,00000000100,a2f,recvmsg
0,02002070600,02002071000,00000000400,a2f,recvmsg
0,02002073000,02002073300,00000000300,a2f,recvmsg
0,02002076200,02002080300,00000004100,a07,poll
0,02002080600,02002082100,00000001500,a2f,recvmsg
0,02002084600,02002085400,00000000800,a2d,recvfrom
0,02002090100,02002090200,00000000100,a2f,recvmsg
0,02002090800,02002091000,00000000200,a2f,recvmsg
0,02002122300,02002122400,00000000100,a2f,recvmsg
0,02002124700,02002124800,00000000100,a2f,recvmsg
0,02002127800,02002130100,00000002300,a07,poll
0,02002130600,02002132200,00000001600,a2f,recvmsg
0,02002133900,02002134600,00000000700,a2d,recvfrom
0,02002139500,02002139600,00000000100,a2f,recvmsg
0,02002140200,02002140400,00000000200,a2f,recvmsg
0,02002182200,02002182600,00000000400,a2f,recvmsg
0,02002184200,02002184400,00000000200,a2f,recvmsg
0,02002197900,02002215500,00000017600,a07,poll
0,02002217000,02002217400,00000000400,a00,read
0,02002231000,02002232200,00000001200,a2f,recvmsg
0,02002302700,02002305000,00000002300,a07,poll
0,02002308200,02002308400,00000000200,a2f,recvmsg
0,02002309100,02002309200,00000000100,a2f,recvmsg
0,02002803700,02002808400,00000004700,a09,mmap
0,02002962600,02002967600,00000005000,a02,open
0,02002975400,02002977500,00000002100,a00,read
0,02003028700,02003029600,00000000900,a00,read
0,02003078400,02003079200,00000000800,a00,read
0,02003125200,02003125900,00000000700,a00,read
0,02003173000,02003173700,00000000700,a00,read
0,02003219300,02003220200,00000000900,a00,read
0,02003264000,02003264700,00000000700,a00,read
0,02003310100,02003310800,00000000700,a00,read
0,02003358000,02003358700,00000000700,a00,read
0,02003406600,02003407300,00000000700,a00,read
0,02003454400,02003455100,00000000700,a00,read
0,02003481500,02003483200,00000001700,a02,open
0,02003487100,02003488100,00000001000,a00,read
0,02003543600,02003544500,00000000900,a00,read
0,02003627200,02003627900,00000000700,a00,read
0,02003699000,02003699700,00000000700,a00,read
0,02003776100,02003776800,00000000700,a00,read
0,02003854400,02003855200,00000000800,a00,read
0,02003930500,02003931200,00000000700,a00,read
0,02004013400,02004014200,00000000800,a00,read
0,02004080100,02004081000,00000000900,a00,read
0,02004138100,02004138600,00000000500,a00,read
0,02004216600,02004252200,00000035600,a07,poll
0,02004255700,02004255900,00000000200,a2f,recvmsg
0,02004256500,02004256700,00000000200,a2f,recvmsg
0,02004259800,02004269500,00000009700,a07,poll
0,02004270700,02004270900,00000000200,a2f,recvmsg
0,02004271300,02004271400,00000000100,a2f,recvmsg
0,02004275900,02004281800,00000005900,a06,lstat
0,02004282600,02004283700,00000001100,a06,lstat
0,02004301000,02004311800,00000010800,a01,write
0,02004317300,02004336500,00000019200,a07,poll
0,02004338500,02004338700,00000000200,a2f,recvmsg
0,02004339100,02004339300,00000000200,a2f,recvmsg
0,02004340500,02004648900,00000308400,a38,clone
0,02005131100,02005131200,00000000100,a0c,brk
0,02005141100,02005144000,00000002900,a15,access
0,02005144800,02005145600,00000000800,a09,mmap
0,02005150800,02005151600,00000000800,a15,access
0,02005158900,02005160000,00000001100,a09,mmap
0,02005164100,02005164500,00000000400,a15,access
0,02005171600,02005172400,00000000800,a00,read
0,02005179500,02005181800,00000002300,a09,mmap
0,02005194100,02005194700,00000000600,a15,access
0,02005198000,02005198600,00000000600,a00,read
0,02005199300,02005200300,00000001000,a09,mmap
0,02005202800,02005204100,00000001300,a09,mmap
0,02005212300,02005212800,00000000500,a15,access
0,02005215900,02005216500,00000000600,a00,read
0,02005217200,02005218000,00000000800,a09,mmap
0,02005219700,02005221400,00000001700,a09,mmap
0,02005231000,02005232200,00000001200,a09,mmap
0,02005241300,02005241900,00000000600,a15,access
0,02005245100,02005246000,00000000900,a00,read
0,02005246700,02005248200,00000001500,a09,mmap
0,02005251300,02005253000,00000001700,a09,mmap
0,02005261200,02005261700,00000000500,a15,access
0,02005264900,02005265400,00000000500,a00,read
0,02005266100,02005267500,00000001400,a09,mmap
0,02005271500,02005273700,00000002200,a09,mmap
0,02005282100,02005282500,00000000400,a15,access
0,02005285100,02005285700,00000000600,a00,read
0,02005286100,02005287200,00000001100,a09,mmap
0,02005288500,02005289800,00000001300,a09,mmap
0,02005293200,02005294500,00000001300,a09,mmap
0,02005300600,02005301100,00000000500,a15,access
0,02005303600,02005304100,00000000500,a00,read
0,02005304800,02005306100,00000001300,a09,mmap
0,02005308700,02005310200,00000001500,a09,mmap
0,02005324000,02005324600,00000000600,a09,mmap
0,02005328300,02005328600,00000000300,a09,mmap
0,02005329700,02005330000,00000000300,a09,mmap
0,02005510700,02005510800,00000000100,a0c,brk
0,02005510900,02005511700,00000000800,a0c,brk
0,02005543000,02005544100,00000001100,a00,read
0,02005555700,02005557000,00000001300,a00,read
0,02005598300,02005599400,00000001100,a00,read
0,02005719400,02005720200,00000000800,a00,read
0,02005791100,02005791500,00000000400,a00,read
0,02005877600,02005878400,00000000800,a00,read
0,02006008800,02006009800,00000001000,a00,read
0,02006137500,02006138200,00000000700,a00,read
0,02006292200,02006292900,00000000700,a00,read
0,02006441800,02006442500,00000000700,a00,read
0,02006503700,02006505200,00000001500,a0c,brk
0,02006619800,02006620700,00000000900,a00,read
0,02006767400,02006768100,00000000700,a00,read
0,02006921900,02006922700,00000000800,a00,read
0,02007080600,02007081300,00000000700,a00,read
0,02007188600,02007189300,00000000700,a00,read
0,02007219600,02007220300,00000000700,a0c,brk
0,02007327900,02007328600,00000000700,a00,read
0,02007571300,02007572000,00000000700,a00,read
0,02007584500,02007584900,00000000400,a00,read
0,02007628000,02007628400,00000000400,a00,read
0,02007648300,02007649000,00000000700,a00,read
0,02007855500,02007856000,00000000500,a00,read
0,02007885600,02007886500,00000000900,a00,read
0,02007983900,02007984500,00000000600,a00,read
0,02008008500,02008009800,00000001300,a0c,brk
0,02008054800,02008055200,00000000400,a00,read
0,02008130800,02008131600,00000000800,a00,read
0,02008286900,02008287400,00000000500,a00,read
0,02008398200,02008398800,00000000600,a00,read
0,02008493300,02008493800,00000000500,a00,read
0,02008505500,02008506000,00000000500,a00,read
0,02008588700,02008589100,00000000400,a00,read
0,02008612900,02008613200,00000000300,a00,read
0,02008635000,02008635600,00000000600,a00,read
0,02008736600,02008737900,00000001300,a0c,brk
0,02008739700,02008740900,00000001200,a00,read
0,02008942300,02008942800,00000000500,a00,read
0,02009028100,02009028800,00000000700,a00,read
0,02009093000,02009093600,00000000600,a00,read
0,02009221700,02009222100,00000000400,a00,read
0,02009254000,02009254700,00000000700,a00,read
0,02009271600,02009273500,00000001900,a02,open
0,02009384200,02009384700,00000000500,a00,read
0,02009455700,02009456200,00000000500,a00,read
0,02009508300,02009509500,00000001200,a0c,brk
0,02009516300,02009517100,00000000800,a00,read
0,02009626300,02009627000,00000000700,a00,read
0,02009776500,02009777500,00000001000,a00,read
0,02009907600,02009908300,00000000700,a00,read
0,02009965700,02009966400,00000000700,a00,read
0,02010022000,02010022700,00000000700,a00,read
0,02010092400,02010093000,00000000600,a00,read
0,02010145400,02010146100,00000000700,a00,read
1,01937094100,01937100800,00000006700,a07,poll
1,01937102000,01937102200,00000000200,a2f,recvmsg
1,01937102500,01937102700,00000000200,a2f,recvmsg
1,01937105500,01937112300,00000006800,a07,poll
1,01937113500,01937113700,00000000200,a2f,recvmsg
1,01937114000,01937114200,00000000200,a2f,recvmsg
1,01937117900,01937124700,00000006800,a07,poll
1,01937125900,01937126100,00000000200,a2f,recvmsg
1,01937126400,01937126500,00000000100,a2f,recvmsg
1,01937129500,01937136200,00000006700,a07,poll
1,01937137400,01937137600,00000000200,a2f,recvmsg
1,01937137800,01937138000,00000000200,a2f,recvmsg
1,01937140900,01937147700,00000006800,a07,poll
1,01937148900,01937149100,00000000200,a2f,recvmsg
1,01937149300,01937149500,00000000200,a2f,recvmsg
1,01937152500,01937159300,00000006800,a07,poll
1,01937160500,01937160600,00000000100,a2f,recvmsg
1,01937160900,01937161100,00000000200,a2f,recvmsg
1,01937169400,01937176200,00000006800,a07,poll
1,01937177500,01937177600,00000000100,a2f,recvmsg
1,01937177800,01937178000,00000000200,a2f,recvmsg
1,01937181300,01937188000,00000006700,a07,poll
1,01937189100,01937189300,00000000200,a2f,recvmsg
1,01937189600,01937189800,00000000200,a2f,recvmsg
1,01937192900,01937199700,00000006800,a07,poll
1,01937200800,01937201000,00000000200,a2f,recvmsg
1,01937201300,01937201500,00000000200,a2f,recvmsg
1,01937204700,01937211400,00000006700,a07,poll
1,01937212600,01937212700,00000000100,a2f,recvmsg
1,01937213000,01937213200,00000000200,a2f,recvmsg
1,01937216300,01937223200,00000006900,a07,poll
1,01937224400,01937224600,00000000200,a2f,recvmsg
1,01937224900,01937225100,00000000200,a2f,recvmsg
1,01937245500,01937273200,00000027700,a57,unlink
1,01937274500,01937279000,00000004500,a14,writev
1,01937279600,01937384100,00000104500,a07,poll
1,01937399700,01937399900,00000000200,a2f,recvmsg
1,01937437100,01937469600,00000032500,a07,poll
1,01937471300,01937530500,00000059200,a07,poll
1,01937531900,01937590000,00000058100,a07,poll
1,01937591200,01937648400,00000057200,a07,poll
1,01937649500,01937708200,00000058700,a07,poll
1,01937710200,01937763800,00000053600,a07,poll
1,01937765000,01937807400,00000042400,a07,poll
1,01937809300,01937851700,00000042400,a07,poll
1,01937853000,01937895400,00000042400,a07,poll
1,01937896500,01937939000,00000042500,a07,poll
1,01937940500,01937983100,00000042600,a07,poll
1,01937984300,01938035200,00000050900,a07,poll
1,01938036500,01938054800,00000018300,a07,poll
1,01938055800,01938070300,00000014500,a07,poll
1,01938071400,01938084900,00000013500,a07,poll
1,01938085900,01938099700,00000013800,a07,poll
1,01938100700,01938113600,00000012900,a07,poll
1,01938114800,01938119100,00000004300,a07,poll
1,01938121400,01938121600,00000000200,a2f,recvmsg
1,01938122100,01938122300,00000000200,a2f,recvmsg
1,01938139900,01938143500,00000003600,a07,poll
1,01938144100,01938145700,00000001600,a2f,recvmsg
1,01938147000,01938148400,00000001400,a2d,recvfrom
1,01938152600,01938152900,00000000300,a2f,recvmsg
1,01938153400,01938153600,00000000200,a2f,recvmsg
1,01938209000,01938209300,00000000300,a2f,recvmsg
1,01938211600,01938211800,00000000200,a2f,recvmsg
1,01938223000,01938356900,00000133900,a07,poll
1,01938357600,01938359500,00000001900,a2f,recvmsg
1,01938366600,01938367300,00000000700,a2d,recvfrom
1,01938368500,01938368700,00000000200,a2f,recvmsg
1,01938369300,01938369500,00000000200,a2f,recvmsg
1,01938401600,01938401800,00000000200,a2f,recvmsg
1,01938404400,01938404500,00000000100,a2f,recvmsg
1,01938407800,01938410600,00000002800,a07,poll
1,01938413300,01938413500,00000000200,a2f,recvmsg
1,01938414100,01938414300,00000000200,a2f,recvmsg
1,01949084300,01938999600,-0010084700,ae8,epoll_wait
1,01939013100,01939015200,00000002100,a2f,recvmsg
1,01939029800,01939030000,00000000200,a2f,recvmsg
1,01939087200,01939092600,00000005400,a2e,sendmsg
1,01939147200,01939183300,00000036100,a07,poll
1,01939298700,01939299100,00000000400,aca,futex
1,01939346500,01939353700,00000007200,a07,poll
1,01939393300,01939393700,00000000400,aca,futex
1,01939468000,01939470300,00000002300,a01,write
1,01939098200,01939481500,00000383300,ae8,epoll_wait
1,01939485100,01939487100,00000002000,a2f,recvmsg
1,01939506600,01939506800,00000000200,a2f,recvmsg
1,01939532200,01939534100,00000001900,a2e,sendmsg
1,01939474000,01939907200,00000433200,a07,poll
1,01940239000,01940247900,00000008900,a02,open
1,01940261000,01940264100,00000003100,a00,read
1,01940321700,01940322400,00000000700,a00,read
1,01940374100,01940374800,00000000700,a00,read
1,01940424800,01940425600,00000000800,a00,read
1,01940477300,01940478000,00000000700,a00,read
1,01940528600,01940529300,00000000700,a00,read
1,01940577400,01940578200,00000000800,a00,read
1,01940627900,01940628600,00000000700,a00,read
1,01940680800,01940681500,00000000700,a00,read
1,01940733200,01940734200,00000001000,a00,read
1,01940783200,01940783900,00000000700,a00,read
1,01940811400,01940813700,00000002300,a02,open
1,01940817300,01940818200,00000000900,a00,read
1,01940873400,01940874200,00000000800,a00,read
1,01940959400,01940960200,00000000800,a00,read
1,01941033200,01941034000,00000000800,a00,read
1,01941113400,01941114100,00000000700,a00,read
1,01941193700,01941194300,00000000600,a00,read
1,01941271900,01941272600,00000000700,a00,read
1,01941357200,01941357800,00000000600,a00,read
1,01941425600,01941426200,00000000600,a00,read
1,01941483900,01941484700,00000000800,a00,read
1,01941565500,01941599000,00000033500,a07,poll
1,01941602800,01941603100,00000000300,a2f,recvmsg
1,01941603800,01941604000,00000000200,a2f,recvmsg
1,01941607800,01941615600,00000007800,a07,poll
1,01941616700,01941616900,00000000200,a2f,recvmsg
1,01941617300,01941617500,00000000200,a2f,recvmsg
1,01941622100,01941629200,00000007100,a06,lstat
1,01941630000,01941631400,00000001400,a06,lstat
1,01941655200,01941670200,00000015000,a01,write
1,01941676100,01941682800,00000006700,a07,poll
1,01941684700,01941684900,00000000200,a2f,recvmsg
1,01941685400,01941685600,00000000200,a2f,recvmsg
1,01941686800,01942003300,00000316500,a38,clone
1,01942485200,01942485400,00000000200,a0c,brk
1,01942496800,01942499700,00000002900,a15,access
1,01942500400,01942501300,00000000900,a09,mmap
1,01942504700,01942505400,00000000700,a15,access
1,01942516700,01942517100,00000000400,a15,access
1,01942524300,01942525400,00000001100,a00,read
1,01942527900,01942529500,00000001600,a09,mmap
1,01942533900,01942536100,00000002200,a09,mmap
1,01942547500,01942548100,00000000600,a15,access
1,01942551400,01942552200,00000000800,a00,read
1,01942552900,01942553800,00000000900,a09,mmap
1,01942555900,01942557100,00000001200,a09,mmap
1,01942565100,01942565700,00000000600,a15,access
1,01942568700,01942569400,00000000700,a00,read
1,01942569900,01942570900,00000001000,a09,mmap
1,01942572400,01942574300,00000001900,a09,mmap
1,01942578100,01942581100,00000003000,a09,mmap
1,01942583200,01942584300,00000001100,a09,mmap
1,01942592700,01942593200,00000000500,a15,access
1,01942595800,01942596400,00000000600,a00,read
1,01942597000,01942598500,00000001500,a09,mmap
1,01942600800,01942602600,00000001800,a09,mmap
1,01942611100,01942611600,00000000500,a15,access
1,01942614800,01942615400,00000000600,a00,read
1,01942616100,01942617500,00000001400,a09,mmap
1,01942620500,01942622800,00000002300,a09,mmap
1,01942631200,01942631800,00000000600,a15,access
1,01942634200,01942634700,00000000500,a00,read
1,01942635200,01942636400,00000001200,a09,mmap
1,01942637600,01942639000,00000001400,a09,mmap
1,01942649100,01942649600,00000000500,a15,access
1,01942651700,01942652200,00000000500,a00,read
1,01942652800,01942654100,00000001300,a09,mmap
1,01942656000,01942657600,00000001600,a09,mmap
1,01942671400,01942672100,00000000700,a09,mmap
1,01942675800,01942676100,00000000300,a09,mmap
1,01942677200,01942677500,00000000300,a09,mmap
1,01942855200,01942855300,00000000100,a0c,brk
1,01942855400,01942856300,00000000900,a0c,brk
1,01942890500,01942891500,00000001000,a00,read
1,01942902700,01942904200,00000001500,a00,read
1,01942941100,01942942200,00000001100,a00,read
1,01943063100,01943063900,00000000800,a00,read
1,01943134500,01943134900,00000000400,a00,read
1,01943222300,01943223000,00000000700,a00,read
1,01943353600,01943354500,00000000900,a00,read
1,01943482800,01943483600,00000000800,a00,read
1,01943640400,01943641100,00000000700,a00,read
1,01943822900,01943823700,00000000800,a00,read
1,01943860200,01943861500,00000001300,a0c,brk
1,01943976700,01943977500,00000000800,a00,read
1,01944124800,01944125500,00000000700,a00,read
1,01944280300,01944281100,00000000800,a00,read
1,01944439700,01944440300,00000000600,a00,read
1,01944548600,01944549400,00000000800,a00,read
1,01944580100,01944580600,00000000500,a0c,brk
1,01944690300,01944691000,00000000700,a00,read
1,01944934400,01944935100,00000000700,a00,read
1,01944946800,01944947200,00000000400,a00,read
1,01944990700,01944991200,00000000500,a00,read
1,01945011100,01945011800,00000000700,a00,read
1,01945217500,01945217900,00000000400,a00,read
1,01945247000,01945247900,00000000900,a00,read
1,01945346700,01945347500,00000000800,a00,read
1,01945371300,01945372400,00000001100,a0c,brk
1,01945417500,01945417900,00000000400,a00,read
1,01945493600,01945494400,00000000800,a00,read
1,01945646900,01945647500,00000000600,a00,read
1,01945758900,01945759600,00000000700,a00,read
1,01945852900,01945853300,00000000400,a00,read
1,01945865400,01945865900,00000000500,a00,read
1,01945950400,01945950900,00000000500,a00,read
1,01945975600,01945976000,00000000400,a00,read
1,01945998900,01945998900,00000000000,a00,read
1,01946102500,01946103700,00000001200,a0c,brk
1,01946104700,01946105800,00000001100,a00,read
1,01946304900,01946305300,00000000400,a00,read
1,01946388900,01946389400,00000000500,a00,read
1,01946452200,01946452800,00000000600,a00,read
1,01946580800,01946581300,00000000500,a00,read
1,01946614300,01946614800,00000000500,a00,read
1,01946628500,01946630200,00000001700,a02,open
1,01946741400,01946742000,00000000600,a00,read
1,01946815600,01946816200,00000000600,a00,read
1,01946868800,01946869900,00000001100,a0c,brk
1,01946876400,01946877100,00000000700,a00,read
1,01946984700,01946985400,00000000700,a00,read
1,01947135500,01947136200,00000000700,a00,read
1,01947265000,01947265700,00000000700,a00,read
1,01947323000,01947323700,00000000700,a00,read
1,01947379100,01947379800,00000000700,a00,read
1,01947449500,01947450200,00000000700,a00,read
1,01947502300,01947503000,00000000700,a00,read
1,01947592000,01947592800,00000000800,a0c,brk
1,01947623900,01947628000,00000004100,a0c,brk
1,01947642900,01947643800,00000000900,a00,read
1,01947765800,01947766600,00000000800,a00,read
1,01947926000,01947926700,00000000700,a00,read
1,01948044000,01948044800,00000000800,a00,read
1,01948191000,01948191700,00000000700,a00,read
1,01948309300,01948309900,00000000600,a00,read
1,01948473200,01948473900,00000000700,a00,read
1,01948478900,01948479600,00000000700,a0c,brk
1,01948594600,01948595200,00000000600,a00,read
1,01948714000,01948714600,00000000600,a00,read
1,01948856300,01948857000,00000000700,a00,read
1,01948988500,01948989200,00000000700,a00,read
1,01949082100,01949082900,00000000800,a00,read
1,01949195200,01949195800,00000000600,a00,read
1,01949320800,01949321500,00000000700,a00,read
1,01949433500,01949434100,00000000600,a0c,brk
1,01949456800,01949457400,00000000600,a00,read
1,01949627300,01949628000,00000000700,a00,read
1,01949779100,01949779700,00000000600,a00,read
1,01949890200,01949890700,00000000500,a00,read
1,01950062700,01950063500,00000000800,a00,read
1,01950173600,01950174400,00000000800,a00,read
1,01950265400,01950266100,00000000700,a00,read
1,01950348500,01950349100,00000000600,a00,read
1,01950422000,01950422600,00000000600,a00,read
1,01950523800,01950524500,00000000700,a00,read
1,01950626800,01950627500,00000000700,a00,read
1,01950717000,01950717700,00000000700,a00,read
1,01950799400,01950800100,00000000700,a00,read
1,01950900900,01950901500,00000000600,a00,read
1,01950981900,01950982400,00000000500,a0c,brk
1,01950984900,01950985500,00000000600,a00,read
1,01951091900,01951092600,00000000700,a00,read
1,01951185100,01951185700,00000000600,a00,read
1,01951304300,01951304900,00000000600,a00,read
1,01951419800,01951420400,00000000600,a00,read
1,01951523000,01951523600,00000000600,a00,read
1,01951624600,01951625100,00000000500,a0c,brk
1,01951998800,01952002300,00000003500,a57,unlink
1,01952027200,01952027800,00000000600,a48,fcntl
1,01952075600,01952091000,00000015400,a01,write
1,01952109000,01952111500,00000002500,a01,write
1,01952127600,01952130000,00000002400,a01,write
1,01951203400,01952369100,00001165700,a17,select
1,01952394500,01952394800,00000000300,a2f,recvmsg
1,01952398700,01952419500,00000020800,a17,select
1,01952423600,01952423700,00000000100,a2f,recvmsg
1,01952424400,01952438400,00000014000,a17,select
1,01952441800,01952442000,00000000200,a2f,recvmsg
1,01952442500,01952457600,00000015100,a17,select
1,01952461500,01952461600,00000000100,a2f,recvmsg
1,01952462200,01952477100,00000014900,a17,select
1,01952481000,01952481200,00000000200,a2f,recvmsg
1,01952481700,01952494900,00000013200,a17,select
1,01952498200,01952498400,00000000200,a2f,recvmsg
1,01952498900,01952523800,00000024900,a17,select
1,01952527800,01952527900,00000000100,a2f,recvmsg
1,01952528500,01952539000,00000010500,a17,select
1,01952542600,01952542700,00000000100,a2f,recvmsg
1,01952543200,01952550600,00000007400,a17,select
1,01952554400,01952554500,00000000100,a2f,recvmsg
1,01952555100,01952563300,00000008200,a17,select
1,01952566900,01952567100,00000000200,a2f,recvmsg
1,01952567600,01952575100,00000007500,a17,select
1,01952578800,01952579000,00000000200,a2f,recvmsg
1,01952579400,01952587100,00000007700,a17,select
1,01952590600,01952590800,00000000200,a2f,recvmsg
1,01952591300,01952598700,00000007400,a17,select
1,01952602700,01952602900,00000000200,a2f,recvmsg
1,01952603400,01952611200,00000007800,a17,select
1,01952614800,01952615000,00000000200,a2f,recvmsg
1,01952615400,01952623900,00000008500,a17,select
1,01952627800,01952628000,00000000200,a2f,recvmsg
1,01952628500,01952636000,00000007500,a17,select
1,01952639800,01952639900,00000000100,a2f,recvmsg
1,01952640400,01952647700,00000007300,a17,select
1,01952651400,01952651600,00000000200,a2f,recvmsg
1,01952652200,01952659400,00000007200,a17,select
1,01952663000,01952663200,00000000200,a2f,recvmsg
1,01952663700,01952670900,00000007200,a17,select
1,01952674600,01952674800,00000000200,a2f,recvmsg
1,01952675300,01952682700,00000007400,a17,select
1,01952686300,01952686500,00000000200,a2f,recvmsg
1,01952687000,01952695800,00000008800,a17,select
1,01952699600,01952699800,00000000200,a2f,recvmsg
1,01952700300,01952707200,00000006900,a17,select
1,01952711000,01952711100,00000000100,a2f,recvmsg
1,01952711700,01952721100,00000009400,a17,select
1,01952724700,01952724900,00000000200,a2f,recvmsg
1,01952725400,01952732200,00000006800,a17,select
1,01952735800,01952736000,00000000200,a2f,recvmsg
1,01952736600,01952743300,00000006700,a17,select
1,01952747100,01952747300,00000000200,a2f,recvmsg
1,01952747800,01952754600,00000006800,a17,select
1,01952758100,01952758300,00000000200,a2f,recvmsg
1,01952758900,01952765900,00000007000,a17,select
1,01952769500,01952769700,00000000200,a2f,recvmsg
1,01952770200,01952777300,00000007100,a17,select
1,01952780800,01952781000,00000000200,a2f,recvmsg
1,01952781500,01952789000,00000007500,a17,select
1,01952792800,01952793000,00000000200,a2f,recvmsg
1,01952793500,01952800800,00000007300,a17,select
1,01952804400,01952804600,00000000200,a2f,recvmsg
1,01952805100,01952812800,00000007700,a17,select
1,01952816700,01952816800,00000000100,a2f,recvmsg
1,01952817400,01952826100,00000008700,a17,select
1,01952829900,01952830000,00000000100,a2f,recvmsg
1,01952830500,01952838100,00000007600,a17,select
1,01952841800,01952842000,00000000200,a2f,recvmsg
1,01952842600,01952852000,00000009400,a17,select
1,01952855700,01952855900,00000000200,a2f,recvmsg
1,01952856400,01952863700,00000007300,a17,select
1,01952867300,01952867500,00000000200,a2f,recvmsg
1,01952868000,01952875200,00000007200,a17,select
1,01952878700,01952878900,00000000200,a2f,recvmsg
1,01952879400,01952887400,00000008000,a17,select
1,01952891000,01952891200,00000000200,a2f,recvmsg
1,01952891800,01952899400,00000007600,a17,select
1,01952903100,01952903200,00000000100,a2f,recvmsg
1,01952903800,01952911800,00000008000,a17,select
1,01952915600,01952915800,00000000200,a2f,recvmsg
1,01952916300,01952923900,00000007600,a17,select
1,01952927600,01952927800,00000000200,a2f,recvmsg
1,01952928400,01952935600,00000007200,a17,select
1,01952939500,01952939700,00000000200,a2f,recvmsg
1,01952940100,01952947300,00000007200,a17,select
1,01952950900,01952951000,00000000100,a2f,recvmsg
1,01952951500,01952959100,00000007600,a17,select
1,01952962900,01952963000,00000000100,a2f,recvmsg
1,01952963600,01952979300,00000015700,a17,select
1,01952982800,01952983000,00000000200,a2f,recvmsg
1,01952983500,01953012700,00000029200,a17,select
1,01953016400,01953016600,00000000200,a2f,recvmsg
1,01953017100,01953035100,00000018000,a17,select
1,01953038700,01953038900,00000000200,a2f,recvmsg
1,01953039400,01953046500,00000007100,a17,select
1,01953050200,01953050300,00000000100,a2f,recvmsg
1,01953050800,01953057600,00000006800,a17,select
1,01953061200,01953061300,00000000100,a2f,recvmsg
1,01953061900,01953068700,00000006800,a17,select
1,01953072300,01953072500,00000000200,a2f,recvmsg
1,01953073000,01953079800,00000006800,a17,select
1,01953083300,01953083500,00000000200,a2f,recvmsg
1,01953084000,01953090800,00000006800,a17,select
1,01953094500,01953094700,00000000200,a2f,recvmsg
1,01953095200,01953102000,00000006800,a17,select
1,01953105500,01953105700,00000000200,a2f,recvmsg
1,01953106300,01953113700,00000007400,a17,select
1,01953117500,01953117700,00000000200,a2f,recvmsg
1,01953118200,01953125100,00000006900,a17,select
1,01953128600,01953128800,00000000200,a2f,recvmsg
1,01953129300,01953137800,00000008500,a17,select
1,01953141500,01953141600,00000000100,a2f,recvmsg
1,01953142200,01953151400,00000009200,a17,select
1,01953155000,01953155200,00000000200,a2f,recvmsg
1,01953155800,01953163300,00000007500,a17,select
1,01953166900,01953167000,00000000100,a2f,recvmsg
1,01953167600,01953174800,00000007200,a17,select
1,01953178400,01953178500,00000000100,a2f,recvmsg
1,01953179100,01953186300,00000007200,a17,select
1,01953189900,01953190100,00000000200,a2f,recvmsg
1,01953190700,01953198000,00000007300,a17,select
1,01953201600,01953201800,00000000200,a2f,recvmsg
1,01953202300,01953210100,00000007800,a17,select
1,01953213800,01953214000,00000000200,a2f,recvmsg
1,01953214500,01953221800,00000007300,a17,select
1,01953225400,01953225600,00000000200,a2f,recvmsg
1,01953226100,01953233200,00000007100,a17,select
1,01953236800,01953237000,00000000200,a2f,recvmsg
1,01953237500,01953244700,00000007200,a17,select
1,01953248300,01953248500,00000000200,a2f,recvmsg
1,01953249100,01953256200,00000007100,a17,select
1,01953259800,01953260000,00000000200,a2f,recvmsg
1,01953260600,01953267700,00000007100,a17,select
1,01953271200,01953271400,00000000200,a2f,recvmsg
1,01953271900,01953279600,00000007700,a17,select
1,01953283500,01953283700,00000000200,a2f,recvmsg
1,01953284100,01953291500,00000007400,a17,select
1,01953295100,01953295200,00000000100,a2f,recvmsg
1,01953295700,01953303000,00000007300,a17,select
1,01953306800,01953306900,00000000100,a2f,recvmsg
1,01953307400,01953314700,00000007300,a17,select
1,01953318400,01953318500,00000000100,a2f,recvmsg
1,01953319100,01953333700,00000014600,a17,select
1,01953337400,01953337600,00000000200,a2f,recvmsg
1,01953338100,01953345600,00000007500,a17,select
1,01953349100,01953349300,00000000200,a2f,recvmsg
1,01953349900,01953356900,00000007000,a17,select
1,01953360600,01953360800,00000000200,a2f,recvmsg
1,01953361400,01953368800,00000007400,a17,select
1,01953372400,01953372500,00000000100,a2f,recvmsg
1,01953373100,01953380600,00000007500,a17,select
1,01953384200,01953384400,00000000200,a2f,recvmsg
1,01953384900,01953442100,00000057200,a17,select
1,01953443000,01953444200,00000001200,a2f,recvmsg
1,01953536800,01953541000,00000004200,a14,writev
1,01953616500,01953618400,00000001900,a14,writev
1,01953675900,01953677400,00000001500,a14,writev
1,01953732200,01953733900,00000001700,a14,writev
1,01953787800,01953789300,00000001500,a14,writev
1,01953843600,01953845000,00000001400,a14,writev
1,01953847500,01953848300,00000000800,a2f,recvmsg
1,01953897600,01953899100,00000001500,a14,writev
1,01953899400,01953899800,00000000400,a14,writev
1,01953944800,01953946900,00000002100,a14,writev
1,01953988900,01953990600,00000001700,a14,writev
1,01954031700,01954033900,00000002200,a14,writev
1,01954076300,01954078000,00000001700,a14,writev
1,01954119600,01954121700,00000002100,a14,writev
1,01954145100,01954147500,00000002400,a2f,recvmsg
1,01954174300,01954175800,00000001500,a14,writev
1,01954193300,01954194800,00000001500,a14,writev
1,01954210300,01954211900,00000001600,a14,writev
1,01954226700,01954228300,00000001600,a14,writev
1,01954241900,01954243500,00000001600,a14,writev
1,01954257900,01954259500,00000001600,a14,writev
1,01954264100,01954264300,00000000200,a2f,recvmsg
1,01954264900,01954265400,00000000500,a14,writev
1,01954265700,01954265900,00000000200,a14,writev
1,01954284600,01954286400,00000001800,a14,writev
1,01954286700,01954288100,00000001400,a14,writev
1,01954288700,01954288900,00000000200,a2f,recvmsg
1,01954300800,01954302400,00000001600,a14,writev
1,01954302500,01954303700,00000001200,a14,writev
1,01954304100,01954304300,00000000200,a2f,recvmsg
1,01941676100,01954312000,00012635900,a07,poll
1,01954318900,01954321400,00000002500,a2f,recvmsg
1,01954326900,01954327100,00000000200,a2f,recvmsg
1,01954330600,01954330800,00000000200,a2f,recvmsg
1,01954331000,01954331200,00000000200,a2f,recvmsg
1,01954335900,01954336100,00000000200,a2f,recvmsg
1,01954336200,01954336400,00000000200,a2f,recvmsg
1,01954337200,01954342000,00000004800,a07,poll
1,01954348100,01954353800,00000005700,a2f,recvmsg
1,01954367300,01954367500,00000000200,a2f,recvmsg
1,01954393700,01954398200,00000004500,a07,poll
1,01954404000,01954409700,00000005700,a2f,recvmsg
1,01954422600,01954422800,00000000200,a2f,recvmsg
1,01954304800,01954451300,00000146500,a17,select
1,01954467100,01954468400,00000001300,a14,writev
1,01954468900,01954469100,00000000200,a2f,recvmsg
1,01954486300,01954486400,00000000100,a2f,recvmsg
1,01954499900,01954500900,00000001000,a14,writev
1,01954501300,01954501500,00000000200,a2f,recvmsg
1,01954446000,01954506200,00000060200,a07,poll
1,01954509600,01954509800,00000000200,a2f,recvmsg
1,01954511400,01954511600,00000000200,a2f,recvmsg
1,01954511900,01954512000,00000000100,a2f,recvmsg
1,01954513300,01954513400,00000000100,a2f,recvmsg
1,01954513600,01954513800,00000000200,a2f,recvmsg
1,01954514200,01954515600,00000001400,a07,poll
1,01954516200,01954517200,00000001000,a2f,recvmsg
1,01954522400,01954523200,00000000800,a2d,recvfrom
1,01954524200,01954524400,00000000200,a2f,recvmsg
1,01954525100,01954525200,00000000100,a2f,recvmsg
1,01954555100,01954555300,00000000200,a2f,recvmsg
1,01954557100,01954557300,00000000200,a2f,recvmsg
1,01954560900,01955162600,00000601700,a07,poll
1,01955184600,01955189200,00000004600,a2e,sendmsg
1,01939537100,01955192900,00015655800,ae8,epoll_wait
1,01955204400,01955205900,00000001500,a2f,recvmsg
1,01955221400,01955221600,00000000200,a2f,recvmsg
1,01955244900,01955248000,00000003100,a2e,sendmsg
1,01954560900,01955255700,00000694800,a07,poll
1,01955257500,01955258300,00000000800,a00,read
1,01955275800,01955276900,00000001100,a2f,recvmsg
1,01955359400,01955363800,00000004400,a07,poll
1,01955513200,01955514300,00000001100,a2f,recvmsg
1,01955520000,01955520200,00000000200,a2f,recvmsg
1,01955538400,01955538900,00000000500,a00,read
1,01955545900,01955549600,00000003700,a2e,sendmsg
1,01955251100,01955551600,00000300500,ae8,epoll_wait
1,01955555800,01955557100,00000001300,a2f,recvmsg
1,01955569800,01955570100,00000000300,a2f,recvmsg
1,01955583000,01955584900,00000001900,a2e,sendmsg
1,01955537500,01955590100,00000052600,a07,poll
1,01955590700,01955591200,00000000500,a00,read
1,01955599300,01955600100,00000000800,a2f,recvmsg
1,01955694700,01955697400,00000002700,a07,poll
1,01956013800,01956015000,00000001200,a2f,recvmsg
1,01954502000,01956633700,00002131700,a17,select
1,01956654600,01956654900,00000000300,a2f,recvmsg
1,01956667700,01956667900,00000000200,a2f,recvmsg
1,01956668500,01956731400,00000062900,a17,select
1,01956735500,01956735700,00000000200,a2f,recvmsg
1,01942023900,01967295800,00025271900,a3d,wait4
1,01967321600,01967323600,00000002000,a00,read
1,01967325800,01967326100,00000000300,a00,read
1,01967346500,01967397800,00000051300,a07,poll
1,01967403900,01967404200,00000000300,a2f,recvmsg
1,01967405000,01967405200,00000000200,a2f,recvmsg
1,01967414700,01967430200,00000015500,a07,poll
1,01967432400,01967432600,00000000200,a2f,recvmsg
1,01967433000,01967433200,00000000200,a2f,recvmsg
1,01967437600,01967451100,00000013500,a07,poll
1,01967453300,01967453500,00000000200,a2f,recvmsg
1,01967453900,01967454100,00000000200,a2f,recvmsg
1,01967459000,01967472400,00000013400,a07,poll
1,01967474500,01967474600,00000000100,a2f,recvmsg
1,01967475000,01967475100,00000000100,a2f,recvmsg
1,01967479100,01967492400,00000013300,a07,poll
1,01967494500,01967494700,00000000200,a2f,recvmsg
1,01967495100,01967495300,00000000200,a2f,recvmsg
1,01967499500,01967512800,00000013300,a07,poll
1,01967515000,01967515100,00000000100,a2f,recvmsg
1,01967515400,01967515600,00000000200,a2f,recvmsg
1,01967516600,01967516900,00000000300,a08,lseek
1,01967528600,01967528700,00000000100,a08,lseek
1,01967531900,01967538900,00000007000,a07,poll
1,01967540100,01967540300,00000000200,a2f,recvmsg
1,01967540700,01967540900,00000000200,a2f,recvmsg
1,01967546400,01967553100,00000006700,a07,poll
1,01967554400,01967554600,00000000200,a2f,recvmsg
1,01967554900,01967555000,00000000100,a2f,recvmsg
1,01967558300,01967565000,00000006700,a07,poll
1,01967566300,01967566300,00000000000,a2f,recvmsg
1,01967566600,01967566800,00000000200,a2f,recvmsg
1,01967570200,01967576700,00000006500,a07,poll
1,01967577900,01967578100,00000000200,a2f,recvmsg
1,01967578400,01967578600,00000000200,a2f,recvmsg
1,01967581900,01967588800,00000006900,a07,poll
1,01967590000,01967590200,00000000200,a2f,recvmsg
1,01967590500,01967590700,00000000200,a2f,recvmsg
1,01967594300,01967600900,00000006600,a07,poll
1,01967602100,01967602300,00000000200,a2f,recvmsg
1,01967602500,01967602700,00000000200,a2f,recvmsg
1,01967606600,01967613600,00000007000,a07,poll
1,01967614900,01967615000,00000000100,a2f,recvmsg
1,01967615400,01967615600,00000000200,a2f,recvmsg
1,01967618300,01967625100,00000006800,a07,poll
1,01967626200,01967626400,00000000200,a2f,recvmsg
1,01967626700,01967626900,00000000200,a2f,recvmsg
1,01967631200,01967638400,00000007200,a07,poll
1,01967639500,01967639600,00000000100,a2f,recvmsg
1,01967640000,01967640200,00000000200,a2f,recvmsg
1,01967643400,01967666100,00000022700,a07,poll
1,01967667600,01967667700,00000000100,a2f,recvmsg
1,01967668100,01967668300,00000000200,a2f,recvmsg
1,01967671800,01967678800,00000007000,a07,poll
1,01967680000,01967680100,00000000100,a2f,recvmsg
1,01967680300,01967680500,00000000200,a2f,recvmsg
1,01967684500,01967691300,00000006800,a07,poll
1,01967692300,01967692500,00000000200,a2f,recvmsg
1,01967692800,01967693000,00000000200,a2f,recvmsg
1,01967696100,01967702800,00000006700,a07,poll
1,01967703900,01967704100,00000000200,a2f,recvmsg
1,01967704400,01967704600,00000000200,a2f,recvmsg
1,01967708800,01967715500,00000006700,a07,poll
1,01967716600,01967716800,00000000200,a2f,recvmsg
1,01967717100,01967717300,00000000200,a2f,recvmsg
1,01967720300,01967727200,00000006900,a07,poll
1,01967728300,01967728500,00000000200,a2f,recvmsg
1,01967728800,01967729000,00000000200,a2f,recvmsg
1,01967731700,01967738500,00000006800,a07,poll
1,01967739500,01967739700,00000000200,a2f,recvmsg
1,01967740000,01967740200,00000000200,a2f,recvmsg
1,01967744900,01967751700,00000006800,a07,poll
1,01967752800,01967753000,00000000200,a2f,recvmsg
1,01967753300,01967753500,00000000200,a2f,recvmsg
1,01967756200,01967763000,00000006800,a07,poll
1,01967764100,01967764300,00000000200,a2f,recvmsg
1,01967764600,01967764800,00000000200,a2f,recvmsg
1,01967767500,01967774200,00000006700,a07,poll
1,01967775300,01967775400,00000000100,a2f,recvmsg
1,01967775800,01967776000,00000000200,a2f,recvmsg
1,01967778800,01967785700,00000006900,a07,poll
1,01967786700,01967786900,00000000200,a2f,recvmsg
1,01967787200,01967787400,00000000200,a2f,recvmsg
1,01967790400,01967797200,00000006800,a07,poll
1,01967798200,01967798400,00000000200,a2f,recvmsg
1,01967798700,01967798900,00000000200,a2f,recvmsg
1,01967801900,01967808500,00000006600,a07,poll
1,01967809500,01967809700,00000000200,a2f,recvmsg
1,01967810000,01967810200,00000000200,a2f,recvmsg
1,01967813500,01967820500,00000007000,a07,poll
1,01967821500,01967821700,00000000200,a2f,recvmsg
1,01967822000,01967822200,00000000200,a2f,recvmsg
1,01967825500,01967832300,00000006800,a07,poll
1,01967833400,01967833600,00000000200,a2f,recvmsg
1,01967833900,01967834100,00000000200,a2f,recvmsg
1,01967837700,01967844700,00000007000,a07,poll
1,01967845800,01967846000,00000000200,a2f,recvmsg
1,01967846300,01967846500,00000000200,a2f,recvmsg
1,01967849900,01967856700,00000006800,a07,poll
1,01967857700,01967857900,00000000200,a2f,recvmsg
1,01967858200,01967858300,00000000100,a2f,recvmsg
1,01967861700,01967868600,00000006900,a07,poll
1,01967869800,01967870000,00000000200,a2f,recvmsg
1,01967870300,01967870400,00000000100,a2f,recvmsg
1,01967875900,01967882700,00000006800,a07,poll
1,01967883800,01967883900,00000000100,a2f,recvmsg
1,01967884200,01967884400,00000000200,a2f,recvmsg
1,01967887400,01967894200,00000006800,a07,poll
1,01967895300,01967895400,00000000100,a2f,recvmsg
1,01967895700,01967895900,00000000200,a2f,recvmsg
1,01967898900,01967905800,00000006900,a07,poll
1,01967906900,01967907100,00000000200,a2f,recvmsg
1,01967907400,01967907600,00000000200,a2f,recvmsg
1,01967911300,01967918100,00000006800,a07,poll
1,01967919400,01967919500,00000000100,a2f,recvmsg
1,01967919700,01967919900,00000000200,a2f,recvmsg
1,01967924300,01967931200,00000006900,a07,poll
1,01967932400,01967932500,00000000100,a2f,recvmsg
1,01967932800,01967933000,00000000200,a2f,recvmsg
1,01967936800,01967943700,00000006900,a07,poll
1,01967944800,01967944900,00000000100,a2f,recvmsg
1,01967945200,01967945400,00000000200,a2f,recvmsg
1,01967948800,01967955700,00000006900,a07,poll
1,01967956800,01967956900,00000000100,a2f,recvmsg
1,01967957200,01967957400,00000000200,a2f,recvmsg
1,01967960400,01967967200,00000006800,a07,poll
1,01967968300,01967968500,00000000200,a2f,recvmsg
1,01967968800,01967969000,00000000200,a2f,recvmsg
1,01967971900,01967978600,00000006700,a07,poll
1,01967979700,01967979900,00000000200,a2f,recvmsg
1,01967980200,01967980400,00000000200,a2f,recvmsg
1,01967983600,01967990400,00000006800,a07,poll
1,01967991600,01967991700,00000000100,a2f,recvmsg
1,01967991900,01967992100,00000000200,a2f,recvmsg
1,01967993200,01967993400,00000000200,a08,lseek
1,01967996400,01968000900,00000004500,a00,read
1,01968004700,01968004800,00000000100,a08,lseek
1,01968007900,01968014500,00000006600,a07,poll
1,01968015900,01968016100,00000000200,a2f,recvmsg
1,01968016500,01968016600,00000000100,a2f,recvmsg
1,01968041700,01968048500,00000006800,a07,poll
1,01968049800,01968050000,00000000200,a2f,recvmsg
1,01968050300,01968050500,00000000200,a2f,recvmsg
1,01968054300,01968055100,00000000800,a00,read
1,01968060500,01968060600,00000000100,a08,lseek
1,01968064000,01968070600,00000006600,a07,poll
1,01968071800,01968072000,00000000200,a2f,recvmsg
1,01968072300,01968072500,00000000200,a2f,recvmsg
1,01968075300,01968082000,00000006700,a07,poll
1,01968083100,01968083300,00000000200,a2f,recvmsg
1,01968083600,01968083800,00000000200,a2f,recvmsg
1,01968086600,01968093100,00000006500,a07,poll
1,01968094300,01968094500,00000000200,a2f,recvmsg
1,01968094700,01968094900,00000000200,a2f,recvmsg
1,01968097700,01968104300,00000006600,a07,poll
1,01968105500,01968105700,00000000200,a2f,recvmsg
1,01968105900,01968106100,00000000200,a2f,recvmsg
1,01968108900,01968115500,00000006600,a07,poll
1,01968116700,01968116800,00000000100,a2f,recvmsg
1,01968117200,01968117300,00000000100,a2f,recvmsg
1,01968119900,01968126700,00000006800,a07,poll
1,01968127800,01968128000,00000000200,a2f,recvmsg
1,01968128300,01968128500,00000000200,a2f,recvmsg
1,01968131300,01968137900,00000006600,a07,poll
1,01968139000,01968139100,00000000100,a2f,recvmsg
1,01968139500,01968139700,00000000200,a2f,recvmsg
1,01968142900,01968149800,00000006900,a07,poll
1,01968150900,01968151100,00000000200,a2f,recvmsg
1,01968151400,01968151500,00000000100,a2f,recvmsg
1,01968154400,01968161000,00000006600,a07,poll
1,01968162200,01968162300,00000000100,a2f,recvmsg
1,01968162700,01968162800,00000000100,a2f,recvmsg
1,01968163200,01968163300,00000000100,a08,lseek
1,01968167100,01968173800,00000006700,a07,poll
1,01968175100,01968175200,00000000100,a2f,recvmsg
1,01968175600,01968175800,00000000200,a2f,recvmsg
1,01968180900,01968187600,00000006700,a07,poll
1,01968188800,01968189000,00000000200,a2f,recvmsg
1,01968189300,01968189500,00000000200,a2f,recvmsg
1,01968192600,01968199200,00000006600,a07,poll
1,01968200400,01968200600,00000000200,a2f,recvmsg
1,01968200900,01968201000,00000000100,a2f,recvmsg
1,01968204200,01968210700,00000006500,a07,poll
1,01968211900,01968212100,00000000200,a2f,recvmsg
1,01968212300,01968212500,00000000200,a2f,recvmsg
1,01968215500,01968222100,00000006600,a07,poll
1,01968223300,01968223500,00000000200,a2f,recvmsg
1,01968223700,01968223900,00000000200,a2f,recvmsg
1,01968227100,01968233700,00000006600,a07,poll
1,01968235100,01968235300,00000000200,a2f,recvmsg
1,01968235600,01968235800,00000000200,a2f,recvmsg
1,01968239300,01968246000,00000006700,a07,poll
1,01968247100,01968247200,00000000100,a2f,recvmsg
1,01968247600,01968247700,00000000100,a2f,recvmsg
1,01968250700,01968257400,00000006700,a07,poll
1,01968258400,01968258600,00000000200,a2f,recvmsg
1,01968258900,01968259100,00000000200,a2f,recvmsg
1,01968262000,01968268700,00000006700,a07,poll
1,01968269800,01968270000,00000000200,a2f,recvmsg
1,01968270300,01968270500,00000000200,a2f,recvmsg
1,01968273400,01968280200,00000006800,a07,poll
1,01968281300,01968281400,00000000100,a2f,recvmsg
1,01968281800,01968281900,00000000100,a2f,recvmsg
1,01968284800,01968291600,00000006800,a07,poll
1,01968292800,01968292900,00000000100,a2f,recvmsg
1,01968293300,01968293400,00000000100,a2f,recvmsg
1,01968296400,01968303200,00000006800,a07,poll
1,01968304200,01968304400,00000000200,a2f,recvmsg
1,01968304700,01968304900,00000000200,a2f,recvmsg
1,01968308400,01968315100,00000006700,a07,poll
1,01968316300,01968316500,00000000200,a2f,recvmsg
1,01968316800,01968316900,00000000100,a2f,recvmsg
1,01968320000,01968326700,00000006700,a07,poll
1,01968327800,01968328000,00000000200,a2f,recvmsg
1,01968328200,01968328400,00000000200,a2f,recvmsg
1,01968331400,01968338000,00000006600,a07,poll
1,01968339200,01968339400,00000000200,a2f,recvmsg
1,01968339600,01968339800,00000000200,a2f,recvmsg
1,01968342900,01968349600,00000006700,a07,poll
1,01968350700,01968350900,00000000200,a2f,recvmsg
1,01968351100,01968351300,00000000200,a2f,recvmsg
1,01968359400,01968366300,00000006900,a07,poll
1,01968367500,01968367700,00000000200,a2f,recvmsg
1,01968368000,01968368100,00000000100,a2f,recvmsg
1,01968371400,01968377900,00000006500,a07,poll
1,01968379100,01968379300,00000000200,a2f,recvmsg
1,01968379500,01968379700,00000000200,a2f,recvmsg
1,01968382600,01968389300,00000006700,a07,poll
1,01968390500,01968390700,00000000200,a2f,recvmsg
1,01968390900,01968391100,00000000200,a2f,recvmsg
1,01968394400,01968400900,00000006500,a07,poll
1,01968402000,01968402200,00000000200,a2f,recvmsg
1,01968402400,01968402600,00000000200,a2f,recvmsg
1,01968405700,01968412400,00000006700,a07,poll
1,01968413600,01968413700,00000000100,a2f,recvmsg
1,01968414000,01968414200,00000000200,a2f,recvmsg
1,01968434500,01968461200,00000026700,a57,unlink
1,01968462700,01968466900,00000004200,a14,writev
1,01968467500,01968567800,00000100300,a07,poll
1,01968467500,01968572100,00000104600,a07,poll
1,01968585300,01968585500,00000000200,a2f,recvmsg
1,01968590100,01968590300,00000000200,a2f,recvmsg
1,01968590500,01968590700,00000000200,a2f,recvmsg
1,01968596100,01968596200,00000000100,a2f,recvmsg
1,01968596300,01968596500,00000000200,a2f,recvmsg
1,01968601400,01968602400,00000001000,a00,read
1,01968612700,01968613000,00000000300,a2f,recvmsg
1,01968647500,01968652500,00000005000,a07,poll
1,01968667000,01968667200,00000000200,a2f,recvmsg
1,01968684700,01968704500,00000019800,a07,poll
1,01968706300,01968760400,00000054100,a07,poll
1,01968761500,01968817300,00000055800,a07,poll
1,01968818500,01968874100,00000055600,a07,poll
1,01968875900,01968929600,00000053700,a07,poll
1,01968930700,01968972700,00000042000,a07,poll
1,01968973800,01969016500,00000042700,a07,poll
1,01969017700,01969059700,00000042000,a07,poll
1,01969060900,01969103500,00000042600,a07,poll
1,01969104700,01969146500,00000041800,a07,poll
1,01969147500,01969200300,00000052800,a07,poll
1,01969201300,01969218900,00000017600,a07,poll
1,01969219800,01969234200,00000014400,a07,poll
1,01969235200,01969250100,00000014900,a07,poll
1,01969251200,01969265500,00000014300,a07,poll
1,01969267100,01969279700,00000012600,a07,poll
1,01969280800,01969284500,00000003700,a07,poll
1,01969287200,01969287400,00000000200,a2f,recvmsg
1,01969288000,01969288200,00000000200,a2f,recvmsg
1,01969280800,01969307000,00000026200,a07,poll
1,01969307400,01969308900,00000001500,a2f,recvmsg
1,01969312100,01969313300,00000001200,a2d,recvfrom
1,01969317500,01969317700,00000000200,a2f,recvmsg
1,01969318200,01969318400,00000000200,a2f,recvmsg
1,01969374300,01969374600,00000000300,a2f,recvmsg
1,01969377100,01969377300,00000000200,a2f,recvmsg
1,01969391700,01969531800,00000140100,a07,poll
1,01969532600,01969534200,00000001600,a2f,recvmsg
1,01969540500,01969541300,00000000800,a2d,recvfrom
1,01969542400,01969542600,00000000200,a2f,recvmsg
1,01969543400,01969543500,00000000100,a2f,recvmsg
1,01969576400,01969576600,00000000200,a2f,recvmsg
1,01969607000,01969607200,00000000200,a2f,recvmsg
1,01969610700,01969612800,00000002100,a07,poll
1,01969615500,01969615700,00000000200,a2f,recvmsg
1,01969616400,01969616400,00000000000,a2f,recvmsg
1,01955587500,01969823400,00014235900,ae8,epoll_wait
1,01969850500,01969850700,00000000200,a2f,recvmsg
1,01969610700,01969883200,00000272500,a07,poll
1,01969887500,01969888100,00000000600,60e,page_fault
1,01969877700,01969889500,00000011800,ae8,epoll_wait
1,01969891100,01969892000,00000000900,a2f,recvmsg
1,01969898600,01969898800,00000000200,a2f,recvmsg
1,01969920400,01969921300,00000000900,a2e,sendmsg
1,01970057500,01970058300,00000000800,a2f,recvmsg
1,01970061700,01970061900,00000000200,a00,read
1,01970114800,01970118500,00000003700,a07,poll
1,01970165700,01970165900,00000000200,a00,read
1,01970221700,01970225100,00000003400,a07,poll
1,01970229100,01970232300,00000003200,a2e,sendmsg
1,01970234800,01970234900,00000000100,a00,read
1,01970798200,01970801800,00000003600,a09,mmap
1,01970964200,01970969500,00000005300,a02,open
1,01970977600,01970979400,00000001800,a00,read
1,01971032000,01971032800,00000000800,a00,read
1,01971081600,01971082400,00000000800,a00,read
1,01971128800,01971129500,00000000700,a00,read
1,01971176800,01971177800,00000001000,a00,read
1,01971224100,01971225000,00000000900,a00,read
1,01971269900,01971270700,00000000800,a00,read
1,01971315900,01971316600,00000000700,a00,read
1,01971364400,01971365400,00000001000,a00,read
1,01971413900,01971414600,00000000700,a00,read
1,01971461400,01971462100,00000000700,a00,read
1,01971489200,01971490900,00000001700,a02,open
1,01971493800,01971494700,00000000900,a00,read
1,01971548600,01971549300,00000000700,a00,read
1,01971632300,01971633000,00000000700,a00,read
1,01971727400,01971728400,00000001000,a00,read
1,01971805100,01971805800,00000000700,a00,read
1,01971883300,01971884100,00000000800,a00,read
1,01971959600,01971960400,00000000800,a00,read
1,01972044200,01972044800,00000000600,a00,read
1,01972109800,01972110600,00000000800,a00,read
1,01972167900,01972168500,00000000600,a00,read
1,01972247400,01972279300,00000031900,a07,poll
1,01972283100,01972283300,00000000200,a2f,recvmsg
1,01972284000,01972284200,00000000200,a2f,recvmsg
1,01972287400,01972295000,00000007600,a07,poll
1,01972296200,01972296300,00000000100,a2f,recvmsg
1,01972296600,01972296800,00000000200,a2f,recvmsg
1,01972301500,01972306500,00000005000,a06,lstat
1,01972307200,01972308200,00000001000,a06,lstat
1,01972326200,01972337700,00000011500,a01,write
1,01972343000,01972350000,00000007000,a07,poll
1,01972352100,01972352300,00000000200,a2f,recvmsg
1,01972352600,01972352800,00000000200,a2f,recvmsg
1,01972354300,01972660300,00000306000,a38,clone
1,01973137500,01973137700,00000000200,a0c,brk
1,01973147700,01973150500,00000002800,a15,access
1,01973151500,01973152300,00000000800,a09,mmap
1,01973156100,01973156900,00000000800,a15,access
1,01973163800,01973164700,00000000900,a09,mmap
1,01973168600,01973169100,00000000500,a15,access
1,01973176000,01973177100,00000001100,a00,read
1,01973178900,01973180400,00000001500,a09,mmap
1,01973197700,01973198200,00000000500,a15,access
1,01973201700,01973202300,00000000600,a00,read
1,01973203000,01973203700,00000000700,a09,mmap
1,01973206300,01973207500,00000001200,a09,mmap
1,01973215800,01973216400,00000000600,a15,access
1,01973219500,01973220400,00000000900,a00,read
1,01973220900,01973221800,00000000900,a09,mmap
1,01973223300,01973225200,00000001900,a09,mmap
1,01973229700,01973232600,00000002900,a09,mmap
1,01973235000,01973236000,00000001000,a09,mmap
1,01973245500,01973246100,00000000600,a15,access
1,01973248700,01973249400,00000000700,a00,read
1,01973250100,01973251600,00000001500,a09,mmap
1,01973254500,01973256200,00000001700,a09,mmap
1,01973264400,01973264900,00000000500,a15,access
1,01973268400,01973269000,00000000600,a00,read
1,01973269700,01973271100,00000001400,a09,mmap
1,01973275000,01973277300,00000002300,a09,mmap
1,01973285900,01973286500,00000000600,a15,access
1,01973289700,01973290300,00000000600,a00,read
1,01973290800,01973291800,00000001000,a09,mmap
1,01973293000,01973294400,00000001400,a09,mmap
1,01973297500,01973298700,00000001200,a09,mmap
1,01973305200,01973305800,00000000600,a15,access
1,01973308100,01973308500,00000000400,a00,read
1,01973309200,01973310500,00000001300,a09,mmap
1,01973328100,01973328600,00000000500,a09,mmap
1,01973333700,01973334000,00000000300,a09,mmap
1,01973513400,01973513600,00000000200,a0c,brk
1,01973513700,01973514600,00000000900,a0c,brk
1,01973547800,01973548900,00000001100,a00,read
1,01973560500,01973561900,00000001400,a00,read
1,01973603500,01973604500,00000001000,a00,read
1,01973726500,01973727300,00000000800,a00,read
1,01973798600,01973799000,00000000400,a00,read
1,01973883700,01973884300,00000000600,a00,read
1,01974014800,01974015700,00000000900,a00,read
1,01974145900,01974146600,00000000700,a00,read
1,01974303000,01974303700,00000000700,a00,read
1,01974454100,01974454800,00000000700,a00,read
1,01974491700,01974493100,00000001400,a0c,brk
1,01974608800,01974609500,00000000700,a00,read
1,01974758700,01974759400,00000000700,a00,read
1,01974916100,01974916900,00000000800,a00,read
1,01975077500,01975078300,00000000800,a00,read
1,01975187300,01975187900,00000000600,a00,read
1,01975219100,01975219700,00000000600,a0c,brk
1,01975327900,01975328800,00000000900,a00,read
1,01975574500,01975575200,00000000700,a00,read
1,01975587300,01975587700,00000000400,a00,read
1,01975631900,01975632300,00000000400,a00,read
1,01975673100,01975673700,00000000600,a00,read
1,01975881100,01975881600,00000000500,a00,read
1,01975911500,01975912300,00000000800,a00,read
1,01976009400,01976010200,00000000800,a00,read
1,01976034200,01976035500,00000001300,a0c,brk
1,01976080600,01976081100,00000000500,a00,read
1,01976160000,01976160800,00000000800,a00,read
1,01976314000,01976314600,00000000600,a00,read
1,01976426500,01976427100,00000000600,a00,read
1,01976521600,01976522100,00000000500,a00,read
1,01976534200,01976534600,00000000400,a00,read
1,01976618200,01976618800,00000000600,a00,read
1,01976643500,01976643900,00000000400,a00,read
1,01976666500,01976667100,00000000600,a00,read
1,01976770200,01976771400,00000001200,a0c,brk
1,01976773100,01976774300,00000001200,a00,read
1,01976977000,01976977400,00000000400,a00,read
1,01977061300,01977061900,00000000600,a00,read
1,01977126500,01977127200,00000000700,a00,read
1,01977256000,01977256300,00000000300,a00,read
1,01977290300,01977290800,00000000500,a00,read
1,01977307800,01977309400,00000001600,a02,open
1,01977425300,01977425700,00000000400,a00,read
1,01977498300,01977498800,00000000500,a00,read
1,01977552200,01977553300,00000001100,a0c,brk
1,01977561400,01977562200,00000000800,a00,read
1,01977670400,01977671000,00000000600,a00,read
1,01977821200,01977822200,00000001000,a00,read
1,01977951800,01977952500,00000000700,a00,read
1,01978010700,01978011600,00000000900,a00,read
1,01978067500,01978068000,00000000500,a00,read
1,01978137700,01978138300,00000000600,a00,read
1,01978190700,01978191400,00000000700,a00,read
1,01978279200,01978280100,00000000900,a0c,brk
1,01978313000,01978316500,00000003500,a0c,brk
1,01978331200,01978331900,00000000700,a00,read
1,01978447200,01978448000,00000000800,a00,read
1,01978607600,01978608400,00000000800,a00,read
1,01978726200,01978726900,00000000700,a00,read
1,01978873400,01978874200,00000000800,a00,read
1,01978992100,01978992800,00000000700,a00,read
1,01979155800,01979156400,00000000600,a00,read
1,01979161400,01979162300,00000000900,a0c,brk
1,01979279600,01979280300,00000000700,a00,read
1,01979399400,01979399900,00000000500,a00,read
1,01979542800,01979543500,00000000700,a00,read
1,01979685700,01979686400,00000000700,a00,read
1,01979780700,01979781400,00000000700,a00,read
1,01979894600,01979895300,00000000700,a00,read
1,01980019800,01980020500,00000000700,a00,read
1,01980134100,01980134800,00000000700,a0c,brk
1,01980157600,01980158300,00000000700,a00,read
1,01980328400,01980329000,00000000600,a00,read
1,01980480000,01980480600,00000000600,a00,read
1,01980591400,01980592200,00000000800,a00,read
1,01980763300,01980764100,00000000800,a00,read
1,01980842400,01980843100,00000000700,a00,read
1,01980925700,01980926500,00000000800,a00,read
1,01980994000,01980994800,00000000800,a0c,brk
1,01981008500,01981009100,00000000600,a00,read
1,01981082400,01981083200,00000000800,a00,read
1,01981184900,01981185500,00000000600,a00,read
1,01981288600,01981289300,00000000700,a00,read
1,01981379400,01981380100,00000000700,a00,read
1,01981461200,01981461900,00000000700,a00,read
1,01981565200,01981565700,00000000500,a00,read
1,01981647100,01981647500,00000000400,a0c,brk
1,01981650000,01981650600,00000000600,a00,read
1,01981758100,01981758800,00000000700,a00,read
1,01981851900,01981852500,00000000600,a00,read
1,01981971800,01981972400,00000000600,a00,read
1,01982086200,01982086900,00000000700,a00,read
1,01982191900,01982192500,00000000600,a00,read
1,01982293700,01982294100,00000000400,a0c,brk
1,01982650800,01982654200,00000003400,a57,unlink
1,01982679100,01982679700,00000000600,a48,fcntl
1,01982726800,01982741600,00000014800,a01,write
1,01982759700,01982762300,00000002600,a01,write
1,01982778300,01982780600,00000002300,a01,write
1,01956736300,01983018100,00026281800,a17,select
1,01983043100,01983043300,00000000200,a2f,recvmsg
1,01983047100,01983067800,00000020700,a17,select
1,01983071700,01983071800,00000000100,a2f,recvmsg
1,01983072500,01983086600,00000014100,a17,select
1,01983090200,01983090400,00000000200,a2f,recvmsg
1,01983091100,01983105900,00000014800,a17,select
1,01983109900,01983110100,00000000200,a2f,recvmsg
1,01983110500,01983125300,00000014800,a17,select
1,01983129200,01983129300,00000000100,a2f,recvmsg
1,01983129800,01983143900,00000014100,a17,select
1,01983147100,01983147200,00000000100,a2f,recvmsg
1,01983147800,01983173200,00000025400,a17,select
1,01983177200,01983177300,00000000100,a2f,recvmsg
1,01983177900,01983187100,00000009200,a17,select
1,01983190700,01983190900,00000000200,a2f,recvmsg
1,01983191400,01983199000,00000007600,a17,select
1,01983202500,01983202700,00000000200,a2f,recvmsg
1,01983203200,01983211000,00000007800,a17,select
1,01983214600,01983214700,00000000100,a2f,recvmsg
1,01983215200,01983222700,00000007500,a17,select
1,01983226300,01983226500,00000000200,a2f,recvmsg
1,01983227000,01983235600,00000008600,a17,select
1,01983239100,01983239300,00000000200,a2f,recvmsg
1,01983239700,01983247900,00000008200,a17,select
1,01983251800,01983252000,00000000200,a2f,recvmsg
1,01983252500,01983259800,00000007300,a17,select
1,01983263100,01983263300,00000000200,a2f,recvmsg
1,01983263800,01983272400,00000008600,a17,select
1,01983276200,01983276400,00000000200,a2f,recvmsg
1,01983276900,01983284400,00000007500,a17,select
1,01983288300,01983288400,00000000100,a2f,recvmsg
1,01983288900,01983296400,00000007500,a17,select
1,01983300000,01983300200,00000000200,a2f,recvmsg
1,01983300600,01983308400,00000007800,a17,select
1,01983311900,01983312100,00000000200,a2f,recvmsg
1,01983312600,01983321500,00000008900,a17,select
1,01983325100,01983325300,00000000200,a2f,recvmsg
1,01983325800,01983333400,00000007600,a17,select
1,01983337000,01983337200,00000000200,a2f,recvmsg
1,01983337800,01983345100,00000007300,a17,select
1,01983348700,01983348800,00000000100,a2f,recvmsg
1,01983349400,01983356200,00000006800,a17,select
1,01983359900,01983360100,00000000200,a2f,recvmsg
1,01983360600,01983369500,00000008900,a17,select
1,01983372900,01983373100,00000000200,a2f,recvmsg
1,01983373700,01983380400,00000006700,a17,select
1,01983384000,01983384200,00000000200,a2f,recvmsg
1,01983384700,01983391600,00000006900,a17,select
1,01983395300,01983395500,00000000200,a2f,recvmsg
1,01983396000,01983402900,00000006900,a17,select
1,01983406500,01983406600,00000000100,a2f,recvmsg
1,01983407100,01983414400,00000007300,a17,select
1,01983418000,01983418100,00000000100,a2f,recvmsg
1,01983418600,01983425600,00000007000,a17,select
1,01983429100,01983429200,00000000100,a2f,recvmsg
1,01983429700,01983437300,00000007600,a17,select
1,01983440900,01983441000,00000000100,a2f,recvmsg
1,01983441600,01983449100,00000007500,a17,select
1,01983452600,01983452800,00000000200,a2f,recvmsg
1,01983453300,01983462000,00000008700,a17,select
1,01983466000,01983466200,00000000200,a2f,recvmsg
1,01983466700,01983474600,00000007900,a17,select
1,01983477900,01983478100,00000000200,a2f,recvmsg
1,01983478600,01983486200,00000007600,a17,select
1,01983489900,01983490100,00000000200,a2f,recvmsg
1,01983490500,01983500000,00000009500,a17,select
1,01983503600,01983503800,00000000200,a2f,recvmsg
1,01983504300,01983511600,00000007300,a17,select
1,01983515100,01983515300,00000000200,a2f,recvmsg
1,01983515800,01983523100,00000007300,a17,select
1,01983526600,01983526800,00000000200,a2f,recvmsg
1,01983527300,01983535300,00000008000,a17,select
1,01983539000,01983539200,00000000200,a2f,recvmsg
1,01983539600,01983548000,00000008400,a17,select
1,01983551600,01983551700,00000000100,a2f,recvmsg
1,01983552300,01983560100,00000007800,a17,select
1,01983563800,01983563900,00000000100,a2f,recvmsg
1,01983564400,01983571900,00000007500,a17,select
1,01983575600,01983575700,00000000100,a2f,recvmsg
1,01983576200,01983583500,00000007300,a17,select
1,01983587100,01983587300,00000000200,a2f,recvmsg
1,01983587800,01983595000,00000007200,a17,select
1,01983598500,01983598600,00000000100,a2f,recvmsg
1,01983599200,01983606600,00000007400,a17,select
1,01983610300,01983610400,00000000100,a2f,recvmsg
1,01983611000,01983626600,00000015600,a17,select
1,01983630000,01983630200,00000000200,a2f,recvmsg
1,01983630800,01983685900,00000055100,a17,select
1,01983690300,01983690400,00000000100,a2f,recvmsg
1,01983691100,01983712800,00000021700,a17,select
1,01983716600,01983716800,00000000200,a2f,recvmsg
1,01983717300,01983724400,00000007100,a17,select
1,01983728000,01983728200,00000000200,a2f,recvmsg
1,01983728700,01983735600,00000006900,a17,select
1,01983739100,01983739200,00000000100,a2f,recvmsg
1,01983739800,01983746700,00000006900,a17,select
1,01983750500,01983750700,00000000200,a2f,recvmsg
1,01983751200,01983758100,00000006900,a17,select
1,01983761700,01983761900,00000000200,a2f,recvmsg
1,01983762300,01983769200,00000006900,a17,select
1,01983772700,01983772900,00000000200,a2f,recvmsg
1,01983773300,01983780200,00000006900,a17,select
1,01983783800,01983783900,00000000100,a2f,recvmsg
1,01983784500,01983792000,00000007500,a17,select
1,01983795700,01983795900,00000000200,a2f,recvmsg
1,01983796300,01983803500,00000007200,a17,select
1,01983807000,01983807200,00000000200,a2f,recvmsg
1,01983807600,01983816300,00000008700,a17,select
1,01983820000,01983820200,00000000200,a2f,recvmsg
1,01983820700,01983830000,00000009300,a17,select
1,01983833800,01983833900,00000000100,a2f,recvmsg
1,01983834400,01983842100,00000007700,a17,select
1,01983845700,01983845800,00000000100,a2f,recvmsg
1,01983846400,01983853600,00000007200,a17,select
1,01983857100,01983857300,00000000200,a2f,recvmsg
1,01983857800,01983865000,00000007200,a17,select
1,01983868500,01983868600,00000000100,a2f,recvmsg
1,01983869200,01983876500,00000007300,a17,select
1,01983879900,01983880100,00000000200,a2f,recvmsg
1,01983880600,01983888400,00000007800,a17,select
1,01983892100,01983892300,00000000200,a2f,recvmsg
1,01983892800,01983900000,00000007200,a17,select
1,01983903500,01983903700,00000000200,a2f,recvmsg
1,01983904200,01983911400,00000007200,a17,select
1,01983915000,01983915100,00000000100,a2f,recvmsg
1,01983915700,01983922800,00000007100,a17,select
1,01983926400,01983926600,00000000200,a2f,recvmsg
1,01983927100,01983934300,00000007200,a17,select
1,01983937800,01983938000,00000000200,a2f,recvmsg
1,01983938500,01983945500,00000007000,a17,select
1,01983948900,01983949000,00000000100,a2f,recvmsg
1,01983949600,01983957300,00000007700,a17,select
1,01983961000,01983961200,00000000200,a2f,recvmsg
1,01983961600,01983968900,00000007300,a17,select
1,01983972300,01983972500,00000000200,a2f,recvmsg
1,01983972900,01983980100,00000007200,a17,select
1,01983983700,01983983800,00000000100,a2f,recvmsg
1,01983984300,01983991600,00000007300,a17,select
1,01983995100,01983995300,00000000200,a2f,recvmsg
1,01983995700,01984008400,00000012700,a17,select
1,01984012100,01984012200,00000000100,a2f,recvmsg
1,01984012700,01984020100,00000007400,a17,select
1,01984023500,01984023600,00000000100,a2f,recvmsg
1,01984024100,01984031400,00000007300,a17,select
1,01984035100,01984035300,00000000200,a2f,recvmsg
1,01984035700,01984043100,00000007400,a17,select
1,01984046600,01984046800,00000000200,a2f,recvmsg
1,01984047200,01984054500,00000007300,a17,select
1,01984058200,01984058300,00000000100,a2f,recvmsg
1,01984058800,01984114700,00000055900,a17,select
1,01984115500,01984117000,00000001500,a2f,recvmsg
1,01984205800,01984210300,00000004500,a14,writev
1,01984287400,01984289800,00000002400,a14,writev
1,01984347700,01984349300,00000001600,a14,writev
1,01984405900,01984407800,00000001900,a14,writev
1,01984462800,01984464400,00000001600,a14,writev
1,01984519800,01984521400,00000001600,a14,writev
1,01984526000,01984526800,00000000800,a2f,recvmsg
1,01984577100,01984578800,00000001700,a14,writev
1,01984621900,01984623200,00000001300,a14,writev
1,01984666400,01984668000,00000001600,a14,writev
1,01984710200,01984711800,00000001600,a14,writev
1,01984754700,01984756300,00000001600,a14,writev
1,01984800000,01984801500,00000001500,a14,writev
1,01984825800,01984827800,00000002000,a2f,recvmsg
1,01984855000,01984856900,00000001900,a14,writev
1,01984873900,01984875500,00000001600,a14,writev
1,01984891000,01984892800,00000001800,a14,writev
1,01984907300,01984908800,00000001500,a14,writev
1,01984922900,01984925300,00000002400,a14,writev
1,01984938400,01984939900,00000001500,a14,writev
1,01984944600,01984944900,00000000300,a2f,recvmsg
1,01984945500,01984945800,00000000300,a14,writev
1,01984946100,01984946500,00000000400,a14,writev
1,01984964900,01984966700,00000001800,a14,writev
1,01984966900,01984968300,00000001400,a14,writev
1,01984968700,01984968900,00000000200,a2f,recvmsg
1,01984980200,01984981800,00000001600,a14,writev
1,01984982000,01984983100,00000001100,a14,writev
1,01984983400,01984983600,00000000200,a2f,recvmsg
1,01972343000,01984991700,00012648700,a07,poll
1,01984998600,01985004600,00000006000,a2f,recvmsg
1,01985017100,01985017300,00000000200,a2f,recvmsg
1,01985042200,01985047100,00000004900,a07,poll
1,01985053100,01985059200,00000006100,a2f,recvmsg
1,01985071800,01985072000,00000000200,a2f,recvmsg
1,01984984000,01985099300,00000115300,a17,select
1,01985114800,01985116100,00000001300,a14,writev
1,01985116600,01985116700,00000000100,a2f,recvmsg
1,01985133600,01985133700,00000000100,a2f,recvmsg
1,01985146600,01985147500,00000000900,a14,writev
1,01985147900,01985148000,00000000100,a2f,recvmsg
1,01985094400,01985153200,00000058800,a07,poll
1,01985157700,01985157900,00000000200,a2f,recvmsg
1,01985159800,01985160000,00000000200,a2f,recvmsg
1,01985160200,01985160300,00000000100,a2f,recvmsg
1,01985162200,01985162300,00000000100,a2f,recvmsg
1,01985162500,01985162700,00000000200,a2f,recvmsg
1,01985163200,01985164700,00000001500,a07,poll
1,01985165400,01985166300,00000000900,a2f,recvmsg
1,01985171400,01985172200,00000000800,a2d,recvfrom
1,01985173300,01985173500,00000000200,a2f,recvmsg
1,01985174000,01985174200,00000000200,a2f,recvmsg
1,01985203800,01985204000,00000000200,a2f,recvmsg
1,01985205900,01985206000,00000000100,a2f,recvmsg
1,01985209600,01985719900,00000510300,a07,poll
1,01985737900,01985743700,00000005800,a2e,sendmsg
1,01969923000,01985747400,00015824400,ae8,epoll_wait
1,01985760900,01985762100,00000001200,a2f,recvmsg
1,01985777200,01985777400,00000000200,a2f,recvmsg
1,01985834900,01985838500,00000003600,a2e,sendmsg
1,01985860600,01985862400,00000001800,a2e,sendmsg
1,01985844000,01985863700,00000019700,ae8,epoll_wait
1,01985866100,01985866900,00000000800,a2f,recvmsg
1,01985873700,01985873900,00000000200,a2f,recvmsg
1,01985903800,01985904700,00000000900,a2e,sendmsg
1,01985920100,01985920500,00000000400,a00,read
1,01985922700,01985927600,00000004900,a07,poll
1,01986120500,01986121400,00000000900,aca,futex
1,01985907800,01986211000,00000303200,ae8,epoll_wait
1,01986214800,01986217400,00000002600,a2f,recvmsg
1,01986250800,01986250900,00000000100,a2f,recvmsg
1,01986277300,01986280900,00000003600,a2e,sendmsg
1,01986300400,01986301400,00000001000,a2e,sendmsg
1,01986208100,01986560000,00000351900,a07,poll
1,01986896500,01986905600,00000009100,a02,open
1,01986918100,01986921300,00000003200,a00,read
1,01986977500,01986978500,00000001000,a00,read
1,01987029500,01987030200,00000000700,a00,read
1,01987079600,01987080400,00000000800,a00,read
1,01987131500,01987132200,00000000700,a00,read
1,01987181600,01987182300,00000000700,a00,read
1,01987229100,01987229700,00000000600,a00,read
1,01987278300,01987278900,00000000600,a00,read
1,01987330200,01987331000,00000000800,a00,read
1,01987381600,01987382400,00000000800,a00,read
1,01987431500,01987432200,00000000700,a00,read
1,01987459300,01987461000,00000001700,a02,open
1,01987464000,01987464900,00000000900,a00,read
1,01987519900,01987520600,00000000700,a00,read
1,01987606800,01987607600,00000000800,a00,read
1,01987713700,01987714600,00000000900,a00,read
1,01987793600,01987794200,00000000600,a00,read
1,01987873900,01987874600,00000000700,a00,read
1,01987952800,01987953500,00000000700,a00,read
1,01988038400,01988039000,00000000600,a00,read
1,01988106000,01988106700,00000000700,a00,read
1,01988164900,01988165600,00000000700,a00,read
1,01988244600,01988278200,00000033600,a07,poll
1,01988282100,01988282400,00000000300,a2f,recvmsg
1,01988283100,01988283300,00000000200,a2f,recvmsg
1,01988284300,01988287200,00000002900,a14,writev
1,01988287500,01988295200,00000007700,a07,poll
1,01988296400,01988296600,00000000200,a2f,recvmsg
1,01988296900,01988297100,00000000200,a2f,recvmsg
1,01988302100,01988309300,00000007200,a06,lstat
1,01988310100,01988311100,00000001000,a06,lstat
1,01988333500,01988348500,00000015000,a01,write
1,01988354200,01988361100,00000006900,a07,poll
1,01988363200,01988363400,00000000200,a2f,recvmsg
1,01988363800,01988364000,00000000200,a2f,recvmsg
1,01988365300,01988673500,00000308200,a38,clone
1,01989151200,01989151400,00000000200,a0c,brk
1,01989161100,01989163600,00000002500,a15,access
1,01989164200,01989165100,00000000900,a09,mmap
1,01989170300,01989171100,00000000800,a15,access
1,01989177700,01989178800,00000001100,a09,mmap
1,01989181800,01989182300,00000000500,a15,access
1,01989190200,01989191400,00000001200,a00,read
1,01989192900,01989194400,00000001500,a09,mmap
1,01989199100,01989201300,00000002200,a09,mmap
1,01989212200,01989213000,00000000800,a15,access
1,01989216200,01989216800,00000000600,a00,read
1,01989217600,01989218600,00000001000,a09,mmap
1,01989220600,01989222000,00000001400,a09,mmap
1,01989230000,01989230500,00000000500,a15,access
1,01989233500,01989234000,00000000500,a00,read
1,01989234700,01989235600,00000000900,a09,mmap
1,01989237100,01989239300,00000002200,a09,mmap
1,01989243200,01989246300,00000003100,a09,mmap
1,01989248500,01989249600,00000001100,a09,mmap
1,01989258500,01989259100,00000000600,a15,access
1,01989262000,01989262500,00000000500,a00,read
1,01989263300,01989264800,00000001500,a09,mmap
1,01989267400,01989269100,00000001700,a09,mmap
1,01989277400,01989278100,00000000700,a15,access
1,01989281100,01989281600,00000000500,a00,read
1,01989282300,01989283700,00000001400,a09,mmap
1,01989287100,01989289300,00000002200,a09,mmap
1,01989297900,01989298500,00000000600,a15,access
1,01989300900,01989301500,00000000600,a00,read
1,01989302000,01989302900,00000000900,a09,mmap
1,01989304200,01989305600,00000001400,a09,mmap
1,01989308200,01989309600,00000001400,a09,mmap
1,01989315700,01989316200,00000000500,a15,access
1,01989318700,01989319200,00000000500,a00,read
1,01989319800,01989321100,00000001300,a09,mmap
1,01989323200,01989325000,00000001800,a09,mmap
1,01989338800,01989339400,00000000600,a09,mmap
1,01989343100,01989343400,00000000300,a09,mmap
1,01989344500,01989344800,00000000300,a09,mmap
1,01989525200,01989525300,00000000100,a0c,brk
1,01989525400,01989526200,00000000800,a0c,brk
1,01989554500,01989555600,00000001100,a00,read
1,01989570200,01989571600,00000001400,a00,read
1,01989609900,01989610700,00000000800,a00,read
1,01989732300,01989733000,00000000700,a00,read
1,01989803900,01989804300,00000000400,a00,read
1,01989889500,01989890200,00000000700,a00,read
1,01990020500,01990021500,00000001000,a00,read
1,01990149800,01990150500,00000000700,a00,read
1,01990304500,01990305200,00000000700,a00,read
1,01990454400,01990455100,00000000700,a00,read
1,01990491700,01990493000,00000001300,a0c,brk
1,01990609700,01990610400,00000000700,a00,read
1,01990756300,01990756900,00000000600,a00,read
1,01990910200,01990911000,00000000800,a00,read
1,01991069500,01991070200,00000000700,a00,read
1,01991177800,01991178500,00000000700,a00,read
1,01991210600,01991211300,00000000700,a0c,brk
1,01991318200,01991319100,00000000900,a00,read
1,01991557300,01991557900,00000000600,a00,read
1,01991569900,01991570300,00000000400,a00,read
1,01991614200,01991614600,00000000400,a00,read
1,01991633900,01991634600,00000000700,a00,read
1,01991862300,01991862900,00000000600,a00,read
1,01991892500,01991893500,00000001000,a00,read
1,01991992400,01991993100,00000000700,a00,read
1,01992017000,01992018200,00000001200,a0c,brk
1,01992063000,01992063400,00000000400,a00,read
1,01992140200,01992141100,00000000900,a00,read
1,01992294100,01992294600,00000000500,a00,read
1,01992406800,01992407300,00000000500,a00,read
1,01992501300,01992501800,00000000500,a00,read
1,01992513400,01992513900,00000000500,a00,read
1,01992598600,01992598900,00000000300,a00,read
1,01992622800,01992623200,00000000400,a00,read
1,01992645100,01992645700,00000000600,a00,read
1,01992747000,01992748200,00000001200,a0c,brk
1,01992749900,01992750900,00000001000,a00,read
1,01992950600,01992951000,00000000400,a00,read
1,01993033600,01993034000,00000000400,a00,read
1,01993099100,01993100000,00000000900,a00,read
1,01993228100,01993228700,00000000600,a00,read
1,01993260700,01993261300,00000000600,a00,read
1,01993278000,01993280300,00000002300,a02,open
1,01993394700,01993395200,00000000500,a00,read
1,01993466300,01993466700,00000000400,a00,read
1,01993519300,01993520300,00000001000,a0c,brk
1,01993526700,01993527500,00000000800,a00,read
1,01993634300,01993635100,00000000800,a00,read
1,01993783800,01993784600,00000000800,a00,read
1,01993915000,01993915600,00000000600,a00,read
1,01993973500,01993974200,00000000700,a00,read
1,01994029600,01994030300,00000000700,a00,read
1,01994099800,01994100600,00000000800,a00,read
1,01994153000,01994153800,00000000800,a00,read
1,01994241600,01994242300,00000000700,a0c,brk
1,01994273300,01994277000,00000003700,a0c,brk
1,01994291200,01994291900,00000000700,a00,read
1,01994406700,01994407600,00000000900,a00,read
1,01994565400,01994566100,00000000700,a00,read
1,01994683000,01994683600,00000000600,a00,read
1,01994828800,01994829400,00000000600,a00,read
1,01994946100,01994946800,00000000700,a00,read
1,01995108300,01995109100,00000000800,a00,read
1,01995114200,01995114800,00000000600,a0c,brk
1,01995229600,01995230300,00000000700,a00,read
1,01995348200,01995348900,00000000700,a00,read
1,01995489800,01995490600,00000000800,a00,read
1,01995621500,01995622100,00000000600,a00,read
1,01995741100,01995741800,00000000700,a00,read
1,01995853600,01995854300,00000000700,a00,read
1,01995977600,01995978300,00000000700,a00,read
1,01996089400,01996090100,00000000700,a0c,brk
1,01996112800,01996113600,00000000800,a00,read
1,01996282100,01996282800,00000000700,a00,read
1,01996432400,01996433100,00000000700,a00,read
1,01996543000,01996543700,00000000700,a00,read
1,01996711900,01996712800,00000000900,a00,read
1,01996789400,01996790100,00000000700,a00,read
1,01996871200,01996871900,00000000700,a00,read
1,01996938400,01996938900,00000000500,a0c,brk
1,01996952600,01996953400,00000000800,a00,read
1,01997025700,01997026300,00000000600,a00,read
1,01997126600,01997127400,00000000800,a00,read
1,01997229500,01997230200,00000000700,a00,read
1,01997318900,01997319600,00000000700,a00,read
1,01997402100,01997402700,00000000600,a00,read
1,01997503100,01997503800,00000000700,a00,read
1,01997584300,01997584500,00000000200,a0c,brk
1,01997587000,01997587800,00000000800,a00,read
1,01997693800,01997694500,00000000700,a00,read
1,01997786700,01997787400,00000000700,a00,read
1,01997905200,01997905800,00000000600,a00,read
1,01998020800,01998021400,00000000600,a00,read
1,01998124000,01998124700,00000000700,a00,read
1,01998581100,01998584700,00000003600,a57,unlink
1,01998609400,01998609900,00000000500,a48,fcntl
1,01998657200,01998673000,00000015800,a01,write
1,01998690600,01998693100,00000002500,a01,write
1,01998709100,01998711600,00000002500,a01,write
1,01985148600,01998960200,00013811600,a17,select
1,01998985200,01998985500,00000000300,a2f,recvmsg
1,01998989300,01999010300,00000021000,a17,select
1,01999014300,01999014500,00000000200,a2f,recvmsg
1,01999015100,01999029400,00000014300,a17,select
1,01999032900,01999033000,00000000100,a2f,recvmsg
1,01999033600,01999048500,00000014900,a17,select
1,01999052200,01999052400,00000000200,a2f,recvmsg
1,01999052900,01999066800,00000013900,a17,select
1,01999070600,01999070800,00000000200,a2f,recvmsg
1,01999071400,01999085500,00000014100,a17,select
1,01999088900,01999089100,00000000200,a2f,recvmsg
1,01999089500,01999115200,00000025700,a17,select
1,01999119100,01999119300,00000000200,a2f,recvmsg
1,01999119700,01999130000,00000010300,a17,select
1,01999133700,01999133800,00000000100,a2f,recvmsg
1,01999134400,01999141700,00000007300,a17,select
1,01999145300,01999145500,00000000200,a2f,recvmsg
1,01999146100,01999154100,00000008000,a17,select
1,01999157600,01999157700,00000000100,a2f,recvmsg
1,01999158200,01999166500,00000008300,a17,select
1,01999170200,01999170400,00000000200,a2f,recvmsg
1,01999170900,01999178500,00000007600,a17,select
1,01999182100,01999182300,00000000200,a2f,recvmsg
1,01999182700,01999190300,00000007600,a17,select
1,01999194100,01999194300,00000000200,a2f,recvmsg
1,01999194800,01999201700,00000006900,a17,select
1,01999205200,01999205400,00000000200,a2f,recvmsg
1,01999205900,01999214200,00000008300,a17,select
1,01999218300,01999218400,00000000100,a2f,recvmsg
1,01999218900,01999226400,00000007500,a17,select
1,01999230000,01999230100,00000000100,a2f,recvmsg
1,01999230700,01999238800,00000008100,a17,select
1,01999242500,01999242700,00000000200,a2f,recvmsg
1,01999243100,01999250700,00000007600,a17,select
1,01999254500,01999254700,00000000200,a2f,recvmsg
1,01999255200,01999262500,00000007300,a17,select
1,01999266000,01999266200,00000000200,a2f,recvmsg
1,01999266700,01999274000,00000007300,a17,select
1,01999277500,01999277700,00000000200,a2f,recvmsg
1,01999278300,01999285600,00000007300,a17,select
1,01999289200,01999289400,00000000200,a2f,recvmsg
1,01999290000,01999296900,00000006900,a17,select
1,01999300800,01999300900,00000000100,a2f,recvmsg
1,01999301500,01999310400,00000008900,a17,select
1,01999313900,01999314100,00000000200,a2f,recvmsg
1,01999314600,01999321500,00000006900,a17,select
1,01999325200,01999325400,00000000200,a2f,recvmsg
1,01999325900,01999332700,00000006800,a17,select
1,01999336400,01999336600,00000000200,a2f,recvmsg
1,01999337100,01999344100,00000007000,a17,select
1,01999347600,01999347800,00000000200,a2f,recvmsg
1,01999348400,01999355700,00000007300,a17,select
1,01999359400,01999359600,00000000200,a2f,recvmsg
1,01999360100,01999367000,00000006900,a17,select
1,01999370500,01999370600,00000000100,a2f,recvmsg
1,01999371200,01999378700,00000007500,a17,select
1,01999382400,01999382600,00000000200,a2f,recvmsg
1,01999383100,01999390600,00000007500,a17,select
1,01999394200,01999394400,00000000200,a2f,recvmsg
1,01999395000,01999402900,00000007900,a17,select
1,01999406900,01999407100,00000000200,a2f,recvmsg
1,01999407600,01999415400,00000007800,a17,select
1,01999419000,01999419100,00000000100,a2f,recvmsg
1,01999419700,01999427300,00000007600,a17,select
1,01999431200,01999431300,00000000100,a2f,recvmsg
1,01999431800,01999442100,00000010300,a17,select
1,01999445900,01999446100,00000000200,a2f,recvmsg
1,01999446500,01999453900,00000007400,a17,select
1,01999457500,01999457600,00000000100,a2f,recvmsg
1,01999458100,01999465100,00000007000,a17,select
1,01999468900,01999469000,00000000100,a2f,recvmsg
1,01999469500,01999477700,00000008200,a17,select
1,01999481500,01999481700,00000000200,a2f,recvmsg
1,01999482300,01999489800,00000007500,a17,select
1,01999493600,01999493700,00000000100,a2f,recvmsg
1,01999494200,01999502000,00000007800,a17,select
1,01999505900,01999506100,00000000200,a2f,recvmsg
1,01999506600,01999514200,00000007600,a17,select
1,01999517900,01999518100,00000000200,a2f,recvmsg
1,01999518600,01999526000,00000007400,a17,select
1,01999529700,01999529900,00000000200,a2f,recvmsg
1,01999530300,01999537400,00000007100,a17,select
1,01999541000,01999541100,00000000100,a2f,recvmsg
1,01999541600,01999549000,00000007400,a17,select
1,01999552700,01999552800,00000000100,a2f,recvmsg
1,01999553400,01999568500,00000015100,a17,select
1,01999572100,01999572300,00000000200,a2f,recvmsg
1,01999572800,01999603900,00000031100,a17,select
1,01999607500,01999607700,00000000200,a2f,recvmsg
1,01999608200,01999625900,00000017700,a17,select
1,01999629500,01999629700,00000000200,a2f,recvmsg
1,01999630300,01999653100,00000022800,a17,select
1,01999656500,01999656700,00000000200,a2f,recvmsg
1,01999657300,01999668300,00000011000,a17,select
1,01999672000,01999672200,00000000200,a2f,recvmsg
1,01999672600,01999679700,00000007100,a17,select
1,01999683200,01999683400,00000000200,a2f,recvmsg
1,01999683900,01999690800,00000006900,a17,select
1,01999694400,01999694600,00000000200,a2f,recvmsg
1,01999695100,01999701900,00000006800,a17,select
1,01999705700,01999705800,00000000100,a2f,recvmsg
1,01999706400,01999713200,00000006800,a17,select
1,01999716700,01999716800,00000000100,a2f,recvmsg
1,01999717400,01999724900,00000007500,a17,select
1,01999728600,01999728800,00000000200,a2f,recvmsg
1,01999729400,01999736300,00000006900,a17,select
1,01999740000,01999740200,00000000200,a2f,recvmsg
1,01999740800,01999749600,00000008800,a17,select
1,01999753100,01999753200,00000000100,a2f,recvmsg
1,01999753800,01999763100,00000009300,a17,select
1,01999766800,01999766900,00000000100,a2f,recvmsg
1,01999767500,01999775000,00000007500,a17,select
1,01999778500,01999778700,00000000200,a2f,recvmsg
1,01999779100,01999786500,00000007400,a17,select
1,01999790200,01999790300,00000000100,a2f,recvmsg
1,01999790800,01999798100,00000007300,a17,select
1,01999801700,01999801800,00000000100,a2f,recvmsg
1,01999802400,01999809500,00000007100,a17,select
1,01999813100,01999813300,00000000200,a2f,recvmsg
1,01999813800,01999821500,00000007700,a17,select
1,01999825000,01999825200,00000000200,a2f,recvmsg
1,01999825700,01999832900,00000007200,a17,select
1,01999836400,01999836600,00000000200,a2f,recvmsg
1,01999837100,01999844600,00000007500,a17,select
1,01999848300,01999848500,00000000200,a2f,recvmsg
1,01999849000,01999856100,00000007100,a17,select
1,01999859700,01999859900,00000000200,a2f,recvmsg
1,01999860400,01999867700,00000007300,a17,select
1,01999871400,01999871600,00000000200,a2f,recvmsg
1,01999872000,01999879200,00000007200,a17,select
1,01999882800,01999883000,00000000200,a2f,recvmsg
1,01999883400,01999891100,00000007700,a17,select
1,01999894800,01999894900,00000000100,a2f,recvmsg
1,01999895400,01999902500,00000007100,a17,select
1,01999906200,01999906200,00000000000,a2f,recvmsg
1,01999906800,01999913900,00000007100,a17,select
1,01999917600,01999917700,00000000100,a2f,recvmsg
1,01999918200,01999925400,00000007200,a17,select
1,01999929000,01999929200,00000000200,a2f,recvmsg
1,01999929700,01999942700,00000013000,a17,select
1,01999946300,01999946500,00000000200,a2f,recvmsg
1,01999947000,01999954500,00000007500,a17,select
1,01999958000,01999958200,00000000200,a2f,recvmsg
1,01999958800,01999966000,00000007200,a17,select
1,01999969500,01999969700,00000000200,a2f,recvmsg
1,01999970300,01999977600,00000007300,a17,select
1,01999981100,01999981300,00000000200,a2f,recvmsg
1,01999981900,01999989200,00000007300,a17,select
1,01999992800,01999993000,00000000200,a2f,recvmsg
1,01999993500,02000051100,00000057600,a17,select
1,02000052000,02000053300,00000001300,a2f,recvmsg
1,02000145700,02000150100,00000004400,a14,writev
1,02000223500,02000225700,00000002200,a14,writev
1,02000284200,02000286000,00000001800,a14,writev
1,02000343900,02000345900,00000002000,a14,writev
1,02000402700,02000404300,00000001600,a14,writev
1,02000460600,02000462400,00000001800,a14,writev
1,02000465700,02000466500,00000000800,a2f,recvmsg
1,02000516000,02000517400,00000001400,a14,writev
1,02000561700,02000563100,00000001400,a14,writev
1,02000606700,02000608200,00000001500,a14,writev
1,02000651500,02000653000,00000001500,a14,writev
0,02004317300,01977614000,-0026703300,a07,poll
0,01977615200,01977656400,00000041200,a07,poll
0,01977657500,01977699400,00000041900,a07,poll
0,01977700500,01977743000,00000042500,a07,poll
0,01977744100,01977786300,00000042200,a07,poll
0,01977787600,01977841100,00000053500,a07,poll
0,01977842200,01977859300,00000017100,a07,poll
0,01977860400,01977875800,00000015400,a07,poll
0,01977877200,01977890400,00000013200,a07,poll
0,01977891700,01977905600,00000013900,a07,poll
0,01977906600,01977920200,00000013600,a07,poll
0,01977921300,01977926000,00000004700,a07,poll
0,01977928400,01977928600,00000000200,a2f,recvmsg
0,01977929000,01977929200,00000000200,a2f,recvmsg
0,01977946200,01977948400,00000002200,a14,writev
0,01977945800,01977950800,00000005000,a07,poll
0,01977951300,01977952700,00000001400,a2f,recvmsg
0,01977954000,01977955200,00000001200,a2d,recvfrom
0,01977959200,01977959400,00000000200,a2f,recvmsg
0,01977960000,01977960200,00000000200,a2f,recvmsg
0,01978015500,01978015800,00000000300,a2f,recvmsg
0,01978018000,01978018200,00000000200,a2f,recvmsg
0,01978029000,01978029200,00000000200,a2f,recvmsg
0,01978029500,01978029700,00000000200,a2f,recvmsg
0,01978522100,01978526300,00000004200,a09,mmap
0,01978716000,01978787300,00000071300,a2f,recvmsg
0,01978026800,01978824600,00000797800,a07,poll
0,01978826800,01978827700,00000000900,a00,read
0,01978843800,01978845400,00000001600,a2f,recvmsg
0,01978954700,01979014100,00000059400,a2f,recvmsg
0,01979055000,01979068500,00000013500,a2f,recvmsg
0,01978918600,01979070400,00000151800,a07,poll
0,01979075800,01979079900,00000004100,a2e,sendmsg
0,01979082500,01979082700,00000000200,a00,read
0,01979110200,01979111500,00000001300,a2f,recvmsg
0,01979150800,01979152200,00000001400,a2f,recvmsg
0,01979181200,01979181400,00000000200,a2f,recvmsg
0,01979214000,01979216900,00000002900,a14,writev
0,01979218000,01979246400,00000028400,a07,poll
0,01979246700,01979248400,00000001700,a2f,recvmsg
0,01979260300,01979261300,00000001000,a2d,recvfrom
0,01979262300,01979262500,00000000200,a2f,recvmsg
0,01979262900,01979263100,00000000200,a2f,recvmsg
0,01979292600,01979294800,00000002200,a14,writev
0,01979295200,01979311400,00000016200,a07,poll
0,01979311600,01979313200,00000001600,a2f,recvmsg
0,01979314200,01979314400,00000000200,a2f,recvmsg
0,01979314800,01979315000,00000000200,a2f,recvmsg
0,01979338100,01979339800,00000001700,a14,writev
0,01979340200,01979353700,00000013500,a07,poll
0,01979353900,01979355500,00000001600,a2f,recvmsg
0,01979356200,01979356400,00000000200,a2f,recvmsg
0,01979356700,01979356900,00000000200,a2f,recvmsg
0,01979379000,01979380700,00000001700,a14,writev
0,01979381100,01979394500,00000013400,a07,poll
0,01979394700,01979396000,00000001300,a2f,recvmsg
0,01979396700,01979396900,00000000200,a2f,recvmsg
0,01979397200,01979397400,00000000200,a2f,recvmsg
0,01979403100,01979403900,00000000800,aca,futex
0,01979413300,01979417100,00000003800,aca,futex
0,01979427500,01979443100,00000015600,a07,poll
0,01979443300,01979444900,00000001600,a2f,recvmsg
0,01979446000,01979446200,00000000200,a2f,recvmsg
0,01979446500,01979446700,00000000200,a2f,recvmsg
0,01979469600,01979481000,00000011400,a07,poll
0,01979481100,01979482600,00000001500,a2f,recvmsg
0,01979483100,01979483300,00000000200,a2f,recvmsg
0,01979483600,01979483800,00000000200,a2f,recvmsg
0,01979507100,01979518400,00000011300,a07,poll
0,01979518500,01979519900,00000001400,a2f,recvmsg
0,01979520600,01979520700,00000000100,a2f,recvmsg
0,01979521000,01979521200,00000000200,a2f,recvmsg
0,01979543800,01979555000,00000011200,a07,poll
0,01979555100,01979556500,00000001400,a2f,recvmsg
0,01979557000,01979557200,00000000200,a2f,recvmsg
0,01979557500,01979557700,00000000200,a2f,recvmsg
0,01979580100,01979591500,00000011400,a07,poll
0,01979591700,01979593100,00000001400,a2f,recvmsg
0,01979593600,01979593800,00000000200,a2f,recvmsg
0,01979594100,01979594500,00000000400,a2f,recvmsg
0,01979617500,01979628700,00000011200,a07,poll
0,01979628800,01979630100,00000001300,a2f,recvmsg
0,01979630800,01979631000,00000000200,a2f,recvmsg
0,01979631200,01979631400,00000000200,a2f,recvmsg
0,01979654600,01979665800,00000011200,a07,poll
0,01979666000,01979667300,00000001300,a2f,recvmsg
0,01979667900,01979668100,00000000200,a2f,recvmsg
0,01979668400,01979668600,00000000200,a2f,recvmsg
0,01979691600,01979702800,00000011200,a07,poll
0,01979702900,01979704300,00000001400,a2f,recvmsg
0,01979704900,01979705100,00000000200,a2f,recvmsg
0,01979705300,01979705500,00000000200,a2f,recvmsg
0,01979728600,01979739800,00000011200,a07,poll
0,01979739900,01979741300,00000001400,a2f,recvmsg
0,01979741900,01979742000,00000000100,a2f,recvmsg
0,01979742400,01979742600,00000000200,a2f,recvmsg
0,01979765200,01979776300,00000011100,a07,poll
0,01979776500,01979777800,00000001300,a2f,recvmsg
0,01979778400,01979778600,00000000200,a2f,recvmsg
0,01979778900,01979779100,00000000200,a2f,recvmsg
0,01979801900,01979813100,00000011200,a07,poll
0,01979813200,01979814500,00000001300,a2f,recvmsg
0,01979815200,01979815300,00000000100,a2f,recvmsg
0,01979815600,01979815800,00000000200,a2f,recvmsg
0,01979838300,01979849600,00000011300,a07,poll
0,01979849800,01979851300,00000001500,a2f,recvmsg
0,01979851800,01979852000,00000000200,a2f,recvmsg
0,01979852300,01979852500,00000000200,a2f,recvmsg
0,01979875400,01979886600,00000011200,a07,poll
0,01979886800,01979888100,00000001300,a2f,recvmsg
0,01979888800,01979888900,00000000100,a2f,recvmsg
0,01979889300,01979889500,00000000200,a2f,recvmsg
0,01979912300,01979923400,00000011100,a07,poll
0,01979923600,01979924900,00000001300,a2f,recvmsg
0,01979925500,01979925600,00000000100,a2f,recvmsg
0,01979925900,01979926100,00000000200,a2f,recvmsg
0,01979948800,01979960100,00000011300,a07,poll
0,01979960200,01979961700,00000001500,a2f,recvmsg
0,01979962200,01979962400,00000000200,a2f,recvmsg
0,01979962800,01979963000,00000000200,a2f,recvmsg
0,01979985500,01979996800,00000011300,a07,poll
0,01979996900,01979998300,00000001400,a2f,recvmsg
0,01979999000,01979999100,00000000100,a2f,recvmsg
0,01979999500,01979999700,00000000200,a2f,recvmsg
0,01980023000,01980034300,00000011300,a07,poll
0,01980034400,01980035800,00000001400,a2f,recvmsg
0,01980036400,01980036600,00000000200,a2f,recvmsg
0,01980036900,01980037100,00000000200,a2f,recvmsg
0,01980060000,01980071100,00000011100,a07,poll
0,01980071200,01980072600,00000001400,a2f,recvmsg
0,01980073200,01980073400,00000000200,a2f,recvmsg
0,01980073700,01980073800,00000000100,a2f,recvmsg
0,01980096500,01980107900,00000011400,a07,poll
0,01980108000,01980109300,00000001300,a2f,recvmsg
0,01980109900,01980110100,00000000200,a2f,recvmsg
0,01980110400,01980110600,00000000200,a2f,recvmsg
0,01980133100,01980144200,00000011100,a07,poll
0,01980144300,01980145800,00000001500,a2f,recvmsg
0,01980146300,01980146500,00000000200,a2f,recvmsg
0,01980146800,01980147000,00000000200,a2f,recvmsg
0,01980169700,01980180900,00000011200,a07,poll
0,01980181000,01980182400,00000001400,a2f,recvmsg
0,01980183000,01980183200,00000000200,a2f,recvmsg
0,01980183600,01980183800,00000000200,a2f,recvmsg
0,01980206500,01980217700,00000011200,a07,poll
0,01980217800,01980219200,00000001400,a2f,recvmsg
0,01980219800,01980220000,00000000200,a2f,recvmsg
0,01980220200,01980220400,00000000200,a2f,recvmsg
0,01980243500,01980254700,00000011200,a07,poll
0,01980254900,01980256200,00000001300,a2f,recvmsg
0,01980256800,01980257000,00000000200,a2f,recvmsg
0,01980257400,01980257600,00000000200,a2f,recvmsg
0,01980276700,01980276900,00000000200,a2f,recvmsg
0,01980939600,01980940300,00000000700,a2f,recvmsg
0,01980993100,01980993400,00000000300,a2f,recvmsg
0,01980994700,01980994900,00000000200,a00,read
0,01981051700,01981052300,00000000600,a2f,recvmsg
0,01949528300,01981064300,00031536000,ae8,epoll_wait
0,01981073200,01981075100,00000001900,a2f,recvmsg
0,01981087700,01981088000,00000000300,a2f,recvmsg
0,01981105600,01981110400,00000004800,a2e,sendmsg
0,01981053300,01981203400,00000150100,a07,poll
0,01981231200,01981231700,00000000500,a2f,recvmsg
0,01981237100,01981237300,00000000200,a2f,recvmsg
0,01979419800,01986040000,00006620200,aca,futex
0,01951522600,01986918200,00035395600,a17,select
0,01986955900,01995042300,00008086400,a17,select
0,01995079500,01995138700,00000059200,a17,select
0,01949236000,02002286700,00053050700,a4a,fsync
0,02002301600,02002340700,00000039100,a52,rename
0,02002351000,02002356000,00000005000,a02,open
0,01981113200,02002469600,00021356400,ae8,epoll_wait
0,02002475300,02002478600,00000003300,a2f,recvmsg
0,02002492500,02002492700,00000000200,a2f,recvmsg
0,02002522900,02002524000,00000001100,a2e,sendmsg
0,02002435100,02002603300,00000168200,a07,poll
0,02002622300,02002628300,00000006000,aca,futex
0,02002642900,02014823900,00012181000,a07,poll
0,02014847300,02014847500,00000000200,a00,read
0,02002525900,02014860000,00012334100,ae8,epoll_wait
0,02014856100,02014865100,00000009000,a07,poll
0,02014867900,02014869500,00000001600,a2e,sendmsg
0,02014884200,02014887100,00000002900,a2f,recvmsg
0,02014902800,02014903100,00000000300,a2f,recvmsg
0,02014941700,02014942500,00000000800,a2e,sendmsg
0,02014877100,02014954500,00000077400,a07,poll
0,02015027800,02015028600,00000000800,a2f,recvmsg
0,02015030900,02015031100,00000000200,a00,read
0,02015069300,02015135100,00000065800,a07,poll
0,02015139000,02015141900,00000002900,a2e,sendmsg
0,02015146800,02015147000,00000000200,a00,read
0,02015152300,02015220600,00000068300,a07,poll
0,02015221400,02015222000,00000000600,a00,read
0,02015254300,02015255500,00000001200,a2f,recvmsg
0,02018222200,02018248400,00000026200,7ef,local_timer_vector
0,02015313300,02024659200,00009345900,a07,poll
0,02024660800,02024661800,00000001000,a00,read
0,02024686100,02024687200,00000001100,a2f,recvmsg
0,02024690200,02029524200,00004834000,a07,poll
0,02029525300,02029525400,00000000100,a2f,recvmsg
0,02029525700,02029525900,00000000200,a2f,recvmsg
0,02029529200,02029535800,00000006600,a07,poll
0,02029536900,02029537100,00000000200,a2f,recvmsg
0,02029537400,02029537600,00000000200,a2f,recvmsg
0,02029542300,02029549100,00000006800,a07,poll
0,02029550200,02029550400,00000000200,a2f,recvmsg
0,02029550700,02029550900,00000000200,a2f,recvmsg
0,02029554100,02029561000,00000006900,a07,poll
0,02029562100,02029562200,00000000100,a2f,recvmsg
0,02029562500,02029562700,00000000200,a2f,recvmsg
0,02029565800,02029572600,00000006800,a07,poll
0,02029573600,02029573800,00000000200,a2f,recvmsg
0,02029574100,02029574300,00000000200,a2f,recvmsg
0,02029576900,02029583800,00000006900,a07,poll
0,02029584900,02029585000,00000000100,a2f,recvmsg
0,02029585400,02029585600,00000000200,a2f,recvmsg
0,02029590200,02029596800,00000006600,a07,poll
0,02029597900,02029598000,00000000100,a2f,recvmsg
0,02029598300,02029598500,00000000200,a2f,recvmsg
0,02029601100,02029607900,00000006800,a07,poll
0,02029609000,02029609200,00000000200,a2f,recvmsg
0,02029609500,02029609700,00000000200,a2f,recvmsg
0,02029612300,02029619200,00000006900,a07,poll
0,02029620300,02029620500,00000000200,a2f,recvmsg
0,02029620800,02029621000,00000000200,a2f,recvmsg
0,02029623700,02029630300,00000006600,a07,poll
0,02029631400,02029631500,00000000100,a2f,recvmsg
0,02029631800,02029632000,00000000200,a2f,recvmsg
0,02029635100,02029641700,00000006600,a07,poll
0,02029642900,02029643000,00000000100,a2f,recvmsg
0,02029643300,02029643500,00000000200,a2f,recvmsg
0,02029646300,02029652900,00000006600,a07,poll
0,02029654000,02029654200,00000000200,a2f,recvmsg
0,02029654400,02029654600,00000000200,a2f,recvmsg
0,02029658100,02029664800,00000006700,a07,poll
0,02029665800,02029666000,00000000200,a2f,recvmsg
0,02029666300,02029666500,00000000200,a2f,recvmsg
0,02029669800,02029676500,00000006700,a07,poll
0,02029677500,02029677700,00000000200,a2f,recvmsg
0,02029678000,02029678200,00000000200,a2f,recvmsg
0,02029682800,02029689900,00000007100,a07,poll
0,02029691000,02029691200,00000000200,a2f,recvmsg
0,02029691500,02029691700,00000000200,a2f,recvmsg
0,02029695300,02029701800,00000006500,a07,poll
0,02029702900,02029703100,00000000200,a2f,recvmsg
0,02029703400,02029703600,00000000200,a2f,recvmsg
0,02029707000,02029713700,00000006700,a07,poll
0,02029714900,02029715000,00000000100,a2f,recvmsg
0,02029715200,02029715400,00000000200,a2f,recvmsg
0,02029720800,02029727600,00000006800,a07,poll
0,02029728700,02029728900,00000000200,a2f,recvmsg
0,02029729200,02029729400,00000000200,a2f,recvmsg
0,02029732300,02029739000,00000006700,a07,poll
0,02029740100,02029740300,00000000200,a2f,recvmsg
0,02029740600,02029740800,00000000200,a2f,recvmsg
0,02029743800,02029750500,00000006700,a07,poll
0,02029751600,02029751800,00000000200,a2f,recvmsg
0,02029752100,02029752300,00000000200,a2f,recvmsg
0,02029756000,02029762800,00000006800,a07,poll
0,02029764100,02029764200,00000000100,a2f,recvmsg
0,02029764500,02029764600,00000000100,a2f,recvmsg
0,02029768700,02029775500,00000006800,a07,poll
0,02029776500,02029776700,00000000200,a2f,recvmsg
0,02029777000,02029777200,00000000200,a2f,recvmsg
0,02029780800,02029787600,00000006800,a07,poll
0,02029788700,02029788900,00000000200,a2f,recvmsg
0,02029789200,02029789300,00000000100,a2f,recvmsg
0,02029792700,02029799400,00000006700,a07,poll
0,02029800600,02029800700,00000000100,a2f,recvmsg
0,02029801000,02029801200,00000000200,a2f,recvmsg
0,02029804200,02029811000,00000006800,a07,poll
0,02029812100,02029812300,00000000200,a2f,recvmsg
0,02029812600,02029812800,00000000200,a2f,recvmsg
0,02029815700,02029822400,00000006700,a07,poll
0,02029823500,02029823600,00000000100,a2f,recvmsg
0,02029823900,02029824100,00000000200,a2f,recvmsg
0,02029827300,02029834200,00000006900,a07,poll
0,02029835300,02029835500,00000000200,a2f,recvmsg
0,02029835800,02029836000,00000000200,a2f,recvmsg
0,02029836900,02029837000,00000000100,a08,lseek
0,02029839600,02029840600,00000001000,a00,read
0,02029844300,02029844300,00000000000,a08,lseek
0,02029847400,02029853800,00000006400,a07,poll
0,02029855100,02029855300,00000000200,a2f,recvmsg
0,02029855600,02029855700,00000000100,a2f,recvmsg
0,02029906300,02029914200,00000007900,a07,poll
0,02029915700,02029915900,00000000200,a2f,recvmsg
0,02029916300,02029916500,00000000200,a2f,recvmsg
0,02029920600,02029924100,00000003500,a00,read
0,02029930000,02029930100,00000000100,a08,lseek
0,02029933600,02029940500,00000006900,a07,poll
0,02029941700,02029941900,00000000200,a2f,recvmsg
0,02029942200,02029942400,00000000200,a2f,recvmsg
0,02029945200,02029951900,00000006700,a07,poll
0,02029953000,02029953200,00000000200,a2f,recvmsg
0,02029953500,02029953700,00000000200,a2f,recvmsg
0,02029956400,02029963000,00000006600,a07,poll
0,02029964000,02029964200,00000000200,a2f,recvmsg
0,02029964500,02029964700,00000000200,a2f,recvmsg
0,02029967500,02029974400,00000006900,a07,poll
0,02029975500,02029975600,00000000100,a2f,recvmsg
0,02029975900,02029976100,00000000200,a2f,recvmsg
0,02029978900,02029985500,00000006600,a07,poll
0,02029986600,02029986800,00000000200,a2f,recvmsg
0,02029987000,02029987200,00000000200,a2f,recvmsg
0,02029989900,02029996500,00000006600,a07,poll
0,02029997600,02029997800,00000000200,a2f,recvmsg
0,02029998100,02029998200,00000000100,a2f,recvmsg
0,02030000900,02030007700,00000006800,a07,poll
0,02030008700,02030008900,00000000200,a2f,recvmsg
0,02030009200,02030009400,00000000200,a2f,recvmsg
0,02030012700,02030019600,00000006900,a07,poll
0,02030020700,02030020800,00000000100,a2f,recvmsg
0,02030021100,02030021300,00000000200,a2f,recvmsg
0,02030024100,02030030800,00000006700,a07,poll
0,02030031900,02030032100,00000000200,a2f,recvmsg
0,02030032400,02030032500,00000000100,a2f,recvmsg
0,02030032900,02030033000,00000000100,a08,lseek
0,02030037100,02030043800,00000006700,a07,poll
0,02030045100,02030045300,00000000200,a2f,recvmsg
0,02030045600,02030045700,00000000100,a2f,recvmsg
0,02030050800,02030057600,00000006800,a07,poll
0,02030058800,02030059000,00000000200,a2f,recvmsg
0,02030059200,02030059400,00000000200,a2f,recvmsg
0,02030062800,02030069600,00000006800,a07,poll
0,02030070700,02030070800,00000000100,a2f,recvmsg
0,02030071100,02030071300,00000000200,a2f,recvmsg
0,02030074300,02030081000,00000006700,a07,poll
0,02030082100,02030082300,00000000200,a2f,recvmsg
0,02030082600,02030082800,00000000200,a2f,recvmsg
0,02030085700,02030092400,00000006700,a07,poll
0,02030093500,02030093600,00000000100,a2f,recvmsg
0,02030093900,02030094100,00000000200,a2f,recvmsg
0,02030097200,02030103800,00000006600,a07,poll
0,02030105000,02030105100,00000000100,a2f,recvmsg
0,02030105500,02030105700,00000000200,a2f,recvmsg
0,02030109100,02030116000,00000006900,a07,poll
0,02030117100,02030117200,00000000100,a2f,recvmsg
0,02030117600,02030117700,00000000100,a2f,recvmsg
0,02030120800,02030127400,00000006600,a07,poll
0,02030128600,02030128700,00000000100,a2f,recvmsg
0,02030129100,02030129200,00000000100,a2f,recvmsg
0,02030132400,02030138800,00000006400,a07,poll
0,02030139900,02030140100,00000000200,a2f,recvmsg
0,02030140400,02030140600,00000000200,a2f,recvmsg
0,02030143600,02030150200,00000006600,a07,poll
0,02030151300,02030151500,00000000200,a2f,recvmsg
0,02030151800,02030152000,00000000200,a2f,recvmsg
0,02030154900,02030161600,00000006700,a07,poll
0,02030162700,02030162900,00000000200,a2f,recvmsg
0,02030163200,02030163400,00000000200,a2f,recvmsg
0,02030166200,02030172700,00000006500,a07,poll
0,02030173800,02030174000,00000000200,a2f,recvmsg
0,02030174300,02030174500,00000000200,a2f,recvmsg
0,02030178000,02030184800,00000006800,a07,poll
0,02030186000,02030186200,00000000200,a2f,recvmsg
0,02030186400,02030186600,00000000200,a2f,recvmsg
0,02030189600,02030196100,00000006500,a07,poll
0,02030197200,02030197400,00000000200,a2f,recvmsg
0,02030197700,02030197800,00000000100,a2f,recvmsg
0,02030200700,02030207400,00000006700,a07,poll
0,02030208600,02030208800,00000000200,a2f,recvmsg
0,02030209100,02030209200,00000000100,a2f,recvmsg
0,02030212300,02030218900,00000006600,a07,poll
0,02030220100,02030220300,00000000200,a2f,recvmsg
0,02030220500,02030220700,00000000200,a2f,recvmsg
0,02030229100,02030235900,00000006800,a07,poll
0,02030237100,02030237200,00000000100,a2f,recvmsg
0,02030237500,02030237600,00000000100,a2f,recvmsg
0,02030240900,02030247300,00000006400,a07,poll
0,02030248500,02030248600,00000000100,a2f,recvmsg
0,02030248900,02030249000,00000000100,a2f,recvmsg
0,02030252100,02030258900,00000006800,a07,poll
0,02030260100,02030260300,00000000200,a2f,recvmsg
0,02030260400,02030260600,00000000200,a2f,recvmsg
0,02030263900,02030270400,00000006500,a07,poll
0,02030271500,02030271700,00000000200,a2f,recvmsg
0,02030271900,02030272100,00000000200,a2f,recvmsg
0,02030275300,02030282000,00000006700,a07,poll
0,02030283100,02030283200,00000000100,a2f,recvmsg
0,02030283500,02030283700,00000000200,a2f,recvmsg
0,02030303800,02030329600,00000025800,a57,unlink
0,02030330800,02030335100,00000004300,a14,writev
0,02030335600,02030434000,00000098400,a07,poll
0,02030335600,02030437700,00000102100,a07,poll
0,02030451200,02030451400,00000000200,a2f,recvmsg
0,02030456500,02030456700,00000000200,a2f,recvmsg
0,02030456900,02030457100,00000000200,a2f,recvmsg
0,02030462100,02030462200,00000000100,a2f,recvmsg
0,02030462400,02030462600,00000000200,a2f,recvmsg
0,02030463400,02030467400,00000004000,a07,poll
0,02030476700,02030476900,00000000200,a2f,recvmsg
0,02030506500,02030514400,00000007900,a07,poll
0,02030517300,02030517400,00000000100,a2f,recvmsg
0,02030518400,02030518500,00000000100,a2f,recvmsg
0,02030518700,02030518800,00000000100,a2f,recvmsg
0,02030519700,02030519900,00000000200,a2f,recvmsg
0,02030520100,02030520300,00000000200,a2f,recvmsg
0,02030520600,02030522100,00000001500,a07,poll
0,02030532000,02030532200,00000000200,a2f,recvmsg
0,02030562400,02030571900,00000009500,a07,poll
0,02030572000,02030574100,00000002100,a2f,recvmsg
0,02030562400,02030575700,00000013300,a07,poll
0,02030578100,02030578300,00000000200,a2f,recvmsg
0,02030579000,02030579200,00000000200,a2f,recvmsg
0,02030579400,02030579600,00000000200,a2f,recvmsg
0,02030580500,02030580600,00000000100,a2f,recvmsg
0,02030580800,02030581000,00000000200,a2f,recvmsg
0,02030581200,02030582700,00000001500,a07,poll
0,02030586000,02030629700,00000043700,a07,poll
0,02030586000,02030632200,00000046200,a07,poll
0,02030634100,02030634300,00000000200,a2f,recvmsg
0,02030634800,02030634900,00000000100,a2f,recvmsg
0,02030635100,02030635300,00000000200,a2f,recvmsg
0,02030635800,02030636000,00000000200,a2f,recvmsg
0,02030636200,02030636400,00000000200,a2f,recvmsg
0,02030636600,02030637900,00000001300,a07,poll
0,02030640600,02030686600,00000046000,a07,poll
0,02030686700,02030687800,00000001100,a2f,recvmsg
0,02030640600,02030688800,00000048200,a07,poll
0,02030691500,02030691700,00000000200,a2f,recvmsg
0,02030692100,02030692200,00000000100,a2f,recvmsg
0,02030692400,02030692600,00000000200,a2f,recvmsg
0,02030693200,02030693300,00000000100,a2f,recvmsg
0,02030693500,02030693600,00000000100,a2f,recvmsg
0,02030693800,02030695200,00000001400,a07,poll
0,02030697800,02030743500,00000045700,a07,poll
0,02030743700,02030744800,00000001100,a2f,recvmsg
0,02030697800,02030745800,00000048000,a07,poll
0,02030747600,02030747800,00000000200,a2f,recvmsg
0,02030748300,02030748500,00000000200,a2f,recvmsg
0,02030748700,02030748800,00000000100,a2f,recvmsg
0,02030749300,02030749500,00000000200,a2f,recvmsg
0,02030749700,02030749900,00000000200,a2f,recvmsg
0,02030750100,02030751500,00000001400,a07,poll
0,02030754400,02030801000,00000046600,a07,poll
0,02030801200,02030802200,00000001000,a2f,recvmsg
0,02030754400,02030803300,00000048900,a07,poll
0,02030805700,02030845700,00000040000,a07,poll
0,02030845900,02030847000,00000001100,a2f,recvmsg
0,02030805700,02030847800,00000042100,a07,poll
0,02030850400,02030890400,00000040000,a07,poll
0,02030890600,02030891500,00000000900,a2f,recvmsg
0,02030850400,02030892400,00000042000,a07,poll
0,02030894900,02030934100,00000039200,a07,poll
0,02030934300,02030935300,00000001000,a2f,recvmsg
0,02030894900,02030936200,00000041300,a07,poll
0,02030940100,02030978600,00000038500,a07,poll
0,02030978700,02030980000,00000001300,a2f,recvmsg
0,02030940100,02030980900,00000040800,a07,poll
0,02030983400,02031023900,00000040500,a07,poll
0,02031024100,02031025100,00000001000,a2f,recvmsg
0,02030983400,02031026000,00000042600,a07,poll
0,02031028600,02031079000,00000050400,a07,poll
0,02031028600,02031081200,00000052600,a07,poll
0,02031084300,02031097900,00000013600,a07,poll
0,02031098000,02031099000,00000001000,a2f,recvmsg
0,02031084300,02031100100,00000015800,a07,poll
0,02031102700,02031115000,00000012300,a07,poll
0,02031102700,02031117100,00000014400,a07,poll
0,02031119500,02031131100,00000011600,a07,poll
0,02031131300,02031132400,00000001100,a2f,recvmsg
0,02031119500,02031133200,00000013700,a07,poll
0,02031135900,02031146900,00000011000,a07,poll
0,02031148100,02031149700,00000001600,a07,poll
0,02031151100,02031162500,00000011400,a07,poll
0,02031162700,02031163700,00000001000,a2f,recvmsg
0,02031151100,02031164600,00000013500,a07,poll
0,02031167100,02031168600,00000001500,a07,poll
0,02031171400,02031171600,00000000200,a2f,recvmsg
0,02031172200,02031172400,00000000200,a2f,recvmsg
0,02031167100,02031191500,00000024400,a07,poll
0,02031191900,02031193400,00000001500,a2f,recvmsg
0,02031195500,02031196600,00000001100,a2d,recvfrom
0,02031200400,02031200600,00000000200,a2f,recvmsg
0,02031201000,02031201200,00000000200,a2f,recvmsg
0,02031167100,02031206200,00000039100,a07,poll
0,02031206600,02031208100,00000001500,a2f,recvmsg
0,02031209600,02031210400,00000000800,a2d,recvfrom
0,02031214300,02031214400,00000000100,a2f,recvmsg
0,02031215000,02031215200,00000000200,a2f,recvmsg
0,02031255600,02031255900,00000000300,a2f,recvmsg
0,02031258100,02031258300,00000000200,a2f,recvmsg
0,02031318000,02031318300,00000000300,a2f,recvmsg
0,02031320600,02031320700,00000000100,a2f,recvmsg
0,02031332700,02031339600,00000006900,a07,poll
0,02031340400,02031342000,00000001600,a2f,recvmsg
0,02031349200,02031350000,00000000800,a2d,recvfrom
0,02031351000,02031351200,00000000200,a2f,recvmsg
0,02031352200,02031352400,00000000200,a2f,recvmsg
0,02031383700,02031384000,00000000300,a2f,recvmsg
0,02031386500,02031386600,00000000100,a2f,recvmsg
0,02031390100,02031392500,00000002400,a07,poll
0,02031394800,02031395000,00000000200,a2f,recvmsg
0,02031395700,02031395900,00000000200,a2f,recvmsg
0,02032002400,02032065400,00000063000,a07,poll
0,02032067500,02032068200,00000000700,a00,read
0,02032084200,02032086000,00000001800,a2f,recvmsg
0,01995177800,02032143700,00036965900,a17,select
0,02032156200,02032156900,00000000700,a2f,recvmsg
0,02032159200,02032159300,00000000100,a00,read
0,02032196500,02032308500,00000112000,a07,poll
0,02032312400,02032316100,00000003700,a2e,sendmsg
0,02032318200,02032318400,00000000200,a00,read
0,02032345200,02032428100,00000082900,a07,poll
0,02032430300,02032431500,00000001200,a2e,sendmsg
0,02032450000,02032506100,00000056100,a07,poll
0,02032509500,02032512000,00000002500,a2f,recvmsg
0,02032518100,02032519400,00000001300,a2f,recvmsg
0,02032688200,02032689100,00000000900,a2f,recvmsg
0,02032691300,02032691400,00000000100,a00,read
0,02032168000,02034478900,00002310900,a17,select
0,02034500100,02034500400,00000000300,a2f,recvmsg
0,02034503400,02034512900,00000009500,a17,select
0,02034517300,02034517500,00000000200,a2f,recvmsg
0,02034518200,02034579100,00000060900,a17,select
0,02034582900,02034583100,00000000200,a2f,recvmsg
0,02004671400,02045126200,00040454800,a3d,wait4
0,02045147400,02045149500,00000002100,a00,read
0,02045151600,02045151900,00000000300,a00,read
0,02045170600,02045218700,00000048100,a07,poll
0,02045223700,02045223900,00000000200,a2f,recvmsg
0,02045224800,02045224800,00000000000,a2f,recvmsg
0,02045230600,02045242500,00000011900,a07,poll
0,02045244700,02045244800,00000000100,a2f,recvmsg
0,02045245300,02045245500,00000000200,a2f,recvmsg
0,02045250000,02045261700,00000011700,a07,poll
0,02045263800,02045263900,00000000100,a2f,recvmsg
0,02045264300,02045264500,00000000200,a2f,recvmsg
0,02045269300,02045280900,00000011600,a07,poll
0,02045282900,02045283100,00000000200,a2f,recvmsg
0,02045283500,02045283700,00000000200,a2f,recvmsg
0,02045287600,02045299300,00000011700,a07,poll
0,02045301400,02045301600,00000000200,a2f,recvmsg
0,02045302000,02045302100,00000000100,a2f,recvmsg
0,02045306400,02045317900,00000011500,a07,poll
0,02045320100,02045320300,00000000200,a2f,recvmsg
0,02045320700,02045320900,00000000200,a2f,recvmsg
0,02045321700,02045321900,00000000200,a08,lseek
0,02045332500,02045332600,00000000100,a08,lseek
0,02045335900,02045343000,00000007100,a07,poll
0,02045344300,02045344500,00000000200,a2f,recvmsg
0,02045344800,02045344900,00000000100,a2f,recvmsg
0,02045350800,02045357600,00000006800,a07,poll
0,02045358600,02045358800,00000000200,a2f,recvmsg
0,02045359100,02045359300,00000000200,a2f,recvmsg
0,02045362400,02045369200,00000006800,a07,poll
0,02045370300,02045370500,00000000200,a2f,recvmsg
0,02045370800,02045371000,00000000200,a2f,recvmsg
0,02045374900,02045381400,00000006500,a07,poll
0,02045382600,02045382800,00000000200,a2f,recvmsg
0,02045383100,02045383300,00000000200,a2f,recvmsg
0,02045387300,02045394000,00000006700,a07,poll
0,02045395200,02045395400,00000000200,a2f,recvmsg
0,02045395700,02045395800,00000000100,a2f,recvmsg
0,02045399500,02045405900,00000006400,a07,poll
0,02045407100,02045407200,00000000100,a2f,recvmsg
0,02045407500,02045407700,00000000200,a2f,recvmsg
0,02045411000,02045418000,00000007000,a07,poll
0,02045419100,02045419200,00000000100,a2f,recvmsg
0,02045419500,02045419700,00000000200,a2f,recvmsg
0,02045422500,02045429100,00000006600,a07,poll
0,02045430100,02045430300,00000000200,a2f,recvmsg
0,02045430600,02045430800,00000000200,a2f,recvmsg
0,02045435000,02045442100,00000007100,a07,poll
0,02045443200,02045443300,00000000100,a2f,recvmsg
0,02045443600,02045443800,00000000200,a2f,recvmsg
0,02045447100,02045453900,00000006800,a07,poll
0,02045455000,02045455100,00000000100,a2f,recvmsg
0,02045455400,02045455600,00000000200,a2f,recvmsg
0,02045459600,02045466300,00000006700,a07,poll
0,02045467700,02045467900,00000000200,a2f,recvmsg
0,02045468100,02045468300,00000000200,a2f,recvmsg
0,02045471500,02045478400,00000006900,a07,poll
0,02045479600,02045479700,00000000100,a2f,recvmsg
0,02045480000,02045480200,00000000200,a2f,recvmsg
0,02045483300,02045489900,00000006600,a07,poll
0,02045490900,02045491100,00000000200,a2f,recvmsg
0,02045491400,02045491600,00000000200,a2f,recvmsg
0,02045494700,02045501400,00000006700,a07,poll
0,02045502600,02045502700,00000000100,a2f,recvmsg
0,02045503000,02045503200,00000000200,a2f,recvmsg
0,02045506300,02045513200,00000006900,a07,poll
0,02045514300,02045514500,00000000200,a2f,recvmsg
0,02045514800,02045514900,00000000100,a2f,recvmsg
0,02045517600,02045524700,00000007100,a07,poll
0,02045525700,02045525900,00000000200,a2f,recvmsg
0,02045526200,02045526400,00000000200,a2f,recvmsg
0,02045531000,02045537800,00000006800,a07,poll
0,02045538900,02045539000,00000000100,a2f,recvmsg
0,02045539400,02045539500,00000000100,a2f,recvmsg
0,02045542100,02045549100,00000007000,a07,poll
0,02045550100,02045550300,00000000200,a2f,recvmsg
0,02045550600,02045550800,00000000200,a2f,recvmsg
0,02045553500,02045560300,00000006800,a07,poll
0,02045561400,02045561600,00000000200,a2f,recvmsg
0,02045561900,02045562100,00000000200,a2f,recvmsg
0,02045564700,02045571600,00000006900,a07,poll
0,02045572700,02045572800,00000000100,a2f,recvmsg
0,02045573100,02045573300,00000000200,a2f,recvmsg
0,02045576400,02045583200,00000006800,a07,poll
0,02045584300,02045584500,00000000200,a2f,recvmsg
0,02045584800,02045585000,00000000200,a2f,recvmsg
0,02045587700,02045594300,00000006600,a07,poll
0,02045595400,02045595500,00000000100,a2f,recvmsg
0,02045595800,02045596000,00000000200,a2f,recvmsg
0,02045599300,02045606300,00000007000,a07,poll
0,02045607300,02045607500,00000000200,a2f,recvmsg
0,02045607800,02045608000,00000000200,a2f,recvmsg
0,02045611200,02045618100,00000006900,a07,poll
0,02045619100,02045619300,00000000200,a2f,recvmsg
0,02045619600,02045619800,00000000200,a2f,recvmsg
0,02045623700,02045630800,00000007100,a07,poll
0,02045631800,02045632000,00000000200,a2f,recvmsg
0,02045632300,02045632500,00000000200,a2f,recvmsg
0,02045636000,02045642800,00000006800,a07,poll
0,02045643900,02045644100,00000000200,a2f,recvmsg
0,02045644400,02045644600,00000000200,a2f,recvmsg
0,02045647900,02045655000,00000007100,a07,poll
0,02045656100,02045656300,00000000200,a2f,recvmsg
0,02045656500,02045656700,00000000200,a2f,recvmsg
0,02045662800,02045669700,00000006900,a07,poll
0,02045670800,02045671000,00000000200,a2f,recvmsg
0,02045671300,02045671400,00000000100,a2f,recvmsg
0,02045674500,02045681300,00000006800,a07,poll
0,02045682400,02045682600,00000000200,a2f,recvmsg
0,02045682800,02045683000,00000000200,a2f,recvmsg
0,02045685900,02045692600,00000006700,a07,poll
0,02045693800,02045694000,00000000200,a2f,recvmsg
0,02045694200,02045694400,00000000200,a2f,recvmsg
0,02045698300,02045705400,00000007100,a07,poll
0,02045706500,02045706700,00000000200,a2f,recvmsg
0,02045707000,02045707200,00000000200,a2f,recvmsg
0,02045710400,02045717400,00000007000,a07,poll
0,02045718500,02045718700,00000000200,a2f,recvmsg
0,02045718900,02045719100,00000000200,a2f,recvmsg
0,02045722700,02045729800,00000007100,a07,poll
0,02045730900,02045731000,00000000100,a2f,recvmsg
0,02045731300,02045731500,00000000200,a2f,recvmsg
0,02045734900,02045741700,00000006800,a07,poll
0,02045742900,02045743000,00000000100,a2f,recvmsg
0,02045743300,02045743500,00000000200,a2f,recvmsg
0,02045746600,02045753500,00000006900,a07,poll
0,02045754600,02045754800,00000000200,a2f,recvmsg
0,02045755000,02045755200,00000000200,a2f,recvmsg
0,02045758000,02045764700,00000006700,a07,poll
0,02045765900,02045766100,00000000200,a2f,recvmsg
0,02045766300,02045766500,00000000200,a2f,recvmsg
0,02045769800,02045776500,00000006700,a07,poll
0,02045777700,02045777700,00000000000,a2f,recvmsg
0,02045778000,02045778200,00000000200,a2f,recvmsg
0,02045779300,02045779400,00000000100,a08,lseek
0,02045781700,02045782700,00000001000,a00,read
0,02045786400,02045786500,00000000100,a08,lseek
0,02045789200,02045796000,00000006800,a07,poll
0,02045797200,02045797400,00000000200,a2f,recvmsg
0,02045797800,02045797900,00000000100,a2f,recvmsg
0,02045824700,02045831300,00000006600,a07,poll
0,02045832700,02045832800,00000000100,a2f,recvmsg
0,02045833100,02045833300,00000000200,a2f,recvmsg
0,02045837100,02045838000,00000000900,a00,read
0,02045843500,02045843600,00000000100,a08,lseek
0,02045846800,02045853400,00000006600,a07,poll
0,02045854600,02045854800,00000000200,a2f,recvmsg
0,02045855100,02045855300,00000000200,a2f,recvmsg
0,02045856400,02045879900,00000023500,a14,writev
0,02045885300,02045885500,00000000200,a2f,recvmsg
0,02045885900,02045886000,00000000100,a2f,recvmsg
0,02045889000,02045895800,00000006800,a07,poll
0,02045897000,02045897200,00000000200,a2f,recvmsg
0,02045897400,02045897600,00000000200,a2f,recvmsg
0,02045900400,02045907000,00000006600,a07,poll
0,02045908200,02045908400,00000000200,a2f,recvmsg
0,02045908700,02045908800,00000000100,a2f,recvmsg
0,02045911500,02045918300,00000006800,a07,poll
0,02045919400,02045919600,00000000200,a2f,recvmsg
0,02045919900,02045920100,00000000200,a2f,recvmsg
0,02045922700,02045929500,00000006800,a07,poll
0,02045930600,02045930800,00000000200,a2f,recvmsg
0,02045931100,02045931300,00000000200,a2f,recvmsg
0,02045933900,02045940600,00000006700,a07,poll
0,02045941600,02045941800,00000000200,a2f,recvmsg
0,02045942100,02045942300,00000000200,a2f,recvmsg
0,02045945600,02045952500,00000006900,a07,poll
0,02045953600,02045953700,00000000100,a2f,recvmsg
0,02045954000,02045954200,00000000200,a2f,recvmsg
0,02045957000,02045963900,00000006900,a07,poll
0,02045965000,02045965200,00000000200,a2f,recvmsg
0,02045965500,02045965700,00000000200,a2f,recvmsg
0,02045966100,02045966200,00000000100,a08,lseek
0,02045970300,02045976900,00000006600,a07,poll
0,02045978100,02045978300,00000000200,a2f,recvmsg
0,02045978600,02045978800,00000000200,a2f,recvmsg
0,02045983900,02045990600,00000006700,a07,poll
0,02045991800,02045992000,00000000200,a2f,recvmsg
0,02045992300,02045992400,00000000100,a2f,recvmsg
0,02045995700,02046002300,00000006600,a07,poll
0,02046003600,02046003800,00000000200,a2f,recvmsg
0,02046004000,02046004200,00000000200,a2f,recvmsg
0,02046007300,02046014000,00000006700,a07,poll
0,02046015200,02046015400,00000000200,a2f,recvmsg
0,02046015700,02046015900,00000000200,a2f,recvmsg
0,02046019000,02046025600,00000006600,a07,poll
0,02046026700,02046026800,00000000100,a2f,recvmsg
0,02046027100,02046027300,00000000200,a2f,recvmsg
0,02046030400,02046036900,00000006500,a07,poll
0,02046038100,02046038200,00000000100,a2f,recvmsg
0,02046038500,02046038700,00000000200,a2f,recvmsg
0,02046042200,02046048900,00000006700,a07,poll
0,02046050100,02046050300,00000000200,a2f,recvmsg
0,02046050500,02046050700,00000000200,a2f,recvmsg
0,02046053600,02046060300,00000006700,a07,poll
0,02046061400,02046061600,00000000200,a2f,recvmsg
0,02046061900,02046062100,00000000200,a2f,recvmsg
0,02046065400,02046072200,00000006800,a07,poll
0,02046073300,02046073500,00000000200,a2f,recvmsg
0,02046073800,02046074000,00000000200,a2f,recvmsg
0,02046076900,02046083600,00000006700,a07,poll
0,02046084700,02046084900,00000000200,a2f,recvmsg
0,02046085200,02046085400,00000000200,a2f,recvmsg
0,02046088400,02046095200,00000006800,a07,poll
0,02046096400,02046096500,00000000100,a2f,recvmsg
0,02046096800,02046096900,00000000100,a2f,recvmsg
0,02046100000,02046106600,00000006600,a07,poll
0,02046107800,02046108000,00000000200,a2f,recvmsg
0,02046108300,02046108400,00000000100,a2f,recvmsg
0,02046112000,02046118600,00000006600,a07,poll
0,02046119700,02046119800,00000000100,a2f,recvmsg
0,02046120100,02046120300,00000000200,a2f,recvmsg
0,02046123300,02046130000,00000006700,a07,poll
0,02046131100,02046131200,00000000100,a2f,recvmsg
0,02046131500,02046131700,00000000200,a2f,recvmsg
0,02046134800,02046141400,00000006600,a07,poll
0,02046142500,02046142700,00000000200,a2f,recvmsg
0,02046143000,02046143200,00000000200,a2f,recvmsg
0,02046146200,02046152900,00000006700,a07,poll
0,02046153900,02046154100,00000000200,a2f,recvmsg
0,02046154400,02046154600,00000000200,a2f,recvmsg
0,02046163400,02046170200,00000006800,a07,poll
0,02046171300,02046171500,00000000200,a2f,recvmsg
0,02046171800,02046172000,00000000200,a2f,recvmsg
0,02046175200,02046182000,00000006800,a07,poll
0,02046183000,02046183200,00000000200,a2f,recvmsg
0,02046183500,02046183700,00000000200,a2f,recvmsg
0,02046186700,02046193400,00000006700,a07,poll
0,02046194500,02046194700,00000000200,a2f,recvmsg
0,02046195000,02046195200,00000000200,a2f,recvmsg
0,02046198400,02046205100,00000006700,a07,poll
0,02046206100,02046206300,00000000200,a2f,recvmsg
0,02046206500,02046206700,00000000200,a2f,recvmsg
0,02046209900,02046216600,00000006700,a07,poll
0,02046217800,02046218000,00000000200,a2f,recvmsg
0,02046218300,02046218500,00000000200,a2f,recvmsg
0,02046239100,02046265900,00000026800,a57,unlink
0,02046267100,02046271400,00000004300,a14,writev
0,02046271900,02046369200,00000097300,a07,poll
0,02046271900,02046377500,00000105600,a07,poll
0,02046389000,02046389200,00000000200,a2f,recvmsg
0,02046437200,02046437400,00000000200,a2f,recvmsg
0,02046425000,02046450400,00000025400,a07,poll
0,02046467100,02046471200,00000004100,a07,poll
0,02046482300,02046482500,00000000200,a2f,recvmsg
0,02046500300,02046507600,00000007300,a07,poll
0,02046500300,02046510300,00000010000,a07,poll
0,02046513700,02046514900,00000001200,a07,poll
0,02046516400,02046566900,00000050500,a07,poll
0,02046516400,02046570000,00000053600,a07,poll
0,02046573100,02046574200,00000001100,a07,poll
0,02046575600,02046625700,00000050100,a07,poll
0,02046627000,02046628700,00000001700,a07,poll
0,02046630100,02046631500,00000001400,a07,poll
0,02046632900,02046683600,00000050700,a07,poll
0,02046632900,02046686500,00000053600,a07,poll
0,02046689400,02046690400,00000001000,a07,poll
0,02046691700,02046739900,00000048200,a07,poll
0,02046740200,02046741200,00000001000,a2f,recvmsg
0,02046691700,02046742300,00000050600,a07,poll
0,02046744800,02046745900,00000001100,a07,poll
0,02046747200,02046785600,00000038400,a07,poll
0,02046747200,02046787400,00000040200,a07,poll
0,02046787600,02046790000,00000002400,a2f,recvmsg
0,02046790700,02046791800,00000001100,a07,poll
0,02046793200,02046830700,00000037500,a07,poll
0,02046793200,02046832400,00000039200,a07,poll
0,02046832700,02046835000,00000002300,a2f,recvmsg
0,02046835600,02046836600,00000001000,a07,poll
0,02046837900,02046875600,00000037700,a07,poll
0,02046837900,02046877400,00000039500,a07,poll
0,02046877600,02046879900,00000002300,a2f,recvmsg
0,02046880400,02046881600,00000001200,a07,poll
0,02046882800,02046920100,00000037300,a07,poll
0,02046920300,02046921400,00000001100,a2f,recvmsg
0,02046882800,02046922400,00000039600,a07,poll
0,02046925100,02046926100,00000001000,a07,poll
0,02046927400,02046963300,00000035900,a07,poll
0,02046927400,02046965100,00000037700,a07,poll
0,02046965200,02046969700,00000004500,a2f,recvmsg
0,02046970400,02046971500,00000001100,a07,poll
0,02046972800,02047018800,00000046000,a07,poll
0,02047019000,02047020100,00000001100,a2f,recvmsg
0,02046972800,02047021100,00000048300,a07,poll
0,02047023900,02047024900,00000001000,a07,poll
0,02047026300,02047039000,00000012700,a07,poll
0,02047026300,02047040600,00000014300,a07,poll
0,02047040900,02047043300,00000002400,a2f,recvmsg
0,02047043800,02047045000,00000001200,a07,poll
0,02047046400,02047056700,00000010300,a07,poll
0,02047046400,02047058400,00000012000,a07,poll
0,02047058700,02047061000,00000002300,a2f,recvmsg
0,02047061700,02047062800,00000001100,a07,poll
0,02047064000,02047073400,00000009400,a07,poll
0,02047073500,02047074600,00000001100,a2f,recvmsg
0,02047064000,02047075500,00000011500,a07,poll
0,02047078600,02047079700,00000001100,a07,poll
0,02047081100,02047089700,00000008600,a07,poll
0,02047089900,02047090900,00000001000,a2f,recvmsg
0,02047081100,02047091800,00000010700,a07,poll
0,02047094400,02047095600,00000001200,a07,poll
0,02047096900,02047106000,00000009100,a07,poll
0,02047106300,02047107300,00000001000,a2f,recvmsg
0,02047096900,02047108200,00000011300,a07,poll
0,02047111200,02047112900,00000001700,a07,poll
0,02047114200,02047115600,00000001400,a07,poll
0,02047118400,02047118600,00000000200,a2f,recvmsg
0,02047119100,02047119300,00000000200,a2f,recvmsg
0,02047119900,02047134400,00000014500,a57,unlink
0,02047114200,02047136100,00000021900,a07,poll
0,02047136300,02047137900,00000001600,a2f,recvmsg
0,02047139300,02047140500,00000001200,a2d,recvfrom
0,02047144600,02047144800,00000000200,a2f,recvmsg
0,02047145400,02047145600,00000000200,a2f,recvmsg
0,02047114200,02047163800,00000049600,a07,poll
0,02047164300,02047165800,00000001500,a2f,recvmsg
0,02047167800,02047168600,00000000800,a2d,recvfrom
0,02047172800,02047172900,00000000100,a2f,recvmsg
0,02047173500,02047173700,00000000200,a2f,recvmsg
0,02047215400,02047215700,00000000300,a2f,recvmsg
0,02047217900,02047218000,00000000100,a2f,recvmsg
0,02047263700,02047264000,00000000300,a2f,recvmsg
0,02047266300,02047266500,00000000200,a2f,recvmsg
0,02047269200,02047272500,00000003300,a07,poll
0,02047273000,02047274100,00000001100,a2f,recvmsg
0,02047275800,02047276600,00000000800,a2d,recvfrom
0,02047281100,02047281300,00000000200,a2f,recvmsg
0,02047281900,02047282000,00000000100,a2f,recvmsg
0,02047309800,02047310000,00000000200,a2f,recvmsg
0,02047312100,02047312300,00000000200,a2f,recvmsg
0,02047327000,02047344400,00000017400,a07,poll
0,02047349000,02047349100,00000000100,a2f,recvmsg
0,02047350900,02047351000,00000000100,a2f,recvmsg
0,02047351200,02047351400,00000000200,a2f,recvmsg
0,02047353100,02047353300,00000000200,a2f,recvmsg
0,02047353400,02047353600,00000000200,a2f,recvmsg
0,02047354100,02047355700,00000001600,a07,poll
0,02047357800,02047358000,00000000200,a2f,recvmsg
0,02047358500,02047358700,00000000200,a2f,recvmsg
0,02014944500,02048025600,00033081100,ae8,epoll_wait
0,02048037600,02048040600,00000003000,a2f,recvmsg
0,02048055600,02048055800,00000000200,a2f,recvmsg
0,02048078100,02048082800,00000004700,a2e,sendmsg
0,02048187400,02048197500,00000010100,a02,open
0,02048209600,02048213700,00000004100,a00,read
0,02048267800,02048268700,00000000900,a00,read
0,02048319500,02048320200,00000000700,a00,read
0,02048368400,02048369300,00000000900,a00,read
0,02048086500,02048372900,00000286400,ae8,epoll_wait
0,02048377400,02048379300,00000001900,a2f,recvmsg
0,02048391700,02048392000,00000000300,a2f,recvmsg
0,02048404000,02048407500,00000003500,a2e,sendmsg
0,02048465100,02048466400,00000001300,a00,read
0,02048514800,02048515600,00000000800,a00,read
0,02048562300,02048563100,00000000800,a00,read
0,02048611400,02048612300,00000000900,a00,read
0,02048663600,02048664200,00000000600,a00,read
0,02048714500,02048715200,00000000700,a00,read
0,02048764000,02048764700,00000000700,a00,read
0,02048795700,02048799200,00000003500,a02,open
0,02048804600,02048805800,00000001200,a00,read
0,02048860400,02048861200,00000000800,a00,read
0,02048945400,02048946200,00000000800,a00,read
0,02049017900,02049018800,00000000900,a00,read
0,02049095800,02049096500,00000000700,a00,read
0,02049176200,02049176900,00000000700,a00,read
0,02049253200,02049254100,00000000900,a00,read
0,02049338900,02049339700,00000000800,a00,read
0,02049405400,02049406100,00000000700,a00,read
0,02049463200,02049463900,00000000700,a00,read
0,02049541400,02049572600,00000031200,a07,poll
0,02049575700,02049575800,00000000100,a2f,recvmsg
0,02049576400,02049576600,00000000200,a2f,recvmsg
0,02049578700,02049585400,00000006700,a07,poll
0,02049586600,02049586800,00000000200,a2f,recvmsg
0,02049587100,02049587200,00000000100,a2f,recvmsg
0,02049592100,02049599100,00000007000,a06,lstat
0,02049600000,02049601100,00000001100,a06,lstat
0,02049623800,02049638300,00000014500,a01,write
0,02049643800,02049651200,00000007400,a07,poll
0,02049653300,02049653500,00000000200,a2f,recvmsg
0,02049653900,02049654100,00000000200,a2f,recvmsg
0,02049655500,02049994200,00000338700,a38,clone
0,02050521700,02050521800,00000000100,a0c,brk
0,02050532800,02050535600,00000002800,a15,access
0,02050536400,02050537200,00000000800,a09,mmap
0,02050541100,02050541900,00000000800,a15,access
0,02050552900,02050553400,00000000500,a15,access
0,02050560800,02050561800,00000001000,a00,read
0,02050564300,02050565900,00000001600,a09,mmap
0,02050570200,02050572400,00000002200,a09,mmap
0,02050583700,02050584500,00000000800,a15,access
0,02050587500,02050588200,00000000700,a00,read
0,02050588900,02050589800,00000000900,a09,mmap
0,02050591600,02050592800,00000001200,a09,mmap
0,02050600800,02050601400,00000000600,a15,access
0,02050603700,02050604300,00000000600,a00,read
0,02050605300,02050606000,00000000700,a09,mmap
0,02050607700,02050609700,00000002000,a09,mmap
0,02050614300,02050617300,00000003000,a09,mmap
0,02050619700,02050620800,00000001100,a09,mmap
0,02050628800,02050629400,00000000600,a15,access
0,02050631900,02050632500,00000000600,a00,read
0,02050633300,02050634700,00000001400,a09,mmap
0,02050636900,02050638500,00000001600,a09,mmap
0,02050645700,02050646300,00000000600,a15,access
0,02050649300,02050649800,00000000500,a00,read
0,02050650500,02050651800,00000001300,a09,mmap
0,02050655700,02050657800,00000002100,a09,mmap
0,02050666200,02050666700,00000000500,a15,access
0,02050669300,02050670000,00000000700,a00,read
0,02050670400,02050671400,00000001000,a09,mmap
0,02050672600,02050674000,00000001400,a09,mmap
0,02050685400,02050685900,00000000500,a15,access
0,02050688100,02050688700,00000000600,a00,read
0,02050689200,02050690700,00000001500,a09,mmap
0,02050693400,02050695000,00000001600,a09,mmap
0,02050709200,02050709800,00000000600,a09,mmap
0,02050713600,02050713900,00000000300,a09,mmap
0,02050715000,02050715300,00000000300,a09,mmap
0,02050893700,02050893800,00000000100,a0c,brk
0,02050893900,02050894800,00000000900,a0c,brk
0,02050929700,02050935900,00000006200,a00,read
0,02050947600,02050949100,00000001500,a00,read
0,02050987100,02050987900,00000000800,a00,read
0,02051109200,02051110100,00000000900,a00,read
0,02051181700,02051182200,00000000500,a00,read
0,02051269400,02051270100,00000000700,a00,read
0,02051400600,02051401500,00000000900,a00,read
0,02051529800,02051530500,00000000700,a00,read
0,02051686200,02051686900,00000000700,a00,read
0,02051837200,02051838000,00000000800,a00,read
0,02051874600,02051875800,00000001200,a0c,brk
0,02051998200,02051998900,00000000700,a00,read
0,02052147600,02052148300,00000000700,a00,read
0,02052304000,02052304700,00000000700,a00,read
0,02052463700,02052464300,00000000600,a00,read
0,02052572600,02052573300,00000000700,a00,read
0,02052604100,02052604700,00000000600,a0c,brk
0,02052713000,02052713800,00000000800,a00,read
0,02052958000,02052958600,00000000600,a00,read
0,02052970500,02052970900,00000000400,a00,read
0,02053014600,02053014900,00000000300,a00,read
0,02053034100,02053034800,00000000700,a00,read
0,02053242800,02053243400,00000000600,a00,read
0,01949236000,02053269000,00104033000,a4a,fsync
0,02053273200,02053274000,00000000800,a00,read
0,02053284400,02053326400,00000042000,a52,rename
0,02053337500,02053343000,00000005500,a02,open
0,02053371500,02053372100,00000000600,a00,read
0,02053396200,02053397300,00000001100,a0c,brk
0,02053442600,02053443000,00000000400,a00,read
0,02053458200,02053458600,00000000400,aca,futex
0,02053521700,02053522400,00000000700,a00,read
0,02053547300,02053554200,00000006900,a01,write
0,02053422800,02053611100,00000188300,a07,poll
0,02053622800,02053623300,00000000500,aca,futex
0,02053630900,02053636100,00000005200,aca,futex
0,02053675600,02053676000,00000000400,a00,read
0,02053789600,02053790100,00000000500,a00,read
0,02053904700,02053905300,00000000600,a00,read
0,02053917300,02053917800,00000000500,a00,read
0,02054000900,02054001400,00000000500,a00,read
0,02054025900,02054026200,00000000300,a00,read
0,02054048600,02054049100,00000000500,a00,read
0,02054151300,02054152600,00000001300,a0c,brk
0,02054153700,02054154800,00000001100,a00,read
0,02054357500,02054358000,00000000500,a00,read
0,02054441300,02054441800,00000000500,a00,read
0,02054505900,02054506400,00000000500,a00,read
0,02054634500,02054635000,00000000500,a00,read
0,02054667600,02054668200,00000000600,a00,read
0,02054682100,02054683400,00000001300,a02,open
0,02054794000,02054794500,00000000500,a00,read
0,02054864900,02054865300,00000000400,a00,read
0,02054918000,02054919100,00000001100,a0c,brk
0,02054925600,02054926200,00000000600,a00,read
0,02055035100,02055035700,00000000600,a00,read
0,02055186900,02055187900,00000001000,a00,read
0,02055317800,02055318500,00000000700,a00,read
0,02055376400,02055377100,00000000700,a00,read
0,02055432900,02055433700,00000000800,a00,read
0,02055503600,02055504200,00000000600,a00,read
0,02055557000,02055557500,00000000500,a00,read
0,02055645700,02055646400,00000000700,a0c,brk
0,02055678500,02055683000,00000004500,a0c,brk
0,02055697100,02055697900,00000000800,a00,read
0,02055812400,02055813300,00000000900,a00,read
0,02055970900,02055971600,00000000700,a00,read
0,02056088300,02056089000,00000000700,a00,read
0,02056234600,02056235300,00000000700,a00,read
0,02056352200,02056352900,00000000700,a00,read
0,02056514200,02056514800,00000000600,a00,read
0,02056519800,02056520500,00000000700,a0c,brk
0,02056636800,02056637700,00000000900,a00,read
0,02056755500,02056756100,00000000600,a00,read
0,02056897200,02056897900,00000000700,a00,read
0,02057028300,02057029000,00000000700,a00,read
0,02057121800,02057122500,00000000700,a00,read
0,02057234600,02057235300,00000000700,a00,read
0,02057359000,02057359700,00000000700,a00,read
0,02057471500,02057472100,00000000600,a0c,brk
0,02057496000,02057496700,00000000700,a00,read
0,02057665400,02057666100,00000000700,a00,read
0,02057816200,02057817000,00000000800,a00,read
0,02057934900,02057935800,00000000900,a00,read
0,02058104900,02058105700,00000000800,a00,read
0,02058182300,02058182900,00000000600,a00,read
0,02058263900,02058264500,00000000600,a00,read
0,02058346500,02058347200,00000000700,a00,read
0,02058419800,02058420500,00000000700,a00,read
0,02058521800,02058522600,00000000800,a00,read
0,02058624800,02058625500,00000000700,a00,read
0,02058714900,02058715600,00000000700,a00,read
0,02058795900,02058796500,00000000600,a00,read
0,02058897500,02058898200,00000000700,a00,read
0,02058979600,02058980000,00000000400,a0c,brk
0,02058982600,02058983200,00000000600,a00,read
0,02059089700,02059090400,00000000700,a00,read
0,02059182700,02059183400,00000000700,a00,read
0,02059301800,02059302500,00000000700,a00,read
0,02059416100,02059416800,00000000700,a00,read
0,02059520800,02059521600,00000000800,a00,read
0,02059621500,02059621900,00000000400,a0c,brk
0,02059981100,02059984600,00000003500,a57,unlink
0,02060006500,02060006900,00000000400,a48,fcntl
0,02060054100,02060069300,00000015200,a01,write
0,02060087300,02060090000,00000002700,a01,write
0,02060106200,02060108500,00000002300,a01,write
0,02034583700,02060355300,00025771600,a17,select
0,02060380300,02060380500,00000000200,a2f,recvmsg
0,02060384100,02060411500,00000027400,a17,select
0,02060415900,02060416100,00000000200,a2f,recvmsg
0,02060416800,02060435300,00000018500,a17,select
0,02060439000,02060439200,00000000200,a2f,recvmsg
0,02060439700,02060455700,00000016000,a17,select
0,02060459500,02060459700,00000000200,a2f,recvmsg
0,02060460200,02060476800,00000016600,a17,select
0,02060480900,02060481000,00000000100,a2f,recvmsg
0,02060481600,02060496200,00000014600,a17,select
0,02060499600,02060499800,00000000200,a2f,recvmsg
0,02060500300,02060527700,00000027400,a17,select
0,02060531600,02060531800,00000000200,a2f,recvmsg
0,02060532300,02060542700,00000010400,a17,select
0,02060546400,02060546500,00000000100,a2f,recvmsg
0,02060547100,02060554600,00000007500,a17,select
0,02060558100,02060558300,00000000200,a2f,recvmsg
0,02060558800,02060566500,00000007700,a17,select
0,02060569900,02060570100,00000000200,a2f,recvmsg
0,02060570600,02060578100,00000007500,a17,select
0,02060581900,02060582100,00000000200,a2f,recvmsg
0,02060582500,02060590300,00000007800,a17,select
0,02060593900,02060594000,00000000100,a2f,recvmsg
0,02060594500,02060602100,00000007600,a17,select
0,02060605900,02060606100,00000000200,a2f,recvmsg
0,02060606600,02060613700,00000007100,a17,select
0,02060617200,02060617300,00000000100,a2f,recvmsg
0,02060617900,02060626200,00000008300,a17,select
0,02060630200,02060630400,00000000200,a2f,recvmsg
0,02060630900,02060638400,00000007500,a17,select
0,02060642000,02060642200,00000000200,a2f,recvmsg
0,02060642700,02060650000,00000007300,a17,select
0,02060653700,02060653900,00000000200,a2f,recvmsg
0,02060654400,02060663400,00000009000,a17,select
0,02060667000,02060667200,00000000200,a2f,recvmsg
0,02060667800,02060674900,00000007100,a17,select
0,02060678400,02060678600,00000000200,a2f,recvmsg
0,02060679100,02060686600,00000007500,a17,select
0,02060690400,02060690600,00000000200,a2f,recvmsg
0,02060691000,02060698400,00000007400,a17,select
0,02060702000,02060702200,00000000200,a2f,recvmsg
0,02060702600,02060709700,00000007100,a17,select
0,02060713500,02060713600,00000000100,a2f,recvmsg
0,02060714100,02060723700,00000009600,a17,select
0,02060727300,02060727500,00000000200,a2f,recvmsg
0,02060728000,02060734900,00000006900,a17,select
0,02060738600,02060738800,00000000200,a2f,recvmsg
0,02060739300,02060746100,00000006800,a17,select
0,02060749700,02060749900,00000000200,a2f,recvmsg
0,02060750400,02060757400,00000007000,a17,select
0,02060761200,02060761400,00000000200,a2f,recvmsg
0,02060761900,02060769900,00000008000,a17,select
0,02060773500,02060773700,00000000200,a2f,recvmsg
0,02060774200,02060781200,00000007000,a17,select
0,02060784800,02060785000,00000000200,a2f,recvmsg
0,02060785500,02060792900,00000007400,a17,select
0,02060796600,02060796800,00000000200,a2f,recvmsg
0,02060797200,02060804800,00000007600,a17,select
0,02060808500,02060808600,00000000100,a2f,recvmsg
0,02060809100,02060818500,00000009400,a17,select
0,02060822400,02060822600,00000000200,a2f,recvmsg
0,02060823100,02060831100,00000008000,a17,select
0,02060834600,02060834800,00000000200,a2f,recvmsg
0,02060835200,02060842900,00000007700,a17,select
0,02060846600,02060846800,00000000200,a2f,recvmsg
0,02060847300,02060856800,00000009500,a17,select
0,02060860500,02060860700,00000000200,a2f,recvmsg
0,02060861200,02060868600,00000007400,a17,select
0,02060872200,02060872400,00000000200,a2f,recvmsg
0,02060872900,02060881300,00000008400,a17,select
0,02060884900,02060885100,00000000200,a2f,recvmsg
0,02060885600,02060893600,00000008000,a17,select
0,02060897300,02060897400,00000000100,a2f,recvmsg
0,02060897900,02060905500,00000007600,a17,select
0,02060909300,02060909500,00000000200,a2f,recvmsg
0,02060910000,02060918100,00000008100,a17,select
0,02060921900,02060922100,00000000200,a2f,recvmsg
0,02060922600,02060930200,00000007600,a17,select
0,02060933900,02060934000,00000000100,a2f,recvmsg
0,02060934500,02060941600,00000007100,a17,select
0,02060945300,02060945400,00000000100,a2f,recvmsg
0,02060945900,02060953000,00000007100,a17,select
0,02060956700,02060956800,00000000100,a2f,recvmsg
0,02060957300,02060965100,00000007800,a17,select
0,02060968700,02060968900,00000000200,a2f,recvmsg
0,02060969400,02060985600,00000016200,a17,select
0,02060989100,02060989300,00000000200,a2f,recvmsg
0,02060989800,02061019300,00000029500,a17,select
0,02061023000,02061023200,00000000200,a2f,recvmsg
0,02061023600,02061041500,00000017900,a17,select
0,02061045200,02061045300,00000000100,a2f,recvmsg
0,02061045800,02061053000,00000007200,a17,select
0,02061056600,02061056700,00000000100,a2f,recvmsg
0,02061057200,02061064200,00000007000,a17,select
0,02061067800,02061068000,00000000200,a2f,recvmsg
0,02061068500,02061075400,00000006900,a17,select
0,02061078900,02061079100,00000000200,a2f,recvmsg
0,02061079600,02061086600,00000007000,a17,select
0,02061090200,02061090300,00000000100,a2f,recvmsg
0,02061090900,02061097800,00000006900,a17,select
0,02061101400,02061101600,00000000200,a2f,recvmsg
0,02061102100,02061109100,00000007000,a17,select
0,02061112600,02061112700,00000000100,a2f,recvmsg
0,02061113300,02061120800,00000007500,a17,select
0,02061124600,02061124800,00000000200,a2f,recvmsg
0,02061125300,02061132400,00000007100,a17,select
0,02061136000,02061136200,00000000200,a2f,recvmsg
0,02061136800,02061145600,00000008800,a17,select
0,02061149300,02061149500,00000000200,a2f,recvmsg
0,02061150000,02061159200,00000009200,a17,select
0,02061163000,02061163200,00000000200,a2f,recvmsg
0,02061163700,02061171400,00000007700,a17,select
0,02061175000,02061175100,00000000100,a2f,recvmsg
0,02061175600,02061182900,00000007300,a17,select
0,02061186600,02061186700,00000000100,a2f,recvmsg
0,02061187200,02061194400,00000007200,a17,select
0,02061198000,02061198100,00000000100,a2f,recvmsg
0,02061198600,02061206000,00000007400,a17,select
0,02061209600,02061209800,00000000200,a2f,recvmsg
0,02061210300,02061218100,00000007800,a17,select
0,02061221700,02061221900,00000000200,a2f,recvmsg
0,02061222400,02061229700,00000007300,a17,select
0,02061233300,02061233500,00000000200,a2f,recvmsg
0,02061234000,02061241100,00000007100,a17,select
0,02061244700,02061244900,00000000200,a2f,recvmsg
0,02061245400,02061252700,00000007300,a17,select
0,02061256300,02061256500,00000000200,a2f,recvmsg
0,02061257000,02061264100,00000007100,a17,select
0,02061267700,02061267800,00000000100,a2f,recvmsg
0,02061268400,02061275600,00000007200,a17,select
0,02061279100,02061279300,00000000200,a2f,recvmsg
0,02061279800,02061287500,00000007700,a17,select
0,02061291200,02061291400,00000000200,a2f,recvmsg
0,02061291900,02061299200,00000007300,a17,select
0,02061302800,02061303000,00000000200,a2f,recvmsg
0,02061303500,02061310600,00000007100,a17,select
0,02061314100,02061314300,00000000200,a2f,recvmsg
0,02061314800,02061322100,00000007300,a17,select
0,02061325800,02061326000,00000000200,a2f,recvmsg
0,02061326500,02061339100,00000012600,a17,select
0,02061342800,02061343000,00000000200,a2f,recvmsg
0,02061343500,02061350900,00000007400,a17,select
0,02061354500,02061354600,00000000100,a2f,recvmsg
0,02061355200,02061362400,00000007200,a17,select
0,02061366000,02061366200,00000000200,a2f,recvmsg
0,02061366700,02061374200,00000007500,a17,select
0,02061377700,02061377800,00000000100,a2f,recvmsg
0,02061378400,02061385500,00000007100,a17,select
0,02061389200,02061389300,00000000100,a2f,recvmsg
0,02061389900,02061447800,00000057900,a17,select
0,02061448700,02061450000,00000001300,a2f,recvmsg
0,02061872900,02061873800,00000000900,a2f,recvmsg
0,02062166500,02062168400,00000001900,a2f,recvmsg
0,02062281300,02062281500,00000000200,a2f,recvmsg
0,02062282200,02062282600,00000000400,a14,writev
0,02062282800,02062283100,00000000300,a14,writev
0,02062301800,02062304200,00000002400,a14,writev
0,02062304500,02062305900,00000001400,a14,writev
0,02062306500,02062306700,00000000200,a2f,recvmsg
0,02053652300,02062315300,00008663000,a07,poll
0,02062321000,02062323900,00000002900,a2f,recvmsg
0,02062329200,02062329400,00000000200,a2f,recvmsg
0,02062333000,02062333100,00000000100,a2f,recvmsg
0,02062333400,02062333600,00000000200,a2f,recvmsg
0,02062338100,02062338200,00000000100,a2f,recvmsg
0,02062338400,02062338500,00000000100,a2f,recvmsg
0,02062339300,02062343100,00000003800,a07,poll
0,02062347400,02062354200,00000006800,a2f,recvmsg
0,02062365100,02062365300,00000000200,a2f,recvmsg
0,02062392800,02062397700,00000004900,a07,poll
0,02062403500,02062410000,00000006500,a2f,recvmsg
0,02062422200,02062422400,00000000200,a2f,recvmsg
0,02062446100,02062450300,00000004200,a07,poll
0,02062455800,02062461900,00000006100,a2f,recvmsg
0,02062474300,02062474500,00000000200,a2f,recvmsg
0,02062307500,02062501600,00000194100,a17,select
0,02062518400,02062519900,00000001500,a14,writev
0,02062520500,02062520600,00000000100,a2f,recvmsg
0,02062534800,02062535700,00000000900,a14,writev
0,02062536000,02062536200,00000000200,a2f,recvmsg
0,02062548400,02062549200,00000000800,a14,writev
0,02062549500,02062549700,00000000200,a2f,recvmsg
0,02062564900,02062565100,00000000200,a2f,recvmsg
0,02062496100,02062569900,00000073800,a07,poll
0,02062573700,02062573800,00000000100,a2f,recvmsg
0,02062575400,02062575600,00000000200,a2f,recvmsg
0,02062575800,02062575900,00000000100,a2f,recvmsg
0,02062577400,02062577500,00000000100,a2f,recvmsg
0,02062577600,02062577800,00000000200,a2f,recvmsg
0,02062578200,02062579800,00000001600,a07,poll
0,02062580300,02062581300,00000001000,a2f,recvmsg
0,02062586200,02062587000,00000000800,a2d,recvfrom
0,02062588000,02062588200,00000000200,a2f,recvmsg
0,02062588800,02062588900,00000000100,a2f,recvmsg
0,02062630300,02062630600,00000000300,a2f,recvmsg
0,02062632700,02062632800,00000000100,a2f,recvmsg
0,02062635200,02062637600,00000002400,a07,poll
0,02062638200,02062639300,00000001100,a2f,recvmsg
0,02062645300,02062645900,00000000600,a2d,recvfrom
0,02062646900,02062647100,00000000200,a2f,recvmsg
0,02062647800,02062647900,00000000100,a2f,recvmsg
0,02062678000,02062678200,00000000200,a2f,recvmsg
0,02062680100,02062680200,00000000100,a2f,recvmsg
0,02062565700,02064404700,00001839000,a17,select
0,02064416600,02064416700,00000000100,a2f,recvmsg
0,02064418300,02064428000,00000009700,a17,select
0,02064432100,02064432300,00000000200,a2f,recvmsg
0,02064432900,02064491600,00000058700,a17,select
0,02064495300,02064495500,00000000200,a2f,recvmsg
0,02053557300,02065045600,00011488300,a4a,fsync
0,02065055700,02065080200,00000024500,a52,rename
0,02065117800,02065124500,00000006700,a09,mmap
0,02062683900,02065207600,00002523700,a07,poll
0,02065212500,02065214200,00000001700,aca,futex
0,02065219100,02065220100,00000001000,aca,futex
0,02065222300,02065223300,00000001000,aca,futex
0,02065243600,02065243800,00000000200,a00,read
0,02048410200,02065252700,00016842500,ae8,epoll_wait
0,02065283100,02065283300,00000000200,a2f,recvmsg
0,02065303700,02065307900,00000004200,a2e,sendmsg
0,02065249100,02065370000,00000120900,a07,poll
0,02065371700,02065372600,00000000900,aca,futex
0,02065374300,02065375200,00000000900,aca,futex
0,02065376700,02065377500,00000000800,aca,futex
0,02065380000,02065382000,00000002000,a2e,sendmsg
0,02065311600,02065390000,00000078400,ae8,epoll_wait
0,02065392700,02065394100,00000001400,a2f,recvmsg
0,02065402400,02065402600,00000000200,a2f,recvmsg
0,02065424400,02065425500,00000001100,a2e,sendmsg
0,02065588400,02065598600,00000010200,a01,write
0,02065427700,02065638900,00000211200,ae8,epoll_wait
0,02065643900,02065646000,00000002100,a2f,recvmsg
0,02065654300,02065654500,00000000200,a2f,recvmsg
0,02065667500,02065670900,00000003400,a2e,sendmsg
0,02065445100,02065673000,00000227900,a07,poll
0,02065674000,02065674400,00000000400,a00,read
0,02065683900,02065684700,00000000800,a2f,recvmsg
0,02064496000,02072854900,00008358900,a17,select
0,02065748200,02075178300,00009430100,a07,poll
0,02050015600,02075606400,00025590800,a3d,wait4
0,02075630400,02075632000,00000001600,a00,read
0,02075634100,02075634300,00000000200,a00,read
0,02075653500,02075702200,00000048700,a07,poll
0,02075707100,02075707300,00000000200,a2f,recvmsg
0,02075708200,02075708400,00000000200,a2f,recvmsg
0,02075714800,02075726600,00000011800,a07,poll
0,02075728800,02075729000,00000000200,a2f,recvmsg
0,02075729300,02075729500,00000000200,a2f,recvmsg
0,02075734100,02075746000,00000011900,a07,poll
0,02075747900,02075748100,00000000200,a2f,recvmsg
0,02075748400,02075748600,00000000200,a2f,recvmsg
0,02075752600,02075764200,00000011600,a07,poll
0,02075766200,02075766400,00000000200,a2f,recvmsg
0,02075766800,02075767000,00000000200,a2f,recvmsg
0,02075771000,02075782600,00000011600,a07,poll
0,02075784600,02075784800,00000000200,a2f,recvmsg
0,02075785200,02075785400,00000000200,a2f,recvmsg
0,02075789700,02075801400,00000011700,a07,poll
0,02075803400,02075803400,00000000000,a2f,recvmsg
0,02075803800,02075804000,00000000200,a2f,recvmsg
0,02075804800,02075805100,00000000300,a08,lseek
0,02075814400,02075814500,00000000100,a08,lseek
0,02075817800,02075824900,00000007100,a07,poll
0,02075826200,02075826300,00000000100,a2f,recvmsg
0,02075826700,02075826900,00000000200,a2f,recvmsg
0,02075831300,02075838000,00000006700,a07,poll
0,02075839300,02075839500,00000000200,a2f,recvmsg
0,02075839700,02075839900,00000000200,a2f,recvmsg
0,02075843100,02075849800,00000006700,a07,poll
0,02075850900,02075851100,00000000200,a2f,recvmsg
0,02075851400,02075851600,00000000200,a2f,recvmsg
0,02075855300,02075861800,00000006500,a07,poll
0,02075862900,02075863100,00000000200,a2f,recvmsg
0,02075863400,02075863600,00000000200,a2f,recvmsg
0,02075866800,02075873600,00000006800,a07,poll
0,02075874700,02075874900,00000000200,a2f,recvmsg
0,02075875200,02075875400,00000000200,a2f,recvmsg
0,02075879900,02075886400,00000006500,a07,poll
0,02075887500,02075887700,00000000200,a2f,recvmsg
0,02075888000,02075888100,00000000100,a2f,recvmsg
0,02075891400,02075898400,00000007000,a07,poll
0,02075899500,02075899600,00000000100,a2f,recvmsg
0,02075900000,02075900200,00000000200,a2f,recvmsg
0,02075903000,02075909700,00000006700,a07,poll
0,02075910800,02075911000,00000000200,a2f,recvmsg
0,02075911300,02075911500,00000000200,a2f,recvmsg
0,02075915800,02075922900,00000007100,a07,poll
0,02075924000,02075924200,00000000200,a2f,recvmsg
0,02075924500,02075924700,00000000200,a2f,recvmsg
0,02075927900,02075934500,00000006600,a07,poll
0,02075935700,02075935900,00000000200,a2f,recvmsg
0,02075936200,02075936400,00000000200,a2f,recvmsg
0,02075939700,02075946400,00000006700,a07,poll
0,02075947600,02075947800,00000000200,a2f,recvmsg
0,02075948000,02075948200,00000000200,a2f,recvmsg
0,02075951400,02075958000,00000006600,a07,poll
0,02075959200,02075959200,00000000000,a2f,recvmsg
0,02075959500,02075959700,00000000200,a2f,recvmsg
0,02075962900,02075969500,00000006600,a07,poll
0,02075970600,02075970700,00000000100,a2f,recvmsg
0,02075971000,02075971200,00000000200,a2f,recvmsg
0,02075974400,02075981200,00000006800,a07,poll
0,02075982200,02075982400,00000000200,a2f,recvmsg
0,02075982700,02075982900,00000000200,a2f,recvmsg
0,02075986000,02075992800,00000006800,a07,poll
0,02075993900,02075994100,00000000200,a2f,recvmsg
0,02075994400,02075994600,00000000200,a2f,recvmsg
0,02075997200,02076004000,00000006800,a07,poll
0,02076005100,02076005300,00000000200,a2f,recvmsg
0,02076005600,02076005800,00000000200,a2f,recvmsg
0,02076011400,02076018300,00000006900,a07,poll
0,02076019500,02076019700,00000000200,a2f,recvmsg
0,02076020000,02076020100,00000000100,a2f,recvmsg
0,02076022800,02076029500,00000006700,a07,poll
0,02076030600,02076030800,00000000200,a2f,recvmsg
0,02076031100,02076031300,00000000200,a2f,recvmsg
0,02076034100,02076040900,00000006800,a07,poll
0,02076042000,02076042200,00000000200,a2f,recvmsg
0,02076042500,02076042700,00000000200,a2f,recvmsg
0,02076046300,02076053000,00000006700,a07,poll
0,02076054100,02076054200,00000000100,a2f,recvmsg
0,02076054500,02076054700,00000000200,a2f,recvmsg
0,02076057900,02076064500,00000006600,a07,poll
0,02076065600,02076065700,00000000100,a2f,recvmsg
0,02076066000,02076066200,00000000200,a2f,recvmsg
0,02076069100,02076075800,00000006700,a07,poll
0,02076076900,02076077000,00000000100,a2f,recvmsg
0,02076077300,02076077500,00000000200,a2f,recvmsg
0,02076080800,02076087700,00000006900,a07,poll
0,02076088800,02076089000,00000000200,a2f,recvmsg
0,02076089300,02076089500,00000000200,a2f,recvmsg
0,02076092800,02076099700,00000006900,a07,poll
0,02076100700,02076100900,00000000200,a2f,recvmsg
0,02076101200,02076101400,00000000200,a2f,recvmsg
0,02076105200,02076112200,00000007000,a07,poll
0,02076113300,02076113500,00000000200,a2f,recvmsg
0,02076113800,02076113900,00000000100,a2f,recvmsg
0,02076117500,02076124200,00000006700,a07,poll
0,02076125200,02076125400,00000000200,a2f,recvmsg
0,02076125700,02076125900,00000000200,a2f,recvmsg
0,02076129400,02076136400,00000007000,a07,poll
0,02076137600,02076137700,00000000100,a2f,recvmsg
0,02076137900,02076138100,00000000200,a2f,recvmsg
0,02076143400,02076150200,00000006800,a07,poll
0,02076151200,02076151400,00000000200,a2f,recvmsg
0,02076151700,02076151900,00000000200,a2f,recvmsg
0,02076155000,02076161800,00000006800,a07,poll
0,02076162800,02076163000,00000000200,a2f,recvmsg
0,02076163300,02076163500,00000000200,a2f,recvmsg
0,02076166700,02076173600,00000006900,a07,poll
0,02076174700,02076174900,00000000200,a2f,recvmsg
0,02076175200,02076175400,00000000200,a2f,recvmsg
0,02076179200,02076186200,00000007000,a07,poll
0,02076187300,02076187400,00000000100,a2f,recvmsg
0,02076187800,02076188000,00000000200,a2f,recvmsg
0,02076191300,02076198200,00000006900,a07,poll
0,02076199200,02076199400,00000000200,a2f,recvmsg
0,02076199700,02076199900,00000000200,a2f,recvmsg
0,02076203800,02076210600,00000006800,a07,poll
0,02076211800,02076211900,00000000100,a2f,recvmsg
0,02076212200,02076212400,00000000200,a2f,recvmsg
0,02076215700,02076222500,00000006800,a07,poll
0,02076223500,02076223700,00000000200,a2f,recvmsg
0,02076224000,02076224200,00000000200,a2f,recvmsg
0,02076227200,02076234100,00000006900,a07,poll
0,02076235200,02076235400,00000000200,a2f,recvmsg
0,02076235700,02076235900,00000000200,a2f,recvmsg
0,02076238800,02076245500,00000006700,a07,poll
0,02076246500,02076246700,00000000200,a2f,recvmsg
0,02076247000,02076247200,00000000200,a2f,recvmsg
0,02076250600,02076257500,00000006900,a07,poll
0,02076258600,02076258800,00000000200,a2f,recvmsg
0,02076259100,02076259300,00000000200,a2f,recvmsg
0,02076260200,02076260400,00000000200,a08,lseek
0,02076263000,02076263800,00000000800,a00,read
0,02076267400,02076267500,00000000100,a08,lseek
0,02076270500,02076277100,00000006600,a07,poll
0,02076278400,02076278600,00000000200,a2f,recvmsg
0,02076278900,02076279100,00000000200,a2f,recvmsg
0,02076305200,02076312300,00000007100,a07,poll
0,02076313700,02076313800,00000000100,a2f,recvmsg
0,02076314200,02076314400,00000000200,a2f,recvmsg
0,02076318200,02076318900,00000000700,a00,read
0,02076324300,02076324400,00000000100,a08,lseek
0,02076327800,02076334500,00000006700,a07,poll
0,02076335700,02076335800,00000000100,a2f,recvmsg
0,02076336200,02076336400,00000000200,a2f,recvmsg
0,02076339200,02076345900,00000006700,a07,poll
0,02076346900,02076347100,00000000200,a2f,recvmsg
0,02076347400,02076347600,00000000200,a2f,recvmsg
0,02076350400,02076356900,00000006500,a07,poll
0,02076358100,02076358200,00000000100,a2f,recvmsg
0,02076358500,02076358700,00000000200,a2f,recvmsg
0,02076361600,02076368200,00000006600,a07,poll
0,02076369400,02076369600,00000000200,a2f,recvmsg
0,02076369800,02076370000,00000000200,a2f,recvmsg
0,02076372800,02076379500,00000006700,a07,poll
0,02076380600,02076380800,00000000200,a2f,recvmsg
0,02076381000,02076381200,00000000200,a2f,recvmsg
0,02076384000,02076390600,00000006600,a07,poll
0,02076391700,02076391900,00000000200,a2f,recvmsg
0,02076392200,02076392400,00000000200,a2f,recvmsg
0,02076395000,02076401600,00000006600,a07,poll
0,02076402700,02076402800,00000000100,a2f,recvmsg
0,02076403100,02076403300,00000000200,a2f,recvmsg
0,02076406700,02076413500,00000006800,a07,poll
0,02076414600,02076414800,00000000200,a2f,recvmsg
0,02076415100,02076415200,00000000100,a2f,recvmsg
0,02076418000,02076424700,00000006700,a07,poll
0,02076425800,02076425900,00000000100,a2f,recvmsg
0,02076426300,02076426500,00000000200,a2f,recvmsg
0,02076426800,02076426900,00000000100,a08,lseek
0,02076430900,02076437600,00000006700,a07,poll
0,02076438700,02076438800,00000000100,a2f,recvmsg
0,02076439200,02076439400,00000000200,a2f,recvmsg
0,02076444400,02076451200,00000006800,a07,poll
0,02076452300,02076452500,00000000200,a2f,recvmsg
0,02076452800,02076453000,00000000200,a2f,recvmsg
0,02076456400,02076463200,00000006800,a07,poll
0,02076464400,02076464500,00000000100,a2f,recvmsg
0,02076464800,02076465000,00000000200,a2f,recvmsg
0,02076468000,02076474600,00000006600,a07,poll
0,02076475700,02076475900,00000000200,a2f,recvmsg
0,02076476100,02076476300,00000000200,a2f,recvmsg
0,02076479400,02076486000,00000006600,a07,poll
0,02076487200,02076487300,00000000100,a2f,recvmsg
0,02076487600,02076487700,00000000100,a2f,recvmsg
0,02076490700,02076497300,00000006600,a07,poll
0,02076498400,02076498600,00000000200,a2f,recvmsg
0,02076498800,02076499000,00000000200,a2f,recvmsg
0,02076502700,02076509300,00000006600,a07,poll
0,02076510400,02076510600,00000000200,a2f,recvmsg
0,02076510900,02076511100,00000000200,a2f,recvmsg
0,02076514100,02076520700,00000006600,a07,poll
0,02076521900,02076522000,00000000100,a2f,recvmsg
0,02076522400,02076522500,00000000100,a2f,recvmsg
0,02076525600,02076532300,00000006700,a07,poll
0,02076533300,02076533500,00000000200,a2f,recvmsg
0,02076533800,02076534000,00000000200,a2f,recvmsg
0,02076537000,02076543800,00000006800,a07,poll
0,02076544900,02076545100,00000000200,a2f,recvmsg
0,02076545400,02076545600,00000000200,a2f,recvmsg
0,02076548600,02076555500,00000006900,a07,poll
0,02076556600,02076556800,00000000200,a2f,recvmsg
0,02076557100,02076557300,00000000200,a2f,recvmsg
0,02076560400,02076567000,00000006600,a07,poll
0,02076568100,02076568200,00000000100,a2f,recvmsg
0,02076568500,02076568700,00000000200,a2f,recvmsg
0,02076572400,02076579100,00000006700,a07,poll
0,02076580400,02076580500,00000000100,a2f,recvmsg
0,02076580800,02076581000,00000000200,a2f,recvmsg
0,02076584000,02076590700,00000006700,a07,poll
0,02076591800,02076591900,00000000100,a2f,recvmsg
0,02076592200,02076592400,00000000200,a2f,recvmsg
0,02076595400,02076602200,00000006800,a07,poll
0,02076603300,02076603500,00000000200,a2f,recvmsg
0,02076603800,02076604000,00000000200,a2f,recvmsg
0,02076607000,02076613600,00000006600,a07,poll
0,02076614700,02076614800,00000000100,a2f,recvmsg
0,02076615200,02076615400,00000000200,a2f,recvmsg
0,02076623800,02076630600,00000006800,a07,poll
0,02076631800,02076631800,00000000000,a2f,recvmsg
0,02076632100,02076632300,00000000200,a2f,recvmsg
0,02076635600,02076642200,00000006600,a07,poll
0,02076643300,02076643400,00000000100,a2f,recvmsg
0,02076643700,02076643900,00000000200,a2f,recvmsg
0,02076647000,02076653800,00000006800,a07,poll
0,02076654900,02076655100,00000000200,a2f,recvmsg
0,02076655400,02076655600,00000000200,a2f,recvmsg
0,02076658800,02076665500,00000006700,a07,poll
0,02076666500,02076666600,00000000100,a2f,recvmsg
0,02076666900,02076667100,00000000200,a2f,recvmsg
0,02076670400,02076677200,00000006800,a07,poll
0,02076678300,02076678400,00000000100,a2f,recvmsg
0,02076678800,02076678900,00000000100,a2f,recvmsg
0,02076699600,02076724700,00000025100,a57,unlink
0,02076725800,02076730000,00000004200,a14,writev
0,02076730600,02076829100,00000098500,a07,poll
0,02076844700,02076844900,00000000200,a2f,recvmsg
0,02076880800,02076906300,00000025500,a07,poll
0,02076907900,02076963400,00000055500,a07,poll
0,02076964500,02077018200,00000053700,a07,poll
0,02077020600,02077072900,00000052300,a07,poll
0,02077074100,02077129600,00000055500,a07,poll
0,02077131500,02077185000,00000053500,a07,poll
1,01995213700,01995215600,00000001900,a2f,recvmsg
1,01995327900,01995328100,00000000200,a2f,recvmsg
1,01995328700,01995329100,00000000400,a14,writev
1,01995329400,01995329800,00000000400,a14,writev
1,01995347700,01995350300,00000002600,a14,writev
1,01995350600,01995352200,00000001600,a14,writev
1,01995352600,01995352800,00000000200,a2f,recvmsg
1,01995366600,01995366800,00000000200,a2f,recvmsg
1,01988354200,01995374600,00007020400,a07,poll
1,01995380400,01995383300,00000002900,a2f,recvmsg
1,01995388700,01995388800,00000000100,a2f,recvmsg
1,01995392400,01995392500,00000000100,a2f,recvmsg
1,01995392800,01995392900,00000000100,a2f,recvmsg
1,01995397800,01995398000,00000000200,a2f,recvmsg
1,01995398200,01995398300,00000000100,a2f,recvmsg
1,01995399200,01995403100,00000003900,a07,poll
1,01995407200,01995413400,00000006200,a2f,recvmsg
1,01995425100,01995425300,00000000200,a2f,recvmsg
1,01995453200,01995457500,00000004300,a07,poll
1,01995463700,01995469900,00000006200,a2f,recvmsg
1,01995484200,01995484400,00000000200,a2f,recvmsg
1,01995508600,01995513500,00000004900,a07,poll
1,01995519700,01995526100,00000006400,a2f,recvmsg
1,01995539600,01995539800,00000000200,a2f,recvmsg
1,01995367400,01995570000,00000202600,a17,select
1,01995586400,01995588000,00000001600,a14,writev
1,01995588400,01995588600,00000000200,a2f,recvmsg
1,01995602900,01995603800,00000000900,a14,writev
1,01995604100,01995604300,00000000200,a2f,recvmsg
1,01995616800,01995617900,00000001100,a14,writev
1,01995618200,01995618400,00000000200,a2f,recvmsg
1,01995564200,01995622900,00000058700,a07,poll
1,01995623500,01995624400,00000000900,a2f,recvmsg
1,01995630500,01995631400,00000000900,a2d,recvfrom
1,01995632400,01995632600,00000000200,a2f,recvmsg
1,01995633200,01995633400,00000000200,a2f,recvmsg
1,01995693400,01995693700,00000000300,a2f,recvmsg
1,01995696000,01995696200,00000000200,a2f,recvmsg
1,01995698600,01995701100,00000002500,a07,poll
1,01995701800,01995702900,00000001100,a2f,recvmsg
1,01995710300,01995711100,00000000800,a2d,recvfrom
1,01995712300,01995712500,00000000200,a2f,recvmsg
1,01995713300,01995713500,00000000200,a2f,recvmsg
1,01995745100,01995745400,00000000300,a2f,recvmsg
1,01995747500,01995747700,00000000200,a2f,recvmsg
1,01995752000,01995757100,00000005100,a07,poll
1,01995757700,01995759100,00000001400,a2f,recvmsg
1,01995764900,01995765800,00000000900,a2d,recvfrom
1,01995766700,01995766800,00000000100,a2f,recvmsg
1,01995767500,01995767700,00000000200,a2f,recvmsg
1,01995798200,01995798500,00000000300,a2f,recvmsg
1,01995800800,01995800900,00000000100,a2f,recvmsg
1,01995804000,01996075700,00000271700,a07,poll
1,01996080400,01996108600,00000028200,aca,futex
1,01996116500,01996122500,00000006000,a2e,sendmsg
1,01986303500,01996125900,00009822400,ae8,epoll_wait
1,01996139500,01996140900,00000001400,a2f,recvmsg
1,01996156000,01996156200,00000000200,a2f,recvmsg
1,01996217200,01996222200,00000005000,a2e,sendmsg
1,01996247900,01996312900,00000065000,a07,poll
1,01996466100,01996468700,00000002600,a01,write
1,01995618800,01996485600,00000866800,a17,select
1,01996495500,01996500500,00000005000,a14,writev
1,01996228100,01996506800,00000278700,ae8,epoll_wait
1,01996511500,01996513200,00000001700,a2f,recvmsg
1,01996533100,01996533300,00000000200,a2f,recvmsg
1,01996565500,01996568700,00000003200,a2e,sendmsg
1,01996474200,01996574800,00000100600,a07,poll
1,01996575500,01996576000,00000000500,a00,read
1,01996588200,01996589100,00000000900,a2f,recvmsg
1,01996501800,01996625600,00000123800,a17,select
1,01996648300,01996649700,00000001400,a14,writev
1,01996650300,01996650500,00000000200,a2f,recvmsg
1,01996652300,01996701400,00000049100,a17,select
1,01996713500,01996714500,00000001000,a14,writev
1,01996714900,01996715100,00000000200,a2f,recvmsg
1,01996716100,01996745900,00000029800,a17,select
1,01996755900,01996756800,00000000900,a14,writev
1,01996757100,01996757300,00000000200,a2f,recvmsg
1,01996758000,01996786900,00000028900,a17,select
1,01996796500,01996797400,00000000900,a14,writev
1,01996797800,01996798000,00000000200,a2f,recvmsg
1,01996811000,01996811300,00000000300,aca,futex
1,01996798500,01996834000,00000035500,a17,select
1,01996845400,01996846200,00000000800,a14,writev
1,01996846700,01996846900,00000000200,a2f,recvmsg
1,01996847900,01996874800,00000026900,a17,select
1,01996883000,01996883800,00000000800,a14,writev
1,01996884000,01996884200,00000000200,a2f,recvmsg
1,01996884700,01996912300,00000027600,a17,select
1,01996920400,01996921200,00000000800,a14,writev
1,01996921500,01996921700,00000000200,a2f,recvmsg
1,01996922100,01996949000,00000026900,a17,select
1,01996957000,01996957800,00000000800,a14,writev
1,01996958100,01996958200,00000000100,a2f,recvmsg
1,01996958700,01996985400,00000026700,a17,select
1,01996993400,01996994400,00000001000,a14,writev
1,01996994700,01996994900,00000000200,a2f,recvmsg
1,01996995400,01997022700,00000027300,a17,select
1,01997030700,01997031500,00000000800,a14,writev
1,01997031800,01997032000,00000000200,a2f,recvmsg
1,01997032500,01997059900,00000027400,a17,select
1,01997067900,01997068700,00000000800,a14,writev
1,01997069000,01997069100,00000000100,a2f,recvmsg
1,01997069700,01997096800,00000027100,a17,select
1,01997104800,01997105600,00000000800,a14,writev
1,01997105900,01997106100,00000000200,a2f,recvmsg
1,01997106500,01997133900,00000027400,a17,select
1,01997141900,01997142600,00000000700,a14,writev
1,01997142900,01997143100,00000000200,a2f,recvmsg
1,01997143600,01997170500,00000026900,a17,select
1,01997178500,01997179200,00000000700,a14,writev
1,01997179500,01997179600,00000000100,a2f,recvmsg
1,01997180200,01997207100,00000026900,a17,select
1,01997215100,01997215900,00000000800,a14,writev
1,01997216200,01997216400,00000000200,a2f,recvmsg
1,01997216800,01997243600,00000026800,a17,select
1,01997251600,01997252600,00000001000,a14,writev
1,01997252800,01997253000,00000000200,a2f,recvmsg
1,01997253500,01997280700,00000027200,a17,select
1,01997288700,01997289500,00000000800,a14,writev
1,01997289800,01997290000,00000000200,a2f,recvmsg
1,01997290500,01997317500,00000027000,a17,select
1,01997325400,01997326300,00000000900,a14,writev
1,01997326600,01997326700,00000000100,a2f,recvmsg
1,01997327200,01997354100,00000026900,a17,select
1,01997362200,01997362900,00000000700,a14,writev
1,01997363200,01997363400,00000000200,a2f,recvmsg
1,01997363900,01997390900,00000027000,a17,select
1,01997398900,01997399800,00000000900,a14,writev
1,01997400000,01997400200,00000000200,a2f,recvmsg
1,01997400700,01997428300,00000027600,a17,select
1,01997436400,01997437100,00000000700,a14,writev
1,01997437400,01997437500,00000000100,a2f,recvmsg
1,01997438100,01997465300,00000027200,a17,select
1,01997473100,01997473900,00000000800,a14,writev
1,01997474200,01997474400,00000000200,a2f,recvmsg
1,01997474900,01997501700,00000026800,a17,select
1,01997509700,01997510800,00000001100,a14,writev
1,01997511000,01997511100,00000000100,a2f,recvmsg
1,01997511700,01997538400,00000026700,a17,select
1,01997546300,01997547100,00000000800,a14,writev
1,01997547200,01997547400,00000000200,a2f,recvmsg
1,01997548000,01997575000,00000027000,a17,select
1,01997583000,01997583700,00000000700,a14,writev
1,01997584000,01997584200,00000000200,a2f,recvmsg
1,01997584700,01997611700,00000027000,a17,select
1,01997619700,01997620500,00000000800,a14,writev
1,01997620800,01997621000,00000000200,a2f,recvmsg
1,01997621400,01997648800,00000027400,a17,select
1,01997656800,01997657600,00000000800,a14,writev
1,01997657900,01997658000,00000000100,a2f,recvmsg
1,01996826300,01998453900,00001627600,a07,poll
1,01998460800,01998463700,00000002900,a2e,sendmsg
1,01998466600,01998466700,00000000100,a00,read
1,01998475600,01998516800,00000041200,a07,poll
1,01998518400,01998519000,00000000600,a00,read
1,01998534100,01998535300,00000001200,a2f,recvmsg
1,01997658600,02004390300,00006731700,a17,select
1,01996822800,02006056200,00009233400,aca,futex
1,01996822800,02006297200,00009474400,aca,futex
1,01998614900,02013206100,00014591200,a07,poll
1,02013207100,02013208100,00000001000,a00,read
1,02013294300,02013299400,00000005100,a09,mmap
1,02013305600,02013306700,00000001100,a09,mmap
1,02013687300,02019809900,00006122600,a07,poll
1,02019813700,02019845600,00000031900,aca,futex
1,02019866200,02019867000,00000000800,a2e,sendmsg
1,02019874100,02019874300,00000000200,a00,read
1,02019878200,02019926400,00000048200,a07,poll
1,02019927300,02019928200,00000000900,a00,read
1,02019977500,02019984300,00000006800,a01,write
1,02019993100,02019993900,00000000800,a2f,recvmsg
1,02019996000,02019996200,00000000200,a00,read
1,01946507900,02032116400,00085608500,a4a,fsync
1,02032164900,02032168300,00000003400,a09,mmap
1,02032263300,02032265800,00000002500,a01,write
1,02032412600,02032422600,00000010000,a01,write
1,02032279200,02032450100,00000170900,a07,poll
1,02032500900,02032501000,00000000100,a00,read
1,01996572200,02032555800,00035983600,ae8,epoll_wait
1,02032561100,02032564100,00000003000,a2f,recvmsg
1,02032585200,02032585400,00000000200,a2f,recvmsg
1,02032600100,02032603100,00000003000,a2e,sendmsg
1,02004418300,02045718700,00041300400,a17,select
1,02045721100,02045791700,00000070600,a00,read
1,02045732500,02049474100,00003741600,a17,select
1,01997656800,02064324000,00066667200,a14,writev
1,02064365300,02064366800,00000001500,a14,writev
1,02064391800,02064393600,00000001800,a2f,recvmsg
1,02064420900,02064422500,00000001600,a14,writev
1,02064441000,02064442300,00000001300,a14,writev
1,02064458800,02064460200,00000001400,a14,writev
1,02064475300,02064477200,00000001900,a14,writev
1,02064491700,02064493300,00000001600,a14,writev
1,02064508000,02064509600,00000001600,a14,writev
1,02064515100,02064515300,00000000200,a2f,recvmsg
1,02064516000,02064516400,00000000400,a14,writev
1,02064516700,02064517200,00000000500,a14,writev
1,02064534700,02064536500,00000001800,a14,writev
1,02064536700,02064538100,00000001400,a14,writev
1,02064538600,02064538800,00000000200,a2f,recvmsg
1,02064551500,02064552600,00000001100,a14,writev
1,02064552900,02064553000,00000000100,a2f,recvmsg
1,02064564000,02064565300,00000001300,a14,writev
1,02064565500,02064566300,00000000800,a14,writev
1,02064566600,02064566800,00000000200,a2f,recvmsg
1,02032539000,02064574600,00032035600,a07,poll
1,02064580700,02064583200,00000002500,a2f,recvmsg
1,02064588000,02064588200,00000000200,a2f,recvmsg
1,02064591900,02064592100,00000000200,a2f,recvmsg
1,02064592400,02064592400,00000000000,a2f,recvmsg
1,02064596800,02064596900,00000000100,a2f,recvmsg
1,02064597100,02064597300,00000000200,a2f,recvmsg
1,02064598000,02064602900,00000004900,a07,poll
1,02064608400,02064614300,00000005900,a2f,recvmsg
1,02064627300,02064627500,00000000200,a2f,recvmsg
1,02064567300,02064656600,00000089300,a17,select
1,02064670300,02064671600,00000001300,a14,writev
1,02064672000,02064672200,00000000200,a2f,recvmsg
1,02064652200,02064679000,00000026800,a07,poll
1,02064679400,02064680400,00000001000,a2f,recvmsg
1,02064685200,02064688200,00000003000,a2d,recvfrom
1,02064689100,02064689200,00000000100,a2f,recvmsg
1,02064689700,02064689900,00000000200,a2f,recvmsg
1,02064717800,02064718000,00000000200,a2f,recvmsg
1,02064719600,02064719700,00000000100,a2f,recvmsg
1,02064673100,02064733300,00000060200,a17,select
1,02064747700,02064747800,00000000100,a2f,recvmsg
1,02064723300,02065396500,00000673200,a07,poll
1,02065417900,02065422500,00000004600,a2e,sendmsg
1,02065432800,02065433100,00000000300,a00,read
1,02065443700,02065489600,00000045900,a07,poll
1,02065491100,02065491600,00000000500,a00,read
1,02065506600,02065507800,00000001200,a2f,recvmsg
1,02065589900,02065594800,00000004900,a07,poll
1,02065747800,02065748800,00000001000,a2f,recvmsg
1,02065754600,02065754900,00000000300,a2f,recvmsg
1,02065755400,02065759900,00000004500,a07,poll
1,02065769000,02065772700,00000003700,a2e,sendmsg
1,02065788500,02065812700,00000024200,a07,poll
1,02065813300,02065813500,00000000200,a00,read
1,02065820700,02065821700,00000001000,a2f,recvmsg
1,02065885500,02065888000,00000002500,a07,poll
1,02066202600,02066203900,00000001300,a2f,recvmsg
1,02064748600,02066955100,00002206500,a17,select
1,02066974800,02066975000,00000000200,a2f,recvmsg
1,02066987600,02066987800,00000000200,a2f,recvmsg
1,02066988300,02067049100,00000060800,a17,select
1,02067053000,02067053200,00000000200,a2f,recvmsg
1,02067527600,02067555400,00000027800,60e,page_fault
1,55921366300,02069388700,-53851977600,a23,nanosleep
1,02069408100,02069453700,00000045600,a00,read
1,02069471700,02069489400,00000017700,a00,read
1,02069494600,02069494900,00000000300,a00,read
1,02069502400,02069507000,00000004600,a02,open
1,02066206400,02070796600,00004590200,a07,poll
1,02070801500,02070834000,00000032500,aca,futex
1,02070852100,02070852800,00000000700,a00,read
1,02070855300,02070856300,00000001000,a2e,sendmsg
1,02032607400,02070873200,00038265800,ae8,epoll_wait
1,02070878200,02070880400,00000002200,a2f,recvmsg
1,02070893800,02070894000,00000000200,a2f,recvmsg
1,02070925400,02070926100,00000000700,a2e,sendmsg
1,02070870000,02070936800,00000066800,a07,poll
1,02071001300,02071002000,00000000700,a2f,recvmsg
1,02071004200,02071004400,00000000200,a00,read
1,02071035400,02071037200,00000001800,aca,futex
1,01988695500,02077696500,00089001000,a3d,wait4
1,02077720000,02077721900,00000001900,a00,read
1,02077723900,02077724200,00000000300,a00,read
1,02077745400,02077797300,00000051900,a07,poll
1,02077803200,02077803400,00000000200,a2f,recvmsg
1,02077804300,02077804500,00000000200,a2f,recvmsg
1,02077812400,02077827800,00000015400,a07,poll
1,02077829900,02077830100,00000000200,a2f,recvmsg
1,02077830500,02077830700,00000000200,a2f,recvmsg
1,02077836000,02077849600,00000013600,a07,poll
1,02077851800,02077852000,00000000200,a2f,recvmsg
1,02077852400,02077852500,00000000100,a2f,recvmsg
1,02077856400,02077869800,00000013400,a07,poll
1,02077871800,02077872000,00000000200,a2f,recvmsg
1,02077872400,02077872600,00000000200,a2f,recvmsg
1,02077877600,02077890800,00000013200,a07,poll
1,02077892900,02077893100,00000000200,a2f,recvmsg
1,02077893500,02077893700,00000000200,a2f,recvmsg
1,02077896900,02077910300,00000013400,a07,poll
1,02077912400,02077912600,00000000200,a2f,recvmsg
1,02077913000,02077913200,00000000200,a2f,recvmsg
1,02077914100,02077914400,00000000300,a08,lseek
1,02077925400,02077925500,00000000100,a08,lseek
1,02077928600,02077935600,00000007000,a07,poll
1,02077936900,02077937000,00000000100,a2f,recvmsg
1,02077937400,02077937600,00000000200,a2f,recvmsg
1,02077943600,02077950300,00000006700,a07,poll
1,02077951600,02077951700,00000000100,a2f,recvmsg
1,02077952100,02077952300,00000000200,a2f,recvmsg
1,02077955300,02077962100,00000006800,a07,poll
1,02077963200,02077963400,00000000200,a2f,recvmsg
1,02077963700,02077963900,00000000200,a2f,recvmsg
1,02077967400,02077973800,00000006400,a07,poll
1,02077975000,02077975100,00000000100,a2f,recvmsg
1,02077975500,02077975700,00000000200,a2f,recvmsg
1,02077978900,02077985700,00000006800,a07,poll
1,02077987000,02077987200,00000000200,a2f,recvmsg
1,02077987400,02077987600,00000000200,a2f,recvmsg
1,02077991100,02077997800,00000006700,a07,poll
1,02077999000,02077999200,00000000200,a2f,recvmsg
1,02077999500,02077999700,00000000200,a2f,recvmsg
1,02078002900,02078009800,00000006900,a07,poll
1,02078011000,02078011100,00000000100,a2f,recvmsg
1,02078011500,02078011600,00000000100,a2f,recvmsg
1,02078014400,02078021100,00000006700,a07,poll
1,02078022200,02078022400,00000000200,a2f,recvmsg
1,02078022700,02078022900,00000000200,a2f,recvmsg
1,02078027000,02078034100,00000007100,a07,poll
1,02078035200,02078035400,00000000200,a2f,recvmsg
1,02078035700,02078035900,00000000200,a2f,recvmsg
1,02078039100,02078045900,00000006800,a07,poll
1,02078047100,02078047200,00000000100,a2f,recvmsg
1,02078047500,02078047700,00000000200,a2f,recvmsg
1,02078050800,02078057600,00000006800,a07,poll
1,02078059600,02078059700,00000000100,a2f,recvmsg
1,02078060000,02078060200,00000000200,a2f,recvmsg
1,02078064100,02078071000,00000006900,a07,poll
1,02078072100,02078072200,00000000100,a2f,recvmsg
1,02078072500,02078072700,00000000200,a2f,recvmsg
1,02078075700,02078082300,00000006600,a07,poll
1,02078083500,02078083600,00000000100,a2f,recvmsg
1,02078083900,02078084100,00000000200,a2f,recvmsg
1,02078087400,02078094300,00000006900,a07,poll
1,02078095400,02078095600,00000000200,a2f,recvmsg
1,02078095800,02078096000,00000000200,a2f,recvmsg
1,02078099100,02078105900,00000006800,a07,poll
1,02078107100,02078107200,00000000100,a2f,recvmsg
1,02078107500,02078107700,00000000200,a2f,recvmsg
1,02078110400,02078117300,00000006900,a07,poll
1,02078118400,02078118500,00000000100,a2f,recvmsg
1,02078118800,02078119000,00000000200,a2f,recvmsg
1,02078124400,02078131200,00000006800,a07,poll
1,02078132400,02078132600,00000000200,a2f,recvmsg
1,02078132900,02078133100,00000000200,a2f,recvmsg
1,02078135700,02078142500,00000006800,a07,poll
1,02078143600,02078143800,00000000200,a2f,recvmsg
1,02078144100,02078144300,00000000200,a2f,recvmsg
1,02078147000,02078153700,00000006700,a07,poll
1,02078154800,02078155000,00000000200,a2f,recvmsg
1,02078155300,02078155500,00000000200,a2f,recvmsg
1,02078158300,02078165200,00000006900,a07,poll
1,02078167100,02078167300,00000000200,a2f,recvmsg
1,02078167600,02078167800,00000000200,a2f,recvmsg
1,02078170700,02078177400,00000006700,a07,poll
1,02078178600,02078178700,00000000100,a2f,recvmsg
1,02078179000,02078179200,00000000200,a2f,recvmsg
1,02078182000,02078188700,00000006700,a07,poll
1,02078189800,02078190000,00000000200,a2f,recvmsg
1,02078190300,02078190500,00000000200,a2f,recvmsg
1,02078193700,02078200400,00000006700,a07,poll
1,02078201600,02078201800,00000000200,a2f,recvmsg
1,02078202100,02078202200,00000000100,a2f,recvmsg
1,02078205600,02078212400,00000006800,a07,poll
1,02078213500,02078213700,00000000200,a2f,recvmsg
1,02078214000,02078214200,00000000200,a2f,recvmsg
1,02078219200,02078226400,00000007200,a07,poll
1,02078227500,02078227700,00000000200,a2f,recvmsg
1,02078228000,02078228200,00000000200,a2f,recvmsg
1,02078231800,02078238500,00000006700,a07,poll
1,02078239700,02078239800,00000000100,a2f,recvmsg
1,02078240100,02078240200,00000000100,a2f,recvmsg
1,02078243700,02078250500,00000006800,a07,poll
1,02078251600,02078251800,00000000200,a2f,recvmsg
1,02078252100,02078252300,00000000200,a2f,recvmsg
1,02078257500,02078264500,00000007000,a07,poll
1,02078265600,02078265800,00000000200,a2f,recvmsg
1,02078266100,02078266300,00000000200,a2f,recvmsg
1,02078269300,02078276200,00000006900,a07,poll
1,02078277300,02078277500,00000000200,a2f,recvmsg
1,02078277800,02078278000,00000000200,a2f,recvmsg
1,02078282000,02078288900,00000006900,a07,poll
1,02078289900,02078290100,00000000200,a2f,recvmsg
1,02078290400,02078290600,00000000200,a2f,recvmsg
1,02078294300,02078301100,00000006800,a07,poll
1,02078302400,02078302500,00000000100,a2f,recvmsg
1,02078302800,02078303000,00000000200,a2f,recvmsg
1,02078306400,02078313200,00000006800,a07,poll
1,02078314400,02078314600,00000000200,a2f,recvmsg
1,02078314900,02078315100,00000000200,a2f,recvmsg
1,02078318800,02078325700,00000006900,a07,poll
1,02078326900,02078327100,00000000200,a2f,recvmsg
1,02078327400,02078327500,00000000100,a2f,recvmsg
1,02078331000,02078337800,00000006800,a07,poll
1,02078338900,02078339000,00000000100,a2f,recvmsg
1,02078339300,02078339500,00000000200,a2f,recvmsg
1,02078342500,02078349100,00000006600,a07,poll
1,02078350300,02078350400,00000000100,a2f,recvmsg
1,02078350700,02078350900,00000000200,a2f,recvmsg
1,02078353800,02078360500,00000006700,a07,poll
1,02078361800,02078362000,00000000200,a2f,recvmsg
1,02078362300,02078362400,00000000100,a2f,recvmsg
1,02078365700,02078372700,00000007000,a07,poll
1,02078373800,02078373900,00000000100,a2f,recvmsg
1,02078374200,02078374400,00000000200,a2f,recvmsg
1,02078375300,02078375500,00000000200,a08,lseek
1,02078378400,02078379700,00000001300,a00,read
1,02078383300,02078383400,00000000100,a08,lseek
1,02078386400,02078393100,00000006700,a07,poll
1,02078394400,02078394500,00000000100,a2f,recvmsg
1,02078394900,02078395100,00000000200,a2f,recvmsg
1,02078420000,02078426800,00000006800,a07,poll
1,02078428200,02078428300,00000000100,a2f,recvmsg
1,02078428700,02078428800,00000000100,a2f,recvmsg
1,02078432500,02078433400,00000000900,a00,read
1,02078438800,02078438900,00000000100,a08,lseek
1,02078442300,02078449100,00000006800,a07,poll
1,02078450300,02078450500,00000000200,a2f,recvmsg
1,02078450800,02078451000,00000000200,a2f,recvmsg
1,02078453700,02078460500,00000006800,a07,poll
1,02078461600,02078461800,00000000200,a2f,recvmsg
1,02078462100,02078462300,00000000200,a2f,recvmsg
1,02078464900,02078471700,00000006800,a07,poll
1,02078472800,02078473000,00000000200,a2f,recvmsg
1,02078473300,02078473500,00000000200,a2f,recvmsg
1,02078476100,02078482800,00000006700,a07,poll
1,02078483900,02078484100,00000000200,a2f,recvmsg
1,02078484400,02078484600,00000000200,a2f,recvmsg
1,02078487300,02078494100,00000006800,a07,poll
1,02078495200,02078495400,00000000200,a2f,recvmsg
1,02078495700,02078495900,00000000200,a2f,recvmsg
1,02078498600,02078505400,00000006800,a07,poll
1,02078506500,02078506700,00000000200,a2f,recvmsg
1,02078507000,02078507200,00000000200,a2f,recvmsg
1,02078509900,02078516500,00000006600,a07,poll
1,02078517600,02078517800,00000000200,a2f,recvmsg
1,02078518100,02078518300,00000000200,a2f,recvmsg
1,02078521600,02078528500,00000006900,a07,poll
1,02078529600,02078529800,00000000200,a2f,recvmsg
1,02078530100,02078530300,00000000200,a2f,recvmsg
1,02078533100,02078540000,00000006900,a07,poll
1,02078541000,02078541200,00000000200,a2f,recvmsg
1,02078541500,02078541700,00000000200,a2f,recvmsg
1,02078542200,02078542200,00000000000,a08,lseek
1,02078546400,02078553200,00000006800,a07,poll
1,02078554400,02078554500,00000000100,a2f,recvmsg
1,02078554900,02078555100,00000000200,a2f,recvmsg
1,02078560000,02078566900,00000006900,a07,poll
1,02078568100,02078568300,00000000200,a2f,recvmsg
1,02078568700,02078568800,00000000100,a2f,recvmsg
1,02078572200,02078578800,00000006600,a07,poll
1,02078580000,02078580200,00000000200,a2f,recvmsg
1,02078580400,02078580600,00000000200,a2f,recvmsg
1,02078583700,02078590400,00000006700,a07,poll
1,02078591600,02078591700,00000000100,a2f,recvmsg
1,02078592000,02078592200,00000000200,a2f,recvmsg
1,02078595200,02078601800,00000006600,a07,poll
1,02078603100,02078603200,00000000100,a2f,recvmsg
1,02078603600,02078603700,00000000100,a2f,recvmsg
1,02078606800,02078613600,00000006800,a07,poll
1,02078614700,02078614900,00000000200,a2f,recvmsg
1,02078615200,02078615400,00000000200,a2f,recvmsg
1,02078618900,02078625600,00000006700,a07,poll
1,02078626700,02078626900,00000000200,a2f,recvmsg
1,02078627200,02078627400,00000000200,a2f,recvmsg
1,02078630400,02078637200,00000006800,a07,poll
1,02078638300,02078638500,00000000200,a2f,recvmsg
1,02078638800,02078639000,00000000200,a2f,recvmsg
1,02078642100,02078648600,00000006500,a07,poll
1,02078649800,02078649900,00000000100,a2f,recvmsg
1,02078650300,02078650500,00000000200,a2f,recvmsg
1,02078653500,02078660200,00000006700,a07,poll
1,02078661300,02078661500,00000000200,a2f,recvmsg
1,02078661800,02078661900,00000000100,a2f,recvmsg
1,02078664800,02078671500,00000006700,a07,poll
1,02078672700,02078672800,00000000100,a2f,recvmsg
1,02078673200,02078673300,00000000100,a2f,recvmsg
1,02078676400,02078683000,00000006600,a07,poll
1,02078684200,02078684300,00000000100,a2f,recvmsg
1,02078684700,02078684800,00000000100,a2f,recvmsg
1,02078688300,02078695100,00000006800,a07,poll
1,02078696200,02078696400,00000000200,a2f,recvmsg
1,02078696700,02078696900,00000000200,a2f,recvmsg
1,02078699900,02078706700,00000006800,a07,poll
1,02078707800,02078707900,00000000100,a2f,recvmsg
1,02078708200,02078708400,00000000200,a2f,recvmsg
1,02078711300,02078718000,00000006700,a07,poll
1,02078719100,02078719300,00000000200,a2f,recvmsg
1,02078719600,02078719800,00000000200,a2f,recvmsg
1,02078722700,02078729700,00000007000,a07,poll
1,02078730800,02078731000,00000000200,a2f,recvmsg
1,02078731300,02078731500,00000000200,a2f,recvmsg
1,02078739900,02078746700,00000006800,a07,poll
1,02078747800,02078748000,00000000200,a2f,recvmsg
1,02078748300,02078748500,00000000200,a2f,recvmsg
1,02078751700,02078758400,00000006700,a07,poll
1,02078759500,02078759700,00000000200,a2f,recvmsg
1,02078760000,02078760200,00000000200,a2f,recvmsg
1,02078763200,02078769900,00000006700,a07,poll
1,02078771000,02078771200,00000000200,a2f,recvmsg
1,02078771500,02078771700,00000000200,a2f,recvmsg
1,02078775000,02078781600,00000006600,a07,poll
1,02078782700,02078782900,00000000200,a2f,recvmsg
1,02078783100,02078783300,00000000200,a2f,recvmsg
1,02078786300,02078793000,00000006700,a07,poll
1,02078794200,02078794400,00000000200,a2f,recvmsg
1,02078794700,02078794900,00000000200,a2f,recvmsg
1,02078815500,02078842600,00000027100,a57,unlink
1,02078844000,02078848100,00000004100,a14,writev
1,02078848700,02078946800,00000098100,a07,poll
1,02078950000,02078950900,00000000900,a00,read
1,02078964400,02078964500,00000000100,a2f,recvmsg
1,02079005400,02079026600,00000021200,a07,poll
1,02079027900,02079082800,00000054900,a07,poll
1,02079083800,02079138300,00000054500,a07,poll
1,02079139300,02079194400,00000055100,a07,poll
1,02079195600,02079251600,00000056000,a07,poll
1,02079253600,02079328000,00000074400,a07,poll
1,02079329300,02079372200,00000042900,a07,poll
1,02079373300,02079416200,00000042900,a07,poll
1,02079418500,02079459600,00000041100,a07,poll
1,02079460600,02079503100,00000042500,a07,poll
1,02079504000,02079545900,00000041900,a07,poll
1,02079547000,02079599200,00000052200,a07,poll
1,02079600300,02079618000,00000017700,a07,poll
1,02079619100,02079634600,00000015500,a07,poll
1,02079635600,02079650500,00000014900,a07,poll
1,02079651800,02079665000,00000013200,a07,poll
1,02079666000,02079679500,00000013500,a07,poll
1,02079680600,02079685500,00000004900,a07,poll
1,02079687900,02079688100,00000000200,a2f,recvmsg
1,02079688800,02079689000,00000000200,a2f,recvmsg
1,02079680600,02079710300,00000029700,a07,poll
1,02079710700,02079712300,00000001600,a2f,recvmsg
1,02079715800,02079717300,00000001500,a2d,recvfrom
1,02079721900,02079722100,00000000200,a2f,recvmsg
1,02079722700,02079722900,00000000200,a2f,recvmsg
1,02079781300,02079781600,00000000300,a2f,recvmsg
1,02079783900,02079784100,00000000200,a2f,recvmsg
1,02079796000,02079923300,00000127300,a07,poll
1,02079924000,02079925600,00000001600,a2f,recvmsg
1,02079932500,02079933300,00000000800,a2d,recvfrom
1,02079934400,02079934600,00000000200,a2f,recvmsg
1,02079935300,02079935400,00000000100,a2f,recvmsg
1,02079968000,02079968300,00000000300,a2f,recvmsg
1,02079970800,02079971000,00000000200,a2f,recvmsg
1,02079974100,02079976700,00000002600,a07,poll
1,02079979100,02079979300,00000000200,a2f,recvmsg
1,02079979800,02079980000,00000000200,a2f,recvmsg
1,02080544700,02080552400,00000007700,a02,open
1,02080563500,02080566600,00000003100,a00,read
1,02080617800,02080618800,00000001000,a00,read
1,02080666800,02080667500,00000000700,a00,read
1,02080713400,02080714100,00000000700,a00,read
1,02080760700,02080761400,00000000700,a00,read
1,02080807000,02080807700,00000000700,a00,read
1,02080851700,02080852400,00000000700,a00,read
1,02080897200,02080897900,00000000700,a00,read
1,02080945300,02080945900,00000000600,a00,read
1,02080993800,02080994500,00000000700,a00,read
1,02081041100,02081041700,00000000600,a00,read
1,02081069500,02081071200,00000001700,a02,open
1,02081074600,02081075500,00000000900,a00,read
1,02081130900,02081131800,00000000900,a00,read
1,02081213700,02081214600,00000000900,a00,read
1,02081285400,02081286100,00000000700,a00,read
1,02081362100,02081362800,00000000700,a00,read
1,02081440200,02081440900,00000000700,a00,read
1,02081516400,02081517200,00000000800,a00,read
1,02081599700,02081600400,00000000700,a00,read
1,02081666500,02081667300,00000000800,a00,read
1,02081724200,02081724900,00000000700,a00,read
1,02081800300,02081821000,00000020700,a07,poll
1,02081824200,02081824400,00000000200,a2f,recvmsg
1,02081825100,02081825300,00000000200,a2f,recvmsg
1,02081828500,02081836100,00000007600,a07,poll
1,02081837600,02081837800,00000000200,a2f,recvmsg
1,02081838100,02081838300,00000000200,a2f,recvmsg
1,02081842500,02081848700,00000006200,a06,lstat
1,02081849600,02081850500,00000000900,a06,lstat
1,02081872400,02081886900,00000014500,a01,write
1,02081892400,02081899500,00000007100,a07,poll
1,02081901400,02081901500,00000000100,a2f,recvmsg
1,02081902000,02081902200,00000000200,a2f,recvmsg
1,02081903500,02082213500,00000310000,a38,clone
1,02081892400,02082717200,00000824800,a07,poll
1,02082721400,02082722200,00000000800,a00,read
1,02082846300,02082847300,00000001000,a2f,recvmsg
1,02082849500,02082849600,00000000100,a00,read
1,02082903600,02082907400,00000003800,a07,poll
1,02082991900,02082995300,00000003400,a07,poll
1,02082999200,02083003300,00000004100,a2e,sendmsg
1,02083007900,02083008100,00000000200,a00,read
1,02083088300,02083088400,00000000100,a0c,brk
1,02083100300,02083104100,00000003800,a15,access
1,02083104700,02083105700,00000001000,a09,mmap
1,02083112000,02083113000,00000001000,a15,access
1,02083119500,02083120600,00000001100,a09,mmap
1,02083124300,02083124900,00000000600,a15,access
1,02083132600,02083134200,00000001600,a00,read
1,02083135800,02083137500,00000001700,a09,mmap
1,02083141500,02083143800,00000002300,a09,mmap
1,02083150300,02083168800,00000018500,60e,page_fault
1,02083171200,02083172300,00000001100,a15,access
1,02083176300,02083177200,00000000900,a00,read
1,02083178100,02083179500,00000001400,a09,mmap
1,02083182400,02083184100,00000001700,a09,mmap
1,02083193200,02083193700,00000000500,a15,access
1,02083197000,02083197600,00000000600,a00,read
1,02083198300,02083199400,00000001100,a09,mmap
1,02083201000,02083203000,00000002000,a09,mmap
1,02083207500,02083210500,00000003000,a09,mmap
1,02083212700,02083213800,00000001100,a09,mmap
1,02083223700,02083224500,00000000800,a15,access
1,02083227300,02083227900,00000000600,a00,read
1,02083228600,02083230100,00000001500,a09,mmap
1,02083233000,02083235000,00000002000,a09,mmap
1,02083243400,02083244000,00000000600,a15,access
1,02083247200,02083247900,00000000700,a00,read
1,02083248500,02083250100,00000001600,a09,mmap
1,02083253600,02083275400,00000021800,a09,mmap
1,02083285100,02083285800,00000000700,a15,access
1,02083286600,02083297400,00000010800,a02,open
1,02083297500,02083298400,00000000900,a00,read
1,02083299000,02083300600,00000001600,a09,mmap
1,02083302100,02083303700,00000001600,a09,mmap
1,02083307200,02083308800,00000001600,a09,mmap
1,02083315800,02083316600,00000000800,a15,access
1,02083319800,02083320300,00000000500,a00,read
1,02083320900,02083322600,00000001700,a09,mmap
1,02083325000,02083326700,00000001700,a09,mmap
1,02083341100,02083341700,00000000600,a09,mmap
1,02083345500,02083345900,00000000400,a09,mmap
1,02083347100,02083347300,00000000200,a09,mmap
1,02083537800,02083538000,00000000200,a0c,brk
1,02083538100,02083539000,00000000900,a0c,brk
1,02083567600,02083674700,00000107100,a00,read
1,02083690500,02083692400,00000001900,a00,read
1,02083729400,02083730400,00000001000,a00,read
1,02083852600,02083853500,00000000900,a00,read
1,02083924200,02083924700,00000000500,a00,read
1,02084009900,02084010400,00000000500,a00,read
1,02084142600,02084143400,00000000800,a00,read
1,02084272100,02084272900,00000000800,a00,read
1,02084429100,02084429900,00000000800,a00,read
1,02084580100,02084580600,00000000500,a00,read
1,02084617400,02084618900,00000001500,a0c,brk
1,02084734600,02084735300,00000000700,a00,read
1,02084883700,02084884400,00000000700,a00,read
1,02085040100,02085040900,00000000800,a00,read
1,02085200300,02085201100,00000000800,a00,read
1,02085309800,02085310500,00000000700,a00,read
1,02085341300,02085341900,00000000600,a0c,brk
1,02085450400,02085451200,00000000800,a00,read
1,02085695700,02085696300,00000000600,a00,read
1,02085708400,02085708900,00000000500,a00,read
1,02085753200,02085753600,00000000400,a00,read
1,02085773500,02085774100,00000000600,a00,read
1,02085982500,02085982800,00000000300,a00,read
1,02086012000,02086013000,00000001000,a00,read
1,02086110600,02086111300,00000000700,a00,read
1,02086135400,02086136500,00000001100,a0c,brk
1,02086182000,02086182300,00000000300,a00,read
1,02086258700,02086259500,00000000800,a00,read
1,02086415800,02086416200,00000000400,a00,read
1,02086528600,02086529300,00000000700,a00,read
1,02086623400,02086623900,00000000500,a00,read
1,02086635700,02086636200,00000000500,a00,read
1,02086718900,02086719300,00000000400,a00,read
1,02086742600,02086743000,00000000400,a00,read
1,02086765100,02086765600,00000000500,a00,read
1,02086866200,02086867400,00000001200,a0c,brk
1,02086869100,02086870000,00000000900,a00,read
1,02087069000,02087069400,00000000400,a00,read
1,02087154500,02087154900,00000000400,a00,read
1,02087219400,02087220000,00000000600,a00,read
1,02087366600,02087367000,00000000400,a00,read
1,02087399300,02087399900,00000000600,a00,read
1,02087416400,02087417900,00000001500,a02,open
1,02087532500,02087533000,00000000500,a00,read
1,02087604000,02087604400,00000000400,a00,read
1,02087657000,02087658200,00000001200,a0c,brk
1,02087664400,02087665200,00000000800,a00,read
1,02087774100,02087774700,00000000600,a00,read
1,02087924400,02087925300,00000000900,a00,read
1,02088055100,02088055700,00000000600,a00,read
1,02088112800,02088113600,00000000800,a00,read
1,02088169200,02088170000,00000000800,a00,read
1,02088239800,02088240500,00000000700,a00,read
1,02088293700,02088293700,00000000000,a00,read
1,02088381500,02088382300,00000000800,a0c,brk
1,02088413500,02088417600,00000004100,a0c,brk
1,02088432200,02088433200,00000001000,a00,read
1,02088547000,02088547800,00000000800,a00,read
1,02088706700,02088707300,00000000600,a00,read
1,02088824000,02088824700,00000000700,a00,read
1,02088969500,02088970100,00000000600,a00,read
1,02089087400,02089088100,00000000700,a00,read
1,02089248900,02089249700,00000000800,a00,read
1,02089254600,02089255400,00000000800,a0c,brk
1,02089370100,02089370800,00000000700,a00,read
1,02089488100,02089488800,00000000700,a00,read
1,02089631400,02089632200,00000000800,a00,read
1,02089762400,02089763100,00000000700,a00,read
1,02089855300,02089856000,00000000700,a00,read
1,02089967900,02089968700,00000000800,a00,read
1,02090092000,02090092700,00000000700,a00,read
1,02090203800,02090204300,00000000500,a0c,brk
1,02067053700,02090211500,00023157800,a17,select
1,02090227200,02090227700,00000000500,a00,read
1,02090397600,02090398200,00000000600,a00,read
1,02090547700,02090548300,00000000600,a00,read
1,02090658200,02090658900,00000000700,a00,read
1,02090825700,02090826500,00000000800,a00,read
1,02090903100,02090903700,00000000600,a00,read
1,02090984900,02090985600,00000000700,a00,read
1,02091052300,02091053000,00000000700,a0c,brk
1,02091066700,02091067300,00000000600,a00,read
1,02091139900,02091140700,00000000800,a00,read
1,02091242300,02091243000,00000000700,a00,read
1,02091251000,02091255200,00000004200,60e,page_fault
1,02091349000,02091349700,00000000700,a00,read
1,02091438400,02091439200,00000000800,a00,read
1,02091519700,02091520400,00000000700,a00,read
1,02091620800,02091621400,00000000600,a00,read
1,02091701600,02091702000,00000000400,a0c,brk
1,02091704500,02091705200,00000000700,a00,read
1,02091813300,02091813900,00000000600,a00,read
1,02091906100,02091906800,00000000700,a00,read
1,02092025200,02092025900,00000000700,a00,read
1,02092138700,02092139300,00000000600,a00,read
1,02092241800,02092242500,00000000700,a00,read
1,02092342500,02092342900,00000000400,a0c,brk
1,02092700300,02092703600,00000003300,a57,unlink
1,02092729000,02092729500,00000000500,a48,fcntl
1,02092777100,02092792300,00000015200,a01,write
1,02092810200,02092812900,00000002700,a01,write
1,02092829300,02092831600,00000002300,a01,write
1,02090226300,02093070300,00002844000,a17,select
1,02093094900,02093095200,00000000300,a2f,recvmsg
1,02093098900,02093120400,00000021500,a17,select
1,02093124300,02093124500,00000000200,a2f,recvmsg
1,02093125100,02093139500,00000014400,a17,select
1,02093142900,02093143100,00000000200,a2f,recvmsg
1,02093143600,02093157900,00000014300,a17,select
1,02093161700,02093161900,00000000200,a2f,recvmsg
1,02093162400,02093176200,00000013800,a17,select
1,02093180300,02093180500,00000000200,a2f,recvmsg
1,02093181000,02093195000,00000014000,a17,select
1,02093198400,02093198500,00000000100,a2f,recvmsg
1,02093199000,02093223100,00000024100,a17,select
1,02093227100,02093227200,00000000100,a2f,recvmsg
1,02093227700,02093236500,00000008800,a17,select
1,02093240200,02093240400,00000000200,a2f,recvmsg
1,02093240800,02093248200,00000007400,a17,select
1,02093252000,02093252100,00000000100,a2f,recvmsg
1,02093252600,02093260400,00000007800,a17,select
1,02093263800,02093264000,00000000200,a2f,recvmsg
1,02093264500,02093272100,00000007600,a17,select
1,02093275700,02093275900,00000000200,a2f,recvmsg
1,02093276400,02093284900,00000008500,a17,select
1,02093288500,02093288600,00000000100,a2f,recvmsg
1,02093289200,02093296600,00000007400,a17,select
1,02093300400,02093300600,00000000200,a2f,recvmsg
1,02093301200,02093308300,00000007100,a17,select
1,02093311800,02093312000,00000000200,a2f,recvmsg
1,02093312500,02093321100,00000008600,a17,select
1,02093325000,02093325200,00000000200,a2f,recvmsg
1,02093325700,02093333100,00000007400,a17,select
1,02093336800,02093336900,00000000100,a2f,recvmsg
1,02093337500,02093344900,00000007400,a17,select
1,02093348600,02093348800,00000000200,a2f,recvmsg
1,02093349300,02093356500,00000007200,a17,select
1,02093360200,02093360300,00000000100,a2f,recvmsg
1,02093360800,02093368100,00000007300,a17,select
1,02093371700,02093371800,00000000100,a2f,recvmsg
1,02093372400,02093379700,00000007300,a17,select
1,02093383300,02093383500,00000000200,a2f,recvmsg
1,02093384000,02093391300,00000007300,a17,select
1,02093394900,02093395100,00000000200,a2f,recvmsg
1,02093395700,02093402500,00000006800,a17,select
1,02093406200,02093406400,00000000200,a2f,recvmsg
1,02093406900,02093416800,00000009900,a17,select
1,02093420400,02093420600,00000000200,a2f,recvmsg
1,02093421100,02093428000,00000006900,a17,select
1,02093431700,02093431900,00000000200,a2f,recvmsg
1,02093432400,02093439300,00000006900,a17,select
1,02093443000,02093443200,00000000200,a2f,recvmsg
1,02093443800,02093451500,00000007700,a17,select
1,02093455200,02093455300,00000000100,a2f,recvmsg
1,02093455800,02093463100,00000007300,a17,select
1,02093466700,02093466700,00000000000,a2f,recvmsg
1,02093467300,02093474300,00000007000,a17,select
1,02093478000,02093478100,00000000100,a2f,recvmsg
1,02093478700,02093486000,00000007300,a17,select
1,02093489800,02093490000,00000000200,a2f,recvmsg
1,02093490600,02093498100,00000007500,a17,select
1,02093501800,02093502000,00000000200,a2f,recvmsg
1,02093502600,02093510400,00000007800,a17,select
1,02093514400,02093514500,00000000100,a2f,recvmsg
1,02093515100,02093522700,00000007600,a17,select
1,02093526300,02093526500,00000000200,a2f,recvmsg
1,02093527000,02093534700,00000007700,a17,select
1,02093538500,02093538700,00000000200,a2f,recvmsg
1,02093539100,02093548600,00000009500,a17,select
1,02093552300,02093552500,00000000200,a2f,recvmsg
1,02093553000,02093560300,00000007300,a17,select
1,02093563900,02093564100,00000000200,a2f,recvmsg
1,02093564600,02093572000,00000007400,a17,select
1,02093575800,02093576000,00000000200,a2f,recvmsg
1,02093576500,02093584500,00000008000,a17,select
1,02093588300,02093588400,00000000100,a2f,recvmsg
1,02093589000,02093596700,00000007700,a17,select
1,02093600300,02093600500,00000000200,a2f,recvmsg
1,02093601000,02093609100,00000008100,a17,select
1,02093612800,02093613000,00000000200,a2f,recvmsg
1,02093613400,02093620900,00000007500,a17,select
1,02093624600,02093624800,00000000200,a2f,recvmsg
1,02093625300,02093632500,00000007200,a17,select
1,02093636200,02093636400,00000000200,a2f,recvmsg
1,02093636900,02093644100,00000007200,a17,select
1,02093647600,02093647700,00000000100,a2f,recvmsg
1,02093648300,02093655900,00000007600,a17,select
1,02093659700,02093659900,00000000200,a2f,recvmsg
1,02093660400,02093675700,00000015300,a17,select
1,02093679300,02093679400,00000000100,a2f,recvmsg
1,02093679900,02093710500,00000030600,a17,select
1,02093714400,02093714600,00000000200,a2f,recvmsg
1,02093715100,02093732900,00000017800,a17,select
1,02093736600,02093736700,00000000100,a2f,recvmsg
1,02093737300,02093744500,00000007200,a17,select
1,02093748000,02093748100,00000000100,a2f,recvmsg
1,02093748700,02093755500,00000006800,a17,select
1,02093759100,02093759300,00000000200,a2f,recvmsg
1,02093759700,02093766800,00000007100,a17,select
1,02093770400,02093770600,00000000200,a2f,recvmsg
1,02093771000,02093778100,00000007100,a17,select
1,02093781700,02093781900,00000000200,a2f,recvmsg
1,02093782300,02093789200,00000006900,a17,select
1,02093792800,02093792900,00000000100,a2f,recvmsg
1,02093793500,02093800300,00000006800,a17,select
1,02093803700,02093803900,00000000200,a2f,recvmsg
1,02093804400,02093811900,00000007500,a17,select
1,02093815700,02093815800,00000000100,a2f,recvmsg
1,02093816300,02093823300,00000007000,a17,select
1,02093826800,02093827000,00000000200,a2f,recvmsg
1,02093827500,02093836200,00000008700,a17,select
1,02093839700,02093839900,00000000200,a2f,recvmsg
1,02093840400,02093849600,00000009200,a17,select
1,02093853300,02093853500,00000000200,a2f,recvmsg
1,02093854000,02093861700,00000007700,a17,select
1,02093865400,02093865500,00000000100,a2f,recvmsg
1,02093866000,02093873300,00000007300,a17,select
1,02093876800,02093877000,00000000200,a2f,recvmsg
1,02093877400,02093884700,00000007300,a17,select
1,02093888200,02093888400,00000000200,a2f,recvmsg
1,02093888800,02093896000,00000007200,a17,select
1,02093899500,02093899700,00000000200,a2f,recvmsg
1,02093900100,02093907900,00000007800,a17,select
1,02093911400,02093911600,00000000200,a2f,recvmsg
1,02093912100,02093919300,00000007200,a17,select
1,02093922800,02093923000,00000000200,a2f,recvmsg
1,02093923600,02093930900,00000007300,a17,select
1,02093934400,02093934500,00000000100,a2f,recvmsg
1,02093935100,02093942300,00000007200,a17,select
1,02093945900,02093946100,00000000200,a2f,recvmsg
1,02093946600,02093953900,00000007300,a17,select
1,02093957600,02093957800,00000000200,a2f,recvmsg
1,02093958300,02093965600,00000007300,a17,select
1,02093969100,02093969300,00000000200,a2f,recvmsg
1,02093969800,02093977700,00000007900,a17,select
1,02093981300,02093981500,00000000200,a2f,recvmsg
1,02093981900,02093989200,00000007300,a17,select
1,02093992900,02093993000,00000000100,a2f,recvmsg
1,02093993500,02094000600,00000007100,a17,select
1,02094004400,02094004400,00000000000,a2f,recvmsg
1,02094005000,02094012200,00000007200,a17,select
1,02094015800,02094015900,00000000100,a2f,recvmsg
1,02094016400,02094029100,00000012700,a17,select
1,02094032800,02094032900,00000000100,a2f,recvmsg
1,02094033400,02094040800,00000007400,a17,select
1,02094044300,02094044500,00000000200,a2f,recvmsg
1,02094045000,02094052200,00000007200,a17,select
1,02094055900,02094056100,00000000200,a2f,recvmsg
1,02094056600,02094064100,00000007500,a17,select
1,02094067600,02094067700,00000000100,a2f,recvmsg
1,02094068200,02094075800,00000007600,a17,select
1,02094079300,02094079500,00000000200,a2f,recvmsg
1,02094080000,02094135800,00000055800,a17,select
1,02094136700,02094137800,00000001100,a2f,recvmsg
1,02094536400,02094537000,00000000600,a2f,recvmsg
